################################################
#. \*@ W\ . @* ...  ..\ \ \ .    .\   *.*. *..\#
#\*.. * .\**** *\\ . \*@ .  *.\.*\ \..*....**. #
#..\\.\. *...\*....\  .. *\..***\...* *...  **.#
#\ * *  . *....... **.\*..   ....* *. ** . ****#
#* **.  \***.. ..\\.*.\..* \.  .\. .* ....*.\. #
#....**\.. * **     . !..\....  * . .\* ..\ !..#
#\*\.*..   \..*.*. .. .\ *.\. . .*\\... * *.\..#
#*.*.\.* * *  **.....\ .* \. .. .* ..*\ * * .*.#
#. *.* . ** .\\..\\\\ . *\.\ . .*....\...*..\ \#
#.\. ..*...* .\\.***. .*...* \...\*. ! ...   * #
#*.\..***. . *W...\ * .  *.*.\*. *   *. . \ ...#
#* *!*.\.*.\\.\.*  ..* *\.\* .* .\...**.  *. **#
#**. ..  . \.*. .*.. . \\ ! \ .\  \. ****..\.*.#
#\.* \    .* ..\.\\. **.  .\*.. \.  *.\.\. * ..#
#. *  *.\ .* *.*\ ..\ *.\*  \ *   .*.* .. . *! #
#.\*. \**\.. * *. .. ... . **.\* ...*. . **\*  #
#\ . \..** \*.. *.* \ . .  **\\*\ * !\*\\...* *#
# .\..   \ ..** ..*\ .\..\ \..*\  .*\ ..***.. .#
#\*.. .\.. ....\  ..*...   ..*\.***\ *. *..... #
#\   \  .\*\.  ..   *...@..** . *.......* *. \*#
#* @.! \. ...*  .* \.*.*...**. .\*..\.*\.  *.**#
#\. .\*.** *..  \*\. .........\  .*.. *  . .\*.#
#!\   .\*.    *.\*  .*\* \. . \....\ . ..\*. .*#
#\...\ .. .W .....***\\...  .* .* \ ** .\*....*#
#.\..*.\*.  .\. *..\...*. ..*\. . *\  \   \  *.#
# *...**.. ** \.. ** \ * .. . ***..\.\.*  *. .*#
# .\....  \....W.**.\.\\  .. ..\..   \ .*..   *#
#!  ** ..* . \.\ ..*.\@..*** *  .* .... .\ .  .#
#.... \.... .. *.**... .\..* ..*.*.*  \ \. * . #
#.\. .. *.\ \.** ..  \@.  ..*. *.*  \....\\**  #
#\.*..*.*.. *. .*.*\\ *\..  *\ *.. *  *.\. .*. #
#  .**  ** .*..*. . * ** \*.\**. \.*... .\*  \ #
# *... ...\.***..\. **.\..** **.*.  * **.*    *#
# .*\.  * **..\*.\ **\ ..*.\ .*.*.  ...* .*\.*.#
#*!.*...\.*.\  . *.\..*.** *  **    .*.**.\. ..#
#\ \\  * .\\ \. *.\   . . ..*\  \.....*.\.. .**#
#  .. .\  .* ..... .   \.    .  **\  **.    *W.#
#  .* .. * ** **\. ..   ** *.  ..\*...   ** * .#
#*.*....*.\.. .*.  . W.**.\.\*W.  \*\** \.\ *..#
#.*!*** * *. .*.* *. **\  . . .\ .. .**\. . ...#
#.. *\. *  . .**.\ . .*.  \*\ .\.\. .\...* ** .#
#*\ .\.\*....***\ .*. .\*\.\* . .\.* .  .  .*\.#
#.\..  .*\.   .*.  ..    . *. !\..\. *\*     . #
#..   \.\  *\\**. *   . . \..\*.\   *\ *    *.*#
#*.  ..\ .\ ...* ..*** .  *. .* . \ \ .\ *....*#
#*.    !   .*  .*  .  .*\ *   *. \.\*. . . . .*#
#\ .. * ... .\ .*.... . ... . \. .*.*\  * .. ..#
# . *..\*    * .\. .*.\   ..\ .** *  ..\.\ ..*.#
#.  .....  *.\.. . \. . .*.*  .* **  *\  .. \.\#
#\ *.*.... .*.*\.*.. *\ *...\ \.*\.... .  ... *#
#* *\* \ * .*.*.*W .*.\    .* .*..**.*  .**.  .#
#\. .  . .\..*.\.\** ..*\ * . .*. ...\  . *.*.*#
#   ** ..*.* .*   . \ .. !* *.\.* \.  \ *.*  .*#
#.* *\\*..\* *..**  *..\  ...\. *.\.\*.*.\*\ .\#
# \ .. \.\*...@..  ..\  ** *  \.. *  * . ...  .#
#\.. *   **** .\.   * .. ***\ **..**R *  . * ..#
#..**\ .*.\.* * ** \!*. . *  *.. .\.\**  *.. * #
#*. \.* .. *..* *.*  \ ..*.. \*.   \ .*....!  *#
#\\.W... ... .\..*. *\.* ..  ..*\*\ .*\. .\ .* #
#\.*.\  .\ ..\*.. \\. *..**!    .\*. ...*  ....#
# \ *. .**..*!.     \ \* *.*.* .\.\\...\ ..  *\#
#  .\*.*\....* .**.*.\ *\. .*******.*....  .\.*#
#..  @** .*  .* \ \ *.**..\. .**...... .* * . *#
#*\*....\*.**.\ .\... \* .*.\*.**\.. * .***\. W#
#** \**\  .* *  .\.*..\\.*\  .. ..*...*. ... **#
#*. \... *....*.***.\. .**. .*\.*\.. \.. \* ...#
#   .. \ \\.. .\.\\.\\. . .*    .*\.\.\*...  * #
#\*\**.* ...**\ *. \**.*.*.\. \\.  \.\.  ... ..#
# @..\     \..  . **..\.\\*.   .*...\ * .\  \ \#
#......\..*.. * *.!..\*. *. .. .*   *\.\ * *.\.#
#\ .. ...\.  *  ..... .*     *.*.* \. \*.  .  .#
# . @. .*..\.\ *   .\. . . ..*\ *\ .*  **.\*.. #
#* .........*  *** .** ..      ... \..**.. . ..#
#.*\ \ .*....\ *\.....\*..  . .\..* .*\  * *\  #
#*. \. *.  .. ...  .\  ** .\*.....\** *.*. * ..#
#  . \**** . . .\.*..\..  . **** *  \.. .\.****#
#\ ....   ..\ * .*....\*.. .**!. *.*.  .\..**. #
# ....** .  ** ..  * .*\.\.\.. \*. .!  \...\...#
#. * *.*..\*.*.***...**. *.*.*.\ \.... .* .. ..#
#.*. \\.**   *\ .. .*..* *...**   .  *  *. \\..#
#*...*\.\** *.    *** .\*. .*.. . *.\. @\. ... #
#\.\\ * **. \.*....\. ...  *...\*.*..*.*..\\...#
# *...\ .*.*..**.  ..   \* .\  .* * \. .**.  W.#
#..  .* *\ *.**\..**.\.*..\*  .\*.*  .. ..*\.*\#
#..\....**..*.\*..*! *.*.  .   *\ .   \  ..**..#
# .*.*.\*** .****   @*\.\.*  . @     *.  *..*..#
#.\* ..***. *..   .W*.. *.   . \ .* *.* .*. .**#
#. *\\\ .\.*  .  .*    .\.  !\ ....**.\.*.*. \ #
#\.*. . . * .**.**..  \ *.       .... *@  .\ . #
#  \  .\. .*\..**\. .*...\.*\ .\..\\.\...*... .#
#\*     ..\*.\..  . .* \. *. * **  \. .. .\. . #
#.    .**  ...\*   ***.\..\. . *...**  .. .. ..#
#\.\ *  *** .\*\   .  . * * .  \....  \***\  * #
#. !.*\ ..**.*. ....\* ..*.\... \..* *.**. * * #
#  .***. \ *\.*\.. ..*   *   **.***.*. ..\ . *.#
#\ **.*...*.   .*.** ** .*\* ..\.@. *... *. ..\#
#.......  .*.*..\*..*..*.*   .**.. .\*. .... \*#
#.   ..  *  .* ..*.\.* \\..\. \**.\\..\\ ..\@\.#
#..  .  ..*.\.... .* \.... *. *!.* .. .\ . **. #
# *   \ *.*.. \    ..*  \ .*.... *  .  .*  ...\#
#\.\ \. \.\* @.*. *  @\*...\ . ***.\.*** \ .*  #
#* *\  .\ *\.\ .*.. \...\.   \.\\@.....\\**\..\#
#*.*  *.....*. .  .@... *. **. *.* ...* .....*.#
#**\ *\..    *\  .  .... . ..  .\. .. * .\ .\. #
# ...***\ @ . . W*.\.\ ... * .\..***\. .*.\** .#
#.\   .  .* \.  ..***.@  \ \.   .*. \*  * **..*#
#\  .**..  ...*   ..\*...\. \  ***\...**. .\. .#
#\   *\ . .*\**...*\.\  ..... . ...\ \*\* .\. *#
#. * \.*.*  .*. ..* *!  \.\ . .****    .*.\.\..#
#  *.. .\* .  \* \*.\. *  .. *..**.\. * .... \ #
#  ....  ...\. .*.*. * ..  *  \..\. **.*!. ..  #
#. *\...\  .**.**.. ... *..*. .\.** .*   \ . .\#
#. *  *!.\* ..\.* @    *..\  ... .*  \....  . *#
#\ .\ .\ .\.* . .@* . ..*..  .*. \.* *. .*..  \#
#. *  **  .\    **.  ... \. *. \.*..*\* *.* * \#
# .\ *\  .\. .\...*..*.   * . *  \..\...\..\.. #
#.* .*..**..  ..* .\\***      .  .*.*   .  .  .#
#... *\..**    \.**...\.      *\*  . .\* \... \#
#   *.\.\    . .* ... *   * ....  **   . \ *. .#
# ..\.*..  ** ***.\  .** .. .*.  \.\.\*  ..*.* #
#  .* * * .\. ..\..\. ..\** \.. \  .*. *\.. \ *#
#  *.  .* *    .\. ...*\\*\ .** \* .... .*\..! #
#*  . .\.*...*** . .\ ...**.  *  .\\. .*. ..\*.#
#.. * . \.*!\.*..**.  *.\**  ...****\ *\@\* *.*#
#.   * .. *.  ** \ . \..*.  .\ *.\*  . *.*.\.\*#
#*** ..* .\  *\ .    .* .\*   ** ..***** \**\ .#
#*...*\*.**. *.* . \.\   *.\.  .*....*.. .*\  .#
#\ \ . \ *. ..*\*..... **.. .\ \*     .\...** .#
# .. *.  .   ..\*\ ..*.*..\*\**.\ *. *\ *  .\*.#
#.*\ . * * \. * !\ . .*   . .  . **.\* .\ .. . #
#\..*. .. * .\***  * *.** .* .**... **.*.. ..* #
#*.  \ **.. \*... *. .***. *\*  ..\*..**.*   *.#
#. ... *.** .. .\*. . \.\ \...   ** *.** . . ..#
#\  \  ..*  \*. .\\.\.  . ..*   \..*..*\ \. **.#
#.....  .... .\*\*.. * ..*\.\ * . *. ..*.\...* #
#.* .\..\.*.\       .\. \.    \ *.*   ..\ *\*\ #
#.\.\. ..****   **    \*..   .. * .**\\*.*.....#
#*..*  ... *.* *.* .. ..@*..\ \*.* \* .* .*..\ #
#.* *\\ *.....*\ .\ ..\ .\. \..\ \*\. \. ..* .\#
#\\ . *.\!..\ ..*. \*\* ..  . *.*. * * * \ ....#
#..*.\... ..  *.\. .*.. *. **.\ .  . .*  \ * **#
#\.*...*.*   \. .*... . *  .**. *\..**  *. \ . #
# \ \. . * *...**.\. * *.\. ..  . *\.*  .*. * .#
# ..\*   .\* .** *.\.*.\.\\ *.\   .**..\.W\*** #
#\  .*  .  .  \... *  * . .   . * .*.**    \.. #
#.\*\.  **.**.*\. @.\. \*  ..*\*\ * \..  .*.\ *#
#.**.* *.\*.*..*\..*. ....  ** ** *\*..\ \.   .#
#..\.. ..\* ..\** ...**..\*.**.*.  ....... \...#
#.***. *  \. .***.**...  *...\**!\.\.. \ * ..*.#
#* . \.. .. .\.*.*.. .*\.!!\   W\ .*.*\..*\.\..#
#* . . \** .\. ..*. . ....  *..\.**.\ ..\.. \**#
#\ .. * \\ .* .*\.*\* !*. * . ...*    **.**...*#
# *. .*  * .*. .*\*.. ... ** .  .*\..\...*.*  *#
#..***.*.*\*. .   .\  ** \.* * .*... *. **.....#
#*.*\. ..\*.*...*.*.. ..!.. \   .* *** *\*\ \.*#
#.\  ..*... .... ..*   **. .  * *..*\\\. . ...@#
#\\.   \.\****.\  **   ... .  *.. \.* ..* .**..#
# ..   .\*\ \. .. .* .\ *. \.*. **. \  \* *.*. #
# .\..**..*...*\**..* ..** *.. *. \ \.  . ...! #
#.\ .*  .\\.\ . .\*\* *..* * ...* ..  *  .   . #
#.* \. .... *\ \ .*.* .*..\*.*W.. .\*\*\   **\ #
#\*. .\. *  .*\. ...****.\ ..* \.!.....  .\. .*#
#**. \...\  .\  \ ....*  .*\.\.*.  .\* ....\  \#
#*..**\. ..*.  ...\. .. \ * * *..\.\.. \.\.** .#
#*.*.*.* ***\ .!.\*.**  .*.*.*\**..*.\.   .@*.*#
#.\\..*..*\** . *\.*...*\#.\**. .#.*. *...*...*#
# ..* .*@* .*.* .* ...\. **..*..  \ .**.\\**\!\#
#.*\  ..*. ..*   \.*. .**  *\*..*\..@ .  .   . #
#..*.\\*\ * \..*...*. ..  \.*.\.\   ..  . * #\ #
#.\. .\*...** *.*  *.*\.* ***.. *.**..****.\.###
#... **. *  *  *. .. !. W.... *.@ .. \.*.. ..*##
#.\.\.\* . *\.*. .*. *  *** .   . *  .***.. \# #
# .\.#* .*@***.\ .\..* @@.***\.*. *#. \ \.#**# #
# .  ..* .....**.* .. ..* .**..**..@.\# #  *\*##
#.... ...\.. .*.*....  *.# #*..*...#\. #\.  ## #
#..*  *  ***\ *.\. *  .*\@....... \.*###.\. #  #
#\.*\*\ .*.\. ...*.\\...#*# * ..    *\ #.#\#   #
#. ...*.*. #   ***.#**. \ #.*. \\*.*\.*.*#.#   #
# ... *\*   \ ..\ * *##.## #.# ..*.##.. # #    #
#*.*\ \  *.. \! .##.## #    # ###*!*  *\#      #
#.    #\ \* ....\ .\*.#          #####.#       #
#  *.**. #@**. .*.####                #        #
#  ..#\#**. .*. ..*#                           #
# .. . *# ..#.\# *#                            #
#. .\ .  * *\###..#                            #
# ** #.L## ##  #.#                             #
#**...\#  #     #                              #
#@# . .*#                                      #
###.#\. #                                      #
#  ##.##                                       #
################################################

Water 0
Flooding 0
Waterproof 2
Razors 25
Growth 39
