######################
#  #.#          #    #
#  #*#L   #    #.#   #
#  #. .# #*#   #.*#  #
###  \.\##.\# #* \#  #
# *. .\* * #  #*# ## #
#.#\  .\ . #  #.#\..##
#\  .***. .# #.\ .. ##
#.*\*.*!*##.#* . *  *#
#\.\.  #\..*.#\..\   #
#. *\. ..*.  *#*\..* #
#.\ **   \.**\ \. *. #
#\.**\ *..*.#\*  \\*\#
#...\.\* *.\*   *..* #
#    *.*\ .*\**..*.  #
# .* ..**\ \\.. *.. .#
#.\..  . .......*W*.!#
# *  .  .*..   .\\.\*#
# . @. ** .\ *.**. \.#
#..*.*****  ..*..*\  #
#. *.*\..\   *. \...*#
#***...*    *.. \\ *.#
#*\..\.\  . \. *.**.*#
#.@.*  *\*.*.  ..*.. #
#\.... ....*\  *..*\ #
# ...  \. \* .*.\.\ .#
#* . ...\.\! *.\**.*\#
#. ..\* !... . ..* * #
#\ *... .*.\* . * .**#
#.**.  .\..*.*.\*\ .*#
# .\*\..   **...*.. .#
#* @.\*\. ..*.  .\. .#
#. * \*..\  ..*. ****#
#  .*  .    *.....\..#
#\ *\.. ... .*.*. . *#
#...**.*\*...\ ...  *#
#.*\.\!*.\.\*.*8. ** #
# \.*\ . .\***@. *.**#
#..*.. *.\ ***.* . ..#
# \*  . * ....*..\ \.#
#.*.\*.*\     \*.*.\*#
#.....\.\**\..  .\...#
#.\.    *.\  .*  ..*.#
#\..   ..\ *... . \* #
#.    . \... . . .\. #
#    * .     .. .\@**#
#\.*\.\.   \.\***.\..#
#\*...*.. *.* \..... #
#.*.  .**..   . \\*. #
#.\ \**    ..* \. .*.#
#\ \ .*.*. \....*   *#
#...  .\\.*.* *.*\  .#
#*. *\. . .  . .*.\\.#
#\ \*. *.     **.W.* #
#...* ...  *.**\ **.*#
#.*.. *. .** .. \*...#
#*.. .***\*. ..* *  *#
#\\*. *.*.*.**\*.\.**#
#. .**..\.*..* .  .\*#
#\*.*.\   *  *.. *..\#
#.*.\   .*** *\*\. .*#
#.* . ** ... ..   * *#
# *.  .\ .\ .  . .\.*#
#.*.\ \.\*  .! \...\*#
#\ *..  *. .*.**   *.#
#. . . ..*........ ..#
#@ W*\ \ .\ .\ *! . *#
#. *\* .**! \. *\ *  #
#*.\..\ ... \.\ *\...#
#. *.\*.  @*. .  .  .#
#.**\ .  .*..   \**..#
#\ \.. .\\*.\*.. ..* #
#..  *... *..* .\. .*#
# . .*.. \*  .. *.. .#
#  . .\ *..*\ .*.\  .#
#.  * *.* ** ...*.\  #
#  *!\.**\*..  *. *!*#
# ..\ **. .*\.\   . .#
#\!*... .. . *  . ..\#
#*.* \\...\  *  * ** #
# ** ..    **  **.\* #
#..\ .. .\**..@...   #
#..   ...\. \ .  \.  #
#\....  .*.*  .\\.  .#
#*.  .  .*. .   * *\ #
#*A .. *....***\.\!.\#
#..\.*\*\*\  *....   #
#..*  .* ..* ..* .\* #
#.*..\\.\*.. ...   ..#
#..*.. \.\* .   ..  .#
#.*.\ ..  \..    *...#
# *. .   *\.. *.*.\.*#
#\.   \ .*.*.  .*.**.#
#** .*...\ **\ . \..*#
#.* @. .*. .\**\ ..**#
# . *. *. ....*. .. .#
#.*..***.\.\  ...  . #
#....  **. * * .  ** #
#...*\**.**..\ *..*..#
#. ..**.\*.\*...  ...#
#. \ .\.**.*...\..R\*#
#\..    .W *\ **. *\*#
# ..... .  .. ..  \ *#
#..\*  .*..\.* *\  .\#
#\ . . .*. . ! \.\*..#
#  **.  ...\.\..*.. .#
#. .*!\     *.* .\*\.#
#.*.* .  .\ .*@ \*\* #
#....   . * . ..  .. #
#\.*.\ \... \  *..\..#
#.*.*. .\.\.\*\. .   #
#** *.\.... ...\.\.  #
#*..**.  \ .\\\  *...#
#*. . ..  *\ ... \ . #
#!. \*\. .. *\.\ .\  #
#\ .. .\. .@\ *. .\  #
#.\.  *.\ ...**..\. *#
#****\\.  \  .  .**..#
#**.*   *     **\.*\.#
#\* *  \. *.*@*.  *  #
#.** . . \   *\.  * .#
# !*.*. ...*\.! . \**#
#.\ ..* * *.. \...* .#
#\*\ *. . ...  \* **\#
#...\.\.\.  *\ .\ \*\#
#*..*\  .*.\. *.  ...#
#**\..   ..*.. . \*. #
#....**...***.  ..   #
#  *.**...\!\ \.\ *\.#
#\ .*.. \  . .! *   *#
#.\*\.  . * \\\*. ..*#
#  .  * * \ ......  *#
#\.\\*\...**  * .*.\*#
#.* .\. .*. .   ..  .#
#...\!.. .\   ... .\.#
#. * **. ** !....**..#
#\*.... .*W\.    .\*.#
#.**. .. *  \. . . .\#
#.*.*. * *\* . ..\.  #
#\. \. .\*.. **...*  #
# **.   . *. .. *\..*#
#*.\ .  *....   \ ..*#
#.**.*... .... ..** .#
# .....\    * .******#
#\***\.*..  .* *.**..#
#. .*  .* .*.* ***.. #
#.W*. *...\. .*. . ..#
#....*.  *.  ...*\*  #
#..\.\ ....\* .*. *.*#
# \. . \ *.*. .   .**#
#. \..\*\*. \.* *  **#
#  .. **  ...*\ .*\..#
#  .. **. .. *.*\ . \#
#\. \ \. .\.  \* \* \#
#**  . *\ .**\..\....#
#..  .*. .\...*    *.#
# \ . ..* . .*. *  .*#
#\.**.. . *\*.\*..  *#
######################

Water 136
Flooding 12
Waterproof 11
Razors 40
Growth 23
Trampoline A targets 8