############################
#L#..#  .** .   \.\.* *..\ #
#\ *.. . ..\.*........\ \. #
##*. * \* *.*\ . \***\.  ..#
# #*.*. . ..\.\  *.\*. ** .#
##** *. \..* . \ *  ..*.*. #
##  .* *.. ..... .\ . . .*R#
# #.*. .** . *.\.*..* *\..\#
#  #*\. ..\ \.\* *..* \ ..*#
#  #\#.**\*.\*\*\**\..\  *.#
############################