#############
#  #.## ### #
####\.*# \.##
#..*. .#\#.*#
#..*\ *   A.#
##.#. .\... #
#.*..*   .\.#
#\.. ..F  * #
# .# L . \.*#
# *..\.*.! *#
#.*...*.\..*#
#*.\ ......\#
#.. . *.*  *#
#. .\*. .\.\#
#*.  . .@*..#
#* ** ..\..\#
#  C.*... \*#
#. *  . .\.\#
#..**  *\..*#
#. **. .*\..#
#...* *.\. *#
#\G * \  .*.#
#.9 *\. . .\#
#\. . .**\ .#
# *. ..*..*\#
#*.*..* .. .#
#. *... *B  #
#\ .. 4..*. #
#...\ W*.*.*#
# . . **\. .#
#  * ..\ .\.#
#\**\\.. \.\#
#*..  .. .\.#
#**.*. \* ..#
#.**..\.* .\#
#....*. * ..#
#*\. * .. .*#
#*.* \@.  @*#
#**.  ...\.\#
#...  \*.* .#
#  . \    .\#
#.  *..\ ..*#
#.*...\ *.**#
#\.\ ****D *#
#. .\* .... #
# . **\ *\*.#
#\  **  *.*.#
#......*\*\ #
# .. ..*.\ .#
#* ...\ .. .#
#* *. ... \R#
#*\*   .*\* #
#*.*\! *.!*.#
#....\*.. .*#
#\ \ * ... .#
# .  ..**  .#
#\   * ..\.*#
#..  ..*\..*#
# *\.* 3* *.#
#\. .* ... .#
# .  .. ..  #
#.* \ * *.**#
# ..\.*.\ ..#
#.. .** .. *#
#\* * . .. .#
#*.\ * .. *.#
#  *. .*.\**#
#.. .\ ..***#
#\  @* ...*\#
#\.. ..  * .#
#.\ *  \... #
#\\*. . .\*.#
#**...*. *.*#
#*\*.\****..#
#E*1\*..*.. #
#*\. * @..\ #
#.*.*..!\.  #
#..*.\\ .\.\#
# .. .. .*.*#
#***  ..\*..#
#...*.*\ .* #
#############

Water 0
Flooding 0
Waterproof 10
Razors 44
Growth 27
Trampoline A targets 9
Trampoline C targets 1
Trampoline B targets 1
Trampoline E targets 4
Trampoline D targets 4
Trampoline G targets 3
Trampoline F targets 4