##############
#     #\### ##
#   ###\...# #
#  #R.#* .\ \#
#  # . *#. . #
#   #.*.#. * #
#   # \*#...W#
###L... ..  .#
# *\.#\  @ \*#
#\..\...* \..#
##  .\ .*\ *.#
##.\* ..\ *. #
# ##* \.  * *#
#  #*..\ \ *.#
##############

Water 0
Flooding 0
Waterproof 10
Razors 33
Growth 17
