######################################################################
#\  * *.*..\.\    \ .\..  .\   *.\*... . . .\.. . ... \  .....\ ..*\.#
#..*. * .. *\ ***  .. \ \.*  **.  ... ..\*  .\  \\  \. .\  . *\ ...\.#
#.....@ *.**\ .*\. * * .*.\  *. * ..\ \.!*  ..\ *..*  !. ** .. \*  \\#
#* \  . .***\**\. * ......*. *\.. .  ..*\..* *  **.. .**.*..*\ ***\.*#
#. .\.*  *..*..\ *.   . . **..** *.\..*\***.. .\. . .*\*\.\ .........#
#..\ ..\*\ *  .*.**... **. *.\\. . * .***\. \*.**.\  **..*..@**.  .. #
#\\*\ . **..\. **...**.\.. ..*  ...  .*.\ \ W\*.*   *.. ...*\...\.\..#
#.\.*  ...* . . *.*  *. ****.  .* . \..*.*  *.. * * .   ***.@  .... *#
#.. *.*@\.*\***.* . . *...** *\  \ *  *. .*.*\.\. .. ****..* **. .\.*#
#.*.\ ..*.\...*\.\\.\ . . *. .  .  . ... *.*.** . ...*. *.*..*..\ *. #
#   ..  * *\. .*. .*\ .*.\.** \* ..  *\.\.*. .. *. . *** \. \..\ ..  #
#\.* * *. \ *.* *. . .**   .\ .. \   ***!.*.*.\ \.\**..\   \..  *.** #
#  .\*..\*\....\.\*\ **\\ \  .  .\*..\....*.*..  *.\.* .  \.*!...*...#
#.. * ....\  ** \*** .\..*.\*  .*....\\ \*.  .\  ....@.\@ .*.\ \ * ..#
#* *. \ !\*.*..* **.. *\..*** *..*\\. **  . .* \  .*\. ..\.*.*...\  .#
#*\ * .....   ..\*.  .\  \.\. .\ .. *..\ \*.      \.   *\ .\.@*  *  *#
#* ..  * .*   ! .**..... .\. .*  .* . * .... ** .*. \ * .    *\..\* .#
#* *.*..  \. * *... .\*.*\. .**\*.. .\ *\*\..*. .\.*... *  ***.* *.  #
#.!..\  ** . ..*. ..**..\ *. .**. *.\ \  ..\  *.* \@\ . * .**   \.  .#
#*!\ !\ . *  .\ ..*. \ * *.*\ .*  ** .*.. ... **.\.. *  ..\...  .\* .#
#*\. \**....\ *.\ \.. **.\ . .* *\*.\ **...*  .*@*...\.**.*\  .\**.. #
#* . .*\@ ..  *.. @ ...*\ .   .\.*.** . .  * .\.* .. *.  .\@@.  .. ..#
#.. *****.. *. **.*.*\.*.\.*  *..... .*...  *     .\.*. ..*\ .*.\   *#
# .. ..* .*.*. .*\.  ...** .  .... \*..*  \\.**\.   \**.*.\*...*. *..#
#\.*.\ **\\**  ..*.\.\\.*.\*.\.*\  .*.\.\. **.*...*  *. .\ ..* *.* * #
#*.*\** .**.  .  .. **@.\  \.. *. ...\. .* \.. *.*. *... ..\*. . .* .#
#\.**\\. \. *\..** . * .**  *.. .. . . . . .*    .* . . .* .*.. ....*#
#.\ * ..\*   ...* .*  \*.**.* .  * * *.... .\ * *... .*. * *.* \  . *#
#\..    *. . **.  * .* ......\*.** \ . ...   ..*.*. ..*.\. \*... .  *#
#  .  * *.\ \..   .  .**   \...! **.\  .*\ ..  . * .* .  *..\ .. . ..#
#.** .W. *....\**\  . *... ..*\.*\*. .\ *.\....\ ..\*  .\.  . *\    *#
#***.\* ..** *\* @** *\*\.  *.. . .\..*..\ *.* . *\*. .      \. * ..\#
#.*..*  . ... ...**. \*. .\*.  * ...\..  **.**\*\*...*.*.  .. ..  \\ #
# \ .\   ** ......\....\. \ .. \ ..*.*\. .\..*.\.*  .\ *....    . ...#
#*.. *.\*.\.**\  \*\@. .* .  . .. \*..*.. .\ *\ \..** ..\@.*.. \..*\.#
#.. .\ .* *.*** \.!\ .* .\ .  ****.*.*\.\ . \\.* **..  . \.*.\\. **.@#
#.\..\. \@ **\. .*@*.\.*. ..\\\\*.* *\...  . *\. ...  * \**\..*  *. *#
#\**!.. .\ **..*.**.*.*\    ... . .*.. . *. *\** **. .* ... ***\ \  .#
# ....*\ ***\. .*.... . ..\ . \ .*\..... .  \*\* .*.  .*\.\.....*  \.#
#\.**.*.. ** \ . .\.** .. *\*..*...***. . *...!*  *.*.\..*. ...*   . #
#. .* \.**.*\.\.\. ...!.. . * **.**...  . .@ .\  ** ... \.*. *  . * *#
#.. ..  .\.\* \*.\* **\..*.*..\ *.*! * .   *\ ....*..\.**... . . *\**#
#  . \.**..@* ..\.* . .* .\*\ .  *.* * **. .*.**... ..*..**.* \ \***\#
# \* .. .. *.**.. .. .\*\ * ..  \ ... .**!\.. ... *.\...\. .\ . .*.* #
#*\. .\.*.\ \*.    \..\. ... .\..  *. *.*\. * .*  . .* \.  *..   . * #
#. *    * **.*...*  .  **.\** @ ..**\.* *.. .\.... \ .  .* .* ***\.. #
# .* .\.\ .**  \..    *... .@*@..\.*  . *.*.\.\..\*. ****\.\.  * *.* #
#\**\* ...*\.*    .\  . . .*\.*\* .*..\..**.*....*....*.\*... **. \.*#
#.\. \.\*.*..*\\.*\    *     .\*.\ .*.  ***.*. . ** \..**. *  *.. . .#
#.   .. .\\* \.  ** *\ .  *.. ...* \*.**\ \ .*.\.\. !**.*\ *. *** . .#
#.*     \ ** .  ... !\.!\ *  *\...*. ..***.. .\ ..** **..*.\.\. * *.\#
#....*. *\**..\ .\. ..... **\.*.....* !!***.. *.*\*. ..****... **\\ *#
#@ .\..*... .. . *\....\ ..*..*. . .* *** ..*\  . .. *\.\ . W** .....#
#\  W* .*. \\ *.*\. .. **.\.*\.    \    .*. . .* *\ .* .\...\*.**.*\.#
#.* .*.*.\..  \**** .... .*.*\ \*.  *  .. * .\.*\*.* . \.\ . \ \* ..*#
# *\ *. .  *.. ..\..  **.\* . ..**\*\  @\ *  *. .* *.. .. \. ....\\..#
# ..... *. .**  *  . *\*...* .  .. \ **\**...** .W .**\*...    *\.\  #
#\ \ * \.*.\.\  . .*.***.\*. *\.\ *.**\*      .\ .\*.. .*.\ \\*. .*..#
#.....   . .* .. *..***... **..*.  .\*..*.. .\ *\***.\. ** .! \. *.\*#
#\.   . *  ..\* ..   .!.@ . .\ \     .. ...*.*..\\.*\...\ * .\  .\. .#
#  . *.\.* .* ..* \\..* **\*  ..@.....\   **\.  ...*  \...** .\.\   .#
#  . . ...  .* .. .!\* *...   .* @.*  *\* *\.\...* \  . .  *\***. \\ #
#  ..  .\!.. ... *.\.\.\** \** \*. \.\\..@*. ..\   . . .. . *. . .* .#
#*.\.\\..*.\***.*\**\. . .*..*. .\*.*. .. .*\ ..*.\..  ..*. * \. .\*.#
#\.\*****\.*. .*.* \ .  .** \...  .\*....* \      . * .. ...\ .\*\!.*#
#****  * *.*.  .* ...*.  *.*. ..\ **...  . ..**.  **! ..\*.\ . ..  *\#
#*...\ . *\\* . ..   ... . .\*.* .* *...\*  *.*..*.!**..*. *. * * *  #
#* . .. \..\*** ** \.  \.** .. \* .\.  .** \. . *\ ...* .* .**.\..* .#
#*\  .\*\ ..*!.\ * .\...* . **\ ..\.\.* *.  *.. \ \\. . .* .\**. .. .#
# ..*\.\ *\ ...  .. \ .. ..\..*  .*..*\\..*.*\.\.** *  **.  **.\\.   #
#\ ...*      *\. .\ ..@.**.  \.\  .* *.*.\*..**  .. . .*.. .\W\* *\* #
#*..   *\.** .W*  ..*W...* **.... ..*.\*\ .*..\ . .\  @.  *\  ... *.*#
# .  *.*. ..** .*\. \ **..* . *\ *  \@\*.  \...* .* *\*..**..\..* .  #
#.***\ * .. .\ . \   ..*.*.*  .  \**.*..*. ..*.  ***!\*.*.. \.\.. \  #
#\.*\  .  .  .    *.  *...* . *  ..*.*.*..* \.*\ !....\*.*\\.* . * *.#
# \*..*  . ** \.*** .* *  ..\.*.*.*. . .  \***. !.*.   \.**.*\.  *...#
#\.**\  \\. .  *..  \.... .\ *. .*..\  .  ...\\.  ..  *. .... . .\*.\#
#\....\  .. .\*. \ *..  .  ..W!  . * \ .\.\...**.*.**.\... *\  .\ ...#
#..\ *...*.**\** . .. *.  \*.. ...... ** \.*...* *.. ..*\..*. *  *.\.#
# .* *.  **.\*.\   ..\* *@ ...*..* \ !... ... \...*.\....\.. ..* ....#
#.\.\..*..***.*\.**\ **\*.    .**.. . .    *\ .. \.*. .... *.**. \..*#
#\ *..*.* \ . *.*.*.*. *\**.   .\.*\ .* \.. .*  . *. *\  .\*.*****.**#
#.* . .*. @ .\**. *\.*..*.*  ..*    \.*..\.\ . **.*...  ....* \.*\ \ #
#.*...**. . .* *   * * ...\.\ ..*.  ...** *..\ ***.*.....   .   .. . #
#\...\.. .*. .*\\.. .\*  ..\ *.\ . *** ..*\*.. .\. @\..   * *. ...*.*#
#**** .* *.   .* .\  ..\\...\**  *.*.**...*. \* \ ...\*... .\* * ..* #
#...*  ...*.*...  .\\\* *.\ *...  ..*\. ..\\\   ...\  \.. \ .*.**  ..#
#* \* **. .@...  . *...\.!. ..\ ***.. \ **...**\ . **   *... . .*... #
#.  ..\* *  .!\ .. ***. .... ! **.\.* \  . .*\..  ..**.*.\. .*. ...\*#
#* \* . .*. *   \ .! .\**..*\..**\ \. *  ..  .. \.*. *.   \**\. ... *#
#.\.. . *. \.. .... \...*..  .\.*..  .\\ *.   .. *\. ..@ ***\.\ * . .#
#..*  .*.. * * .\*\ \* . \\  *.*.* ..\.W . ..\.. *.\*...\*..*.***.\ *#
#\.\. **. **\* ...  ..\.  *.. .\*. *\ . *\ .*.\ .* ...W**\  . * . \. #
#* ..... ...*. * *.\.*\  . ..* *.*.\*\ ..   ***  .*.   * *\.\..   * .#
#*.*.. @*  *\  \...*\\ .. *\ . ....\. .  .. *.. . . *.*..\.\*\ ****.*#
#\ ...*@\.\ *...**\*. .* *\.**.   *..  .* ..\ \ .*.*.*\.  ..\ .*.\*\.#
#\  . .. \. *... .  .\ . .\* ..  ..**    *  . . .. ..**. * *.. . ..*\#
#.  * **.!  ..  ** \  . * *.*\ .*.\***\.***..  .*..\ ***..\...  .* * #
#\* * .. *\*  \  .    .*. ... .****.*.***..*\...\.* ..**. ..  .* \*\.#
#.\*..**.* .\ ...... **. *.*.   ..*.*.@.*..\ *.**...  \.**. .. .**...#
# ...* \ *  . ** **\....*.     **  *.\... ..***.\ *\.\....\*. . \. *\#
#  .\*  . \   *. .\...\*.  .  *\.  ..    **\.* ** *.\..\ ...\  .*  .\#
#. *.*    ...  . *.\*  *   *\..** *\.\....*.\. ..*... . .\.. *\\.\.  #
#*.... \.  \.* \. *..  . ..*  .*..\ .*.*..*..** *. . . ...\*.. **..*.#
#. *** \...  * .*..*\..   .. .  . \. \......!.\.!*.\ .\\. .....\..\. #
#.*. @*W* . ..  .\...\*  *.  * .*..* .*.*.*\ *  **    **.  *\* *\.***#
#.**.\.....\.**  .\..*  ..  *.* . *..*. .* .*\ .!* .     .*\ .\ .\\\.#
#....*\..\.@\. .....\*.*\.*.\..  . \.\ **!\..   ...\\.\*\ *..\*.*.\. #
#  * ** *  *\..\..\. .*.  ... .*\.* \.*. ..* . *\\ . *.. . .* .\. \. #
# *  .  .*.\ . . \*.. .*.  .* **...\*...\. \ *\.*.  \* . ..*.**  \.* #
#\...*  . .** . .*. .  \.\ *. **  ..**. *....***... ... *\..\.. \  ..#
#   ... *.. .. .\.  ..   * ..*.\ . .\* ...*...\* ..   \.\. \ *.*... *#
#  .** .*.\ \ \..@ .**. **\ ..  \      *. . \\. * \.\* ..\ .\..\   *.#
# \...  **.....*    .\ \.\.@\ .*\.*.*!\.*..*\ .   **\.  *..\.\ . * . #
#.\  \\*...  .* .*. ..*.**.\*... .. .  .   . *\ \...\W.\   *.\ ..*  *#
#.! *.*.\ **  \** \\*\.*....**\*\  \*.\  *\ *..\..\*   **....*\ .*..*#
#.*..\*.....** .. * . \. *.\@.\.*.*.\. *\.!*. \. \.*\.*\*. ....* . .\#
#..\  . .\  ....***.\. . . .  * . *\... **. .*.. .*. .  \.\\..\. .*..#
#.* *** \  .\..*.*\. .. .*\.* *  \  .. ...  ..       * *! .**.\.\**\@#
#***. \*\. *.*..**.\ . .@..  .\ \.**  .\ \ .\..* .*\**.*.\  ..*\***\.#
#\. .\ .. *. .. \.*   * * *.\ . * .*. .*\ *.*.*. .*.**..\.. *\**..   #
#**  . * . *\*. W*.**.**  .*.. \* *  . .*** **.* .\*\.\. ..\.*. **.. #
#.\ \ *.\  .*.  .*. . .\ . **. .... .*. ..* *.*.*\  *. ..\...*.* * ..#
#**  .\\. . * *\**.   ....* *.* \. . ..  \* ......*\..  . *****\ .\.\#
#.\**...* .\*..*\.*.. . * *. *.    *.**.* * . *.. *  .\.. * *\.  .!\*#
#   .**.. ..*\* **.  \...\*\ .   *\. .*.*. . .*\..*\** \*\**.  \ \**.#
#.  \ *.*..\.*.*... ..\.*..*. *.. .**....\.*. \. .. *.. .*.*  ..\  .*#
#\.@.***. *.\...* \.@\.\.*.*...* * .\\   .\. \.*\  .*. \ **\.* .\*..\#
#.\.\*  ... .  ..*.......*..\  *  \. ...  . .*.\ * ...  *\..**. *.* .#
#@ .. . *\.\*.**\.....  ...\..\. *  ...   ..*.* ..*. .* .  \.\ ..*..*#
#.\* *..* \*\*.  *  \..\ \ .\ * . .*.\. .\.....\*. .  .. *...* . W.* #
#* .\*.\..  *** **\\ * .....**.. \ *.*   **\. \...\ * ..*. .****   .*#
#.**.\ ..*.*.\**.\* *.\.. .....*.\ *\** \ \*..\*.*.. .\...\ ***. .. *#
#\  * .*...\. ..*  .. .*. . ***W.*.  ..    .*   ..\ **.. \... .. ..* #
#*... *.**  * . . .. ........\.\*\..\.* .*\ .   .*@.*.*.\  .\ .\ *.\ #
#\.\ ..*\.  ....\ . .\* *.  *.**...*.* . ***  .. .* *\.***.*.\.*\. .\#
#*  * *.* . W\. .     . .\. \ \.*  .**  . ...@\  *..\*.*..*.*.*.  * *#
#*. .** \ .\.**\  *.*\   .* .*. **\...\..  *.   \. \.\... .*\ .* \. \#
#*.*\.* .... .\. * \..**.*\ \.*. *.**.  .*.  . *.\. . .* ...*...\.  .#
#.\.* ...**.**.   *.\...\*  ..*\..*...\.**\*  \.   . \..  * ..\\* *  #
#\..*\.. ..*.*. .*\.    .*.W  .  .*. \  .***\ ..\ ..   * *\!    \ *.\#
#  \*** *  *... \** *\*.*  \\.* ..**\ .\** \ .\. .* \ .*.*.* .. ... .#
#*...\.*.\ *.@\...*** . .\ .. *.*.*.\ ..** .. .....\...*!\.   *.*. . #
#*  . **  *... ** *..   \....\.*.*. ..\.@*\.** ..  .*. .\ .  .\ ***. #
# \ . . . .*. * . . *\. .\  *.** .*  **..* \*.\ ** .*..\  \..  ..\.**#
#... .\..  \.**. \  .* \\ \. .*...**@*..\ \.. .\.*  . \ ...*.   * \*.#
# *\ *. \.***\* .  ..\ .. .. \.*.\***.***  ** ***\\... .*.*. . .\ .* #
#*. ..W * *.. .* ...@.*.**  .. * * .\\.* ..*... ... * .*. .  .** . .\#
# .. *..\. \.***.. *\  .*. .* * **\.*.  \ .\    ..  ....    ...* ** .#
#\..  .. ..*..\*\  . .\*\ . *..\... \\***..... \ * *\.  *\*...\* ..*.#
# .*.\\.. * *\.R**.* *.* .. \*  *...   *.*.. \..\  ..\.....  . . *...#
#\.*. \*    *..\*\ . .*.*\***....\ * .*. **. **. * .\.*. * ..   ..**!#
# *. ... . **. .\** .  .. **.**. .. \ ...*\.\ * **\ .@*..*. @\*    ..#
#.*.***\.\*.*   ..**  ..* .. .*  ..      \   .\\**  !..**  *. . \*.  #
# \\ ...\ ..**..*\....***\  *.\..\.\....*. \\ \*.....\ . \.\.   ***.*#
#*. . .\ . \...*\\*.\**.. \ *.... .  \*   .... **.\ .** ...\.  .* * .#
#\*     .\ . \\... .... \.* .*\*      . *\* . \...!.\ ***\.W\.... *  #
#.\ *\**\.W\. ..\ ..  *.  ..\\.** ..\.****. *\ *\   ..  .. ..... **. #
#\. ..\..* *. \ .\.*  .\*\*\*...***.*. \.\* *..*.\\.*. ***\..*\. \*\\#
#...\ .** .\*  .\.\.\* *.*  *.\\ *.**... .** . ....*.*\ .*. \.*.*.. .#
#  *.\...W  \*  .\  .\* .*\.  .. . **.*\\ *..*\..\*.*. **  ...* .*.. #
#. ...**...... . ... .* \....* .\\ *.*  .*.  .  .   *.  **\.* *  \.* #
#*\  *..**.* \ \\ ..... . * ..\ ...*\*....\..*\*\ * *...** .. .* ... #
#... .***\ ... ..\... .** **.\*   @\..\*. *.\. \ ..*.**\.\. * *.. \  #
#.\.. *... .*\. \   .\..\ .*. ..  . *.\..  \. ...*.. .**\.**\ .. ....#
#\.*\ *.\ .\\ * .. * \ ***  .\ . *     \ * **.  *.*\  . . *\.\*\..  \#
#***@ \.. . . \. \*\ .*. *.\     *..\ .\.. .*\. . *.*\....\ *\ .  **.#
#..\\ . \  .  !**  * .*..*.. ..* \.* . . \* *.   ** .. .. \ .*.\*\**.#
#  .\ .\.   .\..  \.   *  **\  ..  .\. \ .**..*  ..\ *..* .**.* \. *.#
#. *.*..  \ \   \*\ *\.  \.\.*  * * *.\ \*.* ....   .**\. \ *\\. .\\ #
#\*. **.......\*..*\.* **..* . ** * \..\ .. .\ ...\\@ * .*.\.. .*. ..#
#*. .\*. **...\*.*..\.. .*..\*..\ . .. . ***\.\*\ **\ \  .\  * !\.*\.#
#.   ..*.\*. \...** ..  ..\ .*.*.*. ... \. .**.\.\....!  . .. !   *  #
#. .*.\*\**.\ \.\..**. * *** ***.*....\..*. **.   .  *\ **@ ****.** .#
#\  .  .*.. *. .. .*** \..@*..!..*.**  *.*..*. \* *.\.. .***\*..... *#
#..* \ ...\*.\* *  **\  *... .\  . ..*\\*.....\. \.. .....*... ..***.#
#@**\.  .\..\ .\.\.**\...**. . .\.   \   *\* *.\  **.*\*.*.*. *. .\..#
#\*..*\  * .\**W.* .. ..*\\*.   *...*.***. *\* *.. *.. .**.*. \\...\ #
#.. \. .*.*. . *\*.\* *\..\.**\** * .\...  . *.\*.   ..  *\.. *   *..#
#\*. . .*... * .\ .*.*....\.** . **\    \. * .* \ *.  ..*..\ ..\*  *.#
#*\\.*...**  . . **\ ...*\ *.\. . \.. *..\*..\*...** * **\.\ ....\*  #
#\ .*.**.*\ .**\ ...   *. *..\*   .. .** .  *.** * .  . ..  .\. *..\ #
# . * ****. .\.*.  .\..**\\ . .*   ... .\  \..** *\. ** .  * .\ .\..*#
#\.*\.\ **.  *.*!  . .*.. .. ...* \* \.\\. .\  . .* .**  *.*\*. *. ..#
#.. . . ..   .**.**  .. \   \*\.*  **  .. . .* *  .. .. *****\. \.*\.#
#. .*.. *\.. . \*** ... . ...*.. .*.\.\** *\.!* *\**. *.....*..*   . #
#.. * * *   . . \..*\ *.\ . ..** .*..*.**.*\. . . ** \* .*. .****.\..#
#.\.. . * *.  *. \ * ....**. ***\ ..*.. ... ..\ \... .*\..  * .. \*\.#
#*..* *.\ \* ..\.. . **\*.\  *. ...   .\* * ** .. *.\  . .* .* ....* #
#.*.*... ..\ \** *\.*.\.\.  *..*.. .*** .\.  \.\.\....   \. .. .* \* #
#...**    *..   .. .* *\  * * *   \*\.. ..\* *** ..** .\*. \W.  .  ..#
#   .\ . *\*.**.  *** *.  \*\ . \*\. *\. ...* * \*\...   * .!*.   *  #
#\. .* * ...**. .\*.\*   . ..\.\..\. .** \.\.    ..W**.. . . . . *!..#
#** ..   .\*  *. ... **. .\.\...\*    .\  . \.\*\* *..  ..*\.\* ***  #
#.\*..  * .\..\*.\*..\.. \..* .\...*\ .* *@..\ .*  .*\. !***  * ..*.*#
#.*.*.*..  * **.\*..*\ \* \ !.\.\..@.. ..  .*.  \.. .   ..... !*\.. .#
# **..!  . .*.*....*..  * \.* . **\ \ *..*  .. .\..\. *   .. \ . *\. #
#*\... *\.* ..\   .  *\ **....\ .....**  *.. . @. ....  ..*  .  *\* *#
#\ **. . ...*.. .***\..*....\..   \*..* *. . * *.  .. . \*.\..*@ *. \#
#.* *@*.*.*\.*\ .. .*.\ *. .. *..\.\..*\.@* .\ .    .. .*..  \.**.@..#
#\ .** ****.  ...*\ * *.....\..*.\ .\...**. \ .. .*.  .*.**  * .\.*. #
#...!\\ ***\.   \...!.* .. *\..\. ...  *.**. **..*.  \ .!\.*...*..*..#
#..*. \  .*..*\*. \*.  \ . .W\  .\* * ..  ..\..* ......\  \* * ..\.  #
#\.**...* .\*... ...*\\.. .   .  *  .!.*.\*  .* \ *  .  .*..*..*\ *\*#
#.* .\ \* * \* ......*.  \W....*!*. .... .**\ .  *.** .*\.*!\.\..\...#
#.*\.*\.\\ * ..**.*\  .. ..* . *\ \ .. \*.*...\**   .\.\..*.*\..\.** #
#..*\*.  *  .*\ ..*.\ *.** \*.. .\..  *...*.*.**.\   .* *  \. .  **. #
#\..   . ..\...\ .\  ..*\ \ .***\@.*\.*.. \ *\*\. \.*.\\*. .\.   .\  #
# *\   \ \ *  **.** *.\ .. .*. . . . *... ..*.  \.  *..\*.  *.\*. !*\#
#...** * * **\ .*. **. .  . .*. *  . .\.*\@\ .*.*.. *\.... .\ ..*\*..#
#*.*..\* .  .*  ** \..  **. *..\.\.\... .*! *. *.   .  *.\\.. \.....*#
#*. . *\.. .  **.*.. *  .*\ . .*..*.*\.*... .@ * .\  .* . ..*  **  .*#
#. .*..  .. *..\*..   .\***.. *. .*\..  .\  *. ***. .\. . .\.. *..#..#
#  .\ ! **.*..\.* *. .\*  .*.\.. *..  .    ***..*.  ...** \ .  **\ \.#
# \. . \*. . *@.. .*\ ..*  .!.   *\*.*.**.\.... ... * .. #... \@ . #.#
#*... **.*** \  .. ** \ . *...\.  . ...   ..\. .*\. .  *.*  **#.  ..##
#..*....*\@.*.*    .*\ *.  ..***  *...* * . .\* .*.** .*.. * \#...#\*#
#*  * \  *. ..    *\.**.*.**\*.\.* .. \ .. .\. .*. .. *..  #*#**. \..#
# \...\* .  .\. \...**..*#.**.. \*\\*\.....**.* \ .\\.. .*..*#. *\#* #
# ..**   *\...  *  *!\*... @*\...*@*  . *\ .. \.#. !..\ . .*.##\#*.###
# ..*. .\ . . \ *....**\ . W*. .\....\  \..* ... *.* ! !.*.**# #.*#  #
#*\.   .* . *   . ***.\ .!**.. \.. #. .*#\.\  . .\ .****!.**#   ##   #
#*.. .**.##  \\   .. .*...#** .. W\*. *.**\*\...#...\ ..  . .#       #
#\ . . ...## .@\.\  \ ..  .*##\\ *.#*#*\.*.*# .\#\@.*    .* #        #
#*.** .  #\.. W# *\ . ##\ *.*#* * # *@\.#####. .. \\. . . *#         #
##.#*#. .*\ . .. .. . \#####.#\ *##.##*\#    #*   # * * \*#          #
# # #*   @* #***...** #     ##. # # #. #      #.###.# #\.\@#         #
#    ####\#*...#\ \\. #    #..\**# ##* #      #.# # ## # ##          #
#      #\*#.##**...\**#     ##.##    #.*#      #   #   #\#           #
#       ## #  ##. . .#        #      #. #              #*#           #
#               L .\*#                #*#               #            #
#               #  ##                  #                             #
#                #.#                                                 #
#                #.#                                                 #
######################################################################

Water 192
Flooding 19
Waterproof 18
Razors 18
Growth 39
