########################################################################################################################################
#                 #.# #                                                                                                                #
#                 #\## #    ##   #                                                                                                     #
#                 #..  ##  # .###.#                                                                                                    #
#                #.\#\\* ##*. # . # #                                                                                                  #
#              ##.**     #\.#\ #*###\#                                                                                                 #
#             #\ **\.\. ......*\\#*#  #                                                                                                #
#              ##\ .*@\*.\.  #\ .\.  *#                                                                                                #
#               #. * . \ *. .*.**.\ \..#                                                                                               #
#          #   #   ..*\..**  *.\*.\##..#                                                                                               #
#         #\#   #.\. *.\  *\*..*\* ..*  ##                                                                                             #
#         #  # ##. . .\.!*.. .*\. *.\ \. .#                                                                                            #
#         #\.@#.*\*..*  *.  ..\.*  *.   # #                            ###   #                                                         #
#   #   ##*@ ..  .*\*.  .* \.\*..  .  **. ####                        #..\# # #                                                        #
#  # ### #..\*. *  .\* . ..*\ ..  \*.\ ...#.@\#     ### #          ##### **#\.# #                                                      #
# #\ ..#. .# #. * ***.**  . *  *.    ..\  . . #   ##...# #  # # ###.\\.# #*.. ##.#                                                     #
#  ##*.. ###..  .* ..* * *..*\*@. ...\.  # *.. ###*.*\.  # #\#.#\.#  *   *#**\#...# ##                                                 #
# #.  ..* .##.W.**.*.* *....\ .***   . @ *.*\  ..##.\..#.# # ....*.#*.. *. ** .\#  # *#                                                #
##..#* ..*. *..**.**.  *.***  **..** \..*.*.#*. ...\. #.### #\**.#\ .*\ ...*  *.\  *\*#                                                #
#\ .#.. *# .\***.*. *.*\\..*\\\..... .* @\ \.\\ * . * \*..\ .*\**..**#* *\ *...#..\. .# ##                                             #
#. \*#.\*!  ..*\ **.\**. *@*.! *..*# ***.\..\   .\. .*#\ #.  \..   **.. ...*..\ . ...*.#\ #   #                                        #
# !. #  *. \. . ***\...  *\\ *..  . *\.\*..\.***..  * \.  *. #*.\**.#. * . . \*..***.*.#* \# #.#                                       #
#  \ \*... **.  ... !\.. .*  .. \.*... .\ *  **.\ * . \.\ \ .*.*.\ .* *\. . * .. ..\##... *##.*#                                       #
# \*.#\ ***.*.**.* *****  .. \*.*\  ....\*  ..   ..*..  .*.@ .\!##. .*@.*   . \ *.\ ... ! ##*\###                                      #
#\....* ... .\..**...***\ \*.*  . \    *.*. ...* *\.... .*..  .\  . **.  \.**. .\ .\.**\.#\.#..*.#                                     #
#*.\ ..    .. ..*  .. .**..  .. * *..  ..\ ..  .\!.\ *  ....\.. ..\*...  .   . .. *. ...*# ..#\*##                                     #
#. . ...***   * *   .\ \*... !..* .*.*. * .  \..*. \*\\ . \ .**.*..*\  *\ ***** ...* ...*..\.* * *#                                    #
# ..*\.  ..\.  .\*.\. .\ .\*.. . * ... ....   *. ..!. * *\.*\.* * \*. ..*..*.. \ \ .* * #.\  . .\.#                                    #
#\  ***.\...   *.. .\...\*  * .*.*\ *....* .!.**.\*.*..@. *. .. ** *\ * ..  ... .\. ***   . \** .\.##                                  #
#\.*. .*  .*..*.**.** . .*.*. .*.**...\..  . *.***. \  .*.* ..  ** ..\...  *.* @*\ ...\*\ *\.*.** ##.#                                 #
#. * * .*... \ .*** . * ..* \ ..W*.**.  \   . \*..*..\. #  \**. ...*.  \ ..... * . .   **...*.\#\.* \#                                 #
#.\. *\. \*\.. \*.  .*.  *W*..** .\. .\**   . \*..* . \...  ... ...... .\  *\*.* *** ** . #.* .*.***\#       #   #                     #
#\*.***  .  .  \.. **.*  .\.....  .\  ..*@.. . . *\ ...**\   .* \ .*.. . .\...**.*....\ ..* . .. *  .# ## ###W# # #                    #
#.\.\*\  ..\.\ .*....*\  *.   *. ..* \  *@ .*\   ** \ .\. . ..   .\.**\. ..\.. .\...*. *.*.\\ *..*.\###  #**..##*@#                    #
#  ..*..*! **   . **.\. .\*. \\.\*.\  *.*\**\ .\  .*..  . *.  . . * ...*.**.\.\* ...**.\*.. . .**...#  \*##*. *.*\.#                   #
#. . \..   .* **.*.. .\.. \  *. \*\*. \ ....**. *  *.\* .....** . .\.. .\.... ..\*\*.*.***. ...*\*\.# .. \** **\. *\#                  #
#  ...*. .  ...\**. \*..  .*  \ .**.* .  \.**  .  \ .**.@\ *\. ... *\ .**.***..\.\.. ..**.*.\.** **\@*..*..@ #\#. *.#                  #
#\...\*.   * .*.*.. ** * *.... .\*. *.  .*. * .  .*.\..*. \..\  \*. *\.*. \ \ \. \*  * .. \.. .**.. ** \  *.* .*#.!..#                 #
#..\ ...\* .\...\*  . *. *\ .*@* .* .*.\.\.\. .**\*\**\.. *\*. \.***. *.*. .**.\ ...\  * **.. * .*  .**.. .*. .. **##                  #
#.*!    .  .\\. .*.W *\.*. .\...* . .. **. ***.*...*..*  *** \*  * ..\*.\** .* .\.  *...**\. ...*   *.#8\  ... .\*\*\#                 #
#...*. .    .*.  * \ .*!. .\.\*..   . .\  .\ *\.*  . .** .***  \ .*.... *.\***   *...*  ..W.*.\.*  ..\**..* .*.*\* . .#                #
# \ ..   ** .\\.\*. . .\.. .\.**.\.!*** . . **. .\... ...**.\* *. \.\.*\.\..**..**..\ .  **\   *. ..\..*...**\.. .. \ #                #
#.   .. .*\  W.*.!. *.*.\*.* ..\. ..*.\.**...** .\*. . .\   \* *   **.\ \*.*\.*  *.   .*.*** *#* .*\*.\*.*....   \ \# *#               #
#.**..\ \ ..  W.\.\*....*\ \.\*.* \\..\@.. .... *...\  . ..*..\* *...**.* **.  .*.**....  **.@**..... . * .*.* . .######               #
# * * *\   \* \ .*\.\ **.   \*. .....* ...*.\ .*..\. *. *\.*  ..*\.\  *.*....\ \..*.\ . .*\.  ....\  .  \...\.\   . ...*#              #
#.. . **.\..*... *   *...   .* .\. .*\** .\.. *** *..*...  . \*\. .*..* **\ ..\. *..*  \ .*... * \..\*  .***. \ * \ \. .#              #
#. . . *@ *.*\. .*....*. *.\   .*B*..* . *.**.. .***.. *  ..   .. *.*.**.. **    ..*\.  .\. \.*\..* .. .**.*..\.. ..# ## #             #
#..*.*... *\..  . * **...\.. *\*.*.R.\ \.\.. ... \ **..... .  . *.**.* . ...   .** ...   .*\. .\*.*..\\...\*\.*.. \ ..\##*#            #
#.\....* \... .!**. *.*  . .\ ..   ..*..* . . .*....*.  \..\ . !\....\..** .**..**\***\*.*..* . .\*\ .***.*.. .*\ .\** ..*#            #
#*  .*.\\.** * ..\  . .. ..  \   .*.  * .\**   .*.. .     ..  ... .* .. .***..*\......\ ..   . .\... .\..**. .\ .** ..  *#*#           #
#  \ .\  . * *  ** **.*.. . *..  \ . ..**.\. \.\*.*\ . **.* * \.  *...  .\..  ..  ...*.  * .. \.*    .*.*\.\. .*.**.* ... ..#          #
#**\ \**. ..@  * \ *. **** ..\\@ . \\\ .*    .\ .\*!..\***.\. .. ..!. .**.*.*.\..*\...  \.*   . . .\\..*..\  .**..**. *\ .\# ####      #
#\.\. ...*. ... ..  *.. \.*   .*.  .. . * .*\    .\ ... .....**.  . *.*\ .**. *\@.   .....* .*\  ..  .\..*\*. *.*...*  .\. .#  **#     #
#*.**.  .*  \ *  .. \*\..* * .. **\\.*.*.\.***..\*.*.** \..**\... .*** .\.... . *  *.\ .. . .*\   ... . .  . *.    *.  *.  .##\*.###  ##
#\ *\**...*\.****.* ..*. * .@\* ....\.   !..*. .*..\W.\ .*\.*.\** *.\. **.\ \. .  @. ** .  * **\.* \.... .  *..*  .. *\.*  *.*#. *.\##\#
#*.** *.\  *!..\* ***\. *.  .*..*. . ..\.*\ .*.\.**  .. ...\..**... *  .*\.. *...\ .*.*.*\!**\. .. . *\... *..\ .. * *    *\.*. . * #..#
#. *\..*.*..   *..\.. ***..*\*.   *. @!**!..*.\ ..\.\  .. * \*.*  * .*\\@ ..\.     \*. *.\ \.   *  ....*** .\.*\ .\\ *.\.!. * # \.\.# .#
#.**.** *.*\...  . .  \.*\ .W.  . * *..\@   ..** . .*  .**.\ *.. **.*.*.*.\***\..*..*@\..*..  * ... *.\\!. \...*.  . *\* .@.*  !*.\ \**#
#.**\.*.. .. *\.\ .** .*.     *\.* *  **** \    . \ \ \*\\* \. **\*\***.*.**\. .\..\..@  ..*.\ . * .* .*\.....**..\*\ ..  . * . .*\.*#.#
#\.  ..\. *. ..   ..* .*. ...*.*.\..\. *..*.\ ...*\*. *\. .. * ...* \.* .\ .    @  .*..**\ ** .**\  ..\.  **  *...... .*\ *.@.# \.*... #
#.. .*\......*\ ***..\  .. \*.\.\.*..* .. . .\.*. ...\. .*\.*.....*..  \.\*.\.*.. .\ * .* .*\*\..* *.*\\ . . *\*\.\.   .  **.\ *.   # ##
#*.. ..*    \ . *.   **\  . .\. .\ \* .**  ***. **\.*.*. .*\.\... ..  \*  \\**\* . ...\ .**. W.   *.*... ...\* !  \. *\.\*.*\...* .\## #
#  .. * .\  *\ ..\*.* *** ** ..\ \. .* \.. ...* *\*\ ...*****. .  .  .\. *..\.*\ . .. .*.**.* **...!*\ *.  .*.* ..***. *.\.*.** .*\#   #
# ..\..\. *.. \.\..   **...  **...\... . *  . *\** *\...\\..\.* \\  \**. **\..* \ *...*.. . .  .*.\*\***..* ...  \...*  ..\. .\@ *. ####
#.\.**. *...\ .* \*.**.*\.   ..\.*\  **  **   .. . .    .\    * \...\... \ .*\   \ *. *. * * \. *..* *.. *..*.\ \..*\. * *   *.**\#. . #
#.* \..*..\\*  .* .. * .. *..\   \.\.**\F.\*.*.\  *  \.*** *.*.. \.**.\* . .*.*\*.  \  . .** . *\*\*...*...!  **. ..*\ . \ .\. ...*. ###
#.*  **. **.* * \*.... .  .* *   . *.*.* \*. *.*......\..   ..** \\*\ ..\ .**.. .*.*.*\..\ \..\... . \ . **....**\. * .  . . .* * . \# #
#.  . . ..*.* *. **...**\... . *.*... ** ..*. .\*.  \. .** . *.\ \*\  * . ..* ...\ .*  *.* ..*.\...\*.. **\.\..*. . . *. *   .. .   *\.#
#.  * .*....* ***...\.... \* *.*  . \ *.* .* .  .*\*.\.\ .*  .\ \ * ..*  @  .* .!! *   *.!  \*\.\***..  \.!.*. . . . **..  .* \*\.* ***#
#..*.. *\ . *\  ..*\ .. ..\**.\.  ..  . .. *     **. ...  *..*.. \.\  . .. \ * .@* . * ..\.!**. . !.  . .\.**   \  \...*  ...*@.... . !#
# .***\.*  .\* \**.. \ ..  ...* .*..**. * **..***.\* .... ***\..   ****. . .\*  .\ ..*.**   .    *  ...***.. @\! *... \. .  ..*.\.*.\ *#
#.*..* \.   ...... **.* *\  ...***** * ...**..*.* *  ..\.\ *. \  ..\ .  .*. ** .* ......\.*. .\.   \.**.**.**.**..*  *.  ... .. * .\...#
#   *.*.\. *\.@ *\ *. **..*. @.* \... \*. ..*** \  ..*\. ...* .*  .\! **.\.*@ \.\  . \..\. .*..**.  \** .\ . **. *. .*\\.  \* .*. *  .\#
# ...*..\.* .\.*.. . . .*\ . **\   .*\.**\ *. *.. . *... .  .. . ** * ..*..* \*  *\ ..*...* .* ...\ .  . . *  ..\.. *.   .**\ .*..#*..##
#*.**.*.. ..\.. @ *. *.. \ .\\..  .\  ..  .. .. \*  ...\ \ *. .. *\ @\ *.\ .  .  .*\*\. . . ..\.*\ .@***  .*.\...... *. .*...* . .*\.# #
#@*.* . . ....*\......  \  . ..\..\ . *.* \\* *. . .**.* .. * *..*  ..*.\.. \*... ..\ .\..\ ***. *. .. .*. . .. **.*\. ...**\.\* #*.*# #
#*..*. ... .***. **\**...*.* *\.\...\\ \ .... . *. \.\*.\\ .*...\.  ..**. .   *.  ** . . **.*@.*\.* .\*\. *. *\**.*. .\**##\*.##...##  #
#*. *\. . * . \  . ****\ .  ..* **. ** .. *.*  ..  .. *...\.*. ..    .. *. \ *..*  .\@.\  \**.\..\* . . .  **...*\* \  *.**..*##*#.#   #
#\.*\... *. . .*. *....\ **..\.\.\ \.. ****.  *  . . ...\ .\*.\.... . *.*.*...*.. @**\..\. . .. \* *.**.** .* **\  *W.* ...#*.# ##*#   #
# \.* .* .   * \\. \* * \.\  .\*  *..\...*.\\.*\*......****. *\... \ .*.* **...\. ..\*. *.. *. ..**. .\**.. ** * ..*. \. \*. ###  #    #
#\. ..*     .\ \...\. . .** *\ \.*. *****. *\ . *\  ...*..   ..\  .\.*  \ *\*\ *..  **..*\*.*  .\..*..\... ..* !. ...*\  *. *..*#      #
#*  **\..*\. .. \..*.!   .... \..\...\.*...*. \*..!*. \  ...\.  * .* ..*\ .*.***..** .*  .....  ..\* .!..**  .\ ...\ .*\**.\ .##       #
#.* ..**.\. \ .*. \ . .*.*  * .* *.  !*\ .*   ...  * \..  .*. . .*.**.*.*   \*\.....\.* \ \.** \....   .\ **. *      .*.**. .#         #
#*..*..*  *.*\***..... \*.**.  * *** **** *. .**.\ *\ *... .*. ..*..*\.!* . *.. .. ..*\ \. * . .*..**   .* \..    \*.* \ .*.*.#        #
#.  .**.  .     . . *.* \ .\* *. .*... ..\*\**.\ *. \ .. *  \  .* **.W !.* \!* .   * ..\.\  . . *.\*@\.... .** * ...... \...* # #      #
#  . ..\.\**..\.\. \*. . .   **.*...\.\   .*..\.*. .. * *. ..@. **.....*. ..*..\.* *.. *...*  .*.\ *.* *  *.*. **. ..*... *..**#*##    #
#.  .\....\... *.***..*.\. ***\*!.. .\ . *.*. * ...... ...*. *.**\* .  .*** .* **\ .. . .**.**.* **. .... W.*    ..*.. * \..\ . .#.#   #
# *.\ . .   @\ .\. .\*\.  *..\ . \ . .\..\...*\\.*...* *.*\*\*.\.*\. ...... .\*.\..  ...  .  \.  ..*.**. ..!..  * .*.  # .*\  *\*\.#   #
#... \  .\  .@ .   .... .*. . ..\ .!.\*. .* \!**.\.* *.* ...** . ...  *  .. .*** ....  *   *... \ .*\.\**.* .\\ .\* \  . *.  * *#..#   #
# ..\*.*...* *.*. *..\\. ..\  .*.@ *. ...*.* .*  ..*..*.  .*..* \.\ \*\**\ \ *.*\*\..\ . \ .. \...*..*  . . * .*  \ \  ....**..*.##    #
#*\  ... . . .** .. \..\. \  ** *..!*** *  .\ ... ..* \..*..\ ....*  ***.. ***@.*  .  * *.. *. \...* .. \..\. .*..*.  . * !... #.#     #
# *.. *.     ...  .!.\ *  \* .**..  *.*.* **   ** ......\.\\      \.\***\\ ..\. \ .  .. ...  **!....\ \ H. .*.... ** .*..\ @ \    #    #
#\. .\ .. *.. *\\.  .. ... ...**.....\ ......... \ . **.. .. *  *. ...*  *. **. .. .\ \. \...* .**@*.  * .* ..*.\**\  \..  ..  * ###   #
#...*  .\... *..\ .. . .!\ *   * ..\. **...** .*..*\.. * .* .  \ * \  *\***.\.\ *.**!  *....\ ..*...* *.**.\*.*...***\.\ * ... . . .#  #
# \ .**..* *..**.* .\... * .  \* *\.. .\ .  \.*.. .*\  .\ .* \ *.\*. *\ *..*..  **\....\\* \*... *\.. . ..  @..!\\*\.. ...*#\.****\ #  #
#\*\ .   *...  .*.@..* .. .*  ..*\*\ *.. .   * *.**. ..\*. ** ... ***\* .* .  ..... \   *  .*.\.\ .\ \.  .\**...*.* * * *\.***\ ..*\#  #
# . .    *..* \**.. .. *** **.  .\. . *.  .\..\W.. .  \  * *.* ....*...W. . ..*.. .. \*..\ . .!   .  .. \.!..\.   * ..\.**  #\.. ###   #
#***\ .@*..*...W\*.@ ..\*\.. ..  .* ..\  .  .  ..  *.*.* . \*.\   . ... .* .\...*. .... ... **\.. .  . ..**\ . .\ . .   **\...*..*#    #
#\.. .** ....*\... . . * * .  .*.\. .. . .   .*..*.\.  .\ ..!.*\ \.**....*    ...* *. *. *. * * * .. .. \.  .*  *.. .\* .* \ .\ **\##  #
#..  **.\*\**..\..  * .\.*.  *\. ..*. .*   ...** **.\\**  .*..*. .\. * * \ ..\.\\. *. .  *  \*.*\\\. \  .\ \ .   \. *. ..\   \*..\...# #
#*.\. ** . **.\.\*... W.*.  **. * .*   @.*.*  .  .*  *\.\ *.  ....** \ \....\\ ..\*\\.\.\***.\.!..\ *.\ \ . .**. *\  @. .***   . * \.*##
#\ .*  *\  *\  ...*!  *.*\ ....   * .!** .*.   ..\. *.! . .     * ..* .*.\ .   **.D *\.. ...  **. .... *.  * \ \.*.*. . .*..\.****.  .##
#*.\*.\ *...*..*\.* \.\*...*.. \ ..\ .\.. .* *\* *... .*\ \.  **. . ..*.\ .\.*..\*\ .*.*\..* ... * *\\ .   .  . ** .\ *\ \ . ***..  *###
#*...* .\ * \.\. .*   .   *\** .*..*..*   ..*\*\* \ *.*. . .\.\\ .* \.* ...**. . . .  \.**\....  .*.*.. . ** \ *.  . .\  . \\.#.*#.\\ *#
#*...*   .. . . @..\..*  \.\..  .*\.   **.... *** . \.\.\..  **\**.\ !.\ \*.* .\@ .*\..*....\.. ..*..  . *.\  *. \*\ .**    \* .*.#*.\*#
#\  .* . *.\ *.*. *.*\.*.* ..  ..\.  *...\*\ ..** .**..*.\.  .  ... ...\ .*.*  ...\...\.* . . ...\*\... .  .\*....\ * ..  .\...*..*## *#
#..*.** **. .. \ \.....*.* *.. .*.@ \. .. ..\  \..* * *.  *\*  \..  !. .* ...*.*...  ..\*. **.. *..  .  .*\..\.**   * .*..*. \**..#  ###
#\ *.\...*.**.*.. .* *\*.... * \... .    ...\.*. *.  .\ **\  \ .*\ ****\..*\\*.\.*..  .*..*..*. .*** . **\ \..*\.*@*.@*\\* ..**...*##  #
#. \.  \*\...... *.. \.* \*.*...*..**.. *\.\ . . \. .. .*. **. .*.*.**.*...\*\\*  \   .* ..*\.* *..\.*  *..*. . *..*.**!.* \*.\. **#.# #
# .\** .... . *\ .@ \..*  .*.   .\*..**.* \  *.   \  \ ..\..\***\*.*..  .\*..\.** .\  ... **.*. *.\.*!*... ...\\ \.*\***.**@*.\ . .**.##
# *..*. ** \  *   \ .!.\ . .*.* . .  .\*..**.***\\.*   *\ .* .** ** \ ** ** ***\* *. \.  *.*..\\. *\.  \.\\* .\  . ...*\..*..**.*..### #
# *.\* .* *....\ .*..\.! .*   .  \   * *.@.*.*..\* .\ ..* ... **... .**. ..**..  *\\.*\.* * \   .\@**\..  * * \ .*\.\.. * \\  . #*\\*# #
#**\ *  .**.* . * .. ***9. *.\\ .. .\* *\ .. \*...\     .\. .*..* *.\.*. ..\ **.*.*.*\**.  .*. ***.\..   *\ .*  **. .* *.* .  \ \. \.*##
#* ... .\.  ***.\  .  ..\\**. .. *  ... *.\*.    *!*\ \** ** . *. .\..**..*..\.\ .**. .. .*..** .\  ** ***  *. . .\.*.*. * *  ..\..  # #
#\ *.*  **.E. .   \  .  .*..*\.W. \. ....**.   \**.*\..* .* .*.*........*.* *.. *...! *.* . .\*  ......\   ..*\ \ .**\  \.**   *** ..# #
#*  *..\.*    .. \.* *..* . . * \..* * *\*.. \  *.\ **...\*\.**** *@**  *...**... .**\ . .*  *\..... *\  ..\\ .*..\.. . !\..*****.*#.*##
#.*.\.\ *   \*  .. * . *..*.. . .\ . *...* *.* \* . ..\. ..  ...\*..*.  *.**** ..* .*.  * \@.* *. .\...*@ \.*..***. .\ **. **\ .\.# ## #
#*. .. \.\* \.\. .*\.\... .. * .   \.\**\ **\. ..*.*\ .. \. *..W\. . . **\\..*  *.  .\*.*  .*....    * .  \*..**  ...**.!....*\..\\#   #
# .  .*  *..*.    .*.**.\*\.*... ...**..* .**.* .....   . *.*\ .  \..\*.*.\.*  .. ..* ..  *@** . \ \ ....* .  *. .\.*.\ \*. \*.*\** #  #
# \..*.\....\ .*. *.\ \\\* ..*\  .**   *.  *\.*.\  \*\ . \* \. . **.\ \*.\ *. ..* . .**..**..  .\..  . \ \!..\. .  ..\*.. . ..*\.@.#   #
#.  ..*.****.\ .*.*\..*..    **\ * . .\  .*\ ..\. ..*..** * .   ...\  ..*.**. ...*.* \*..**..\*..* .. \ \.* ..*.\ ***.\... \.\ #*.#    #
#*.*  \ ..* ..  .\*  \* \ .*.!....\..  *...* .\*   *..\*\*\.... .\ . *.\ ...\* ..\*\*....*. \ \ .*  . ** **  \@    .* . .\* .*\##.#    #
#... .*** \  \.. .  **\ \ \*\  **.*.* .***..  .*.\*..... *    \.\.\* **.* *\*.  * *. * ..\ . . .. .*.*\\*\...*.\ .. *. *\.. .\..\.#    #
#.W*. .\**.\.*\.. * .. \ * @\.*\ *\ .2  ...*\* *\ .*! .** .*. *..*.*.\..... \ . . .*...  .   *\ ..\*.\ ***\*\ .\**.... .*   .\ .##     #
#\***  .  \ .\*\. .. .\ \....*...\.   *. \*..!**.. ..\.* *.\..**\.*.*C.\ .  .\***. .* \.\  W*.***\.** ..**..*.*\!\** *...* **. * .#    #
#..**  .\A  @*.  .\ \  .* .*\.@  .  \..    *\. .  .* *\.*.\. *.\* ..  .. . .**.\.\.\* ........ ..*  *\ * *.*. ..*...\\..\ *.. *# . #   #
#\*\. \*  \..*  .\ . \* . .* *.  .**. . *\ *. . \\ *.. ..   *....*  \.**. * \.*. **.. \. ..  \   *.\ .\* ...  \.      .. *.*.\ *. *#   #
#\.. *.. *   *.. ..* .** **.* . .*\.  .*.. .*.!*   *\ * * \..*  .. . ..\**  .*.  ... ..* *..  ..**** \.*\ ***  *\ .** .  .**\*.! .\\#  #
#*  * .\ .. .***\\  .*....*.\.  .. .   . ! .  .*.**..\. ! **.\  **\ **\.*.. ... .** \.\ .. *..\ *.*.   .*.\.\*\! *..*.*. *.@*.   #.\.# #
#. .. .  .\. *.  *\. \*\ ...*\.\ *\.. .** *\.  . ..  *\@ @*.*.* *.**\. \. ..  ** **.. *. .\.. .*....*\.***.**@. .\. * .  .  **\**####  #
#..\ *\ .    ..  ..  \***.  \*. .. **. ...*. *.\..*  \ .*\ *. . *\.  .*..* \ ***.*\ \.*   ..  \..*    *.!\ .*.\.* . .  *\.\* #. #      #
#*  \...*\. **\..* . *.*.\  ...  *\.. .  *.. . .  .* .  . ...  ....*. W**.\ \.\.\..*. .  .\.\. *\. .. \@** .  .\*.\.\  **.. * .*#      #
#*\ .\ \.* ....  .\ .\ .  **...\ \!\.. \ ..\ \.* \*. ... ..*.. .*   \.*\..* .. * *.\.  . .** . ..\   .. \**\ .* .. **\*\ ..** ***#     #
#\ .. .\*\ ..**  .. **.*\ \. * *..  *\  \... ...  *\ *. ** @   \ \*. ..*... ..*. *. *\   \. ...  .* . .! \.  *.\..* ... \ .\.\######   #
#* . ***.  ..*.   *...**. .. \ **..**. ..\*...    *  .\  ...\. .\ ..! ...  .***.\. ..* *\ ...\ \.*.\* *\\. \..\.  .  \\\ . . .**. ..#  #
#.*  .\*...\.*. *.* . \*  .* . *\*\... **.*** *\ *.   \.   .*..  . .\ . * *.\.***\ *.\.**\  .  .. **...*.*.   *  \*\.  *\ .\... *.##   #
#*.*\ ...  * \* .\.  . *.\*...\..\.*.* *.*. * *@\ .\*.*   ** ****.* ...*.\ \  \. .\**....** *\**..\.\  ***.. . *.*.. ..\.  . **.*\#    #
#\*. . .\ \*.@.*.**. *.. ..\. .  \ ..*.****  .. *.  ...\* *\ \*..* \..*  * *.. .*.*.\ *  *@.*.\..*.    .  *** .\ .. . * .**. *\\#.#    #
#.\   .\\.\. .***. . .*   .*\...   * ...*..* .. *.*\* ... .@. . ...  *...*.. .\ .*  *  .*.\ \ ..*.    .* *\..*  ..  *\  *.*\ . # #     #
#\.**..  *.\.* .\**.*\.**  .*\* * .. \*!\ **  .\*.* ..\  . . ..** \.  ..\.**. ..\ *\..* !\ . ..\*.*.\* ..    **... *\\ \...* \ #       #
#.****..*\. ..*  .* **.*\.*****.*. ** .* ...    \...\..\*  .*. **\. .  \. .\ *..  \   .  .*. \..\ * **  **  *.... ...*  \...  #        #
# *.\. .*.   ** .** **.. *. ..* ..\ .*..* *\ ***@.\\.*\ * .**.  .. .\*  *\ ...*@ \  ....\.*\*. . **\. \**\*..** ! \...* .*# \#         #
# .... .\. ....@... ..** . **.. *..***.\* *.  . *\  .* \..  *       \  **.\...* ..**.\.\..  . \*.\ .\. .**\\.. \...* *.\ ...#          #
#.*... \!\ \. ** .\ *..   \*... ..  ...*@...\\**** *\. .*.... . **.. \ .* ..!.. . .* ... ... *.*. .*.*\ . ..\ * ..*. \  W....#         #
#\ \*  . ..\.\.\*  ..  *  .\..\..\ .\ \...\*..*..* .  .*.*. .*\ .  . .*.\ .  .*\*. . \* . *  .*.*. ...  .*. *.\.*\...! . \.##          #
#.*!. \**\   *..** *.*.\ . ..**  .  .. \   . *..@. \ \*\.**  . .\..  *.*.\.*.*..*.  * . \ .   .\..\   \*.\. . ..\*.. *\ ..*#           #
#.*  .  .\ *\ . ...**.*.. .  .**.* ** *.  \. .** . .*..@.* . \ \ .   **.*  * .\ *** .  ** * .  .. . .. *..\ *.* .*\  ..\.##.#          #
#* .\. *. *.. . ..\.*.*.. *.*.\ * **. ..*     .\...*\ ***.**.. ... .. .*. ** *...*. ***.*.. *\...*@.  .  *\ \  . .* **.. *.\#          #
#..\.@*.  .....     *. .*.\ .\ ..*\ .* 7*.*.**\.\ .*..\*.  .\ \.*.*  . .\ .. *\. **...\ . . *. * **\   * .....*  .*.\ ..\# #           #
#\**..   \\*\ *\.\.. *\* ...\\   ... .\\.! ..\.*.* ...  **\* \*  ..    . .*.*. **\\ .*.*\. *** .  .*.\ ... *..*  \.*..  *#.#           #
#*.*\  **   !*  .\*\\.*.\ **  ..\   *  .. \  * \*..\ . * \ .\.*..**\ * \. . .*...*..*..*   ...\...\.  .   *.* .  .****.... #           #
#.*.*  \.*\. @...\* .***. . \ . .  *.\* \ ...*\...\.*.\.   *   ...*..\ ...\  . * .     . .\.*....**.\* *.****. .\ .. *.  ##            #
#..\..  ** ...\.  *. .. .*   *** *. **. *.\* *..   *.*..\  **   * .. .*\***\.\\.** *\.\*\.*..*\* .*..\ ....\..*\\*\.\#..  *#           #
#* .*  *****   . ..\.* **.. ..\. ..*.*\.\*  .*    *\.\ *\.\\* *.. * .\**.\  .*  ..\. *** .*  \.   *.\*.** .   . ...\.#. # #            #
#..**@**.\*.    **..*.\.. *\   . *.*...\..*.\ \.\*\.*.  ..  .\..*.*.**.. *   \    .\**... **\.**\*. ***  .* . * .*. L#.# #             #
#\ .** \ *.    . \*..\.   **** ...**.*\**..**\.!.\* *..*\ * . *\. *\*.\     .. .\W*.*... \....@   .\*!* . * ..*  *..# #                #
#.  .\ . **. ... . \  \ **\.***** .*.. *. 3. .    \ \***.\ . .*!* .*..*\  .*\. \....*..\ !...\ \ .\.* .. ..  .. \..W #                 #
#* \. . .\*\\ .*... .*...  .*. ..  \ . \ .. * ** \. ......** *.*.*\.* .*. .**. ..*.  .\*  *.*..*.\ **.*.. .. * \. .\.#                 #
#\ .* \*. . W ***.. .\**\*. .    \*.*...*\. ..*.\. ..**\ *..\**.\* .* ..\ **.*...** .. . \.*.  .*  \. \.    *.\   # #                  #
#  *.. .  .*....*.**** *  *.***\\..\**.\... .  . . .\. \ .\ .\\.** ...\*.\..... \.* ** @\ \ * \\  \.. . .*.*.\.    #                   #
#*\.*.@. ..  ..\....*..*.*.*..**..  .***   *\ !...\  ..  .    .. *.*\*\.**..@..\.*.  *...  ..  *.   \  *..\. .. ..**#                  #
#\.  *..  *.** * \\  ..*.*. . \*\   .\*. .***  \  .* ..*\.\!. .. ....\.\.. ..*.\ ..  *.*  .* . ..   .**...  .W  *.##                   #
#    ..* !.**\ .     *..\. .  *..\ * **   .*@*.  *\\. \. **.\. \..\.  .  . .*..**...\ .. .*. . ...\* .....*.**#.##                     #
#.*.* .....\.  *.!.\.\\* .  *.. ..*** .*.*\****    *   * .*.  \..* *. !  .. .... .*\. *.*\*.**.* *. . \*\.  \@..#                      #
#. *\* **\ *  ** . .*.\*   !.*    .\.*.. ....\.\*..*.  . \....**.. .*. .. \.*.*   ...   ** *.. . *.\  **.*. #.##                       #
#..* .*...\  *.\*. .\\@. ..*** .*... .* .\. * @*\. .* .**. *. .*.** ..  \\...** ****.\..\*.*  .\.* ** ...#.* #                         #
#\ .W***.   .*. .. ** ... *\*. *.. \ ** . * \*\*.*.** *.*. ..*.. *.* *.*..   .*........ *.\\*   * .*\    .* #                          #
#***. .\.\  .*.  *.\*.*\\..*.. ... ....  \ ..* .* ..  \....\. ..**.. ...!.@   \ .*\\ *... **.  *. *. \\*\. \*#                         #
#.**\ **!*...*  .*\@.  .**.\.\ *.  . *   .. .**.*\.* ****.. *\  .*.\  .\.\..**. @.\. ..   .*\  . .*. .*.  #\*#                         #
#.\..* ...*..\ .......* *.* *... ...\......*\.. \.   .. \.*  * ...  *. .W.*...*.. . \ *\.. *..*.**   \# .*...#                         #
#  .*.\*.*. .. ..\\..\*.\*.*.\ ...*   \.\\*.**** * ... *. *\. ..    *. .. .   \ \      .*.\. \...*.#.# ######                          #
#.* * . **. \.\**. *\*.***\..  ***..*.  . . *. .  ** * .. *.**. .** *\.\\.\ *....\*\ .  .  .\ \ ..*. #                                 #
#.* ..  *..\..  *. . . *..@\..\... ** ... . .. \* *. !\ **\. ... .\*.\  *\\ * \*.\. ** * .\* . .*..* #                                 #
#.*    \\. .*.. . * \  .*.**. ...\*\\.   .* * \.* *. !*.\   * .  * *.. \. .*.. . .. ** .*..   .\**.##                                  #
# .\ .\...*\ * .\...  *.**\ *  ..*..\ .*\ *\... ...  *. * . \ . *.*. .*  *.  *  *\ .*.. . \  . **.  #                                  #
#\ .**.*\. * *.*.*.  ..\ *... . \... ...**\...\.*\*..\ *.   .** *\  *\  .\ . . ...*.@ ...*.*. .\! ..#                                  #
#.\*.\\.*.*@ ...*.\.\ \.*....*.  .*\.. . *!\\*...  \...\* **\**.\. ...**\  \* * *\.*.\.... .   W   **#                                 #
# .*...\\... * *. .\.\ .. **.   \\.*\ *\\.....* * * ..\ * *. ..*. \ * ..\ .** ..\W ..   **.   * .*#.#                                  #
#\  ..* . .*\. ...  *.*  *..  ..\. ...\ *   *..\\**\*.\..*.\***\* .\*    . ..*\* *\ @ ..\* !.\. #!##                                   #
# .   * \..*..*.  .\*.  ..*..* \.\....**\ \*\ .*.** ...* *** .\ ..*..*.* .. *.*.\..   .  *. . \ ##                                     #
#\***..*I\ .... .*.*\.**...  . *.**. * **\. .\ \. . .**. \.. \.*\.\*\*\.   \...     \.*... *.  # #                                     #
#...*..*.*.    .*...*  * \.** **..***..*..*  . W .\ * . *..\  ..* *\ .***... **...\W*.. *.*\.\*..*#                                    #
#*@ **.*.\\.*.  ..  * .  .\.*\*.\ *.. *.* . .\*.   ..  ..*\ . *\. ..*. ..*\**...*\* ..* .   .\####                                     #
#.\ *. .\  ***  ..* *    *..  . .* .*\.*.  .* *\.... *.*.*..  \. * *.\  .*  ...\ .\ . . *. #\*#                                        #
#\. .   \...!..* *. *\ .\*\\ ..\..*.** .  @ *..  .\*.. .\... \  \  \* .  \.\ ... \*.* #     *#                                         #
#*... . !   ..\. *.**....\..\ ..* ***. .**.\  *\ **..\...\*  .\.. ..  ... \*..*\* ..*  \\ \*#                                          #
#@. .. .** **..*.**.\ ..\ \. .\  *.**.***...* *.\***\.***. \*\  . .  . \ .  **. . * .**#* ##                                           #
# . * .****.\* *.* .  ...\  *\.*.\... *\\  * ..!.\** *..\. .*  \. \.**..*\ .*\..# #\# .#.* #                                           #
#  **. .\...**....* ....\* .* * .* \.*.. .\. \..*.*\ **.. ..*  .* .\*.* ... *.# .# ###  \\ #                                           #
#\ . .*..* *..\..*.\\ \ \. *.*.\ !*.* *\ **\\ .*\*...*\****\* **. .##\*** . ..**..##  ..# #                                            #
#   .\.. ... *.* *.  *.* \ *... ...*\...**... \**  . \. ..\.. **. ... \ .. . #*  #.##\ # #                                             #
#***.***.... ****.*.\. * .*.\*.  *\  . ..\..  .  ...\\.......\#.\*  #**#*\.\ #\   * ###                                                #
#... ..\. **.!.. .\. ...* ...... .*.*  .\ . \...* .****  ..#..\@\#\\##. ...*\* \  ##                                                   #
#*.. \ * *\.* \.@.* \* *.** *..@* .*\ *\.   .. *.  # *.**  * \  #**@*.\   .\#\@#\#                                                     #
#.. *.\. .*\#\... *  . * *.\.*..\#** *... .\   ...  *.* \*.* ..*.\########## ## #                                                      #
##.G ...\ ..**...\\ \ *..\ ... ..* . **. .\..\. .\..\#  \# # *. .#                                                                     #
#...\*   .  .*\.*..\..\ .*. \    *# .*..  *   \  ..\..    .  ###*#                                                                     #
#.**.  .  #..* .*...*.*...***\**.\ . ..\*.. ...  *\.*. .*. # #  #                                                                      #
# . \ ** ## *..*.\ *. *\ \*.. .*.*#\##*.*\ *.* . #@\. \  #\##                                                                          #
#.*  #*..*### *.*.\. ..*##**\  .*\**##* .*  *\  ..\ ... .##                                                                            #
##.\*#.  ##.  ... * . *.*#*.\. *#*.#.#..**.**..\\*.# \ **.#                                                                            #
#* ## ###  ## \#***  .. \ *.*\. .###\.*.\....\ \.* \#. ###                                                                             #
#.#         #. ###* .. *#\*#*#\. ..*. ** .  \..\. \# ##                                                                                #
##          # .#  # ##*. *.#*  . *\.\#..\.*\ \.* .#                                                                                    #
#            ##    # #...#*\. ..*.  .*..** .\. *.*#                                                                                    #
#                     #\# ##.#  \  .\#.##**.*  **#                                                                                     #
#                     #*#  # #\ #\  ##* #..#. ...#                                                                                     #
#                      #    ## *.***# #\###\*..\*#                                                                                     #
#                            #.\#.*.#  # #*....#*#                                                                                     #
#                            #.## #\*#    #\# \ #                                                                                      #
#                            # #*.#*#    #. \ *.\#                                                                                     #
#                             # # ##     # **#.##                                                                                      #
#                                #        ##\. .\#                                                                                     #
#                                           # \##                                                                                      #
########################################################################################################################################

Water 142
Flooding 13
Waterproof 4
Razors 46
Growth 34
Trampoline A targets 9
Trampoline C targets 9
Trampoline B targets 8
Trampoline E targets 7
Trampoline D targets 3
Trampoline G targets 2
Trampoline F targets 2
Trampoline I targets 2
Trampoline H targets 7