############################################################
# *..  ..\.*.\ .\...*.  \. *.. \.*!\*.. .***.. *\.\.**  *. #
#.* . .\ \.*.  \ .* *  ..* ..  .*.!*.*\  *...* ***... .\..\#
# *.**\. .\*.*  *.. . \ *.. ** *.. . ...*..\ ..**..*.*.*.\*#
#\.\.*.  ****.**.. . ..*..*..\ .*.\.*.. ..  . .\.... *..@*.#
#...... ...**\* *.**.\\ \\..**  . *..** .\ .*  .   *****..*#
#. ..*..\. .. . ..\..\*  *. *. \. *. *.\. ..\.\. .  .*. \\.#
#\. .\. .\*   .  .. ..  .\. . *. .   ...\ *..*.... *\.. .\.#
#. **..\..*\ * *..\.  .* . .\...\. .* .. . \*..*.  .*.   .\#
#\\.. *  * . .\\...*   .W\.*.. . **.\.  * . \ . ..\ ..  *..#
#**. .*...\.  ....*\. . *. ..\.\ . . .  .  . \**.*. .. .\.*#
#\.\ *.*..\ .. *..\*. \ *. .\..*..  \ ..\ ****.\.* *\  ***.#
#.  \*. *.*  *\  . \ ....  * *..***... *. . \...\..* . .\*.#
#\\ ... **.*..* *.  *.. *\\*.. ...*  \*. .... ......*.*   .#
# .. . **... \... . .*. . .* ..  . \. .***.  **. .\ * . .*\#
#. .*.... ..*. .  *\*.\ *.*.*.\ *.\. .\. *.  .*.*.. .... ..#
#.  !\.* . ..  * ** .@.*.\.*\.. .*.  ..  .    \*.. .*  *.  #
#..*\*     \ \*.\. **... * *. . \.* . *\**..*\**  .*    *\\#
#\*..\.*  .***..@ .@.*.* . .*. *  .. *. .\\ *. !. .*...**..#
# ..\  * . .\\* *   ....\ **\  .       * *.\..*.  *. *.\\  #
# *\. *.\\***...   *\. **...*. *.*.  .*. *..\*.* @. \..\...#
#**\*...* .\.  * .***....   .. \*.   .. .*\**..* \.*..\ .  #
#....\ \ **  W* \*..\  \. ...* **.*. *...*.\ .*    ***.*  *#
# ..* ..\.\.\**\ .* \*. .** .*  . ..\. ***.*\..  *. W.\..\*#
#*  .**\.. ***..\*.* . * *.\*. .*.\  \. .. .  *..\.\.*.  \.#
#. *\.**** ..*.. * *   .....\ *\.*.*... * **  *.   . ...*..#
#@ .*\...\.. * \ .*.    .*\*. \  . .\ . ... ...\  * .\. ..\#
#@\..*\ ..\  ..*  .  * *.*. \*. *  * !**.  . **.... ... * *#
#* \..** * *.... **  . .\.. ..* ....* ..  ..*.  * .\ *. *\*#
#..*.\*\. ..  * *..\* .*.. \.**   .\.. * *  ..  ..\ ** *.* #
# \**..*   W*\\...*.*. .*   .... * * * . .  .. * \ *..   @*#
#*.... .  ...*..\ . \  .*  .** W.\*\ .\*. .  .*.  \... \...#
#.*\.\.... **.\..*.*. . .\....  ..*..\..* . ..*..*\ * ....*#
#\...*.. \. ..*..  *.. ...*    .\ . \!\. * .. * \..... **\.#
#. ** *.   \ \. \ *..*.*. .*  .     !*  \.. *. \.\*.*\  .\*#
#* .*\  . *..\*..*...*\ .. ***.*\.........\ ......... *.\**#
#.. * .**WW * \. ..* *.\..  *... **.@ \..*    .**\.... *...#
#*.\ *\.**... !*. .. .\* ..*.    \*.. *\\.  * *.... .**. \*#
#.  ..* \.    .* \.\. ** * .@\ ! ..  ....*\*\ *  \. ...*..\#
#*.\  .  . **\** .... .* ..**.. * \ . \..@.*.\.* .\\.\*..* #
#*.*.*.**   ..*.   ..* .*   * *.      *  *...**. **. .*\ . #
#*.\.*\.... .\.*  \ *.. ..  .\*...*.\ \\ \* \.*...* \@    \#
#  * * .\.*  ...   @.   .  .  ** *.*.\**.\.*. .* ....... *.#
#.\. ...  . * .\  . . .\ ***. .\.\.*. *.*.*...\.***..  *..\#
#* . **..*.\ *.*.* \  *....* \\.\..  .\ ...*. .**.\   ****.#
#* *.\ .*.. ..*** .  \.\ \ *...\ \. **.*.. \  @** *****\.* #
#* \ .*\*.!* \*** . *.! \ ..  \ *.\ .\...**. .... *..*\.*..#
#...*\.*..**   *.*.*.*\.\..   . .\.*....  *  . \ \.\..  * .#
#.*.**\.* \.\\ .\*.W...\ ...   .  *..**..\ . .@..  .*\ .* *#
#*. .**\.*.**.* **. * * !* *. **. *!.*.   .  *. .   . ..\ .#
#*.**. .@\ .. \ **..*\ ..**.*\ .* . *.*\. *..\ *\.* .. .  *#
#. .*.  ..* ..  *.*\   ..*.* .* \.**.. ..*.....*.  ...   \*#
#\ *. *. **.  *** .*.\**.* . ..*  ..\ .* .*\.\ *.***.\.**W.#
#. \.... .\  .\ .*..*.*\*   .  .  * .. .\..** \. .\.**..*\ #
#\..*. * **.\*  .*.**\.\..*! ....*.@* ***  !*.\**.\.\.. . .#
#*..*. . *. *......***\.....\. .\**..\!*\ . . * \..  .. . *#
#. *.  *. ..\\ .*.*\..*. *.* . ..*. . *.*@  .\**...*.***..\#
#  .*\..\ .*.   . \ .\..\.   ..\.. .\.. .*.  *\..***!*...* #
#.   .  \\\.\    ..  .*..\\**\ .\* *.*** *. *!*. **. ..* . #
#* *.  ..\*.* ..\*\.*\*\  \.* \.\.\  *.. .*\....*...  .*.  #
#. .* .! . \. .    \. .   .\\*... . .\** *. *.*.** ... \. *#
#...... .  *. . .\..*.  .*. \.\ *.\ .***.\..*. *..  \.*.* .#
#   ..\..* .\ .**.\ .\.*\.. \  .***  *.**.  \\.*....  .** *#
#*.  .. \.\ .  *. *... ..@.  ** * .  * \!\.\. *. ...  \..\*#
#*.\ \.*. *.@. \ **.*\*  .\  ..**. ..\.  .\.* .   .*.  . \.#
#** ..  *.\ W...**.***.. .     .*.*\... ....*.*. *   .  ..*#
# .    .... ... ...\.* .    .  .. .. \  ** \*\ ..  . ... \\#
# .\   *.*.*..\. ... . . .* .. *\   ..\...  . **\ *  ... ..#
#*... .** ***... .*..  .\ .\ *.\... . * * .*.*.. **\ . ..*.#
#.*.*....\\..   \**... \.  *.  *.\. *.. \ **.\ . .   . ****#
#.*...   ..\ **. ....**.@.\ \ ..\ *.**.. .\. . ** .*.\.....#
# * \.. . ..  .  *.  .*@*.  ..  .* .*..!\.\*   *.   *.. ...#
#..    *.\*\*** .... *.\*.. .\.\.*.\ \* *.*.  .  ** \**\ ..#
#\ . **..**... *.@.*..\ *..\ .*. .*.\.**... *  \..*.*** *! #
#.  .... \ *.* *...**...*. \  * *..  ...\*\ .\**\ .* . .*\*#
# ...\..\ *..*. .*.*.. *.  ...* *. ..\.  ....*..*  ..  .\. #
#\*.\    *.... ..*.**. .\..\ ..*..\ \ ****.\ *..  *.\.\..\.#
#..*.\*  .\.*  ..*\*.   . .*..\. .....*..**. \  \... .  \..#
#\.* ...\  .\.* **** \.  *...*.  .. \...****\* *   . ....*.#
#*\\. *\*\.!... *..*\.***\.*\\*\**\ .*.*** .*.**.**. ..***.#
# ** \..\* *.*.*.... .*.. *.\.. ..*\ **.*\.  ..**..\.*.*.\.#
#.\.\. \***\..! *.  .**  *.*...  \. ***.. ...**\  . .. ..  #
#  *..  *.\**.*.\. ..*..\. *  *.@.  .....  * *..*.**.**\.*.#
#  **\*.**...\* .*. ..     *.*.\. .. ....  ...* \*. .**.\.\#
#\*\..... . . .  ... .*..\ * ...\.   .. .\. .**  . *..* ** #
#.* *.. *\      .. .  * .*..\.  *.** .*. .*.*.**W... \.\*.*#
#\. .\.\\..*. . . *  *. ** *...***.****\ \ *...*.*\... ....#
#!. *   . \***.. ..\*..*..*.  ..*\ . .. \***  \... \!.. *  #
#\ . ..  .\.\.*.\. ... . ..  \**. *  !  .*.  \* . *..\....*#
#* *.   * . ....... .\ * . . ** *...*  ***.. .   \.\..\ * *#
#..  . @\ .\* * .\*  .**@**  . ..\*\\.*...\.*.\.  .*\...\.*#
#.* .\.. \ .      *\...*.\*.*   \. ..\. \*. ** .* \.*\ *...#
# . *   ...*..*\\.*.*. ..*..    \.. .  \ \*..* *\ .\. .****#
#* ....  .. ..*.. \ .    *  @  *   \  ..  .*.. . * *   ....#
#.* . .* ..***\@.. *\ . *.  . \* *\  .* .  ... ..* .... *!\#
# ...  *.\\.*...*.  ....*\*    .\.*    ..  *.... ..**  * . #
#\    ..**\ .\ *.\ .*.**. .     ... \. .*\ .\ \..  .. \.. *#
#*. *.* \. \*...*...**.*   .*....\.   *..\.  \*.\. ** ...@.#
#*. .!* .\  .* .**!.**.*..* .\\. \..**  .*\ ...*..* . ...**#
#.\. **.*....*\ .*..\*.\.*\    *   \ .. .**. .\*.   *. \\\.#
#\.  .\*...@ .  ..*\ ..***.. .*. * *.*. *..\ .***.***...  *#
#**\*..*.\...* . *.*. .*.\*\ ..* * \..****. @ .*. .***\\.\ #
#\.*\* .** *.*\ .\.. . .*.*   \*  . ...\.\\ . . ..@\....* .#
#*..*... .**... **   . *.\. \*.\ *.\.**.** *\ ..*\.*\*...*.#
# ..\\*\\.*\.*\. ! *  ***.  . *.   *\.. .. . \.*\ \.\*  \..#
#. *..*. @..**   *.\.*.*\*\.\.. * \.*. .**\ ...\ .   ..\.*\#
#* .\*.*\.  .\\...  .. .*....\ *.  ...\ *.*.   ...\.*  .*. #
#\* *..\*\ .*   *.   * \ *.** ** **.* \ \ \* \.**\. ...**\*#
#...*.*.*.*\ \ * \. \.*  * ..\*. @ .  \*.*\*..*....*  .*.. #
#.**  *.\.. ..*...  . *. \..  . ***  .....*.\*.. \...* . ..#
#. .  .*. .**.. . .   . ..* * . *..**  *.** ..* .  \\.\.** #
#\ *****\.*. *.. ..  .*\  .*.**...*.*W\...\  *. . .. ..*.\ #
#....\.\. .  . . *  . ..**.\.***\ \**.*\ .. ..\.\* . ***...#
# * ***  \.\*..* ..\ .. .\ *\* .. *.\*.* \..*\.* .\  **\.\ #
#..\*.. * \..*...**  ..\.*.  .*\.*@** * \ . .* .\  .\. *...#
# * \*.... ***.**.** ....* .\*.* . .\ .  . .\    ..*. \ ..\#
#\.\**    ..\**.. **\. .***  . *..\   .*.*  **...*..  .* \.#
#\  ...**..*...  ...\*.... @\* *. *. ...  . .*..*.. .. ...*#
#  .\. ** .* \\  \ ***.. *\.** *..\** .\.*   *.*.. * \..* *#
#*     ..*..  \.*..*\. . ..**..\ *.**   ****...* *.**.\.  *#
#*.**.  .**  *.  \   . *.***.***  **. .*\\**. .\..  *  \@..#
#  ..\  *!\!*. *..*\\.\.*\. \**. .**  \ . ........W\..\.@.*#
#  *.\*  \.*\.*\ *..**  .* .*\. .*.... . * . . .   \  \ .  #
# ....* ..*.\**. ** ..\*\.\ ..\   *.\*.* *.\.*   ..@ .. .. #
#.*.\ . ... .*. ... . ..*.. *. .\\.  . . .  \. .....\* .*. #
#\.* *\. ...*. ....\..  * * . ..*\* .   .*\   *\\*  ..*.\..#
#*.\\* ...  * * . .\ \.\..*  .**\.\\ .**  * \*\... ** * *. #
#*.. * *@*  * .***@*... .****.. *.   ... * *** .* .\..\  .*#
#.** * \**  * .*.. .**..*\ ......\.  * \*. . .\.\ ** ... .*#
# *\ .   * .*\\.\*..*\ \. .\*. . .. \\. . .*..**....    ..*#
#\... ..*.  . \.*..   *...*.\ ..** *\..   \* .... \  . \ ..#
#* *\*  .*  \.*\*\  .\.*..** \.*. ** .\*  .. **\..*\\*  *\*#
#* . . *.. ...\..  .   ***.*\ *..\.*\* *..   !. ***\*. *.  #
# *..\....   \*  .* *\ *.... ..*\ .* ..\*W* * .* ***.\ . *.#
#\ . *..\  .* . *** ..  \..  . \ . .\**..** .* ..*\ ..*  *.#
#!.* .. . * W  .. * * . ...*..\.. *. *.*  \*\.. .\\\\    .*#
#\ .*.***..  . *\*...*\.*.* ...\@ **.\* *..\* .**\*\.** \..#
#.\ *. . *\**.*..  *.*. \*.**.\..  \ .* ..**.**.. *    \ *.#
#*...*...*.!\.  \.\.  ***.* \ *.** ..!..\..\ \ .*.  ..*...*#
# @\**.\ ..*. * .. *..  *  . ...*..  *    **\ ..*\*\. *.. *#
#...*\ @   .  .* \*..* .*  *. \ .. . . \.\*..*..\.. \ .*. .#
#* .* .\.  .\..\..* .. .** \*. ..* .\...\.. .\  *..***\.*. #
#...*\... .\*\   ..@* ! .* .  ..\.*\ * . . .@.. *\ .*... ..#
#\** .*\ \. \. ..\\ .  \ ..*.* ***. .* . .\ .. \ ..  * *   #
#*\.\.***  .  \.....\.  *  . .* .*\. **  .. *.*.  ..*\. \ \#
#.* . *. . *\*..*..\*\ ..* \  *\*.. *\.*.\@.. * .  \. .. *.#
#\. \.\ .\ . .*..*..*.*  \. .. **....* *...*.\.   .\ *.**.*#
# *.. *. \ \* .......*\  .* .*.!\   .***\*\*.*. .. \.\... .#
#*..\*.  ...** \*  ***.\   \..\**.*** ****...*. . ..*\   . #
#\... ..\.*.*.*.. \.. .**\ . *. .  *. .**. .*. . . .\. !.\ #
#**   .**@. .  *..*... .*.\ \.. .*.\.\*.* .... .. \.*\   *.#
#@\ \.*...*.\.*.\\***..*\  *\ *  .\. \..**** \  . . .** *.\#
#*..! ..*\ .\... \! . .***\*.\*\**....*\. ....* *. .*** *.*#
#. .    *....   \.   .*. . . ...*.*  ...\....* !  . .*****.#
#\* .\ W*! ** **  ..**.. .* *.@ .\*\  *\.  * .  *..  *... .#
#... *... .*..\. *  .*..\.  * \\... * *. \ .   *. !.\** .\ #
#..  * *.. ..  \ .  \ .* *  *...* ..* .  .  \**.\ .. ..  ! #
# \\ . ....  .\**..\   .  \...  . .. .  ** . .***   .  \.**#
#*. .*. .. \.  *.\*..  **\. \ .\.  .**\..*..**..\!.    ..**#
#... ...\*.*\  ..\ \\.\*. *.. ..* * ..    ..\*.*\*.\\. *.\.#
# *      .\\ **.  ..* *\*..*. ***  \. *.**\ .*.. ..*....\*.#
# ..@ * * *\.*.*..... ..\. .  .....  ..\*.****\.. \..*. \ *#
#*.. ...*\.\ ..**.\ *  .*..*.    *.** .. ..... *\  *.   ..\#
# .* \  \*  . .**  ..!.. .** .\ *..* \**..   * \*. ..* .\ .#
#..* .* . @*       * .  . ** *..*\ * .\...*\*....    ..*. !#
#.!*.**\* ..\*\* ** \**.*\ . .\..*.** ...** .* \!*.\*  . * #
#. ....*\** !*****.*  . *** ..** .* . **\.... .\.**.*. .\*.#
#\  . ...**\*....\.*\*\. .. . *...*.**.. \ W*\.  *\ . *. \.#
#..\. . ..@\...... .***\ @\. ..\  .\*...\   ..*\...\. .. . #
#\ .. ....* * .**  ...* *.*@\  .\* ..   .. *.  .  *.\.*..*.#
#* *\ \. *\.*. .\.\ *..\..***.. . .*\.   .\*   * ...  \* *.#
#....**  @ *.*   .*\.*@ .*\ ..\... .* .... . ... . *\ ..*\\#
# * **\..... * \*\\.\\* *** *. .\.. W \ \.. *..  .* .* ..  #
#.* *\  .\!.\.*...*.... @. .. *  .  \.** ..*. .**\..\.\*..\#
#..*.\.. *\*  \ .\......* .*  . *\... .* *.*..***  ..* . . #
#* .\\.\..** *. \ \..\  .**\ .* . **.*.. *.  . *.\.* . \.. #
#   **.*.**. ..  .* ..*.***  .. \ **. **.....\**.**.* \.**.#
#. **.\ .\.\.** . ..\  \**\ .  ....* ... *..***.\*\ .* *..*#
#.\.. *. ...* .****.. . .. .\  .. .   \*.. @\.\.*.* .\*.  .#
#*. * .\\*.. ...*.\... .*\@*  \..*...... .** .. \* **..  \ #
#..  *\*.\ *  ... *.\  **...**\.*\*..*...*.*.\* .\ !.*  . .#
# .*.*..*..* ....... \.... *.\ \ .\.* .\ \ .. . *. ..**.\**#
#\\*.*\*. ****.  .* \* *. *.\ . .. \  *... ..@ ** ..\\..* .#
#* * ***\*  .* ..*.\..!* !.* .  *\ .* . *\..** .*..    *\. #
#... ..\*@  **.* . **  . *\*\ \....\** \. .\... .  ...\. **#
#**.*!. .\...\.*   \*... *   ..  . ..\ .\  . \.\  .W* **\.*#
#.*.*  .*....**  \.\. *. .....*  * \...* *....* \.  *.. ...#
#.\ ..  \.\*. . *\*.\.* \\ ....*.\ .*. *\.  .\. \ \ . *\.*\#
#.  . ... *.*.*.*.* ...**\. \ \! .\ .*.* *.   *\.*.\..*.\ *#
#\..*...**. \*. \.*  . . *\. * * ..* .\....* \*.!..*\.. . \#
#W.*  .\.. **. @ *...* .*.  *.\  . ..   **.*.   * .\**.*. .#
#..   **\ *.\. . \. \. * ..* . .   \.   ***.\ !  .. . ..*\*#
#.*.* \ . *. . ***. . ..  \ *  .*. ...*.\.*..**  . \. . * .#
#\. .*  *\\   ...*.\ . \. . ..  .* *.\.\  .* ....  *.   ...#
#. . * *\   ... *. ***. .* ... . . * .*..   .\. *.. \  . ..#
#  \.***  ...\\.  .. ** \.***\. \* .  .*...  *\...\.     \ #
# .W.*.. ***..... **. ....\*.*   \* !.*.* .!..    \***..\ .#
#.*. **\ *. * *  . \\* *. ...* .. .... *.\  ..\  * . .\.***#
#..\...*.  **\.. ** .\\.*\\  . .. .\\ .*.\ \*. . ..!*\*..\\#
#**..  . *. ..**.*\    ..* ..\  .. *  *.*....\.*.\.. .. *. #
# .   . ...  .* ... \. *.* .\  \  \***\**.\. . *. \ ** **. #
# * \\.\*..\ ...!  *\..* .\..*\.\.  .  \*..*.\.!.. . * *. *#
#    .*@*. .* \. * *.  .  .\.  .  \..\ ..***\ .\  *\**..  .#
# * .. ..   *\  ..  * .*. .. .. . ...*.\*\ *  * \..  .. .*.#
#...\. .. . ....*. *.  \ ..  W ..\* \. ...\.\ . .  \**.*\.*#
# *\.*.*. *.** ** **\ .....  * \.\..\ * \...*.!* *\*\**.  .#
# **  .. * *.*  *...   . .\*...**\* ....   ..\  ...* .*\\. #
#\.*..\  *.\   \   **.*\. *.\ \..*.  \. . \.  .* * \ ..*. *#
#.*.. .*.* *  \.**.* .\*\.. .  \ *....  .\...  .\** *.**.*.#
# *.   . **.  *...  .....\.*.   *..**.* ** \  ........ ..*.#
#.. . *.\.. .\ \   .@. *   ...* .. ..\*.\.    *.  \  ..  !.#
#***.  .*..*..\  \*\.\ .  .*  . ..* .!*..  .*!\*.* * *  *.*#
#...\ \. .*.. * ..*...\.   *\ *.**..\. .**. *. .@ ... **.\.#
#.\  ...** **.*.*\. * .  *....\ ..\......\**.*..\ ....*.* *#
#...*\*\....***\..... ** \**\  \\  *\ *\ ....*\ . *\.\   **#
#**...    \ ...    .  ..*.**.\.\ .\ *..  *  \...*\..*\ . \*#
#.  ***\  .*.  \**  \**.***..\ .*.  .. .\.**...\*\**.*** ..#
#* *.\*..*\.  *.\**\*.\*..*\  .\...@ .\*  .* \ * ...\... .*#
#*** .  \**.\*.*  * *  ..\*...* .  .\ *..\ . .*\ .*\. @\. .#
# .. .\* ..\*.... .*.* . ****.**. *..   **...* \  ...\*\   #
#.*!* .**.*  \.*\ *.. .\.\\...\*  .  \\.*\  ..   ..... .  *#
# ..... .\. ...* .. ..\..* ** @ .\ *..*..!    *..*\   *..\.#
# ..\... *.  *\.**  ...* * .* \.. *. W\. ....\.\. *..*.* ..#
# \.**.*\ .  * .\.. *.*.* ....  .*.  ...\.. ..* . \ ..*\  .#
#.. .\*\...**.\*..*\*. \.  .\*. ..***. * .\*. *...\ \*. *\.#
#  .\ .    ...*\.   .. .* . ... *\.**. .  ..... \ *\*. \. .#
#**\.. .... \..   . . ..  ...\  .*.*.*.  ...@*  .\. \   .  #
#.\.**  **.*.*  . *\ **  ..\\.   !*. .*.\.*\. .** \  .\  ..#
#....*\. \****. . * **.*\.\* !  . ..* * .**\..*\.\*.. ..\*.#
#* *. * . .* *\ *.\*.*...*.\.\.\*.* ....  ***.. . \*   \. *#
#..\*.* *... \  *. *** . ..     *\\   *..**** .** ..\*\.. *#
# .. **\ \** . *.\ .\.\.     \ * \ ***** * .\ ** \* *.*. *.#
#..\.*. \.*. * . ** @.   \***.*..*. ...* *\* ..\ ..\*\*!   #
#*.\.*.* .   ..  *..*. ... .* .***  .  .\\ *.*\   .*\.. .. #
#* \. .\ *..*  .\!**. .. .\.. \*... .\@ .. .***..* \  .* * #
#  **\ * .*\* .\*\.... . *.*.. .\\ **.*   .@*. . *\.\ *. * #
# *.*. * ....* **\  \ ** .*... . .  *\...\*.**   *..  *. *\#
#..**  .\  .\..* ..\.. * *\**.*\ * .*   \.\ *\.  .  .*** . #
#\..  . .*  ..\.\**  .\. .\ \\. ..  *.* ..* ..*..*.*.\ ..  #
#*.. .  *\\ * *\....\*.\. \..  \\\.\. .  ..*.  **.*.* \ .  #
#  \ .\  .*.* . *\   ..  *  . \..\\..*.  .\**\.\* .*.\.*\ *#
#..\ \.  ...\. *.*. .. *\*  ! \...\ ..\ R ...\.*...\* \*  *#
# ..* *... . .\. .*.. .\. \**\.   . * . .. *\*..*. *. .* .*#
#\.*..*\*** ** .*..*\.* ...*.* * *.*. .*\ *.**. . . ..*. *.#
#***\.... **.**.!.*.  .\ \..***..* \.. \!\*\ *. *.... .. .*#
#**.* . .@*\ .\.  .*\..*... .\.. ..  *.**..  .\. \ . .. **\#
#***.   *. *.*  \\   .  . \.  ... .\ @*...*   .*..!...\ .*.#
#*.. \*.*... . ..\.\  * *.** *.*. .. @\****...*\*. .\ *  *\#
#.    .\@.\*  .*.*   **\..\* \  \ * ..\*...**\ .*.** .** .*#
#\... .**  .. * ....*.*** **.. .  *\.*..\ *.  *  \..\.... .#
#*.  ** ..*\  .    \ .*.*\ .\**.*.*  \\\ ....\.*\..***  . *#
# .\... *    * .  .  . *. *. *.*\*\ ...    \.*\.!  *.\ \ ..#
#..@\*\.*\. ****\ \.* ...\*. . .*.. \.*.\ * \**. **\  ... *#
#...@. ..\*.***.  *.\ .*..*.. . *\.*. .  .* . \***.**. \* *#
#.! \\.. ..*  .....*  .\  *.\. . . *.. * \.*. .**. .. \.  .#
#..*..*.  . .\ .*  . . .* ..* .\**......*. \**..\.\. ..*.**#
# .\**  *\    .**.. . * . \...*...**@\.. .\ \*\.*.*.  .!..*#
#.  .\*.. \*.\ *.   .  .\... \*.  .. *\ \..\...   **** * *.#
#*.*.*\  \... \.*. @*.*...\. ...**. ** * @\*.\* .\*\. .. .*#
#..\*...*.\   @\ *.*\**\ **\..  \.  .. \ * * *.. .  *\.\  .#
#  **...  *..\.  ...\@@  . !**   .*\ .*.**.\ ..  .  .*\ .. #
# \*.!\*\\.*\*  .\.*.\. **.\*. ..***. .* . .!. W.* . ...**.#
#. .. ..\* . .. \.*.. *.** *\* .   .\.\**  .... *.\* ..\..*#
#\.*\.\... .*....*\*.***..  .* ..* ... ...*  ..*.\ ..*.  *.#
#.\.*\.* ..@****.! ...*\*\. *\ .* . \*\* *..\..* .  ** \*. #
#\  *..*. \** ..*.. ... **. ...*\..... * *.*\ .* ...*.\* **#
#.....**\.*.*** *\ **.....\ *. .   .*\.\ ..*.* .\..*. !..**#
#**  .\*\** \.* .. .*\ \ ** .*\\*** .* *.\..\*.. * .\.. .\*#
#*.\.  *  *\. ***. .\*!\ ...**  \ . .*\.\*.**..*\..  *.*\.*#
#\*.   * *.** *\.\ .*\..*. .\.  .\.\ * *.....  *\.*  .\.! *#
#*.***.\.*.\  ..*.  ...*.  *. .. *\*.**. \  ..\  * .\.** *\#
#.. .* **. * *\*    *.*.\ \. **...*. . .  ..\ .**.  ...*.\ #
# *\ .*.. * ..*  \.**\ !  .  ..*.\**..  \.\.   ..\*. ......#
#\@  *****\ *.\ *.\..\..\   . ..* ..    . * \ *. @. \.. .\ #
#.....* *..  \. \ . ** ...\   * .. \.\....**. . * \ ..   ..#
#  \*.\*\*.\.   ...\*..** .  **.*. ...** .\\ * *  .  * . .\#
# ... ...**.**.**\.......  ....   *  .*..*.  . * .\.**.\. *#
#  \  \*\.*\*. .. *\***.\*.**...**..*   ..*  \.\.*. ....* .#
#*.. . \\....  *..\.!.* *.\*.*.\.* \ . . .\\     . \* .*\.*#
#  \* *... .**..* . .\. . *. \*\.... . *...* *** W  .**.  *#
# .*.  .......* \  . *.* ..\..\** .\ \.. * .*. *\   \...  *#
#....   * .\..*  * *\!*... .\*...     \. .\ .*..**. .\\ .* #
#.   .  *  @...  .. @\.... \*.\. .\  ... *..*\*...   **.* .#
# *.\.\.*..*\.  .\ .\*.\. .*..\..*.  ..  ..  ...  * *.. *..#
# ..  . \. . .\.\*.\ .*. .... ..*** \ . ..\.   \ .*.*\..*..#
#*..*\*..  \..**..*  \*. *.....*.. *.  *...* .*W* *....*.\ #
#..*  .*.\. ....!  ... * ..\ . .* .. *...* . !\..  .*. .  .#
# \.*\*.*. .\ .*    .  ..***. .\. *\*.*\*\   .  ..* *.. *\*#
#   .. .\.*....  \. *\*. \.*..  .........   .  *. W\.*@   *#
#*.*\ \ . * .\  .. .. . . *...!... .    **\.*..*.. *.*\. *.#
#*.* .....*\.  .@. . ... * .  . ..\  ...\.  *\...  *.....*!#
#   \*@ \..*  . .**....* \. .*    ..* @ .***\.*\.**\ **. ..#
#.. .....\..\  **\..   *...\*.. \*.  ... *..  .**.\.\ .  ..#
# .... .  .  *..*.\*.@ *@*    .\ .W** ..\.**..\*..*.  **..*#
#...\ . ..*. \**.. !.. \.*  **.    .. * *. . . .*.*  ...\ @#
#. . .. *\.  ..*\\. .\ .\.**** . ...*. .*. . \   *. *\.*\**#
#* *\ .*.*\ . \. .*!@. .*.**.. *. *\**.\. .\...* ....  .* *#
#...**...\ **\.  .***.\!.\.*. .\. .* ... * ..*\  . * \.\* *#
#\ .\. .*... ... .*..*.\  **..  .\@* .*** ..\..** ..* . .**#
#.. *.\ .\.. .\. .. . *. .    ***..\. .\ . *   ..\@ *\....\#
#.\ . !\     ..\ *.. \*. * *  *.  @.*   *  . W..  \ ..  ...#
# *. .  *    *\. \\.  . ....\.*. .. . *\... \.* .\...\. .\.#
#*.** \.. .**.  . *\   .* \* \    \*.*..\.. . . *** . . ..*#
#**.....*...\**. **.**\**.. \.*.*....**  *.\* . *.  *  .@ .#
#\.\  .\ ...*.* *.\.*\.\.  * .!\**.. . \ .* ..*.\* ..  *. .#
#....\ ....*.***.\.\.*   .* * ...*\..*\*.*. ..*\*.. \  .*\ #
#.     .\. *... ..  .. *  . *\ \*..*......\ *.**  \.... \*.#
#. .\ \.......***..*.*\. *...* *.....  .* *\...\*\. *.\.** #
#*.*.. ..  \* .*\ .\ *@  ..*.* \@*..  *  ..!.*\...\*.. *\**#
#\ .* .*.* ..\....*  .****..**\  . **..\* . *.  \ ... .\*..#
#.\ .   .****.. \....  ..\.*...*  .\! ...**\.\*.. .*\ \.* \#
#..   .*....\* .. .* .**  ...*.. \... .*\* . .....  *.\** .#
#  \.\**...*..\.  *\*.. . * .* *... . *..* .\ *. ...*.*. .*#
# . **..*.*  * **.. .* \ \..\...*.*\* ...\. . .*.  * .  **.#
#*\*.\ .* ...\@\*.. ....\ .\*.\**@*.\. *\ . \ *. \ *... \.\#
#. ...* *\......\...*.*  \*..*..*. * *. .* . ..*  .*\.. .. #
#** *..**.. *. *...\.\.\ !  *..\.. .\  ....* .. .\..*. .\ .#
#.  . **\ . **  *  . ..  *.\.\  .. \ * **       *   .\    .#
#\  *\..... .\\*.* ** .**. ... . . \ .\ . *.. \. .** *.\ * #
#  *.*.* . . ****\.\. *... ..*. ***... * *... **..\. .* . .#
#.  *.*\\ *\....*. .\.*. *.*  \  * *.. ..\.*@***.*.**.. .*\#
#\  ...*. ** !..  \   . ..*.* ***\!. \\. .*..\..* *..**. . #
# *\ *\ \**     \*.*\. \ .***.\***  . \.\...*  .@\* .\ *.. #
# \.\@* \*.  .  *.. * .....\.*.*\!\.\..  .\...... ! \.*.**.#
#*...*. ..*..  ..*.*.\\*..**.*.... * .!* .\*.*.\..\  ..  **#
#\ .\**** *..\ ..*. .\\..\ . .. .      .\ \* .* \ .\.*. ...#
#  !.\.. ..*..!*.  ..@ *\ ..  *\  ..\*. * \* ****.\ ...!   #
# \.  * .*.\.. *. .*.* **. \. \*.*  *.  \...\\*.\.\*..* ..\#
# *\. * *\  . . \ *.W***\*. * ***.\\..**.\*\. .* **\* ... .#
#*.. .. ..!.!. *.... *\.*\..* .***..\ \. .   ...\. .*\* .. #
#**. **. * *..\ . .* ..*. .. \ .*....*\...*\.. \ . *.* \.* #
#*.   .**. .  *....*  \*.\. *.*** .  *.\*.* *@. .*\..* .*. #
# ..\ ... .*\  .\..\.*. .......*...\ .*.*.* .\*..**.**. !*.#
#\. .\ *\. . ...\..*\.@*** ..\ \.\\.***..** *.. ..* ..\\ ..#
#**..* .. * .  *. *....\.**** *** .*..  .*  ...* *..   *.**#
#*. *. .  *  ..\* *  *\ *.*.\ \..  ..\ *.\*.*.\.  \....*..*#
#*\* ..*. * ..*..** \....***..\ . .**..** ...   ... \\.* \\#
# * *\ * .. .*. \\.*\.   **\*. .  ..   .   .* ***.*\   .*\ #
# *@ ..*\**\*.  . \* \*...* \...*..\*\..** .****. . . *!. .#
#\ .**\* . ... *  .... . .  !\.*    ...*.. *.*.. \*\ \ .@. #
#*.\.\ \ . ..*\.. . *.  * .**.\.\. \\* .** ..*!\ \.*\ . ..*#
#\\.\*.\..   .*.\** .  .\    ***.*  *.*...*\..  .. .* *\.**#
#..**. .. *. .\.*..\ .*\ .  * ..*..  *   .*.. **.\  *.*  .\#
#. **\ \* * .   **** *.*..\ . *\. * *...  .* \.*..\*\    \ #
# .. *\..\*..  *\ *... .***\\*.   \.*.     *\ . *.  . ..*. #
#\  ..\.** . \* *\..*.. ..\  *.....*...\...\ *  . **...*\..#
#.*.\ ..  *.*.. ***\..**.*. \. .. *..*.  ...\. *.*.*.*\.  *#
#..\. *.... \.\\.*.. * ..**.\ \..*.\\. ...*.  .. * \ ..*\.*#
# .*. ......  .* . .\.**..*  *\.\@\.\   **\ ... \  .*. ..  #
#..\ .\.\. *.  *  .*. *.. ..\\... .  ..\***. . * *... * \.*#
#..*\  \ ..*.*..! **....* \...  .@.  . ...\  \.. *.. .@*@ .#
#. . .\  !...**   ...** .*. . \.*.***. ...\.\.  ..* \ *.\ \#
#\.. .*. *@. ..\ *\*.* \*.* ... .*. \ *\.  \*.\.\ **. \   .#
# *\.*\ *... . .*..*..\ .. ...\..* .  * *.*.@ .**  .\*.... #
#\.. .*\..\.**. .  *\.**. *. .** .* ***.*\...* ..\** .\*.*.#
# * * ..*@....*  \W  \*.* .***. .*.\.\. .\. *  .* .. .* ..*#
#...\.* .\ \.*   ..\ .**.\ ..*.\.*. \ ..\..\. **. .*\*. * .#
#*  *\  ****..\****\ ..**... .....    *.* ****.*.. .... .\ #
#...\.\\..*. \. *..  ..\...\ *\*. ...***. ...*\.  .\   ***.#
#\. *  .* .\  \ .\.*.\*.\*  *. .**\*.* **\ W .*... .. \*.\@#
#.\*@ . .\    . *.\ *\. .*. * *... . *..\*\ \**. ..*.\..*..#
#*  \\ . ... . *.*\**   \.. .   ..*!.*.*... ...  ....*\ *  #
# . .**.   \ ** *. \.. *..* * .\***. .****  ..**.*. ** . . #
#  . .. \.\  \.  *\.. *!*\*\. *.\.\.   .*\**.@.*\.* *.\.. .#
#\.*    ..**..   ..   . ** \@**** ..\*\ ...\ .**. . *  **\*#
#.\.. ##.#.*  .\ ..    .\ *...*.*.*. .*.* * **..*. .!* *. .#
#.* *\* *..\#*.**\..... .. .  *.. .\*.  .\.*. .\\.. \.\**.\#
#. L.*.\. *... .**.*. * ...\.**. \ ** *  ....\* ..* .  ....#
# .  #.\*\... @ ..\  ...\!**.\.. . .**\..   .*.  .* *.*. .*#
# .\.#  .!  *\    .*.*\.\*..\* .   \.\.   .\  \. ..\**\. . #
#\ **#\**#* ..\* \ .\. *..**!*.\ .\. *   \  .\.* . \*.  ..*#
#**\ \### #.##*\ . \...@* .... * **\ ****.*\.. . .\.\ ** ..#
#*.#@#     ##.  ..*.*\.\*   @* .\..**.*\.. .\* *. *.*..\...#
#*# #        ## # #\*. *  *.!. . . ..@.*.*.*...\. .*\*. **\#
#.#            # #  .******.\..\*    .\* *.\    .\..!\  .*.#
##               #.*....**.\ *.*.\ .*.** *  .  *\.  . *. ..#
#               #..\*\.*..# #** .. **..*.*\. .. * ** #.*..\#
#                #. #... *\*#*#. \....*..** * .*...\   .  *#
#                #\#.\.**###\.*#*. # .** .. *  !  \#  @  \.#
#                 # ##\*#  #.*.. .*   #  ...\\* \. \##.! .*#
#                     ##    ##*.\   *\  \ \ . *\* ## #\.  .#
#                             # .  *.*\#..#  ** .*.# #*# .*#
#                              #\...#.*#* *.\.*\ \ # #\** .#
#                               ## .##.## ** *. ..#  #. . .#
#                                 ## #.#\**#...*.#   #. .*.#
#                                     #\ #**.#.\#   # .\..*#
#                                      ## #.\# *#   # ##\#.#
#                                         # ## .#    #  # ##
#                                          #  #*#          #
############################################################

Water 0
Flooding 0
Waterproof 15
Razors 8
Growth 32
