################
#   .*8*.    ..#
#\* .. .B.* *.*#
#. ..***. * .. #
# R \*... *A. ##
##.\ ..*\7*.*\*#
# # **.#*.*** .#
# # \. .# . * *#
# #\*.*# #\.#\##
#  #.. # # @.4##
#  # . ##\ .\C##
#  # ##  ##.\# #
#  #\L     ##  #
################

Water 9
Flooding 14
Waterproof 2
Razors 19
Growth 14
Trampoline A targets 4
Trampoline C targets 8
Trampoline B targets 7