############
# # ###   ##
###\# *###.#
#.. #\*# #.#
#\#..\.\4*\#
### .*... .#
# #.*\* *\ #
##**. .\ *A#
##.#*\*  . #
##  .*.##*##
#.#.  \.#*\#
#.. .#. .  #
#L#*##R. #.#
#  # # . ###
############

Water 1
Flooding 9
Waterproof 19
Razors 0
Growth 5
Trampoline A targets 4