####################################################
##.*.* *.*.@. ... ..*..@\.. ... *.* \  \  *. *\..# #
#\*\ .* ..**.   .\.*.* .. ...\ *\ .*\.1\ .*.. ###  #
#*.. \.  ..*\.  . *..! *.. .. \ .. . \   .\ \* #   #
#*.\.\  .* . .  .*.*\ \.\*  ***...*.*. \ \ \.***#  #
#.\.*. .\.\* . \.\ \**.*.\.\ **!.WR.  B*.3# !##.#L##
#***..* ..\.....\*.**... . \..*.W\!...*! \**. .##**#
#\.\ .*.     .**..**\..*.* .....*..   ..*. ... . .##
#. .*.*. .\*\ ... *.  *. .* \.* . .   \*.\ .**.*\*##
#\...  ....*\. ...\* . . **\  . .**. .... **..*. # #
# *..*  *@.. . ..*.... *. .  \** ..* . *\.***#.##  #
#\..\. *. *.*@.\.*.**. .  \. .*. ..**  * \ .*#\#   #
#* .*\\.\* *.*\.\.*...\ \*...**.*.*  A*.*....*\#   #
#.   *\. . ..*\* .** * ..**\ .* \.*   *.* *.\.#    #
# *  .  ..\\...* .@.*.*.**  * ....\ \...*  ..#     #
#\....* .**.* \..*\*\.**. *.*. *  *..\ *\ * #      #
####################################################

Water 16
Flooding 4
Waterproof 12
Razors 47
Growth 42
Trampoline A targets 3
Trampoline B targets 1