###########################################################
#                          ##.#        #                # #
#                #     ####\. ##    # #.#    #       ###.##
#             # # ##  #\*.#. *..####\#**#   #*#     #.\#. #
#            # ##*\ ## #. **.* ##* *!#.*##  #.#  # #..*#*.#
#        #   #.*.. #* ##\ *\*\\\#*.##*.\ *##!.*##*#*  .**\#
#       # ####.  .\#*#.# ** .* \.*.### ..*.#.\#..* \.\**.*#
#       # \\*..*.\ # *. *.*  @\.*\ #*\\ *\ **\\.#\ .  *.\.#
#        ##.*..*.  . \**\!.. *.*.* \.*. *#\*.\  .* *. .   #
#         # #.*.* .*  * .*.*... *.* *..*\ \#\  \**.* . *  #
#        #.\ *.*  .**\. .... .\...\*.*#**.*.*. ..W*\.*   \#
#         ##*. \. .\. .\* **.**..@* ..  ..***. .# *\.* . .#
#        #\..\#.. .* **.. ...*. \..*..   ..*\....\.   ..* #
## ##   #*.* .* \.\**..  .\ *.... .***.\*...*.*  *. \   .*#
#*#..#L# .\.\  *.  *.*\.\\.* \.. .\\ * .\  .**.\**.**\**..#
#.\. #  *. .*  .*.. .*.*** *.!.....@ .\.*. **.. **  .*... #
#\ . *  .*   . .*.*\..*.\. .       .\.. ...*..* \.   *   *#
#***.\.* *. .\ *    \\.*. @.. .*...   . *.**\..\. .  .   .#
#...* **.**..* *\ .\  **.\**\. *. ..*..* * . **   \.*\\*.*#
#*.  ****.. .*..  * .**.* *  * *.\@ ..\.  . *\.\.\ !..*\..#
#..\.*\.***.  .  *\   .\...***\.....\ .\..*\. . .. \ *.. .#
##***\.*. \ **\ ****.****..\** \ *     . .\.  *   \ ..  *.#
#...  . * . *..\*\.**\*.. **.\ .. *.**. .  *     \ .** *. #
#. *.** ***.. .... *\ ..\ ...  ..\. .. \  .*.\  *. *\..** #
#\\! * \. * .*.. ..\....* .. . ..*.\ *  .* ...   **.*  ..*#
#.  *.. **. .. .. .*****....@\*.*. . . .*\** ...*\*.. . \.#
#\..\* . *...\ ** . *..**...*.*\.   . \*\*....**...    . *#
#. ... * *....\.. .* .\ ..*  ..\.    . ... ..\.\\ . . . ..#
# .* . *  .*.\.  **..\* * * .\.. . *.* .\   \*   ** .\** *#
#   \***\  * *  .\..\.*....* .*\. .\  .*.*\  .*.**..  .* .#
#\.\ .\... \*\   **\**.**. ..\*. \ * .**\. ..*. .* .\ *.. #
#.B..  \****..  ..\.*....\.. *\. .*..\*.*\. \.@\..\   . \@#
# .\.  .*...!*..\ . . \.  . ..*\ ..@...*.. **..* . .... !.#
# **  *  ..  . ***..\....   . .  @.  **.*.* *.*\. .. **.*.#
#..\  ..  ..**..\ ! .. .\\. ....  ..\*.* ..  !\ \. \* * ..#
#\.* .   .  .\.\.    . .   *...!\*. .  **  . *  *.  \*.\.\#
#\*. \   *..**\ *..*.* .\ ..** ***\* .***. \  *..\ *.\    #
#*\.\.*... \..*\.*\ \.*\..... \*.* .\ .\..*\ *...  \*.\** #
# *\*.* .. \ \*. *. . . . ..*...*.\3 .\*  .. ..\. *.*.**..#
#.\* *\  \...**   .\*  \..\ *.\ \.**  *. ..\.    \*\. .* .#
#. ..\*\..*..!... .@ ..   . *\ .\ *.\*.*.\.   .\* * \  .\ #
#\ * !**\.*. .*..  .  .\ * .... .*.\ . . . .  *.* *... ..*#
#.***...* * \ . * ..\..\. * . .*.  *  ..*..  ..*\..\ \ . .#
# . .    \  ..!\  . . .***\***.\.***.\ . .\.*..* \. .\.\ .#
#\.  .**  \*...*    \ ...\. .*..*.*.\ .*..*  * ... *\  ..\#
#  .*\.*  *  \ . . .  . .*.\ *..\.\.!*\..*.\ .*   .\. *. .#
#.* . ..\*.... *.*. .. .*\\ .\\ ... \.*.!.** ..\ ..\ \. *.#
#*  . *  .. !. . **....*.*.. *. \  \ \ *\.\.****..@\. .\*.#
#*\* .. ******.  .. .  @*.\ ** ..*. .*.. \  .\*.\.  ..* **#
#*.*..  . ..\*\.   . *.**. .!*. **\..*..  .\\.\ .*...\.* .#
#\*. \*@. ....  ...  \*.*  *\ .*.\! ..W\.* @* ...*  . . . #
# ..*... . *. ..**** \\ \* . **.*  \\   .**.. ....\    .  #
#*\...@.*.. \ *.. .*.  .@\...\     . *\.***. ***. *  \*\ *#
#\.\.\.* \* *. .** .**\..*   .  .. .* . ...* .... .*...*\.#
#@ *@ .*..  . ..*..**.. \ *..*..  *.* \..\\.**\ \ .\ * * *#
#. ..\@.\  *.\.*..*.*.*. ...* **..\ ** .*  **.**. *. \\..\#
# *. . .* ... ..*\.* **. . \. *.\ ...\  . ..***. *\ *. .*.#
#\.. .  ..\ \ ...\.**.\.\...\ . .  ...\  \ .. **\* .@*... #
#.  \   \* \.. *\* **. ..   .  \ \ *   **..\* ...\* *.    #
# *.. \. *   \ .*. ..  .\ **.\.!.* *....\**   .\. * \ **.\#
#.. \.. . *.*. \.*.*\.*..*\***\. . . . .* *\....... ..\..*#
#.\..  *.***\! . ***** ...***..   . .     *.\ @\.  \. **..#
# *.. .. \\**.*.\.***...\  !\ .***\ .. *@**\*.. * .   ...*#
#\!\. * . .* \. **. .  .. ..*. . \ . \ **.**.  .*.\\.\.\\.#
#*.*...  \ .  \*\. .. * \   .*\*!. *\..*!. * ..*.*. \*\* .#
#. . .. * * ... * \...!   ..*.....****. . \. ..... *... ..#
#    \*  ..     .****W.\* ....\\ \\...\\ ....*..\. . \**..#
#\   .. *.\.\*.. ..*.\* .\  * . * * \.***... . *. \.\ \** #
#*.  . .\.*..* **\ .* **.*\*\*\  *..*.\**\  * .. \..* ... #
#* **   .*..\...\ ... ..*\ .. *** .\! *\! \\** .  * .\* . #
#\ *   ..* *.\* * \.*.\*.*  . .*.* . ..**.\ *.\ .\*\... * #
#. . ..  . .\. ...!*  .*\... . *@*. .*. *\ \. *.  * . *..*#
#\*  .     .  *. . *. \.  **.. .**.  ...\*  **.\***\* .. \#
#...  .\! . * *!...* .. *.**.*  *. . \   .   *\..*...** *\#
# \...**.. .  .*..*..* ..**\ ..... .  .\.*.\ .. *.*\..  *.#
#.\ ..A  .. * .*. \ *.\*..  *.   * .\  !.*  .!\....W*\.*..#
#\   .*..   .\ . ...***. .* .* * .*   * ** .*  **.... .**.#
# .*. ..W .*\..  ..\. . . ** \ .....*.. *.  \. .\*.*\ \...#
#  **  \    *...*... ..  *.\*.  .  ..* \. .\  \  ..\..\.. #
# \*  \.. ..  * .\    \!\.  **.... \. * .. .  ..\..*\ . .*#
#\...** . ...** **.. ..\.. \..\ .\* \ .* ..\..\  .*. * * .#
# \*.@**...  *.\. D  ...... \****\. *...\*.  . *****....\.#
#W .  ..*  . ***\.   ...* **..*\   *......  * .**..****. *#
#*\ .\..**..\..**. .\ .\*..  *.\**\**  ..  *..*W. *..\*. .#
#.  * \ ...\.*...\*\.. *..\. .  *** *.   .\*....*.\  \. . #
#*\*. @.*.\... ***...* .*.**** * @**.\\..\ .*..@.\... ... #
#*.\ \ .* . * \.. . *.  \**.. .*\.\ *.W\.   .*..**   **\  #
#\ .\ .\*..*...  ..\..\*.\* **.**.  .\.....*..*.**\.*\*.\*#
# .\. .** \\. \..\ .* **  *.....*\* ..**\***. ..... * ..*.#
#* .  . * \. . *\  .\**..   . **\ .  . . *.\*\.* .**  * **#
#.*..   ... *.*.*\.*\.\.*\ \  .*...*  .\* .  . *\ ..\\2..*#
#\  \.\   *.....*  .**...\ * \ . .  .. ..\ . ...*. ..***.\#
#..\.\.*  **\   *** \.**.* . \..\.. **.. *.* .\*. **...\.*#
#**. \.* *\..*. * \ .**.. .*...\... **. ***\.. *. ..\ **.\#
#.. .. . ..\ ...\ . ..\  ..\.\* *..*\*.**..   **.*\.. ..\*#
# .*.\ . .\   .\\.*.....\. *.** . * ..* ** . . .*. .  .\..#
#\.\...*\ *..*  *..\... .* .. ..  \..**..* *.\.\.\. ..\.* #
#.    *\ *.  .   ...  * .* *\..  *.**...\.*.. .  .  **  .*#
#    *...     .*.   . . .. . .. \  .. .\.   \ *..* *.* ..\#
# **.\.....*.... .. *.* . \*. .  * .  @..   ..  ..* * .\ .#
#* . **\*  .. .* *.*...\ *  \   *. .\. *.    *.... \.\ ..\#
#\ \ .*\\*. \ .  \ .. . \*   . ..*..*.*.     . .\.*.\ .***#
#***!\. ** ..*.. . .\.. .  .*.6.@\. . . . ..*\  **.. \ .*.#
#*...\ *.   \...  . *\..*.*\.****.... \* ** *.\.*\. *.. .*#
#\\ . \.    *..   . ..    ..*......* **..*. .@ . **** \* .#
#..  ......\... .  \.* ** **.\.**\*. .\\* * .*. ***.. *.  #
#.   *\* .. \ *\.  . *.*. \**.*..*\ ..*\ .\. .*..\. .\. * #
# .*\. .   ..*\.*\\  . *.....*.**.**\  * ..*..... .  * *  #
#*  \**\ \  \  *\..*. .\*.. .. *.!. *.*   .@. .. . . ..*.*#
#\.. . ...\ .\**. *\   .*.. .  \.* . .. \..*..*\ .\.\  .**#
#*.***... \ \.*..  *.*...\** . .  ..*.. *.*\* \*  .. .\ .*#
#.***\..*** .*.. .\*\  **.\.   *..*.*.\   *   .. \* *    *#
#* .*@ *.  **** .*.*.  ..**\...*.   *.  * .*\ * * @*.*. @!#
#....*.. . ..1.. .\  \  \**. \ \*....\.**. .*\* * ***.\*\.#
#\   *... ....@. \.*. .\.\* . \!**.* **\*!. * *.\*..! .*. #
#. ..\.\.*  *.* \ *.** *...   *!*. ..\..*. \.  .*. \..\..\#
# ... \ * \  **\..*.** .\.. **\\**@*   \. ..* . .\ . \* ..#
#. ** ...*..*....\.\..  ... *.  . ** \..  . ****\*.* \. .\#
# .   .\ *.  .* .\ *.. \ *. .**  . * .*. \ \*.\.*. .  .  *#
#\ .***. .*.* .. ..* . .\.***.*\*  * ..\ .\..  .\.     . !#
#.**\... .* \...  ..  .*  .*\*......** .!.*.! . *\ ** * *\#
#.*..*.  ... ** ..\.*  *. \.\*.\..** . .*.* *   . * *\@\ *#
#\. ..  .. !*.* *  !\* \.*\..* .\.**\  . \ .* \ \*  ...\*.#
# . .**. ****** \\. **.. . . **.  .*  \!**.\*..* .. \.....#
#.*.@..*  \*\.....  .*..\ .\*... * @.*.***.. . . . . .*.W #
#** .\.**\..*.\ .  *..\*.\. ..*\* \*\..*\... *\..* .! \.\ #
# .***...**  * .   ..*.. .\..*. \.***..**..... .*.*\ \..  #
#  *..\  .. **...\ .* **\ . \***. . .   . .\ \.**\. ..*. *#
#*.. ..*\ . .\..\ .\*\.\  . ...\  .  .\  .* ..\* **.....\!#
#*..\. . ..\* \*..  *.   \* *....   \ * .\*.W*...*W  *.\ .#
#. .*** \..*\* .  .**.. \.\ . .\.*  * \ **.. *   * .\*. *.#
# . ..* . \.*.* .. C.* \ \*.\. ......\* .  **.   .*\.*.\**#
#\* \  .* \ .!.\*.*.*.\  .\ .**.*.*.\.\    **.\* .**. .. .#
# . .*  *\.. \  **. .\.* * .*\.*. **.\.*.  *\..*. ...\**.\#
#\*\ .  *.\*.*  \.* *..**  ... .*.* .*  *... . .*\.\  ..**#
# ..*.. \ . ..\ ...\ .*\.  *\ . .\.\..*...*\   *  ...\  .*#
#*\***...*.\** .   *.\..\.. . **\ . **..*\.* ....* . ...* #
#*..\.* *@* ... . .* .\.*.   .. *....\*...  .*.*. ** .\ **#
#..   . *.@.... \\ .  .**. . \ \** .  *\.*.... ....*   ..*#
# ** \  *... * \. ..\@*.**  *.. *. @..*\.. .** *\*..*..! .#
# !  .\**. ........  .**.\ *..*!.* .**.  !***... *\ .. .  #
# .*\..\.*\.\*\   *.\*. ..\.\ .*  . ...* *.. *..\.*. * .*\#
#***\.*. .*. .\..*.\.. .*...** \  *\..\..\** *. ..  . **..#
#\.*.*.\*.*** .. . ... *.* \ * * . *. .**..\.\ \\**\  \\ .#
#*    . . ...*  \.\.\.*.**\. . *    .**..  .....**\** \ . #
#*..\  . .**.@****.  .\* ...  ..!*.....* **!\ .*...*\   ..#
#.  .. . *.....*..*\..  *.*.   . .\ @\\ *.*\ *.... *. .. .#
# . * . ..  *.*\.\ .*..\.  . *   \ ..*   .*. \* . \..  *. #
#.*.*. .. * **.  .*....*. ..*.\ ..\*** .\*..* .*. ... ....#
# .*.\. * *   .W* .\ .\. ..  ..  \*. . * .  .\!....\*. ...#
#  .*..\.*.. .**\  . . * **.*.\.. .. \....\ .  \.*.*.. * .#
# \.\ ***. .  ..*. .  .*.\.. @ ..   . ..* *.. .    .. \...#
#  .. . .*\ **. .   ...*. .*..\.\* .. *.** *.*. **..  .*.\#
#.   * .\*\ *..*.@* \..*\*\.   @ ..*....*. \..\ *..\... .*#
#..@*.**.\ .\\.\  *... **. .*  .**  .* .*.*..**\\*  * *\*.#
# .*.\.. \.**  .  \*. *...  \   \**..** \ .. *..*\.*. ...*#
#*\.* .*.\.*!*@\ \ * .. *\**..*. .. * \ **.***.\ ..... ...#
#.*.* *..  .\.*   . *..*.!.\.*.....@. . *.\..**  *.* . .\*#
#*.*.\ . \*.\   \**.**\.\.\ *... *.@..*..**\ **. @*.*.   *#
#. .  *   ..\* *..*  .  .. ..  .. *.  *...\. . *... ******#
#.   \...  . \*\..@.. ...*\\. .. ..@\..*........ . .\ *. .#
# ..\.* *   **\*..* *  *.*.  * ** . .\ W *\..******..\*.\.#
#..\. .*   ..\ ..\  .. \ ....**** * .\ \\\**\ \**.\* **!  #
#...*..*.\  ... .\.***\**@ .*.* ... ... .  . *...** * . **#
#. * ... *\** ** *....**** .. .*..\. \.  \*\ *.. *. . \...#
#. .  ..  **. .. .  \!\ .  .. .. ..** * ...* ** ..  .  *. #
# * ** *\*\.  *\ . ..* .*. !\  ** \.\. .. .. .. . .. **.*\#
#..\ ... .... \*  *  .. **. .. .... .. *.*.\** ... .....* #
# ... \ .**\  ..@    ..*.* ..*\*   .@ **\.. .. .   .*  \..#
# * *\ ....*.. *.... . .\.*.*.\*** *..... .*. *.\***. \.* #
# * . .!\\ .**....\*. *.. *.. ...\   \*.\ *. .\ .. ..* *. #
#\*.\ *\.\ ..*\ .**.*\.*. ..\* *.*. ...\..*. **   .\ . .**#
#*. .*.. ... . \*..\ .*.**  .*..***   . **.. .. * ..\.. . #
#.*   .\. *   . \ *.@.****..\.    . *  ..* . \ *. *\.* .  #
# *\*   ..*.*. \. .**. !*\ *.\*. *..***. *** \.\  ***. .*.#
#. .* ..\...***@ ..\**\*.*.*.*..*.\\***\ . . *\.**\ ... !.#
#!**.*.   *.**.\**.**\.** !**** . *.*....*  ** **.* \  .  #
#*.\***\..\** **.!.*\..** .**. *. .. .*\.*.*\..***...  *\.#
#**..**..  ..\...\ ..  ..\ *   .*.**..**.**.*** *..*.\ .. #
#**  .. *.*. \.***   ...\..*\.*  .*.**.. .*...*..\.. \.! .#
#\*.. .*.\.! .***.* *\. **. *.. *.* *.  ..*.  ***.   ..\  #
#.**\ ..\* .\ .  .* * * \  .*.  ..\ .\ . **.*\...**..*... #
#\.....\*\. ..*\    .   ..**...\.    ..\*.*..**\* .. .    #
#  \...... . .. * . * *.\..**\*....*. * *..*.\...**\.  .* #
#\  *.\....*... \..\* \. .*.*.\ .  .... *...*.\ *\  .   *\#
# * *.* *.  \*.*. * .\. . . .. . ***.**.  .*. ..\  \ ..\. #
#\.**  .*. ..\..*..\  .    ***\\*..\*.. ..  .\  ..\ *\. *!#
# *....\ .  *.\ * ... *.*  .**... *.*.**   * **. \ *\. .. #
# \.**.  \ \* .**   \.. ***...*\. ..* ..*. ...\ . .\*.. **#
#*.\!** *  ..\ R..** .*\.\@*. ..  . ***.*..  ..  . ..*..@.#
# * .*... ** .***...* **\ ..*.\\*.. **.*!.. . ..  \. .. . #
#\*..***. .*...*** * \.....*....* *\.* \**\ \ ****. .*  . #
#.......@ \..\\....* *\. .* * *.*.\..*\ ... . *...*...  \*#
#.  .\*.. .  . *.* *\. .\*. *.**.*.**.* \. . ..*. .**.  . #
#*   .\*** \!*.\*  .. * \..  **.*.  ..\..*\ . ..*. .**..*\#
#.*. .*... ..** .**.\ \ ...* ..... *. .**..* .**. * ..*  .#
#\ *!.\. ****\*\***..\!\* \*. \ * .*. \*\**.\. *\ * \\..**#
###########################################################

Water 0
Flooding 0
Waterproof 7
Razors 19
Growth 2
Trampoline A targets 2
Trampoline C targets 1
Trampoline B targets 3
Trampoline D targets 6