##########
#   ##\  #
#  #.  *.#
## #\# . #
#*#** *. #
#...* ..*#
# . ...* #
# .R*. \*#
#\ ** .. #
#  *.  \.#
## * *\ *#
#.**\. \*#
#.\.\**. #
#*.\..\  #
#\\...  \#
# . ***\ #
#*.\* *.##
#.  # .\##
#\#*.## ##
## #*L#.##
#   # #*##
##########