####################################################################################################################################################################################################################
# . *.. . \.   \ .**... ..*. *.*. .   .*\   \.\.\. * *..* *..*. .        **.  ..*  ...\**   ...*..**   ..\* *.\...\  .*.. ! ** .*\\.\***  *. *..\. .\.*!*. .*. *. *\.\. \.\\..\..***. . ..\#                       #
# *.. .*..**  *.** .. .* \**\*** .*\.  .**  .\ .   \ .. .\\.\.*\*\  \* **.*\. .@.\. \\... .*\*   \.. \.\  ..\***.\.*!*.*. \..**\..   ..* .W**. .  *.* .\...*..\.. \*.**..\.. * \..... *\###                        #
#*... *.\   \.*\..*\\ *. ....*..  \.*  .\. ..\ *.*..*.\. **.*\* \   . . .   .. *. ... \.\.** .\.* \*.. ***...***. ..\*..*  .\.*... ....*. ..*\@  . \*.*.*\.* *** ...*.. .  . .  .* *\ \*\ #                        #
#...\ ..  * . . **.\. \*.*\.\.*..\. \   .\. ..\..   *.*. \ ..** \   ..  .. .\. \. .*. *  ..\\. *\.*.!*\.*. . . *.** *. ..*. .* ...\. \**.*\.*..    \!\.*. *...*.@.*. \*.*\*  \.\ * ..@ *.#.#                       #
#.\**.** *. .* *.. *   * .\.**.*  * . .***. ..*.*.\*\.  *..  .. \ ..*\.\..  !\* *  W*   ....  *. *. \.\ .*.** *. .. . . ..   *. *..\.  .....*.*.*. .*.\. .***..*. .**\.* *. ..**. *\*\**\.*##                      #
# @.**.\. *  .\\ \*.\.     ..\ ..\*. .*\*....\. . *...   .  \*\.\. *.*.@**..*\  *. **. \ .\.*...*\. .  * .**.  .  . ..*.  *  . ***       **.  . * .\..\...*. .\...* . .* \* .  * \....*## *#.##   ##               #
# \ .* * .\..  *\.*..\. \.. \     *. ..*\ \.\.  .. \    *...\..* . .*. *.....*.\*\! .   . ..\ . .. .  \ \ *..    \.\... .....* ..*\*\ ..*\ .  * @\ . ..*. \.\...* . !\.\ ...  *.\.\.* **...*.. ###  ##             #
#.!..*\*.  *  . .\..\.  .\\  \.*.*!   .*  * * \ *\  * .\..  .*.. .\*.*.   . ***\.  ! \* **  ..**. *..  ..  .. ..\. *\ \    .\..  . . *. ..  **. ..**..\ .\. .\*..  *  .*.. . ..*. . ..\*.\.*.\#*\\ *.*#            #
# *  @****\.\.*..... \ ...*\ .\*.*.\*\.*  .*\ * .*..\.    .****..\*.*..\  * .**.** . ..**** * .  ***\.  \ * \.**...\. .  *.\**\..*....* ** .\. \ .*. **\..  *.**.*..*\..  \...*\*  .  \ **...*\*#.#\*#             #
#\. .*.. *. \...  ..   *\ .*   .**.*.**...\. \..!* ... ..   ...\ ** .*.  \*\. * \. \.*.*\.*.* \..\..\\ ..*\.*..**.. . .\*.\* .\...  . . ...* *.. ..*.\\*..***  *.\...... ...\.* *\. *..\..*   . .\  # #            #
# *\*. * **   **. \\.. .*.. *.***  ...*\  **.  **\..  .. .@.!  ..\* .\\*..\ **. !. .*\ ..  .. .   ......\.. *. .* .  ..*..*.   \.\  ..\ .\ . .  * * \. ..*..**.. .. \. * *\ . ...@ ..*. ***.. *. .\.##*#           #
# . \..\ .. . \.*.. ..  . *\.. **  ... . * .*\*... \.   .\*    .\ .. . .\... ..**\ ...  .  .\.. * \..*  *\ *\..**\   .*\. *\ *. *\ .  .! .* *   * *  *. .** ***\** .. .**..*   \*..\ .  * .\ W\.. ..** #           #
#  * . ....* \.*.*. **  .*.. **.!..  . .*.*   *.* * ***.* .  *..*. ... *.  * ! . . *.  \ @   .**\  .\.\ \..\ \*... .\** . . * \.. .*. \  \ ..\ *. \ ..  \.*\*..*. . .\*.\.* \  ..* .\.\  \   .. . .*..#*#          #
#*\. . ..* .W.*\*.\...\**.. **. .  *.\.**.*. *..\ *. **\.\ . *...\.. ...\ ... .\ . . . . \ * .. .  .*\. .\.\ ..** \*...* **\. .*..*   . ..\*.. .\ .. \*  @\*!.. * \*\.      .  . * ....  .... !....\ \#.#          #
#...\ .. .\   . \. \. .\ ** *\ . .\... .. * **. **.*...*   . *\ \    \.* ***   .. . . ..\. .\  .*.*\. ..  *.  ... ..*.\*. .*. *...*...*.   .*\  *****. .\\**.   ..!..* . *\* \! . .* . * . ..** .\. * *. #         #
# ..*\* **.*. . .. . . .*** *.*\*\. ** ..**\.\\...*.. .*\ .*\. ...\ \. . **\ **  \.*    *\.**.  \..!.\  .*.*\* \*. \.\..*  *  .**.  .\*    . .*.\*.*..* . .*\. .@.*\@.\  .*. . .. .\ ** \...*.\   *....\#          #
#\.**\  * * .*!\ .* ...*...\. *.\ . .\*.\*W.*  .. .  * ...\..   * .  .. .*.. *. .*...\**.* ..... **\     . ...\... .   *. .  .\..*.     ..*\*.  .. .. * . ...*  \.\.\...*.* .\ ..\..... ..\.\**...*\.. .#          #
#  ..*. .\........\ .*\..*. *..\ .\.*\.\. *\   .\  \ ... \ .  .    **\. *.*. .. ..    !*..\. * .\..  ..\\  *.\..   *.  *  *   .. * . **.  . . *\*\. \..  .  \.* * ... . .\.. \.\ ..\.*..\*@**\*.\ !  *#.#          #
# ..\*\.\    . **  **..*.***  .! \.. ..  *.   **. *    \* .*\.\.***.*.\ .* .* !.* .\ ..*. **  *.*.  *\...\...*\.***** **...** . *.\....*   .*...*.  .\. * * .*.  \ ..     *\.  .   *.* \*.*.@.\*....!\.##          #
#\. .*. . ...***.\ !\..**... * *.. .. *.*.. *.*..\. .W*..* .*  * \@ .. . .* **\.\*. .   .*** ** ** ..* *   .... *\*.\@*.\* *.**.\.*\ .\* *.**\ \.  .*..   . \*..*\... . ..\ . *\  \ *  *. *.*.*.*.  *# #*#         #
#**..*. . .**!.*  *. *...\ .*.\*     *\  *  \.. ..** \..**.\..*.  . *.   @....  .... *..* **...\.. * .*\ *...\.\. .*.*.\ ..*\*. **.  @*  .*. *..*\.@*\ .*. \..* . .*. . \..\\** \  .    *\  \\*!*.\ ..  .##        #
#...@*.. \***.\*  . ***** * *..*\..   ....\ ..** .** .\ .. . \*.\..\ .*.... *!.**\* *. . *.****..*..* *.@**.\ \*** . .*. *\* .\ ..*\ .. * *\...   *..*..*..\*.*  ....**\.\.*\. \..\* **.\*.  *...  **\*\* .#       #
#  .**.* .\... .\  \. ... . **..\*.\..*. . ...\*  .\ .* *.\.\*.\  * . \  .. .\*\*.....\\\..*.....***.. *.\. *.**..\..**. \..**.   ... .*.  .*. .*.**\.. ... * \...  \ \*. .*. *.W .!.@\  .** *...  .. # \*#        #
# .\*\..\* ..*\ . \.*. ** *!*.*.*.\ *.*. *     .  **\ ..\.   ** *.  .* . .. \\..\\..**  ..***.* \...* .*.  *\**@....*\..*.  ..  *.*. .*...\ \** .  \ ..\  . . ** *  \ .\ *\.*..... .\ * * ..*.\.    .\####         #
# *... \*.  .. .*.  .. ..**\. . ... .**\ .. .  .  ...*  ..    ** ....*  ..  .. .\.\.* .. *..\..\.\  **.....**.**\ .  .   . *. *.*  * ..  \. ... . * *  . *.. .\.. *.. * ...**\.*.*..*.* .\ \...@* \ *\**#          #
#..**  .. .  *  * .*\.*. * ..@ .\.*\.\. .* .   **\... ...\...* ! ! .\* .\. *.\\*.  *.\. *.*  ***\ *\***  *..\  *.  .***.***...* **\.\.*..   **. .***\    *.\.\...\*  **  @.\*.\*... . .*\.   .... . ***.#          #
#...\ .    .\\. *...* .\ .  \. .*. .   ... . ..*.** .\* \..**.\..\. *.. * \.*..\.\*\**\ . .\*\..* *@.\\ .....  . ....* .*..@** .\.*** *.* \ .*. \.*.**\* . ..*@ @*.*.*. \*  .....** \ ** .....@.\ .. .\#*##        #
#.** .*. .. ..\*...\..   . .  \  .\ *. ..\....\*\*. @.\ .\ .*. * . .. * .\ *. \  .*\*..*\   .   . .  .*\.* ..  \ !.  \**.  * * ..*. . *.. .  \.\ .  *..***.* .*...*\.\ ***.* *\ \.\..*\ .\\\*.\*.  .*\.* \ #       #
#  \  *. *     .\  .**.* **  \.! **..\. ..   . .\\ ....!*.  .!*@.* .\*\**.. . ..  .*.  ...    .\*  * ..**. \. *.. .. ....\!*.\.\*.. *..*.. .*.  ..  ..\.\***..  *.*. * .\.*..** .... .. * .*.*\   . .  \##.#       #
#.  \ \ .*.  \*.   \*... \.  *   ..*\  \*..   *  .\*  .*.**\.... * \.\..*...  * **... .@.* . . ..\ \* .*. ... \ . \*   .\\*\\..**\*.. ...\* .*\..*..* .*. .\.*. *..\**\ ....\W\\ * .* *.*\*.*\.\ .*. ..#  #        #
#.!  \. ...  .*.  . . *  ..\.\ . .*\. .  ..** *\. ..\*.*  ..    **\ ..**  \.\.\ *..\* .\.*\ .  .\.. *..*.   .. .  ..  *.  \ \.....*\. \  .*\   \... .  ...*..*\ .*  ** .***......\ .* ...*...***\ **.##            #
# .. \ **.   *.\.*  .\ *\!. .     * \*.   **  .     .*...\  .   ..  .\...*.*.\ .*.. .    \*\*.*\. .  *.\*.\.* .* .*.\.*.   . *\ .\*  *.* *\*.  .     .\ * . ..\*..*. . ..*\ .  *\.\.  .*\* .\ ** .*\. *#           #
#**  *..** .. .. .\.\ \.\... . . *.  . * * \**...    .** .. *   *  .  ..\*\**.. ... *\.\\..*!*\*. . ..\ ** *. *\ *\* \* .  * .*.*  . . ..\.  .\ ..\*  \.\    \..\ * ..\**..@*.... .... .....* *\ .*  .. #          #
#**.*\.*\.*..  *.\.\*  ** \*.*.\ .  .\ .\..\\*.\\..**\.\\*. . \R*  \*\  *.**** \ \ \. ** *  *. .\.*.*\* \* .@.*  * *.*..  *  .. .** \ \ \.*.*\..\ *. *  ......\   . *...*  ..!*.\ . . *\ *.*. . ...\*. .#          #
#...*.*\ .* .\.\.  .. .*.  **.\ .  ..*!\..*. **.**..**\.    .  *. *..**.. *..*   ...*..* !.\**...**.*    .. .\ \.*.\ .*.\**.  \.  \.. *.. .\*  .  .. ..\.*.*   .\  ..  \*.\   . .**\....**.* .@.\.* .@#*#####      #
# .\*....\..   .@\* *\.\  *****..\..\. .\*.** \* ..*\ .  ..\. ...*!\... .* .*.  * . . * **. .. * .\ ....\.\.  ! \. *.\.\*.* ..*.**... ** . ...\*\*\ . ..*.\..   . \.**..**.*.*   \ .. .*.\. \.\* . .\\#\ W.  ###   #
# * .\. *. ..\...*\ ....*.\  \. *.**.\ *\.*.*@ ..!.. .\.*.*  . .    *\... \..* *\.*\. * ...\.\ !*\ . .\*\   .*.*W* . .  *...\ . ..\.\*.@..* @.. *.* * .*.  .** \ ...\.*..*.\*.\ . *. *.*\ . .**\*...\  @\#. \ .*#  #
#\  ..* *\.\*..*\**  W* **   ..\.\..\ .\.  .\ .* *\\\ . *.... .  **\.*\ . ..\. *..\.***. .*. *.\.....  ...\\* *\.*.*. *.. .  .*.\.  *...*...\..  ... . ..\ *.*  .* .*..* .... . ***\*\* . . .***. .. *  .. ###*#   #
# \* **. * .. *. . .\.*  @.\*\** \  ..* . *   .*   .. .*. * .  .*\.*.*.**  *   . \. .\. *..\.\ *   *\!.\....\ .* .\* .    .\.*. .\\.\* .. .* **..*.. .*\.  *..*. \* *  * *.* . ...*..*.*\.  ..\ .  .\*.\. *\###    #
#\ !...**..   .. ..*.**. *..\..**  .*\.*. \. .*\.. **  ..   *.\.*. .*.* .\ .* ...****\. .*.\ *. .   . .... \** \\... \ ..\...\* **  .*\... .*.  .\*. ... . .. .*.\.\.\. ..*.**.*  .. * \.*   ..*.    .*..  *#.##   #
#* ***...*\ *. .   .*\@ *.\ *..**.\ *.... .** ** ... ..*.\ .@** \ . * * . ...***\*..... ..* .\*.\ .\      .\.* .*\ * **.*.\.\. . * . ..\..  ..*.* ** ..*\.\*\ .\** * .@*  . **  .  ..*..*.* * *\ .\*  .  *  *.**#  #
#*...*.. ...*...* @ \ ....*\* \** * ..*.* .  .**.*\\    *.**... ..*.\.*\** .* *\@* **\*.   . ....\..     .*\\. *   \\**.*.\ \*  .. *   * *   . .. .. \...\*** \..\*.** *** * ... ..*\. ..**\**\ .*.*\   *#*..##.#  #
#***.... .. .. *......*.\*.. * .\. ..*....*..*..\...\  ... ..\*. \*   .\.!  **.*\  .  *!\ *!.*. * ..  .\. .* .*\.\ ..*\ . .*..* *  . .\ ... . . . *\  \*.*...*. *...\.\** **  .....* .* . .*.\ *. ..\ \ **..\##.#  #
#*.....\*.*.*.. .\. *.\ *. *.. .. \  ..  .\. \ .   *. .\* * \.  *** *.  *.**...**\\..... .* ..**\\.. .  .*@*.  . ..* .   \. **\  *\.\.   *   \   . .. .. .*\.\\..*   \*..**.*.. .\ .\ *\*.  \ \*..*\ ..***.*  ##   #
#*!\*.**.\*\** ..  * .**....\*.*    ..*  \.\ .\. *.*\*\.. *..*   .*\**   .\***..  *\ .*\  *......\. *. * ...*.*.****!\..*. .\....**. *\.\*\.*.  *\.  \ \\ *.  *\*.\.*.*. * .\.  .. .. . *..  *.. .\   \*.. .# *#   #
#\ .@**. *....*\@ .*   \ . \.\* * ****.....*. ..  ..\.*.. .*   . \*. \!\. !\** .  .*.**\.\ * . .  .\*\ *\. .. .  \...*. .. .**...**\ ........!.*..* ... .*.... .*\ ** *.*. . \ \* .\..**..*  **  * *   ** *  .\.## #
#*  ....*.. \\.** *..*\@\ .. .*.. *.*.**\* *.\ .*.* *..\\.\. .* *.**  .\*** .\*...\...... .***...*  ..*.. . *  *!  * .*     *.*  *\\*   *  .*****\* .    . \*.*  * \**...... ..*. . \..@\..*..*\ .*.  **   #  . **##
#...\.. \.\  . ....*\..**.\*\ *.\ * *.  ....**  !***.** .  . \ *...*\*  ..* *.\**. .   *.  *.\**\. **.*...\   *..  .* . *..*. . .*.*..*.. *.*..... .*.@@.**\. .\ ... *. \.  .*\..*.\ ... *  *... *. .\#  \*.##.### #
# *\.. * **\  .* *..*..\. .. .* .**.\.. ........**.\ *. ! *\   .*\. *. \\.*\.W\.. **** *.\*..* ... *. .\.  .**.\.\.* . .***  ..*..@ *** \.*..* \ . ..*.\**** !**  . *. .. ***\.*.\ @.\ . .. *. . ..*  **\. ..##    #
#\..   .\.** . *.** \.   * .. .  \...* .*..\..   W* .\ !  *.* **** *.. .*..*\*\.  *.*. *...  .  .***\. ..*....\.\*.. * .****. ..*. ..*.\. \ .*.*. \ **.  ... . .\   \*. !* . ** *  \.@ . \  ..... *.  *.  .*#      #
# .\..  W\.*  .. ...*.. .**  @.  *   .. .** .\.**\\.\. ..**. .*.*...  **.*   ...  * .*.\ . ...\.*..\..   . .*.\. **..   ..*. *\*.*.. * ..... ... ..\.\. ..\ . **.  .. * *.  ..* \..\ *** .* !*.** ***    ***#      #
#. .. *    *  *\*.. . .*  .* .. \.\    \..*.\.*\..  ... *..* ....**. . *..\.\  . ...@....  \. .   *.* .* .\ .. * .*\*\*****  ...\..*... .*  \.. **. .* .. \.. *...  .*.**  * \.\.!   .\.\*.\..*..\ . .*\*\..##     #
#\*. .* *..  .*. . . *..\ .. *. .\.***  *..! *..\\.\.\ \....*  *.**.!* *  .** * .*.*.* !.*\   .  *\ ..*.   . .**  .. \. . . .\ .  \..**. *.     .\***.. . .*@*. ...  *..*...*. ..**\*\**.***   . ..\* ...*.  \#    #
#..  \.  . . **.   *...*. .\  *  .. *...\. *..  ..* .....*.** .\ .\.*@  .*.*\** ..\*\* .\.   .   **.  ..*. .  .  *\.. \ . \..    \.* *...\.*.*.\ .*\ .* . \.*. *.  .*. *. \\ .*  **.\.*....\.*.* * .* .. #\   #    #
#*. .   * . *..*.\.\. .**.\!\*.   ...   .*. *\. * .\**   ..\\ **.\.****...W.*.\  *..*. .   .**\*\*  .* ..**.\.   \.\.  *...\.*.\   ..*\*.  ..* .\.. \ .  *.\  ..*...*..*. .** *  . .**\.\    .*\.** * .\  *..\#    #
#\.. *  .\   .*. *.. * **.  ..** .  **. \ *\....\.\   .*\*.\ *..*\.** !\... . . *** .  *. . .  .\...\** ..** *...... .  .****.\*\ .\**.* .  .\.@* *..   .*\  !.\.   \ \*\.\.\ *.* \ *  * * . .*\\....  \.\*###     #
#.*...\****.... .*.*\*\. ** *.*\ *\.\.** .**  \.*.** *. .\ .\. .....* ***.\ .. .....  *.... **. . ..... * .*.*** ...\. *....  !.**.*...**   . . ...**  .*.\*\*@  . ..   *..  .\ .. *.\. *.  * .  * ****#*..\#      #
#\ *   *\..*\.\.*..\.. **.\\. ...\ .!  ..  .\*....\..*.* .*\..\.  * .\******.*\.\* *\*.  . ** *.\\  .. *\. .\.\  .* .  *\**..  ..\W\.\**.. *\ . *\  * * .  * ..* ...\*.*. \ **  *\.*\.\*.  *\ .***..\*# \..*.# ##  #
# ** **.  .. ...... .*  *\..*  \*.... \\  .*..\. .   .\.   ..\***..\* \\ ...*.  .* * * \* ..\\.*.\.** \**\* *. \ *\**.*.  .*..\ .* . .*.*. . *  *. .. . . .\* *.*\*. . .\*..*... *\*\  .** .**....*..*# ...\ ##..# #
#\.\ .\... .*\*\ ..\.*  \@* .*\ . *.*. .*.*.* *  **..**.**.*\  .\* *\*. . *.\.*. * **.*.. .\ . .***.  .\.*.\*\  .\*.*..*\.  ** .  **\ * .. **..\..\*.*\ *\  .*....* .*.\***\*\ ... *. ..**.... ....#**\\#  *. \.#.##
# ..*.  *.\*....*...*...... .!  *\.   ...***.\!\  * *.\**.\*.   .*   ...  ...*.\.. .*..*..** .. *\ .\.\ .*  .. .*.....\!** . ..\ .* **\  ... *! *\ ***..* .@*. .\@*\..\ *.**.. *.*.*.*\  *\*. *  *\*.. *\..#... \*##
#*@*.. *. . . *. .\. *. *.* ...    . ..**.*..***  .*\ **.*.\*\ *.  .\ \. .. *.. \   .* .. ..***  *  *. .  *\  . ..* * . .. *  ..\ . \*. .    **\ \\.\..*. \... .\.*..**  \*. ..*\.  *\.*\.*. ...*.... .\\\\ . ..*.##
#@.\*..\. ..  \.. .*.* \* * *\..\! .@...**.... *.  ..!  * **.*..***.. .. .*\*.\.\ * @*. .\\ . * .* .* *  ...*\ *..\*  .** .*   \ *  !..\. . .*.\. *.. .* \   \.\  ..*..*..@  * ..  *. \* .....\..@#   * . *... .*.*#
#..**.   . \ * \ .\*@.....**.* ..*. @.*\.. **  . .*.** @\ .**...*.\ . *.  * \ .  \.*.......*.\* .. .\ .\. ...*.\.\..  *..  \  .. *\ \.   *\....  ...\ \...*\.  .. ....*.* *\ *\.*.*.. .\.\.  *\.\.  *.* ..\.\**.*\##
#*\ .* ..\*. . .* .\.* \*.....\  ..\*\ ..\ ..*\..\*.\\... \\* \ \*..\ .\..\ .\....  .* . .\..* \ .  *   . * . ..\**\.** * *..* .   \. \* .*.. .* .*. \...*. ..  . .* ...\*..*\!**.*\ **.. *\\\.\ \  .*.*** ..**.#.##
#*  **.*\*. ..\*.. \ .\..*..\.* .*.....*\  \*  .*.*.**  ... .\*.*W.*   .  ***\***.\... .\   **.    *. . **.. ..\ .\  .....* . .*.*......  .    .\.. * *****.* .*! \.! ....*....**\..*.. .*.* ** ..\**\ ....*..#\## #
#* **\* ..\. . .** .. . \...**  \.*.* *\ .\\. \.\.  .* . *.. **..**.\.\*\*......\ *.   . .* .\!! ..\.   .\.*..  **.. ....*..\* **  . \*...\*\\.*\.  \.... . .*...\. \.*...\*\*\. .\.\. ..**. *   ...\*. **.*\# #   #
#*...*.W.\.\.\..*.. \  *.. *.. .*.\\* .*.* *  ..\ *.*.. \..\\\.**  \  .*....* *. .* .*.**.* .*. . ... .***.*..\. .  . * . \*..\.\  .  \*\*.\*.  W  \****.\.  .**\. *.\.\\\...  .  .**  \.***** ..\*.\..#*##**\#    #
#**  * ...*.**\....   \*!. .@  *.  \ . ..*.\.* *.* .**.  \\*.*. \ ..  .\ .... **. . ..**.*..!.\ . .  ... . .  ..\  ..*\ .*.**\ \**\*.***....\ *.  ..*.. \*** \!. . . ...**..*     ..*. ..**.\!.\ .. \ \.##\* #     #
#***.@***...*\.\* . * .!*   . \**...   . .*.\. .*.. * ..\ .*.. *.**\.*  *...   . . .\* . . \.*    .\. . . . .    . *..*.***.. \*!..**.*. .. ... \*.* * *.*.  *  *   *. *.***. *...  ..**\.* *  *\  .... .####      #
#*\. \*.\..*\ .... . .\ . *  . .*. .*\  *...***\..*.*! .. *\..\**\. .*  \\  ** . . *..*\.**\ .*.*\...  . *  \.  @\  * *...!.\ .*  *. **.W \ *.  .*...*!\**\ ..\..\*\.. ..*\.* .**.  .  *\  \. *   *. *. \*#        #
#\  @.*. * ! \** \* . W.. .** *..\\.  ***.\.*.*** .\.   @..  . ....\**. .*  \.  . \..\...*..  **.* . ..*. \* *.\..\**\*\.* ** \*...   \!*   .   .* .**.**.  *  **.**. *.\. **...\ \   *  \* .\. ..**....##         #
#** * * ..\. ...  . .\*.*  *. . ..*\ *\ *..*.*.. .* . **.\ \* .*!..\ .  \.\...  *.*\.* ... ..*\.*\ *..*.. ....*.   *.*@***. *  . *\**  \. *.*. *  ....\*. \@*.**!*.*  .*\.....*\* ..**\.\.    **\* *.  *###        #
#\* .. \    .. *.. ..*....**\. .* .* \ *\..**\\* *.. ..*\*...  .*\ .  ...  .*.*.* .*..\ .\**! .\*..\\.  .  . \.*. .* . ..*..**. .*. . .. .. ** *.. \  .**\**** *\*\    * .... . * . ....* ** ...**.*!. .\**#       #
#\ * * .* \  . \* .\** .  ****  *\.**.. .*.*. \.  *.* \. . \ .. .*.\ .\    \\ .*.\* *\ .\ ..*\. \.*.. *..!\. .  \***...    \*.*.*...* ...*\ **...*.**.  .*.....* \.\ .*..*  .. \ .*\*.\** .*. *.. .\ ..*#...#      #
#.*!..* . . ***. ....\* .*. .**  *.....  .**. .* . !*  .* .. ....\..* . \ ..!\ .\ *. .* .   .\ \.\ \..**.\.*.. *\.*.\ . \.**.*..*.**..*\ * *\..\ .*.... .. . \.*  .\. \..   .*.** .\...***\***.* . . **.* \#       #
#...* . **\.\.!!.     .  *  .!.. \ \  . \\.  *.*  **.\ *.   . \ *.  .\*\*..* ** .* .. .\.\.  . *  \. \.\*. * * \* .  . . ..*..*..\  *... .@. \\. *.\. . ..  \... . .*... \ *.**.*.\. **.\.... .** ......###        #
#.\...* ...\..*.  *\. ..*  .*.  \ *.* . *. ..*.*..** *\...* *...\*\* * ..*\.*..  ..*\.. **.\. **.\.  . *. *. . .*.   *. \ \. . .*.  *.W. .. ..\ .  .*  .**.\..*.@.  .     .. **.** ....*.\*.. ..\ * ..* #\ #       #
#**\ \.\.**.  .   .*\. **.*.. .   .  * ..**\..**   \ *. \\..\   *.*.***\.. *..  .\.. .*.**  . **  **\  .\ \....** \ *.\.  ** ** .. *\. .*\...* .... ** *.*. .\*\*\  \..* **\ .\. .. .*. \*   .* . \.*.###.#        #
#* .  .*\.\.\ .\.* * . .  \  \*  **\ \..*\ **  .*.*.***...  .  ..**.... .  .@\.* .\** *.\  *   . .*\  . .\.. !\. . *..**  *\ *. \ **.*..*.* .\*\  .***\*... !\**..  ..\..\\*. .*..\. ..\.*\ .*..\ . .  ..\#        #
#* .***\*\ . * * *\.. *.* .\*........ * .  *\ *  *. .\   . * * .\.** .*\ ..*****.**W.\..*..\*...\.*.. \. . * *.\  .* ...*\..**  ..*. . \...*. *. \ .....*. **  *   .*  * .. @..*.     \ ..   . .. ....*## #        #
#@.\.\* . .  @ ***. \*..\ . .*  *W ..*\ .\*\*.. * ... . ...*\ .*  * .*   ** ..*\ .. \ * ! !..*\. .  **.** \.**\ ....!\ .. *\.   * ..  . \ *.\.*.\*\.\.*.**. .*\. *....*.\...**..*   \ .. .  ...\* .\ . .. #        #
#.*. ..    *****\@ *. .**   ***..*..*\..* ... \. *  ..*  .\\    . .*\.*. *  .\...\ \.. .   * .*  .. ..\.. .\** ...*...\.\.** *.   \.. \.. .\ *.\. .*..@*..*\*..\*. . ... ***.* ..\ *..\ \.* . *  \***\####         #
#*. *\. *...W\. \.*\.* ..\. .*\* \.....*. . \.. \..* ..!* !\ *.* *\*  .*  *  . \ . .*\. ..\.\ .* . .. . .\ *.* *\ .*. **\. * .* \ .!  .@* ...* * \...***..*.. ...* **\ ..*\...**.. \  .\.*. * *  .... ..*#         #
#.*.  ...*\. ..*  .. ... *.\.. .   \ .. \. *.\.*. .! *\\.  *.*   . . ....*.\.... **\..  \** . *\  \.*.  . .    \...**...*.*\* * . . ..\*.**.*..\ ..  .** *..  *\\*..\.   \ ** ... *   \...*.\ * .\  **.*#          #
# *.\    *  .. .   ..  .*...    .* ..  .* \.*.. *\ * *.\*\**\.. .\** \ **\.*\\  *.\\.\*\ **\.!.. *. ...\ *.\*. \ *.***** .. ..\.* .   *. ..\. *  . \ *!*. .*.\* *.....**... .*\. **.* .\ *.  ..*. * \.*\###        #
#*...*  .\ .   .\. *\...   . ** ..\ .   * .*.\...* *.\.*..\. .*.* .. .\*!.*.*\  *...*.***..* \ ...*.\ .. * .* *. .*.*... . *.** ! *.*.**.* *\*   . . . . *.**...  \..\*. .*.*.\  \ ..*.  .**..*.*\.  \*.\..#       #
#.*\. ..*.\*. *@\  .. ..... .*@ \....\  .*.  \* ..***\ . ..\ ... ..  .W.  . *..*\ * . * ..*. *.  \*\ *\.*. \*.\ . *.\. ...*.**. *\. *.\\.\***. ..\.*   .** \  *  ..\ *!.... \...\...** ** .   . # *\*!*. #*#       #
# .. . . . *..*\  \!\.*.  \....  .\\*..\.. .  . \ ... * . . .   *... \  \ .* . @ ...*.*.**.  . **... * \ *\*.*   .. ** *..** .\.***..**  ....*.  .\.\*\.. \*.\.\\ ..*. *..****....  .\  .  .* . . ...*. \.. ##     #
#. \\..    .* .*..... .. \.** **\ .\ \ ..!. ...  ..  ..\.\*.  . .\ \@.\*  .. * .\*\.  *..   ***.*\\..* . . . . \**.....*.\.. *\ .\.*\  . @ **.*\ .  *.    .. ....* ** **...*..\ ..**. ****!.**\ . *\ .#\ .#.**#    #
#  ..*. ****.\ ...\*. ***.    .@ . .\ * .. .**  *.* *.\   *.\.\ .    ...\**  .* .**\..\. *. . ... *  .  .   * ...\... ..\...\.* .. .  . .. \. !   .. **. . **\. . *   .\ \ . .** *. .**.\..\.. . .\#*#L  .**.@#    #
#*. \.*.**.*\.\.\\*.  \.. . .\..  .. @..@..\*.  * *\* .*.*. .* *..*\. \. *.**..  \.  \.****.**  **..*. \  ...**\.  *. *\ ..\* .\ \  .\.*** .*...*.  *. .*   .\ .*.   *!  .*..\....*   . **\.\.\  *W\*##\*  \ .#    #
#*.* *\*.*\....  ...    .*\ .*\.*.*  .*.. .** . .*\.*.\ .  . . . * .. .* **.\.\**    * ..* ....*..*. . . *\ *.*..\.  ..*\ .... . .   *.*. *\**.* .*\.\. \ \.  . ..  *..\...  * .*\\  .. *.  ..*\*. ...##*##.##     #
#.\.....\.*.\...\. *\\ .\...** **\. **.. \*.\. *....\.   .* **   ** .  **\..*. .* .. . * . .. ...** .. \.* *..\ ***... *..*\* .** *.*.  \\ .\. . \..*.*. * ! \* ..! .  .**.* .. * **\*.*.  .*\...*...#### #. #     #
#..   . * \ ..\.* ...   * ** . ..   .. .. .\*.**   .. .\\ ..*\**. ...\ ..!*** \..* ...\.  ... . .**\\  .*.*\ \..\**...*@ ..*   .. . ! *\.    . \ .*\. \ .**\*.*.*.\ *  **... .**.\.* \*..  *. *. #.**#..*##*#      #
#     *   . * ..** *\ *\.\*.\.* \.\* .\.\.*.  .*.. .   .\ \ *** *.!* *\\.\... ..**   *. .\  *.\**  .\.* @.**..\ .* *  ..*  .\* **    ***. \ \ *\. *  . . *\ *.*. *\*.  .* **  ****.*....  ** ..*.*\.. \\#  #       #
#  \***. * \.*\ .  * ..  .  ...  .**.  .**.\*  \ ..*....  \ . . *.** .\.@..*. ......*.**  **  @  ***. . * *\*  * . .    . ** . *\.*.*.\.*..\*.**. . . ...*... \*\...*..*..*\*.....*.\.  *** ...*.\* @\ * #         #
#\* .*\.*. * ...* . * . .**.   .**.* * * *\ . *.\ .\*\..*   * . .!\.   .\ **. ** \* *. *@ .\\ .* \.*.! \\ *...  \ .... *\ *.* ... . . .. *  ....\\..*..  .  .....\...**\\ ...  *\.*\.\*.\.\  .*...*.* .. !#        #
#..\*. *..*.*\ ..  .\. . *.\ \.*** *\. * *.   ..    .  \.**.\.*\   *\*  ..*...** .. .***  *.*..\. .... ..\. .\..\.\. .  .*\.*     *.*..  . . .  .****  *\.. ..\.** * .. !.\** \    \ ** **.*. . * .  . .##         #
#*\.W* .* . * ....\ .\   *..*.*** *\.*..*...**\. *** **.*.\.*  *..****.*\. \.....\. ...\ *\... .*.   * * * ... *.\@* *..\.*..   \**\.\.*  ..  \**...\**. ..... ... *.*\..\. \*.*  *.\...*.* .  \. .* @* #          #
# * \* !*   .     ..  . ....** \\ *.\\... \.*.*** ..\ . * .*. ..*.\... .***.@ .* ..*.... .. \.\... .\ \. ** .\ *\ \ **.. * ** \ .\.\@ *. *.* . **. . .*.. !.\*\.   * *.     .* .**\.! .*  . *  .\\ ##*\#           #
#\*\*\  * .   .** .* ** *\. ..*.*.*.*\  . ..*.*..  .*.....\...***.. .  * ...  .. \.*.* * \. \** \. *    \ *\ . *\. . * ..  ** . \   .\..\\.. . .... ***  \. ***\ .\...*\ ..*    ..\  . .* *\.\...#*. .*#           #
#.@..  .*** .*....  * * W\  .*..**\...! . \ .*\..  ..  \   .*\\.... .*\*\**. \ *... .*\. .*.**. ..\.*.\*.*. .  . .\... ....*.  .  \. .*.. .\  .*. \*.*\.\. **..... \ .***\!. ** @\ *..*\. *..  *. #* ##            #
#*\  \.***.\.... *.. .* **.*!* . \..* ***.   . \.\ *  \.. ***.*\*!* .*. .. *\. ..   *.. * *...   \. *.*.* .** *  ** \  *  *\. .. ...\ .. ... * \**. .. **.**.  *... \ **... *.. *.**.\*.*.. #*.#..*.*##            #
#\  . . ..\ ...\*** . \.. \*.**\!*.\.*...*  *\ .*  ..  .. .*  .*. .**.\... @. \*   .*.\ *...\**. *.*. . . **..*\ .\  * . ..  . \ .. ...*.  ..  \ *.\* ...*.*..  * \ .**\ **\**...... .*.. .  *\   ***.\#           #
#  . .*.@ \ ..  *.*\*\. .*.. .*     .....** .****\\  . *\.   **\........ . . . . * **.*.*.*\\.*  .*. .   . . *\.*..   .* ..  *..  .    . . . .*. .  .  *\.**.**\..\.*......*@.*.*.\..*...*\.\...*.\###.#           #
#.** *.*!. \***.*. **.. .* **.. *      .\.**..*.\... * !*****\*  \.. .\  .*\@\.\*..*..! . .*\.\.*** *  .**   *  * . \...***..\..  .\\.*\     .\ . . ...\... .***.  *.  \ \ .. .  * .\.\  .*@ .  *\.  \ #           #
#\.. . ...*..\*  . \.. .\! .****\*.  *\* \.*... .  .*. *.. .. . ....\ .\\..\. * . **... \... *. ..*.\..\ .*..* ..*** .  *.! .***   *..\.*  \ !*  *.....\. *   .. .*  * **\ @  .  ..  .*\  ...  *. ..\. #           #
#  .\...\ ... *.*....* **. *\@. . .  **. . \. * ...*...\.*. \ \ .*** @.. ***\.*\  **    . * ..**\**\ ** .**  .   *\.    .***..* ..*.... . * . .*...** ..  \\ . *\.*.* \ *... .*. .\..@* *.   \ .*\..## #           #
#.**.*\* @*.\*.*. \.*  **. ..\   **\* ...*.*  ***  \....\.. ....\*.*\ . .\\.. **..**\  *  * .\. .*.*.** ...... **  .*. \ ..@.  ..!*!*\ .  @ \**..\..*.   !..  *\ *\.\...****.*\*  . \\. .  *      .#  #            #
#\*\** .W *.*.* .*.* \ **  \*.\.*\*.\ **\. ...*\.*\. *\.*.\..*. *..\ *   .*.*..***.*.. *\*.\ .\  \.. ***..* .* **  *.*..** *\. **\* *.\\ \..\.*\\**\.\.**    *\ *.*\.\  **\.*. *  .* . **....\*.*# .#              #
####################################################################################################################################################################################################################

Water 79
Flooding 19
Waterproof 14
Razors 38
Growth 11
