#####################################################################################################################################
# *.\* ***\ \.  .  .\*\.\.** * .\. \. *W\ *..\   .\ \ *.*.\. *. 2 *.@\ . * *.*.* \.*.. .*.**... ... *.\. \..\. ...   *. *.* .  *** .#
#.. *.\.\. . . .*  * *\ . .\ ...*. . *\ *.*.**@.\.**. .* \.*.\. \.**  .*. . \.   \ *.. *.**. *..\\ .. ** . * \* ***....\.\.** *... *#
#\.\. ..*.. *.  ..\*\.*. . *.\\*.*.* \  ... .\. *.\*   .   *\*\...*...*\ ** .. .*...*. .\....*.*      .\ \..*.. .\.... .***..W.\@\ .#
#\\. ... *.\* .*. *.... .... .!. \.\* ...\**\**...  .   .......\ .* *.. ***   . .  .W... .\  .\  ..*\ \     .  .\ ..\\  .\... *.*. *#
#... *\.\*\.*\ \  .\\ ** .*\ *.\..*.**......*.W..** .  .*.. *\. * .**   ..* ...  *.\\ .\*....*.*.   .\...@...   ..\.  * .. ***...\ .#
#.*... *.*.\.*..*.\ . *.\.. .....    * . \  ...* . .    **\ @.**.*...\    .  . *.* *.\. .\.. .. \\\* * . .\*..*  .  * .*!\ .\  .**\ #
#\*.*  * .   .**. ..\ .*..*\*  .*. *.\*\.. \* .\. *\ *.... \  ... .* .*. \.**. \ .\*. *.\ **.*.. \ .** .  .*. .   *\. ..*  * ....@\.#
#*. ** * *.\\*.  .\ .* .\*...\   ** * ....  *\.*.... *.@.   *  *..*    * ...@**\* ..... *... .*.  *.*. *  \.  . **\.    .. ... \.*..#
#.  .*. ..\...\. *...*  ... * ... . *W \..  *. .. \\*W*.*.  ...** .***... \ *.....*.*  ..! .\\**. .  ..*  !*. *.\.\ . **.\ .**\..*\.#
# \. ...\ ..  .\** \ @  ..  .\*\*..!.*..\   \..* .. ..*  \. *@..* *\..   \..\*...  \.  \ \* ...*.**.. ...**..\*\*\   .**.  ....  @\.#
#. .   .. **.\.  *....**. . ... .* .*... . \.\ ** .** **..  *.*.. **.\ *.. \*  \.**. . ...* \*.* *.  \.\****  .\..  .  .  .*.*. .\*\#
#*.  *    ..**....*  \*. .  ** .**\..   . \*.  .\  .....\ * ...\.  .*\\.\. .. \\*!*\ *  .*\.. ** .*.. .**.\.\@  ... \ ..\* . .*.  \.#
#   .\. *  .*@ * .  *.*.  . ...\.  *@ *  ..\    . *. ..* .. . **.  . .*\. \* * *.*  *\.\  @*.*.* *\*. *. *   .  .* *... ..\..\.\ . .#
#\*. ...*  . \.. .\ ...\ .\. .\  *.\  . *.\.  . .\*.@ ..\   . .*. . .\   . *   .    .. .. . . .* ..** .! .*.. *...* ..\ \  .**.. \*.#
# ..\ \*\.*! .\ \ **** ..**..*.*\. \.*\ * *.\. \*.*.. .....  . *\  !.* *.\.* . .!*.. \ \ ....\.\@ *..\.  .** **  .   ** .*  *.. . ..#
# .  \ ..*..W.  ...**\ . **..   .*   .... *...  *\\.* \ **.  .*. !.. *..** .\  .\...  ...\  .. .**.   .*\.*.  .. *.**...*.*... * . .#
#*\.  .\*..*.*.  .\.@*R.\. .** ...\\ *   .*..*. .. *.. .\.*..\*.* *\**  .... \....\ \ .    *.\ ..** . *\.\*.*. .*.* * .\*.*. . *\...#
#. *    . .. *.   ** *.**\. *. **\*\ .*. ..*.**.\\ *  ....**..\...\**.*.\*.*. * * *\. ......** \...*\.*. *... *   . . .*...\..\... *#
#  .. ..  *\ \ ! ..* ..*.. .\*\....  **\ . .*\\. .*.\** .\.. ** *  .*.\ *\ . .. .\. .\ .*.\**.*..\ .. *\ .*\   .***\* .. \. ..* .\..#
# W*.  @.   ..\    \..**  . ***** ..\.  * . ** .*.  *\. ... *   .. *. .**... * \* ***...**.*\ **\..*.*. . . .\ ....  ..  \...@ \ *.\#
#\..*..\. *. ..  . .*.*..*\.*. .   \*  \.\. ..\ \...*...\.\ .  * *** \*... *.\* . *.     . . *..*. .\*. .    .*.\ *...*.  **\.**... #
# *  . .! . .**\\. .* .\ .  . .! ! .. .\\.**..\ \.\*.*\. ...  \..\ \.. * \...*  *    *.  *.. *  ....*.. .\* .\..... .\*\\*...*.\@.*.#
#. \.. \*\. *..**\  .*.  * \.* *  .  .** .@\...!.\..\. .\* ....*\. ..\ ..*...**.*  \.@.\*\..\.. .\\***.\....* \.\   . .*\ **...* ***#
#*  *!* .*.    .\* **\.\*. *\.\ ..... .* .** *\..* ...*  * \ \. * \ ..   *\\.*\\*.  \* ..  \@.*.. ..*.\ \..\*.* .***\**. . *.*\***\*#
#*@*. ...\...* .*. .*. *.\.*. \.\* \. ***..*.... .  *\.*......*. *   \..\**\..  *..@**.  .. . .\  \   . ..\ \..  \.\.\\  .**\*.\*..*#
#. ***.\ *.. .  * .*.W*\.*.*.\ \ \.  \***. .**\*.\@ \ \.\.*  ..\ ..  ..\.\ \ \.*.*  .*. \.   . .\...\..   **.*.. .*.  .* \.  .\..*\.#
#\ \.\.*....  \ . .. *....  * *.  * .**...\....*.\  ..  *.\ .  * ..*... @ .. .\.*.. *.. .\.*....*. *.. .. .**.**\ .* . *..  * ..**\\#
#.*...\*  .......    .\. \.... .\   *.. *.*\ \ \  **\ .**\.\ \.. *\.**.\  *.* . *. * !. .. \* . .  ..*    ....  .* ..\..  ....\*.\\ #
#.*  . . .. * \.\ . .*..   *\ \   .\.  \. .\*  .  ... \@*....**.\.  *. *\   \.  .* . \ * . ..\\ ..  \..\*..\*. ..   \ *\ . @  \.*.\.#
#.. ... \\ .. .. . .**\*****   *\..\..*. .. @@.* .\* .\.... **..*\**\. .** .*. ..* .\....  * *.\ * ....**** .. ..\ ... ..    .. . **#
#\   .** *.**..* . * .****.*.  * .*. \. **\ ..@ \...\*.*   .*  ** **... **\.!   *.*..  \   .\..***. .\ *.*.*@*.*\...*   *.... .****.#
#.\ . .*\*\. ...  \\.** *..*. ...\**.\*.. ..* .. .@ .**\  ..  \....*   .\..*. .***. ** .* **.  .\. *\.\**..*. \.  \..\*...*\  \....*#
#. * * .....**\*...  *\ *\.* *. **!\@ \*.*\*...W ..\..\.. *.\. ** *.*\ *   .. *... ....*. ..  *   .**\.*\*...  *\ .*.*.  *.. *. .*.*#
# .\.*. \. \\. .\...\.. .* * \. *.\*....*\...\*\ *\.*..   .*  *.. .\\**. .* .  *  . . .. .  * .  *\.*\ . .*  *!. . *\. *.. .*\.  *..#
#  *.. \ * *.  *...*@@. .. .*..  ...   \.. **...\* *.*.\....   .\ ** .*.*.!*..  .\*\ .. . \...\ ***.*.*.\  . @\** \* \...\  .*\\*.**#
#.*..\\  . ...  . .!****.** .\..**.*\  *.\ *.*\*.* .... .*\  . *.!.   . .\ . *   .* \.  .\..  . .*.*..\  . .*\.*.\..*. ..*. *.*.** .#
#\.*\.\ * *.  *..\  **.\*.** *.*. \ @.*.   *....\.*\ ..\.....  .\\ *. .\\ .. .* ...\  .*\W\ * \  .  \* ***\ *.**. ***.\. .  .*. ..**#
#*....*.*\  .\...*.\.*....!.\..\ \. *.*.*** .@...\.  *.*.. \  . ..*..\. .\..\ \\     ...  .\. W    ... !*.  .*.. ** \ .* ***  * . ..#
#.*\*...\.\..@* \.  *. *. @\  \..\ **...*.\  *..\.*.\.*   * . * **. *@.*..\*  .\**.*   .*.\.  ****.  ....* .   *  .\*.*...*..\.\.*\.#
#\... *.\*.**..** ..\ .. \*  * *....*.\**..*.  ..**.   *.W****. \* \.*\W.\ \. ** \.*.*.*\..\. . .* .*.*  .. \*... .*\ *.  .!\.** .  #
#. .* .  .*.*.\ .\.\\     ..*..\ .\.\*.\.. ..\.*\W* \@\ .*..\.**.**. @.* **\.\** .\...*\ *. *.\ *.     *\.   ..* .*.. .. . **\..\.  #
#..\.*... . ....\  **.   ....**..\.\ *.*\..*  *...\.@.*.\....*!*\* . *\...*****. .*.  * *.. *....* * ..**....* .@...***... .*.*... .#
# \. * *\ .\  ..*\ ...*..** ..\  .\ ***..\*\\**.\. \.*.*. *. * *.*   . ..**  \..   *\*..*. ... .\.**. . \*.*..\ .. .*\...\  . \** . #
#\ .\. ..*. .   . *\..\**.. *. *  . ..\*. !*.*.\. *.*\.****.** * .. *\  \..  \ .\. @\.*..\ *\....\.\.*\*.*** ...* .  .* *.. .  ..*.\#
#.  . **. . ..*  * .  ..*.* ..*\.\ . *.*.\*\*. .*\  .W*. .\..*....  ..\.. **  *......*. **.!*..  .\. * ..*\.  . *. \. ...*  *. \*\* #
#  *\.*\. ..    \. ..   . .  \..**. @\*....*.*.\  .*.*. *.**.. .\..\...*@\ .**...\**  \ ..  .*\ *  * .\ \@*\..*.. \. .  .*  .....*\.#
# *  .\* * . ..\. \...@*.. *.. ..* . ...\ **. .. \.*.* ..**.*. *..\ \.*.*  *.. ....*  .**      ...*..* ..* * *.\....\  *.. .  .\ .* #
# *\   * \. * ..**  *  *.  *. .**\.\ *\.. ..***@* *.....\ \ **\*\*. \.* \*.* @*..   *.\..**\*.*\ .*\ ...* . \.* .\ .. . .. .* .**.**#
#.* .  \!  .\ **..\ .\ *.*\*\  .. .\*.*\  . ..* \* \ .*. .....\*... .\ . *\. .**\*\** *...\ *..**...\*.*. ***** .. \W\.\ ** .  W@\..#
#.* \. . \.. .*..**\.  \ ..\*... \  *\*. .   *..\... ...  *\  ..** . *.  *  . ...\.**..\. . *   . *. *\. ..!\* \. .\  * \..*\ . . .\#
# . *\.. . *\..*\@\ ***\.* *.*.* .. ***.   *\***.\  . **\....*  .   .*....* ..** * ** ....  .*. * @.... * .. *\.*\**  \ .*  *. .*. .#
#** \..\.\\..\ ....*\**..**! **..  ** . .\* ......  .*...*\. *\.  ..  W\\.\*\..  **..\ .\  *.*. . @ \   .*.  .!.. .*... .!\*.   **  #
#..*.* \* .  .  . \. .!\.\. .\*\* .*.. *. ..\\  . *.*.***@\.... .* .**\  * .. .**. . ***  \.*. .\..*.*\***\.*.\*.*.***\*......**.   #
#**.*.\...\**.. \..\ \.\ . * *..* .\.\.\. .\..  *  .. .. *. **   *\..  .** * * .......*.. *   *\. **..  ...*\*. **.*.. .*.. . .  *\.#
#*\ *.*\ . *.***\*..*  ..\..*. .\. *  .  *..\ \\\ . \ . *.  *. ..***\ . ..*\ .\ \  * .*...  * ..W.\*. *. * .*.  .**.*  **  .. .* . .#
#..@..**.* .*. . .* \* .\*. *\ *.. *@.*....*. .*  .\. ..*.. .*.*...*.  \ **.**** .\. \*. *.** \ .*..  \*\ .\.  *. ..*   .. @ .\.*** #
#***\.*... ***\**.* *...*.* * ..*. * *.* *\.! ..\*...\.   * . *!* .. ..!*..... *.*..\.   \..*....@.\. .. . .  *. !.\.\.\ * *.** .\* #
#\ ..\\ *.*..**.*\.\* ...* .. .*.\.*..*. .\... . * *  *\*..  **\.\.*  *.\.\** .\.*\ *.* \...*.  \ . \ . \  *.*.*.  \.  . .*.**..*..\#
#\ * .*.... .....* ..  **.*.*. . .\*...*..    ..*\. \.. ..**. *..***.*...  ..  .@\  \ *..\. .. *... ****..*.\.@\*. .** \* * ..    ..#
#... *.  *.\. .. .  .  .!.****\..  *.*.\   \.*  ..* . \  .*** **.\*W  * ..  .  . .\  \.*  **\..\  * \* .  \ .*..*.**..  .\ *.\.\.  .#
#\..*.\ ....  .*\*.\*\ **\.. *.\* *.*.. \   . .*. ...\ ... ..*..\*\..*\....** ..**.*. *..*.\*.\  *.. *. *.\**.. ..*.***\\  .  ** . \#
#** .. .\.. ..\. *. .....*.. . *..\\*  *. .  \ .*  ..* .\ \\*. . . \.@\**..*.**\.**.  .* .*.*. ..**      **..* \*\..... ..\  .   *..#
#** \. *.*.   ** .*    .\\ .   .*.\*.*..**.*\ . *\..\.**.*.\.\ .\.. * * * *...\   .\.. *. . * . ..*.*..... *.\\.*   .\.  .  *  .*..*#
# .\.\**.. .*.**.*.   . .. .* ... .  *\. ...!.*... *\.\**.\.!.    .\.\.   . **  *** .  .\   .!  * ....*\\.. \*.\\ .  .\ .\* *. .*. *#
#.. * ..*  .. **\ *\.*. .. *.*.\.. .... . *..*. .\ ..  .\ ** *..!\**\.  * . .*  ..\  .**.\ **\ ..*\.*..*     . . ***. *. .. ..\ *...#
#..*. \ . .@ ..** *.*. * \ .\**  .... \\.\. ..*. .!.\..*   *\*!.\*...  *\.*\*.\..*\  ..*.  .\*.*..    \.\ . *\. \ .* .. . *. ..*.\. #
#   ...\. * .. !*.\*. .*@** .\. \. ...... * \..*\*  .*.. * .***\.. ..*\. ** \* .. ..* \...!....  \   \ *  \ .   ..*.*. .*.. *\....  #
#\* ..  \.\.\*. *.*.. ... * ...\.*  . *.  **..\ \.. .*.\\. .. \. \*.\.*\***\***.**  *  * * .\ *..  \ *** \.* .* ...*\.  .\  . \* *. #
#.* .*.  .** .*\**..\* * .. .* ..*\.  \** *..  \.. ...\.. \. *  *.**\****.\......W..  ** .\****\ .*.*...*!. . .\   *.  .* *  \.*.\..#
# .*\ . * ... ...* . .\. .*...*.\.*\.. .**.@  ...\ \..\\.**\ . **...*.*...\*. * . .... ** *\.*..*.. .*..*.. ..\..*.\\*@\* .*  .\. *\#
# *. .  \  ..  *\. @.*. . ...*\ .\\!\*\..\ *.\.*. \. *.. ...\ ..*.. .*.\. * *** * ..@.**  .  ..\*\ * . ***.*   *\.\***...  \...@.* .#
#**\...* .  \ ..*\ ... **.\.*.\ \\  ***.* \*** \.  .\ ** *  *. ..\.*\. ........**. *\  \ ..\ * .*.. ** \** .. ** \\..**.\!..  . .*.*#
# .. . .   *   .. \ ..\.*  .. *..  ***..**.. .\ *\ ..**.\* .. * . ...\.*@ ...**.*. \*. . ..*  .\...\........ .*.\.. ..\ * .  . *.. .#
#...*  . *.*  * * .\.. *..\ ** *\ *!. . *.*  \*.!*  * \.\*. \ . \     \\.  . * *\\.\  *.*\ \*.*.*  **...*  .. ..W.   *.\. . .. .. .\#
#\**.\..\...*W* *. .*...\....**..\.  *..* . .*\.. .\.*.  . *.\*. *   ..**\ *.\***..** *\.\*....*W  \. *.. \ . *.  \  !**.@.*\... .* #
#* \.*.\* .\**. .*..*\.....**..*  .. ..\\ * * *..\\ \...\  .* *...... \*\*\.*... *.\.*..**. \ .*. *...*. .. * * \... .*.\. .     .. #
#.   . ..  ... **\.*  ..   .   *.*. *\**\.*   \... ..**** . \ .**. !\.....***.\*\. . .....B \.**....*.*..*.*...\ \**. .*. .*.* *. *\#
#.. ...  . ** ..*... *....\*  *..**..*.. .*\....*. ..\. *   .. .*.* * * ...\\ ..*.*** .*\.* . .\***....*..\.*\ \ . * .*\.**..  .*\..#
# ...  *\ .****\.*\. .!.   .* .\* .\\. \\  . .. ..   *..\.*\*. ..*\ ..  . ..   \. \ .@ .. ..* * *......@ .**\. .*\ **** .  \ ***.** #
#   .. *.\ *\*\..*.*....\ *** .\**.. .\.\**.\*.** \*   ..*.*.*** *@.*. *.*\. * .   . .\..  .* *  .* * .   @.*. *.   ... *  . * . .. #
#.*\.. ..  \.*. ...* .. *.\*\  . .    *.*.\. ...**.*\ ****....**. *..\*... . *\    .* ..\ .*. .\ **.* .  .. . *.* ..* .\ @*. .\\ . .#
#.* \\** *\**...\  .*  ..  **. ***\..**.. *. .  \.*.\..***\..**. ...\ **. .*.\ *.*.** *\.*... ****. .*..** ..*.* ..\.**..*.*.\ ..* *#
#\ \..* \.**\*..  .\..**.*.*.. ..** \.. \. \*. ........*\  .  . ..*.. .  * .\.** \* .\*.\. .  \.\.\* ..\*.*. *.*   \.\.. .*\.\*..\ .#
#*.  *.\.**\  \..  *\...*..*.\. .. .. **.\*....\ *. ...*... .   *..\*\. **  *..\ . . *.\    .. .\!*..* .*\.. \...*..\ ..\.\....**.\.#
#. \**!....*.   . **. .*.**. .\.*\*.  . . ..*.. \\  @..**... ..... .\. *.\.** . ..*  . \. . . .   .\.\.\.  \...* .\.**\ ..    *..*..#
# *...\  . \.\  .* .* . *..**.. .**.* \.\   ..* .*\.\.*\.\...*.*.\ .. *... *. \.\ *\\  . *   \ ..   .  *..  *..**   .\   ....\**.\*.#
# . *.. .. .  .* .. .   ** !\.* * . **.. \..**. ***  .. \*  *.\ ..*  *..*.\.\  .*\.  .. . \ *\*... .*..*  .*. *\.*\\  .*  . **..\..*#
# \ .*  *.... \. \.  \..\. .*.*\.   *.** *. \*.   . *** ..\ .\*   *.**\**  \.. ...  *\ \....\** .   .. \  *. *.. ... ..\ *  *.\ .*..#
#..  .\.. \.*\*. * .*..  **  *....*\*\.**\..*. *..*\*...... *.*..   .* *\ ..\ *\.**.\.  . .* ****... \.*. .\ ..\ .\  .*.**\.\  \..\ #
# \. ..\   ... .\...*** *\*\*\  *.....*.**. .*.**\.  \.  **. ..\*... . \.@*...\  .* ** \*. .\..*\.*\***  \. * ....* *** .* \*.......#
#   .... *  .\*\\*. * ..  .**..\.*.*.*.  *..*.*.*...\. \*\.*..  ..*\ .\*\..       **.*.\* .. @ **\..... \ *..  *\...\* ..\\.\**\..  #
#.*\  *.\.   *  ...... .. **.**  .  .@\. \ **.  *.* . *.* *\. *. .* ...*.**\*. *@...*...*  * .*...\*  *  \*\ .\.  ***. *\*.*. **. . #
#\*! *  *\ .. * .**  .* .... *.  \ .   *   .... ...\ *... *. . \\.**** **....  *..\..*.\* *....* \*. .\. .\*.\ * .* \ .*.***  *\.\  #
# \.\. \ ..* .*.\.*\ \..**.   .!.. *\ .*.* .....\***\..W\  \*\ . *\.\.  ****. .. . *\*\.* *\ * .\...*.  *** *. .  .  ..*.\.\**.  *..#
#\. ** . ***\** *\* *. \.*..\ . .\...  . *   \....*.  \* \..*\.  .! .*! *.\.. !\ *\.    .*.* \  .*\.     .. .*  ...\..\  ! ** **.. *#
#. *..\ *.\**..\.. .*.. **......*. * *.\**.** . * .\  ...\* \ *. .*. .* \*@*       *.*  *\......**  ...***.  **. . .*\ \ *..**.* \ .#
#  * **\. . .*\* .\*  .\ .  *....\ . *. . \** ...*\.  *. *.  .*..\.*\ . \..***....\*.*. \ .\ *. **.\\..*.\..* .*\ **\ . *.\*.*\ *.*.#
# .\ .\ * \  ..  . . . .\  !*. ..  . . .\. .. \ ...***. .* .. ..   **.* . .....*.. ...*. .\ .. .**. . ..* .\. *.   ! * *\ .*....... #
#*\.* ..**.\ .  . .*.*\ ..  \ .*  \ \.\.** \. .* ..*..  .*.*@..\ *\\.* .** .  ..* \*... *...\.  .\.*.\* .. *\ ..\.*\ .** . ..@\ . *\#
#.@\.. ..\**..*** **\...**  . \@.\. .!.**.*.!***. .. *..\*. .*   . . . ** \    .. .   \  \  . .*... *@.    .* *  **.*... . !*.\** **#
#*.\...\*.* . *. **\.   *. \ *..** .....* .. **.\\\...* \* .  * .\.\..W....*.  *   . .... .*. .* .*.  .*.*  *..\ .\*.\.*\..*.....\*.#
#. @.\*.. *.*. **....*..***. *. .*.\  @.  .\.\ \ \** \.*.* **.*..*   .   \*\*.* .*.*. .\* \.*. \.*!. .\ ..*!\..  **...\.*.\.. \*  . #
#\.. .*.  ..*\.*..\* \ **.. ....\  *.*\ \.\* .* .\..\..\*\ .\..**.. \...\.. .*\ ...* .**..  .\*.. \ ***  ..\ .**\*... \*. .. ..* ***#
#.  . .... \.  . ... .!\.   .  *  *. ...** *  * ***.  . . *. *.... ****.\!   .  *  * ..  \. ...\..*\...*  * *\. .\. *...    .\*. \..#
#.. *  . \**\.\ .\   *.* \  . *.\ . .\.*.. \ *  \..\.**.*....\** *\. \.@*    *\*.\.  ** **.. *... ...  *.. ..**\.. \*....\ * *.!*. .#
#.**.*.\*..* **** . .\*** * !.\ ****....*\..*..\....\..\..**\ \.***\  * ...\** *.   .\.\.  * ** . ***..  .*\**..*. .. ..*  ..  \. . #
#\ .*   \*\. ..*.. * *..* * * .** !.* *.. !*** .*.....\  *.* . .**   ..*.*\..  *.*@\ ..**..*  * *...*  .*...*.\  *  .@. *\ * @* ... #
# .  .*  ...\.*..\*. .*\* ..*.. .*!*\.. ..*..\.... *.. *.. .\.\* .\. *...  * . . . ...  *. . .. .**  ...\*\ ..* ..**\...\**. \**.** #
# * . .*.\ \.... ** !... .**.** \  ..\ \* .** \**\    *.*. \.**...*\\..* **. \  *.\*.  **** **\ ..*. \   .*.  .. ...\ \. ... . .  * #
# .*.  .*W .* .* *. *****... ...\.* \.. . *..\. *\.* .\.. \.  *\.*.*.*\. .\... ..\.\*\****\**..*  ...\. . .**. .** .   ..* ....* *  #
#\..\..* \*...\. . ..**\.. !\@ .*\*.... . .  \.*  .. *.*. . ....*!\.\.. .\* ..  . .*..\..**..**  *. .   .\ ....*..\..* ... .\ .* .. #
#. ... .. .*. .\     . . .**  ..\ ..\... .. *.\*  .\.*.**  .  **.... *\  *..   *   *\ . .\ .  *. **\.*   *. *\\*\\**. .* *.  ...... #
#.. .*.\!** * W.**** **.  .\ .*. ..*\ \  * ..*. *  .\*@* * *.\.* .\  .\.  **\  \*   ....*..***.**\....*\...*.*..*\...* **.*.  . .  .#
# .   \* ..*. . ... !.  .**. \...\ . * .\..\ *@\.**.\!\*\. .. .\* ..*. \...*..\...  \*\..\*\.....*......*\ .. .\...\ \.*... \.. .\.D#
#.  *.. * *.*. \.**.  *  *  .. ..*.....   *....  .*.*.*.! *\. * ..  *.**....\***\. ...** *...  .\.  * ..... ..*. .*.  ... *.     **.#
#.. .* ..\* *...*.\.*.. *.*.*. \ .. .\.*..  .\ ...**\  .*  .  **. .*. .\ \ ...*... @  .. \ ** *\W **.*.\. .. ...  *. ***\\. ** \...*#
#.. *.. \ .   \..*. **\.\ \  *...\ ...\\*. . .\.* **..\*.\..  *\*\ * ...*. \ .. \.\\\.. ..*.  *... *..\.   . ...*** .*...\.W.* \.  *#
#\  .*.* .*. .\ *.. ..  .....  *  \*\*.**   ..  . * . .*..***.**\ . .*\ .\ \  *. ..\.. . \.*  *\.*\* \.  ..**. *.*.\ . ..   ..  \ \.#
#.\....*\\ .\. .*.\.. .*\.\ .. **\.!**** ..*..*  .\*\......*..*\**  *..  \.. \.   . * .* . .*\ ...*. *\   .*.* .  . .  \. .  . * \..#
#..**...   *. .*\ ..\  ..*..**\\. .\.*...**.. *\. ... .*\*.** * .*   .  *..*..  .....\.\  . .  *  .\.\*\.* . ..\.*. @.    *\ ...  .\#
#\*****..*.\* *. ....* **.  *. *.\*. .\ *.. *\. .*.*\ \...**.\ ..\*.*  ...... .\* ....* ..\*\.  ..**...*.** * *\ .*..\.\.... *..** @#
#.* .*.\.* *.*. ...! . .. .\***.\\.\\*.*.. **  \*.. . .\  *.. . *.*..*  . *\* * \.*\. \\ \..  . \ \..*.  .. . .! *. \* *.  * .... .\#
#*. ..\.  *\.\*.** *  **. .***\ .*\... . . \.\ *.\*.**\. \*.\\* . ****.\* \.*\..  .. \..*\. \*\ .  ...\@ *\.*. \ .*  . ..\     \.  .#
#*\ \. ....  .*\ * * .\. .\.*.* \.*. \. .!*. *  @    . \*.* **\ .**.@.**\  *\ *.\*\ .\* ...* \   .*.* *. ...\ *..\..\..\***.  *.  . #
#**.***  **..   *  . \..* *. .!* *.    .\..... **\ *.*\ .**.....\****.\.\\ \. .  ..*.*.\ \ *. . ..* * . . **... \ ..  . .* ... *. .*#
#... ** * ** .\*   **  \ *.*.*.\.* .  . \.. ...\*. ... *.\... *\**..*. ... .***.*\! .. . *\.*. *\*\     .\.\ .. ...* .\* .\ . **. .!#
#..\..*** .*\. \*.\.  \..\ \..*..*  .**\.*\. ..*. *  \*.\. .* \.... .\  **\. .\..  . ..* .* .  **..*.\...!**  *. * .\ ..\ ..\..**** #
#*  *.**\ ... ..*\.\...\ *\.*..  .. *.. *...\ \@ ***. * *.\.\ ...\ .**.*\.*\\.  * *.\  ...\ *.*.\* . . .  *.   * **@...\. *.*.\.**. #
#*. . .\ \ \  * *..**\*.\.  **.@  .  .. *..\. ..\*..*@....*.. * .\ .***\**\.. .\..\* .\  ** ..\... *\\..@. ..  .\**. .\ \ * .*  . ..#
#. .\ *...*!.\. \* .***  ..! .*.* \ * .\..\.  . *.  \ *  .. * . ... *..@* *\.* . . ......** \.****.* ** . .\..*  .* \ !..**\.\*. . .#
#. *.*\*.\.  \! ...\.*.* *.\.\......  *\*..*.   .. .*..\ .* .\*.\. * .*\*.\.\*.  *\ .** ** .. .\.* .@ ..    *.    ... ..\* . ....\  #
#... ..*  .\ . ...* ..\.  .* *. .\.\*\\..*. . ..  .** .\. ..**..  *. \. ...**. . *..\..\.@.\..**** ..\... @ .*.*\* .*..\ .*\.\*\ ...#
#* * . \* \*  *\..\  **.\..**\. * *.\.*\ . .*. .\...\*\  *\*..*...*\**.   *...\. ..* *.  *   .  *. *\.\ **.* .**.*\..*\* ...A. * .. #
#.\!\\.\.\.* ..****.*.. .  .**... ..  *.*. \.\*  * \* \ *\.* \\ . ...... . .  ..\  **..... *.* .* .\.\ . \ ....\**..*. .*\**..@.    #
#*.\ .. . ..  * .....*. ... *\.\. * .\*.\.\..\.\***.. .*.**....*@..*.   ** \ \ ... **.\..\.\ * ***\\. * ......*\..*\... .\   *.   . #
#.  *\ . *\ * \.!.\   *@... * *\.*..\..\  *  ...\6\   *.... .*\* \*.* *.*.*. *.\ .  .*.*\\.*\  .\*..  . .*\..\. **..**\. *   . *.   #
#  \.*. \....@..\... ..* . .\*.*\.*.*.\*.\..\*.*.\.*..**.*\\ *   .* . *.\ ... .  . . \ .. .\. \  .\ .\ \*.. *..\.\.\***..*** .  ..*.#
#  . ..\..*.*... * .\      .\* .. *..*.*\   *..  *\* *\ ** . \*.*.\ .\*\.\ .\  .@. *  . \   *\.*   ! .. ..\ *.. ..  *..*.. *@...  *\#
#**\ \. *.. *\.*. ..*\   * @ .*\*\* \... . ***\  ..  *. \.     * .   .*....  .  \*\. *.\. ..* . .* .. .W... .. @  . .\\..@ . *.\. \ #
#.\.  \ ..\ *...* .\  .** \ *......\ .* . .\.. *....@ \..\ .  \*.**.....  *\* \*.@.   \*\!\ \. . .\\ **.*\   \  **   .\...\. .*.*.\\#
#*W **.  .*\.*\*.**... *.\. \.  \* .. \W*   ** .\ * . . \. **.    * \*   *..  ....* .*.*.*. * *.*  .\.. . . ..****\\ @. *    \.  *  #
#\ .*...\ ..\..***.  .\. \. .*\.**.**\ .. \....*. ... . .*\..\ *.*.*\*.. *\.   . .. \.!..*.** .!.\ \* . . ....\*.* *... .\  *.\.*.. #
#...*.* .\*    ..\.. .  .  \ *. \* .....* .  *  *  \ .   .. \  \ \ *.**\....*.  .\*. .\.\.**.\.\.**..  .** .@. * * *\. .. . \ !**. *#
#.   \.\*.. .**.** ..*..   .   **.\  \*\*..* .@. .  *.  \*.*....*..**...\.. ...  .  * .*. .* .@**..     *.\.. .\.. .*..@..* .\ .* ..#
# .*\ *.\**. .*\.......\. *  *  . *  **.** ****.   \\*\..*.  *.   ...*.  . . .\*\..\.*\.* *.\ *.*\ .\.....*** \... .* .*\ .. .  .   #
#... *.*.  *.**.*.. **\..\.\.\*.* \.*.\..  \\.. **  !@ ***. .*\...\ .....  .** \....**..\ . .. .*... *  ...*.\ ... *. .. ..    ** \ #
#\... \ ** *\..* .   .... *@*. .  .**  ...\.. .\..\  .\..... ...    .*  .  \.\ .\*.**\.!* \*  * .\  ...\ * . .. *.**.*.  .\\..\*   .#
#  \ * ....*..*. ...\ *\. \ @\. ...*.  \..** .* * * .. \ .\*..  ..   .  * \ ..*.. .**  \ * .   \\.  *  \ .. .. *.\ **.. **.* . .  \.#
#*.. ...\.** *.. .\*.\. .\..** .   *.**..\*. ..**.\  * . \.  \*\...*.\..*.*\ .*.. . ..!.\.\ .   .*  .*  .*  *\ .  *...  .*.* *\ .\ \#
#.@ \. ..@\ \...  . \* . *.\.. ****.*... *..   .. **.. ** . .. . \.\   \.\. * *  ..  \ .**\.   **. \ *.. . \* *. *..\ *\ . .** . .*\#
#*.\...@..*.  ..\.*.  *\* \..***...*. \. \*.\ . *\. .\. .. * *.   \.... * *!. \* . ... \.. ... . ...*\**.\ ..\. .\.* ..*\*. .* . *\.#
#*.  * \..\*\  \ \* .*..*\!\ *.*..*.... ... *.* *..\ **\* ..@.   ..*. **.\ * **..  *\. ..*F* .*  W**  *   \ \* .*. *\**\ .  *..**.\.#
#*..\* .\.*...\.\ ...\* **. *\*. ..* \* !..\* . **.  ..*.*.* \.. . *. \ * .. .*\.\ *.. *\...\.*\....\. \.**..\* ....  \  \*..*@.** \#
#.*. .   ...\ **** ...**..*\*..* *      \  ... ..*  *.*.*.\. . *.\..* .*.**...  . . .  *..  .\.** \.. .!.\..  .    .\  .*..** .\ **.#
#\ \\..\*.\ ..\.****.\*.. \**  . .\ \.*...\***     .*. *\*.*  \* \  .\ ****. \.  .*  \ *\ **   ....*\  .. .*     .\ *\ *.\*.**... \ #
#...\ \ . ... ...*.*.. .\. .\ \  *. . ..**.@ ..*.. **. * . . *.**.*.**  ..\ *.\ \....*.\.  . *.  \ .\......\ . .*.... **.. \..*.. . #
#\.\*. \ ** . ** *W.\. .* *.. * *\.\.**\.\.. .**.. \.   \ *...... .\.* *  * *  .* .*\.*\**\* .*\*   .* .\ ...\...\ **. ..\ ...  .*\ #
#.. .*..\.\ \.\.*.  * ... . **. .. \ .. *.*  . .\*..* *.\..*. *.\    . *..! ** . * .\ ....\* \...*.*\*. ..* *..*  ..\\*\.*.*\\*\*...#
#*   .*   ....  *  \*.\* \*..*.   ...\\ .***** *... .* **. ***. *.* .*.*.*  .*  ** *    \ *.\E*. * * !... ... .!\.*.**.*\.***..  \..#
#*.  *.*  . ... .*  .. . .*... .*  . *.*....\.*.W .* . . .. .*.. *.* .....  *.@.@\*.\ * . ....\ *.\.* *.\. \.\  .\*..* .....*!.   \.#
#!   .*. *  .*  **  *\ \. ..\.  C\ *....*.*\  .\.  \.\.* .   . . \ .**.\....* * .*\!.* ..\.... *  .*.*.@.  *\*\*.*. \.  ** ..*\.  ..#
#**W* **..*\..   . *. .. *. ...**  ***  ..**.. .*. .\***  **\\. ..\*.  **..  .!. @ .*...*.. \..*.*.\.!\. \..*..\ ** . ...*.* .  *.*\#
# ...*....** .* *\ .*\ *.\* .  .*\ \. .! . .*.  . *@  *\..\.   . \ * ..*.\*@   \ \  . . *     *\ ****\  \ **** **.*  .\.\*** .*.. . #
#\**.*** \ . * *\.  !.....\. \ \.*  ...** . *.*. ...* @ *.***..*\!..* ***.*@!****.*.*.**\  .** .. .*...\. *.*. * *.\. .*..**.. **   #
# .*   ..\.. \* ** *\ ..* .*   . *\..*... @ *\\.** *  * ...*.. ....*\ ... .*\*.. \...*.*.***\. . *.. . *. .* \.. .  ..\\**  .   .**.#
# .*.*.*  *... \ *.@   *.. .. \* ..  *...*\*.***....*\*..  .* .* \ . **\ .*. ..\ .\  .\..... *\  \   * *.*\*. ** *... ..*\. .***..*\#
#  .\... .\   .. \***.*..*\   *.**\  . \\. .*....  *..***@.*.**.*.\  *\.* \. ***** \.*...\ . .. \.  .\*  ..*\..  **.. . .*.\..\.*\**#
# \ .. .  . ***** .*\*\. *. .*.**.     .  .\.*... .*....... ....... *.*.@    * ...\. *.   *****.  . \.. . .\.** .*    .. . 7 .. .*..#
#\..\  * .\..*. ****... .\ *...@* *\  .*.  .***\.. \ \..*.\\ \\\* \*\   . .**. ** \. .\*\..*..* \*..     *. . .. ...\*.! \*.*\..*\ *#
#  . .\**\. * . ..*.  .**. .\ !.\..  **.* .*****....!  \\\...* .\ ..*. * *.*\. \ **.\ . . .*\*** ...*..  ...*.*.  *....\  .\. .  . .#
#*.. . .*.* *  . *.  *. ..  . \  . **.. . \..\..*\   .\.***\ .\..\ *.\. .*. @. ..** * ....\....*.**.*\*.*\*.. . .**   .. .   .\.*\ \#
# * ...*.**\*  .*** .** .... ..*** ..\ @ .! . . ..*.*.*.... * ***...*    *..\    .\...*.  . @.*.\ *. \..... .. . ..!\.*.\   ... ... #
# .\ @ ..\.** *  ***\.  .* * .**\* *! .\ ...\ ...*..\*\*\.  \ ..\.\\.  .*.\.*  .   . ..\ ** .\..*.** ..  \ * *. .\ .*... *....*   .*#
# *.\. \.  \. . .*...* @*\* *.*\.. . \\* .\\*\ ***.* ...*\.*  .. .\..*.5.\.\ ** *\ *.  .**.. .\.\ *   ..\. *.\.\ .\  .*\ .\***.****.#
#  ..*\.  *   ..\. \ .  ...*.  * *   \ * .*  *..*.\.  *\* .**\ .. * \.*.  ..** **   .  .**\ . ....* .**....\   .**.*. ..*. *.*\..*\*#
# \ *. .\ . . * *  *.  *\* ...***.**....**\.*  *..** *. .\.*..\. .*.  *\ *.*. \***.* .***.. . \  *.\  .*. .** .\* ..**\.* ***\. \.**#
#*. .   **..  \\ . *.\...*.*...\*\.*.\. ****.* .*  .*.\.\*\* \*\..*... *....*\. .*\ \.. .* *  ...!**. .  *.... ** .**** .  .\..\.*\ #
#..\*\..  **   *.  .\.\.*** . . .. .\ ...... .  * *...***. . \....*.**\  .\.*.*\ . * ....  * ** .* .  *  .*\*\ .\ ....*  .. *.\.\..\#
#**.*.\* .*.  \.. *  \..*.*.\.* ... ..*.  *\ ..   . * ... * .* ...! *.  \ .  .* .\.. \ \.  .*.. . .  ** . * .  . \*\* * . ...\. . .*#
# * ..*....  .. \W\\...*..*.  \ .*    @*\  .*.. ..  . .* *. . **.\..* \\ ..\\  * . .\. .  .*. *...   *. .*\.\ . \ ... ..  .. * ..\ !#
#.*.\ *..*. .   ........ \.*\*.* *.. ..  . *..* .. . . .\.*  \.**. .......* * \. .  *. **.\. *.   ....  *.. .*.*.**. **\ .**..   ..*#
#\*..\..\.**. \. \   ..* ...** ..*.\.\.. *.*.* .\\.  .\  **.. .*. *!\**.\\..**\*. ..*...\.\.*.. * \* ...*.\ \.*. ... .**  .  # .# .##
#**\ *.*. . . . *.\ **.\\.\..\ ! *. *.\*** .*. *\ ..  *..*.**   \  *\.* * \*\*@.  * * .\*  ..*. .  \**\*\.  .*\*.*** .*..\ \ ##\## *#
#\  ..*..* .\  . \ ......\ *\*. .*..\**..W.*.. . \*  ..* ....\\*.  ***..@....\*.\. \.  .\  *...*.* .*.*...*..**..*..  @*\. L#  #  ###
# *.\*.*\* . *.\\. .   .@*.. *\  .. ..\*\*..\* @*.*..\.. \  .*** .\ .**.*..\ .**.\. .\.\!\ .\**..*.. .\. *.*.\.  \*. #. # \*#       #
##. ** **   *. .  ** .\..*.  .    .**...* .\ * .* ..\     *   .\....\*.*.* .\*....\** .*..**    *  .. \**...*. .!#*.##.*####        #
#**.*. *    \*.\.\ *\*  .* . \*.*. *.@*.  . \.  . **.  ..*... \. ..\...  .\ *.* \ \.\ .*....** ..*\.*\*.*\ \..\\  . *###            #
#.. .* \ \. ..  *..  * *\.\*.. \.**\ * *\. \....  \.  * .**....   *. *\* .  .*  .\ \.. .*** \.#.....\ \\*.. ..* .   #               #
# . *. ...*... ***   \ *.. .. .....* ..* *. \*.. .*.  *   . *.  .. . . .  .   **\. .*\.*\*.*  ...** .**!**..* \ *.#*#               #
# *..   \\*\  . . \ \. .*  **\  ..* . ..  ....*.!.*\ .. *. \\.*  \ . * . *.. .*\.   . !\.\.*.* \..*.*.  .\ . *.*.*##                #
# . \ *..\. ...  \.*..\. *\..*.\.. ...**  . . *\.\ .    *\  .* *.**..* ... \.  ..***\..*\    * . *\*..*...#\.\**#\#                 #
# # .  *** @*  @  ..\ *  ..*. *\.\*.* ..   *.\ *  .** * ..*\ \ .. *..* ***@.*\.\ .*.. *.. \. .\*.\\.. . \.\ ..**##                  #
#**.*. ..* ..\ . . \..\.\ \.. .. .\ .*\.  *.. *...****....*\. . \ .*..\.....\*\ . .**...\  * *.  ** \# * \ . .#\#                   #
##\#.*.\.   .. W. \ ..* * .*\  .  !   .   \ *\. .\..**..* ....*   ..*\**.  ... * ..*\. \...*\.. .! *.. ......###                    #
# #*..*..\**.*..\. .**\.!\.**   .*  \.*\. .\..* *   .\. ..* *\. . * * .\.*.**. * *\.* ..\ **#* *#* *.*#*\\.\*\.\#                   #
#  ### *.*.. *.\..  \ !.\.*. *.. .  **.* .\@  ..@\ \. *\\.  ..  . . ** *..@\**\...* . **#.*...\#*  .*\*\*.*#####                    #
#     ##** **\...  ..  \.*. .*.   \ *\ *  ..  \ *.\  \.\.*  . ..\.**\.\ \#..!..*..\   .**..*#..##** . *..\.\#                       #
#      #** .*... !.  .#.*# # #*  ..*. ... ..* . *\**  @ \  . \ \*..\ *. *. \\.!**.* ** ..\*\.\  *.*#\ #... \#                       #
#      #\* .. *\ * *.##*#* .\\ \.. *.* ..!*  \ . *.*. ...**. .@.\.  .** .*\ . .\.\* * \.@..##*\ *  #**\ #\*#                        #
#      # .. .*. *####  # # #.\# **.\.*\\. .\...   *@ *   !*.***\**.*\\*.. ..  ..\   *.#*\*...!##*. **#.##.#                         #
#       #\\  ..#*.#       ##.# # . ....#..\.! *\\.#..# .. ..**...*\. .*...\.*  \ \..* .\.#####  ## .#. .#\ #                        #
#      ###.\.** **.#        # # *  *\. . **  ....\* \ .  .\ *!* *..*.*.\     ...\. \. . *#        #\ ##.###                         #
#     #*.\  .####* .#          ##.***..\.\\.* \ *. ..*.#\\\.***.*. .\ .**.\ *** * .. #*.#          #.# #                            #
#      #\ # .\#  # #            #.#..\** .. . #\.. \##.  *.* .\  ...* *. **.@*  .*.*.*.*.#          #                               #
#       ##\  #   # \#          #** #**..***.*# #.##..##  .\*. .! . *. ...\....  \...*. ***#                                         #
#        # # #    ##            #\*...# *#. *#  # #\# #\.. *.@  .***.  . \* * \..# *. *###                                          #
#         ## #                   ##.. .. # \ #     #  #* \ ** *\* ..*.**.*. .#.\ . \  .#                                            #
#           #                      #  . ##\.##       ##* #*.. ..\. .. **.\* *\. .#.#..#.#                                           #
#                                  #\.\*\#. *\#     #\*\  ..# # *. **... #. #.#*.### .\.#                                           #
#                                 #  *..* .###       ##.#*##* * \. .*.\ #\ # .#. #  ### #                                           #
#                                 #.## #*. #           # .# *\ *.** #..*#* #*#..##    #\#                                           #
#                                  # #.###.#            #*###.##.*** . .##\#*#*\**#    #                                            #
#                                    #.#  #              #   #  ###\*.. \## # ###*#                                                 #
#                                     #                           #\  ###        #                                                  #
#                                                                  # #                                                              #
#                                                                  # #                                                              #
#                                                                  #\#                                                              #
#####################################################################################################################################

Water 2
Flooding 6
Waterproof 15
Razors 7
Growth 38
Trampoline A targets 5
Trampoline C targets 2
Trampoline B targets 7
Trampoline E targets 7
Trampoline D targets 6
Trampoline F targets 6