########################################################################################################
#     .**\.. . ..* . \ *  \..*.. *. ** .* *** * *.  *\. ..\.\\\ *..  .  \ . ..\ **.*. *. .*. #.*# ####L#
#..\.* **.\. ....*\ .  ..* *.\  ..  **..\ ...\* . .*. .* .*\.\  *\. **..!. .* ..\ .. .. #.. .  *\#  .*!#
#.*.*...*.*    *\.... ..\ *. .*.. . \ .*. .\**.  *  \... .\***. ...*. ....  . * .*.*    .*    **..*\ *##
# \..\ \.\  ... \* .! \ . \..   \..\.\..\. .\*. *\ ...**\ *...** \* ..  . .\ ..\\@..  *   *\**..* * ## #
# .\.*. ...* . * . .\ * *\.*..*\.* **.   ..**.*.@  .\ .*..  .*.. ....  .\. .\*  *..*.*..*.**... *.\..# #
#\ ..\. \ .*  .* ..  . * ..W  @. .\ ..*.  \..*..*   *. .** .  .*..*\...*.\.\ \\..\@\  .*.*.. .* .#.**# #
#   ..  ** . ..   @.*\.. \   **.\ .  * *... \** .\... . \.*\  .\ **. W*. .\ ..*....  \..*.\.* . *\ .#  #
#\. .   ***\*  *.\.*. .*\ .\*..  * **.*\* \ ..* \..  *..*\..\.. .\ .*!*. ***.\. ..\. **. \  .#.#  #*#  #
# \.*.. *.*   .. * .* \* .**...\*\.\*\.** .  .\ . *\\\. *....   .!..*.. . . *. .*..* \.....**.\. ###   #
#\.**...\*..** \** .*. **R*.*..*.*  . \*\*\*.\..*\*.*... *\...*\*....\\* *  \ . ....   \ \.\ \.\ *.\#  #
########################################################################################################

Water 0
Flooding 0
Waterproof 4
Razors 6
Growth 32
