###################################################
#                                     #.#         #
#                      #              #.L   #     #
#                     #@#            #. \###*#    #
#                    #\.##      ## ## ..* *#.\##  #
#                     #* \#    #.*#** *.*\**\.#.###
#                   ## . ####  #...## #.. \* .\  *#
#              #####*## .#*. ##*. *\*#  ***.#\*.\##
#             #.*.\\.*.  . #*#\\. \ \   *\.. *\ #.#
#            ##**D#*\#**.*...#   . ...* . *  .***\#
#           #.**\.....#..*#. #..#*. ...*\ .. \.*  #
#            #.* \. . .\!#\*.. \*..\ \..*..\  *..*#
#             ##.  \..\.#.#. \  .. * . ... .\.\\*.#
#             ##.#. * ..!*!*..* .. \.. .*.* .. ..\#
#            #   ....  R.. * *\. **.. * * .     . #
#           ## \  .\\**. **  *.\..* . *... **..*..#
#          #..* *.. *.\.*...*.. ....  !* *\.. .!#.#
#   #     ## ..* *\.\ .   . \.!. *\..**. * *.\!.*.#
#  #.#   #\. . \.*.**\...* .. . \.  *...\ . \*. .\#
# #* #   #.*.*. \\.\.* . .#..*. *.  .. ... ....*..#
##.* *# #\..**\ . \.*   *...   *\*. *. **\  .. *..#
#**\ ###. *.*.!   \ . **  \    .  .*\**. .*   *. \#
#.. *\...\...\ .. ...... * ..**. .*...*.\. . .**\.#
#\*.. *  . . .*  . \ . ...\.*\\E\ \.\*   ..** . . #
#*.*. . ..* .*\*.. .. ** .!***.*. .....\ .@.\  *.\#
#*#**\*.  ..\....* *. . .  ... \...  \ *\.\.\* * .#
## \\ \. .*. **.*. . . @*. *.\ .*\. * .\.** ...***#
# *. * ** \* .. *\*. ...** *3*. ..  ..\.*..  . ..*#
##*\ # ** ***\.*.*.*.*. **C  . . *\.... *. . **.*.#
#\.. .*\.\.*.... * ...\ ......\  . * **.. .  .\.. #
#.\.  * ..\. \.* ..  \.*  *  *. .  .*.. ..B.* **. #
#.#\* . .... ...\**\*.*. .\**.  * **.\ ..  W. ....#
# # . .*. . .*.\ ..**.*.\  .. . .*.   .*. .**  \  #
#.  **..*.*. .**.*\ .\*......* .\*.. . .G**.*\  .*#
# .*.* . *. *... \......\  . . .*.*\ \ ***\ \*.  .#
#.\.\.*.A \...    *\ .   \ **W\.*\.   . **\  .*  *#
#..* \ .\. *\.....   .  **. .\. .*\  . ..**.. .  !#
#\*.\.. ..    .\. *..*. **   . .    *.  .*. .*...*#
# ..\  *.  .\ \ * \.. .*... .* *\.  . \W.**.*.  *.#
## * . .**....  \* .\. \ . ... .\\.! . .*.*..* .  #
#.\.   . .\  @.*.* * **. ** .** ** *\ .**.*.**\.*.#
#\.  *..\*.. *\ **\..\ . \2 *. 1\.\  .!.*\..*\..\!#
#.***.  *.  .\*\ \..   * !\. *  *\**@..** \ . ..  #
# ****.\..\ .. .   .   **  *..  .F...**. \.*  *\ .#
# *.*.. * ... .  * ..\\\.*\.* .\ \  .*.**.\* ...* #
#. *.* *.  ** .. .\   . \..*. .  ..\..\ *    * \* #
#. * * *\\...** ..***.....@** . *     . .\  ......#
#. ....*\ .\...   \..  *\.\\.\*.*\\.*... .\  \**\.#
# *.**....* .\* . .**. .*.*\.*.\..*......*.\* !\**#
#*\..\  ..*.\*\.   .\.  *... .*. . *. *\.. .. .. *#
#. .\ ...*. .** .\*.. \.W   *\..*. .     .\  \. .*#
#*\ .\ . \   *.  \.\**. *. \..\..*\ . .\ **.\.\  .#
#*  *.*. . .\ .\* *..**\.\*.*  \*.*.*.  \\..* ..*.#
#.*.. *. ....**.. ***.** *... .\..\*.. *.*... *\*.#
##.@\ **     ***...**...\.\ ...**. .*... . \*.* .\#
#**\.*.*.. *.. . !...\.\ * \.\ .**. .     ..**.\.\#
#*....  ..\ ..   ** * \ .. . ..\*\. \.**\..*..\ \*#
##\. ****.\. . *.** .*.\*!..*  ......* .*** . *.. #
#...\*\\.*  \\*. @*\ .\ ..\*\*.\.\ . ...**... **  #
##\. \..\.  .   *.\. *  \  *. \  . ...***.\ *....\#
#*#\...    *..  *!*\.**.. *. *...*..\.\* *@  .. **#
# #* . .  .@* ..... \*......   *.* . \. ..*  \ ...#
#*.\   \  .*. \. *** ..   **  .*.**\*.\..*..\.  6 #
#\ **\\#*W.\* .\*. *\**..\*@..*** .*.\ .*  \   .\.#
###################################################

Water 0
Flooding 0
Waterproof 3
Razors 18
Growth 27
Trampoline A targets 6
Trampoline C targets 2
Trampoline B targets 2
Trampoline E targets 1
Trampoline D targets 2
Trampoline G targets 3
Trampoline F targets 6