#################################################################
#****    *... *.*... .\*\.. ..**..* ** .\* .*.. .. L##  #       #
# * . .\.*!\ \  . !\*..**.*  .*W... .***.\ \* * \   ..\.#       #
#\..\ *. @.*..**\ \*.\ .\. *. .. .** *..*..****. \*. *# #       #
#. *.**\**. * *. \..*** . .\ .* *\..\.*\. *.*\ .***  *##        #
#**.\*. ..\@.\.**....\*    *\ ..** \. * .*.*..\.\..*..# #       #
#* \...*  * *..*.*.* **\\\.\.* * \..\ .**.*!  . *.  . .*#       #
#.. *.\. *\ .. * * *\.. .*. ..*.\\ .    **  \.. .     \.\#      #
# * ..*.*. * .** *\..   \!   ..   \  . **... * \**\\*..##       #
#! ...\*.\* **...*.    *.\.. \W**.\* *  .\.\ . .*\. .# #        #
#.\ * .\**...\ .  \*  *  .\. . .**!..... ..*\! .  .\ *#         #
# .*\   ..   *   * . *.*. ...* \\.. *\   . .*!\   \ ..###       #
#  ...*  \ .*.\.\. *\*... **\..* .\.\   \   .*..* #* *#.*#      #
#\ .\. ...     . W*\ .    *.*..\**. . .*@ .   \ . \. \. .#      #
#*.*. .*.\   *\.\\.... \.** ..* .. *. *.\ \ # .***.  .*.*###    #
#\*  **\ ......\* .\**\.  . ..*  \\. \*   \**\ . ..*\.**##. ##  #
#  . *\ .\. \*\.*  *.\*.....  ..*.* ...  \ \ ... . .#*#*  *\*.# #
#\*\.. \ **\. .. * \* *\* .* .. .\. . . ....***..\.\ . .*\..#.# #
#* **\.....W.\*.** .. .... ....*\...\ . .*\\ .\*\.@. \. #*\\*#  #
#...\**\ \  \....*\  \.*.** *. \* .\ **.*..\   .* .. .#.\. .#   #
#*  ***.\..\. ***\\    *\ * . *** .   . .. .***\\  \*..*  ##    #
#\.*\..*  * * ....  *.    .  ..*.  ** *..* **.**  *.. *..#      #
# .\ *...*. *\*.\**\*** *.** *W. \ *.\.* .  .***\.*...**\## #   #
#.*. * \* ..*.\ . *.*.*\.. *\* * . \*.*\  *. .**\ * * .\**.#.#  #
#. *.\ ...  .* .\***.*...*\....  **..* * \... ...   ****..\ .*# #
#*.*\...    *.\.*...*. .**. *..\.*. .**.@\.. **\ *. \ \..***..# #
#\.* . .  ..* .*..* .\  ..\ *. .  .* . .  * **\ *.\... * ..*\*###
# ..\. .    .  *\*.  . ...  .*W . *. ** *...*..*@ **...* **\*#..#
# * *\   . .. .. .. * . ..W..\ .****\ . \. .\\..**@\\.\.  \.*.\##
#*.  ..** ..\\*   * ... .  .\. . \*.. .*. . .*.\... .*  . .\..# #
#\**. .. . \.\. * \  *\*.\**.\** ..*. ......*. .\  \.. \. *. \# #
#*..\ ... *.** ..\ .... .... .    ....*....\.**.* .* .\ * *  #  #
#...*\.  ..*. * .*  \*   .* **\**\  .*\.\. *\\..\.*\#\...#\.*#  #
#\*.\ . .\ .. ..*W* *.\ **.*..  *.\ .\* .*.\ .. .W#**  \ #.\#   #
#.**..*\*  *  \..\..\. ....*\  *..*   ..*. \.*W.*\.\.   .#####  #
#.\. .\*  * .**  ....** .  ..* \. ..\.**.*\.\.*.*.*...*   \   # #
#R\*.*@*.  \ \.\ . *\ .. .*. \.\.*.*. * .\ *. ...*.  \.**..  #  #
#.*.. *...*. . ...... *.** *  ****. *\... *\.\ **. . ***.*.  *# #
#..\ *.\*.*.\.\* *.  *\ . ..\..*..\*. *\*\\*. ...* \ .  *.. .**##
#  . .  ..*.**.*\.\* ..!\  ..  **. .\ ..\.\.\. \*.\#\!*\\\  ##\##
#.\ *.. ...\..\*. \\* \..**. .*. ..*. *..** . ..*\.* \.*.*#*.## #
#\.. .\.  \. ..\.....*.\  .*\ . .\ ..\.* *.\ ...! .*\. \.*##.\*##
#*.\*..**..* * .***  . ..\\.\**  *. * .. . *\ *.. #**\  #* # #*##
#.\**\*..\ *. ..*..@**. * *\. *...*..\ ..  \**. .\*. * ...\*# # #
#* ***.**.\*  ...  .\..\.\*...*\.\.\ ..  \ ..* \.... \ * . #    #
#..** ..*\!*** * .\  *   . *\*..\.**\@  .... *. ..\*  ** ##     #
#*\...\ .. . **.!*. .\ \.*.. ... .**....\..  .\** *\ .!*.*#     #
#**.. *   \* ....*.*.** \.\ \.. \..  \ *\ * *.   .\.  #**#      #
#.   .\ .\.\*  \ *  ....  .*\ ...*.   \**** .** .**.. .*#       #
#*.**..  **  \.  ..*\. .\ .*..\..\*.\ . ........#** *.##        #
#*.*. .\ \* .*.   \*\.\ .   .\.* ..\*\     * . \* .#*#          #
#\.*..*** .\..  \.*.*\**.. * .**\.  . .. .*. **.. *#.#          #
#\*.  \ * *.*.\ .*. ..*.!  \.*\.*  *   . ..  \#*##.\*#          #
# *  *.*\..*\*. ** ..\@* ! ...*.\. . .*\ .\ * \  *#.#           #
#\.  *... *\.. \ . .**\ . .*  \  *. ...  \.*.** \.*#            #
#.*. \. ....\ ..... ....* ****.  *.  *\*..**.\\* \#             #
#\. ...\*.* . .\.  .  ***.* .. \ \.**...\ .*.#\###              #
#. !W.* .\*\*  . \ *.\... *\....\.. .!..# \*.  #                #
#..*\ ** *. \@.\ ..*.  .*.**\  **  . \ . ...\.#                 #
#.*. .*\*  .  ..* **..\.  * *..*.\*. ..*..# ##                  #
# .**. *.. .\\ \  *\ *.. \* *.\. . * \..\.. #                   #
#################################################################

Water 0
Flooding 0
Waterproof 8
Razors 10
Growth 16
