###########################################################
#..*\.\  *..\  .\ .*****. *.\ *.\*\\..\ ...* .\\\* ..*..* #
#.\**  *  . *.. *  .* *.*. .* \\....\*   . .* *..*\.\*. * #
#.\.  \. .\.\*  *\**. ..\*\ .\.. .. *.. .    \.*.**.*.*.* #
# .\.. *\*!. *. ..** *!**  .\. .*\   .  .\*  ..**\*.*.*.\*#
#* .   \..* ...   ...* *.\..*. .* *\.. .\ .\  **... .\**..#
#. ** .   *..*.\. * **\.*  *. **W \  .* .  .. . **\.\.\.  #
#  ..  ..\* *.*. *\**..*....  *  .. * *.\ *......\ ..*. *\#
# .* **\  . \ .  ..\..\**  . ***  ....... *\**\\ . .  *.**#
#!\.\..***.***.   * . *\**  *\*. ** \\***  **\. . ** .*..\#
#.* *  .\ .*..* \..\..*. .  * ...  \*\..** .*\.   *. .**\ #
#.\** **\*..\.. ..\.  . *. *\. . .. .* ...  . . **!* *..*.#
# .* \...*\ *.. .\.*  ..*\ .* .*.*.**.\*\ ***.. ..*****.\.#
# .. * *\  ..**\**.* . *..**.\..*  .\\*. .\*..*   ..\.* ..#
#\***.  **\\ .\**\.\   . .*\* . .* \.*.. \ ....@..\ .*. ..#
#..*.. \.\.. . \... ...\@..*. \. .\ . . . \ .*.  **  .* .\#
#! .* ..\ ..*  .\\  *\\..   **.**@ .. \@*.  .\*..**\.*.*\ #
#\  . . * *..*\*.*  ... \ .*.... *\.  ..**. . ..\ **..\ ..#
#. *  ..\*** .*. .  .\ *\ \. !\. *.\.\ *.    **  *.**.*.  #
# \..*.**.\.. \\*..\* ..*. *\* * \ . . .  *.*\.. . *\...* #
# .* ...  .\.*!.* \ * .*. ..*. .*.* *..* ..**.*.\.*.....*\#
#*\..*..  .. .  \*.*.\.*..*   * . .\.* *\.. **.*...    *.\#
# .. . *\ ** *.... \.  .. * .!.. \ ..* \ *  *.\...\  . .  #
#\**.  *. * \ *...*.\..   .  *. . *. *.. .\*. **  . . \***#
#\*.. .  \.  *.\* .  \.\ . .\..*\\\ ** \.\*...*  .... .** #
#..*. .*  *\ .. * . . .* * * \\.*\.\.. .... **. \ \.*@... #
#\.*.\\.. ..**\. ...\ \   *...   **.*..*  *.* **.*..*\*\  #
#  *.   .\  ..*..** \\.* .*.* \.. \*.\..  *.**...  ..* .\.#
#  .\.. *  ..\ .*..  . .*.*..*!.*\ .\  *  . *! . .\.. ...*#
#...*.\*.*.  *  ... **.\..... ..* .*.  ..  .\\ *  **\    .#
#.\ .....* *\*.\.*  *.*@****.. .*.*.*.*\  \. .*  . !..@* *#
# * .    \ * .\..\.\\.**.*. .  ......*\!.   *\*   \   .. *#
#*\\... *. * \.  ** **\.*...  *\*.\  *.\\..\* ..   *  ....#
#*.  .. \ *.     !...\* *.\  ..**.*. \\\\.\.. \**... . .. #
#\    * ..*   . *..\ *. . ..  \.**\ ..*. .*...\\. \.***.. #
# ..@. . .*  \...*\*.. *.\* .* \.. *.\ *...*  *.... \ *.\.#
# *\**\  ..*.. . *.*..\. ... .. .\ ... *.*...\**. *..\..*.#
# ..@..** ..!\   ..*.   . \ . \.*.** \..!..*...* .. .*.\..#
#* .*...* \ **..  ..  **.  *. .** \..\ *.*..  *.*.*  .  ..#
#.  *..*\...*.\ .  **.*.\ . \ ..@  * * .@..\ *.*.*.  . *.\#
#\ ..**.*.... * ....*..\.. .*.  **.** . .*. .\.. **......*#
#\  \.*.\.  *\ *.\ .*. *.\*..\*.\* *.*\..**\  * *...\*  \*#
#\ .  .\.\R.\.*\  \... * ..\ ..*...*\..\..\*\ \*** .\** * #
#* .  *.**. * ..* ..\*.*. \*W .* .*..* *.\*.. \ .. .** .**#
#... \.**.* ....*\. !\ \....\. . .**..   ***.*..* . .*.  *#
# .\* ..\*.* *.\.*.   \  * .. * . .\ * .**..** \.\**..* .*#
# . .   .*.\ *   .. .*.*\..\.* . .*  ***..*\.\*.. *\.!\ ..#
#\*   \  *  .* *.*.. .\..\ *.....**..... \. ..*\* * * * ..#
#*\\.*.  . \ . .  .\* *\   .. \  ..  ** ..*  .. .*.*\*.**\#
#. *\ *...*.*. *.*..\ ..*\ *  .\.*!. ..\  .  \***. ...  *.#
#.  . .\***\. .....*!*  *. \\.  ***.. **.*.**\. ** ***.*. #
# . .   \ \*  .\*.\ ..\ *.\.*\..*. .  . *..\..* \..*...\  #
#\* . .\.@..\* * \. .*.  \.....* .. *\**\ \  *\@ \... \*  #
#. .*\.*.*W.*.*\ \     * ..\*  .\.**\...  . .... .*  *.*  #
#. *.. *.**@ ..*. ..\ \.\ .... *.*.*\*  * ..**.***. *... .#
#\*.*.@\W\.* .*....\*... ..**.....  \*..* ..*.\. ... ..* .#
#**\.. . . **.*\.\ .*.\..\. *** .\ *.  ..  \**..\\ . ..*.*#
#\!. ..*  ..*.*  . .** * . *!\. *.*.***\ . \..\*. \..**.*.#
#* .* . \ \ \ . .\*. . .* **. *\.*.@.*.  * ..* . ... .**\ #
#.   *\.\.. .\\.  \*\ . .... *.* ..\ .\ \** @... .*  ***  #
# . \. ..*.. .. *\..\@   * *\..*..*.   ....@\*  *.* *.*..*#
#* *. \ ..*\   .*.*.*..\.*\*.@.* .*\@*@   \*\.\...  .*.\..#
#* .*.. **.\   . *. *  **..  *\\.\*.*\\***.. \.. \.\ .* .\#
#*\.\  .\* *.... .\.\**.. ..  ..* \ .*.....\*..\   \* !*. #
#*** **... . . .. . ....  \ .\.. \.. *\ . \ \*.......   **#
#*.. *.\! *   *** .\  ..\. *.** .!\* . ** .* * \ *. \. \\ #
#**.**    *\ \. .\\.. .   .. \  *\*...\*** . . .\....\. *\#
#.. \.\ . *.. * ..*... *\.   \.***. **\.*\*  *. *\** . *. #
#.  .  .  ***.*\ ..\*.*.   \    *.\.\\. *  . . \\.*\..*. .#
#\   .*.\..*..*. **\.\...... @* \.    \**\ * \ .. *@.\*.*.#
#.  *...  **. \**\....*  *   .\**. .  \.. .\ *.\....... *\#
#*** .  .  .   *\.*. *\* .*\*.*..\  ... * \........*. \.* #
#*..@* \**\\   \ .*\.. .. ....\. . * *.\  !\.  .***.... .*#
#.\*. **..*.* *.*... \ ...*\  ***. . !..*. . \. . .****** #
#\ .**.. . \\  *.. \* . **\**.\... *\*. ** \   . * ..\.* .#
#   ..** .\\..** ....  \**.\.\      .\. *.    ... . ..**..#
# ..  .@ *W.  *. *\\ .\ ..*... . * **.\.*.  . . .*.  ....\#
#*    .\ .!*\.. *. .. ..\ . *.. \  \.* . . * * .*.*  .\.\*#
#. **\..****.\ \.*.*.***.*\ .  *.@. .**...\  .*.@ . .*\.  #
#.\..*  .  \ *.. .. \..*\***. .\.* \...*..*\\\... !  ..\  #
#** \*\*\ *.*\  .  *..*..*.\.* . .. *\*. .*. \*.*\.* ..*  #
#..\.*.*... ..  \..\   ..*.\ * \   .. @ *. .\ *\.** . .*  #
#  ..* .* .. *. .\*.\....*.* .*... \..*..*  **.....\* *.\\#
#..... *.\ * ..  .... **\..* \.  \*....  . ...*. **.\\.\..#
# .\*\*\  .. \*  *.  *  *\.\* *. .\..  .* . . .**.\ .\\. *#
#. *. \. \.\.. .\ . \.**..\ .*..!\ *.** *\ \   \*  * .  .*#
#*..* . *.\  . .. *.. *..*  \\   **\..\. ..* * .** *. *\..#
#. .\.* .  ***.*. . . .  ** . .* .. ** \*\ . \. .\\.**.  \#
#. .. . .\..*.\\.*\*   **.\  * **...\  .***\. * **.**\... #
#*\\** .** .\*.***.. ****    . .. .  .*..\*  \. .* .**.*..#
#*.*... . \ .!...*   *\*\*\.  .  \*. *.    \.  **.*\.\ ..\#
# ..*\\..*.   @\.   **.\*   .   . . \*.\ \*.\.\.\.\@**...*#
#  \...\.*** **  \. .*..* . .\.    *  ....**..***....* ...#
#\ ..\.*.....*.*W *    *\***.*  *. **.*.  .. **..  W *  *.#
#.\ ..\\ \ \* .* *. \ ... *\*.* \* \** \ . *\..* .*  *!**.#
#  ... .\. *.\ . ....\ .* **..\\.   \*\ *. ..**  *\*....*\#
#. * .*.*.....\\* ...   . \.**..*.  @.  **..  .   .**\@\@.#
#... *..*****\..\....  \\ .. *.\ .  .* . . . *\ .*. . .!..#
#.*  * ***\*.** ..*.  \ *\*.*..* * . \*..\**.*.  .*  *  .!#
#.* *. * \.... ***..\.* \..  *\*.\..* . . ..\W\  .\.\ \!* #
# .\... ...  \*.....\\. . **...  *.\*\.  .\ . . .\...\ ..\#
#*   ...  *  .... *.  .  \.*  \.*..** ..*\*.!\ .\*\.\.   \#
#\**. *..*.*.* .*...   .*W*** .*.\..  .*. .*\..\ . * ..*.\#
#*.\  \... .**\.. . **.\. . ..*..*.*\\. *  * .\. ..\ \ . *#
#\. * .  \..*.   * *\.. **  .\...  *  .\*    *.\*.\..\**.*#
#*  .\ . . . *\* *. *** .. .    ..@.*.... * \.. *.\ ...\ .#
#. \ ***..**...*.. .\.. *..\ \.**...\ \  *. .* * ....*\** #
#\\. *..*\... *. . .* *.  .   ... *\. ** . ... . **. . ..!#
# .. ***\. . \..   ..*. \ ..\.\   ..  .. \ ** *  \.*\* \.\#
#. ..... .. \ *.*.\ ... .***.*!\.*...*\ .. ..*   . *\*. . #
#.\  *.* . ....** . . ......* *.**..\*.  *. ..  . .\.*... #
#*  \.  *  .*.**. *.   .*. \.\\.**..**\....  ..\  * \.. *.#
#\\..**** *  *..* ..**.\** ....**. ..** . *.*  . *.\ .....#
#\ **. .  *\. \..\ *... .*\. .*.\.*........\..*.\.\*..  *.#
#.***\** . * .**. *.  ..* ..  .@*... *.. *\. ..  **..*\ ..#
#\. . .*\ *. ..* .* .*\  ....**.. ...\ .*..\.**\*\......*\#
#**.*\...*. *. \.\**...... .\.. ...** **.  ***.\.   *.\*..#
# .*....*** *..\.\*  *.* @.*.  .*....\... ...\.  .**\ ..**#
# .. . .**...  ....**\** *\  ...\.*\..*.*  .\*..\*..*\*...#
#\ *   .... . * .!** *..*.. ..\\*..*. .** \***.\  ***\* . #
#..\  . \. * ** \.*.\..\..*. .*.\*..** ..\...\\ .... .\ *.#
# . *.**\.  . ....\**\..  *.\..*.*\ \.  .. * \\.\.\*   ...#
#.\.\. . . . \  \**\*  \   *..*****\.\ * *\  .* .. \ ..  .#
#** ..\ ** * . *.\.*. *.**\.....\ \!.... *. *\..\ *.\.*\ *#
#\..\   ..*..***   .*.* .*.*\*.. .. .\.  *.! .* .****\ . .#
#..*..*. \* .\.\. . ***. .\... \... .* .* ..\***..\.\*\.  #
#\ .\ ..*.*.**..  ..*...\ .\.  .*.   . ...  *..*\\.. \ **\#
#!.*    *..\ *.\ ..\    .!\ **\ ..*\**.*.. \..*..    .....#
#.\... ..  * **.* **** ...*..\  *.* ..  . . .\*\.\*\  **. #
#\ .*.  \ ..**. ***...**.... ** *.**   .\...  **\.*\.\!\  #
#*\*.  ..\ **... \*\. .@*.\. ****...  ..* \ .*.\* *.  ... #
#...* .*.!*.\ *\.... *. . \.**. .\.*. .\!.. *.**. \. ...* #
#.\...  \ \ ..**. \* .*\ ..*.\*. *.. .\* **.**\. *.** ***##
#\.  *. *    \**\...  . . *\*..*. .. *..*\.\.#   ..*\.*.**#
#\\  .**. \. \.* \.*..\.  **.  *...*.**\.*..\. .\**  *...##
#\.   . ... ..*. **. \ **.***  .* .. \*.@..  ...*#..\*\#*\#
#.  ** ..*\\ *.\ \.*.....**.   \  \.  **.* \* *.#.**..*..*#
# *...** ...\* . . ..    *.  . ... .\ \*..*#....* . .*\\\*#
#*. .**.  \ ** .\..   .*..*\*. *.\  .\.**#####.\# .\*. *.*#
#. ..**\.*. ... . ..\*..W\**. *.  .* W\.. . # ## ###*. .*\#
#. .*. . .*.  *.  \ *.  * * * * *..* ..\.#. \#      # *.\ #
#.**. ..\ .. .*..*. . **\ .#W*\ *\. .\* *##\#        ######
#* ... W . ..*.**.. * .@..* *.#\#..*##*\ .\#              #
#. .\**\ *.*.. ..\.**\.\. \ . !**\\**##** .#              #
#\. ...* \ .. .  . .* . !\.\. ...* #..##*# #              #
# *.\*....*  .    **. .*.*\*  .#.*##*#  # #               #
# .**..*.*..*\... .*  ..*\.\ #*###  #                     #
#\ ...\.*..* *  * .\... .!\*\##                           #
#* . ....  .**.*..\*...*  *##                             #
#.\*\    *....\*\***\. *.\*#                              #
#..#. *...****..*..*# .**.#                               #
###*.\. * .*...***..# .###                                #
# #   *..  ..*.\.#*.**#                                   #
##*.\ \.   ..*.*\\.#.\*#                                  #
## ... ..**  \ # . . *#                                   #
##....  \..\. * * ...#                                    #
# ###L.*# .   *\.*.##                                     #
#   #\ *#\. *.**..\W#                                     #
#    # . #### .*#\.**#                                    #
#   #   #    #@# # #*#                                    #
#    ##*#     #  # ##                                     #
#     #.#         #                                       #
###########################################################

Water 0
Flooding 0
Waterproof 15
Razors 27
Growth 18
