####################
#     #\*.# *** .. #
#  ###*. \  ..**.\ #
### . .\. *.\.**.* #
#.    ****.** . **\#
####*\*. .*..\ ..*.#
# ##.*. *..* *** .*#
## *.\* .  . ...  .#
# #**\.. *. .*\\ *\#
# #*.... *.R*   \\*#
#  # .  ...\\..\ ..#
# #***. .*.#. # .. #
#  #.*#  .* ....\. #
#  #\##L*.#  .... ##
#   #\ *\ ###\... ##
####################