######################################################################################################################################################################################################
#..*\ \..*.*\... . .. .**.. ***..* ..\.**@. .\.*\ \..!. .  *  * .*.  \    .* ..*.*.**  \\. .\\ .***.  ..\. ... . \...\\ * .*\  \.* ..  \ ..* * *.   \...  ...*. !. * .. . .*\.  #                    #
#****.  ...**.\  .. . *.*. .\\.*\.\*.. ...\. **..* \\*. ...**  .@ . .. ..\...  .* ..*  .*..  * ..  *.* .* **.\.*.     .   \. .*     ** .\. **\.*\  @.*.      ..  . ..* .\.*#* ..#                    #
# \. *..   *...*.    *...   ** *.\. . . *** ..**** .\..\.*..\.. . . ...\ *@.. ***\..*.. . .. .\.   *..**. .\...*  . .\...*..*  .\*.. .**.* .. \* ...*\.  . .\ *\*.*\. \**.# .* #                     #
#*. \ **  *\  *. ..... W...  \...*   \. \.   \***\.\*\ .\ **. **\.@.\.. ..*.**.*.\ *.* **  \ *\... ... .. .**@**   .  . *..\*.*..*\* \.*...   . .. .. .    *.. .* .. *..  *..* #                     #
#. .     .*. *.  ** *   *\*!*.**..*..  \.*. \ **.W\ ..\\..\   *..  \..*\. .*....\* ***\.@..  * .   *\ ..\  \* *. ** *..  *.*.\. \.\ .B ...* *!.\*..  * .**\...  \ *\.** *..*.* ##                    #
#\. .  \. \ ..  ... ...* .*. ** .\*. **.... *..\   . *..  \ .\.   ..*!\ .* .*\ .*.**  *\ .*. .\*. *. .\\*. *\ \... .**\!.\ * \. \ \ .     ..*\W. ..\ !  ..*.  *.. .*..* . *.*# #*#                   #
#.\.* ....\**... @\ . .. *\*.\.****** \.*.   . *.  * *. *.   *\@.. ..... .\. . *  **  .*  .*.**.** \. .\ . *. .** \**..\....\. \*\. * .*  .  ***.\ . **.*\* *..\.\.*. .\. .*\.*#!## ##               #
# ...\ . ....*.**.*\*\.  * * ..\........\.* .. *\    \..\ . .....\. * \*.\     *.\\  \...\ *....*\ .*. ....\** \.....*. !* .  *\.  \*.. \. . \\...*. * . ***.\... ..*  *.!*\*.**\#\#..#              #
#\ \ . * \. .*... .  *.\.W*\. ***\  *.  .**..    * .*..**\*.\..   .* ....  .**.   *\  *     .\.. ..**\  . **. . ** . \@*\.   .\ .\...*  \**. ..\  \.\. ..*** ..\..**\\ .\*\..*. ..*\...#             #
#.*.. ...* *.\ ... .....**\***\***\ ..* ..* .  *  .* \ ..*.* *.. **.. @  \..*\.* .*\ * .  *.   * **.\. ***.\ .*. \ .*\.*. . . .\   \ .\. .... *.* .*   **..!\\.*.*\... . ..@ .  \.*.##\#             #
#.\ ** ..* *1* .* ..*\ \ \...\.\..*..@  .\.  . .*...  .* .*  ..\..\ ...*.\* .. * *.!\.\**.*.* .*  .***..\\\\* \.*. **...**. ..*\*\. .*....   .\ . .. .* *@\ .. ..**..*. .*   ..\  *.  * #            #
# *..* .*\..*. ..\\ *.*.\ ***  *\*.  .*.. ..W.\* .*. . *\ .\ * .*\..  .\.*...... . .*..*.** .\*.. .*.\. **!... \. **.. . *.. ..*.*A. \*\ ***.* .\*..*.\\\. .\.\* W..\. **\.*.      *.#*#             #
#\. .! .. . . \**\  ..   *....! *\ ..\...  \\  . * . .*\.* *. \*..\.**.\*. ***.\* \ .  .*..\  .     . . *.*. @\ ...* \*  . \**\.\*..... \.*.**.. *. \** ...... ..*.... W.*..\* .. ### #              #
# . .*\.  ..\..*  ....*..* *. .!.. . . \*.\.\..* * *\.\* .!.W\ \ .....*... ..*...** \ *.* *  ..\.\.. ..... .\.*.\...\*!..*..... .. .*..\.. *...\ \\ .**\*.@*.*!\ .\..*.  .*..\\*#.##                 #
#.**.\.* .. \. * ... ****\.* ...* *** \.*.  .\.. . ..  ..   * ...\*\.\.*.* *.... .\\ . .\*\  \ \ *.*.\ . *\*.\*    ..** \.\. \  * *... .*\.*.. ....\..* ...*..   ****. **.\  \..\***#                #
#*. .  .  .\.\**..*\..*.. @.  . .\!\..* *..* * *. .. *   .\ .*\ . \.* *.\*  ..  . *   *\.. .*. ..*.* *.*.* .\ ..* **. ..! *\*..*  !\...\ * *\ *  *. . .**  \.  . .\. \.**\ .... *#.# #               #
#\*.. * .\ .   *\\..  *\..\    *..*.*@.\*\ * \ *\ .... .*** .**. \.\. *.*  *\*.\. .*\.**\*. . .. ..   .*..... \...*.\ **...** **  .\.*! .. *. * .. .\\ !... \ \! **..*. ... .. * .# #*#              #
# .!*  ** * .. .\  ***..*..\ .**..\ .\*.. *.*.**.... ..*. .*\   \. .  *\.\  .. *\.*\ .**..\ .*.*. . \..*\ *\.. .W\.*..\*. *...\...*. **\***. \* *.* .. ..  ..* . ..**\ .*\* * .#.. #*.#              #
#** .\* . \*..\\  .*\.\\. * .*...*. * .........**..*\.*.\.*   .*.*\.. *   ...  *.*..\**. \.\ ..  \. .\ .*.! .  .*.*..*..  . .\.*\ ...*..*\.\* *.. . .*..\. *\*...\*..*    ! . *..*...*\#             #
#...\  .   .*..* \..\     .*.. *\.**** * .**  **.\\.* .\ \..*. \... **\ **   . * **\..* \. .  \\..**. \\. *.\.. .. **.*..  \****. .* *....*\* ..*   *** **.\..\.  ..*\. .**..\*.*.##.\ #             #
# .* . .\*..\.*. ...  . .*.. . **..... \.**. *.**. *..*. *  .\..**\.*.. .\W . \. .*. \*...\ * ...*.\.\..\ .  **\    \ *\* .*... \  *\.*.*.* .*\@.. *.... ..  ..  .. *.***.**  * .\*.*.#              #
#\ * \.\..\*  .... .* *. *. .\. .* *  . .\.\  *..*@**..  .   *  *..*..* .*  \ .*...**  ..@ . **.\ \.** \....\*....W\*..*.\ .***.. ..*.. ....\..* . ..\.\ *\ ....\**..*\*. \.*.\\..*..*#              #
#....\. **.. . *\ \ *\. . ..*. .\.\ \\. .**.\ .\.*\...*\   . .. ** \.@ W***..***. **.*.*.* \..*  ..\..\ ..\ ..\  .* \ .*..*.*\.**..\\    *..  *.. .\. ....** .\****. **.*  ..#.    **#*#             #
#*   .*. \ *\**.  @\**  **..*..*.** .*  ... ***.... ***.\.*.* . .*\ .   . *...*.*.\... .\.*. . *. \.  . * !*\. .* ... .\*...**\*.. .** ..\**  *.*\...  .*\.  ..* .* * .\.\ *\   .\..*.*#             #
#\*....  ..*.*. *.. **.\. ..**....*. \ ..@*...\ !\ * . .*..... . *.* .*!* .*. \.*.*.   .**.*\. \.*.* **.\ ...*.... \ .* .** ..  \*.*.  ..*** ..\..*...     ...\.  .. !\** .. # *..#*###              #
#!. . .. **...* **  .. *\.   . . *\ \  ...****.. ... .* *  .  .  ..  * .*  *. . .*.  \..\.*\*\*.*\ \.**. .\.*.\  \.. \.. .\.  *  ..*@.\*.....**. *. .. *. **. **. **.. \....\  **.*\#                #
# ..  .**\ \**\*.\.*\.. ... ..   ..   \ * ...\* \@*\. .*. \  *  . \. .*\*.***\.*. ..*. *\ .*..\ *.....**\ .\... ..  ..  .\ ..* *. ...***\*   .\ .*\\..*@. **\...\***\ **.\ . .\*..#.\#               #
#*\.   . .  \**. . ..\   *.  \  \. . . * *. \*.*  *\   \** \ . . \.**. @\.@.. \.* . .\.. \.* . ........ ..\ . \*..\ \..!\.. ***. \ *\..@...  @\.*..\ .... .\*.**..\ *... .\   .#.***!#               #
#*. @** .    .!. *.\.*  \.. . ...** \  ..**..@ * *** . ..*..\**.   *.*..*...\. \  \.*.***.\..\\  *\  \...**..*... . . *.   ***\\. .\** * ** .  \  ....\.\\*.*\*W*   \.\*... *  **\**\#               #
#\*...*..***\.. \*.  .\....\ . \*@.*... \. ... W .... . .*.\ .**  .* .  .** *\*...*.. ...\     ***. *..*.** ..  ..** *.***** ...  \!...\..   ....   .* .. .* .... ..  *.*** \ ..#.**\#               #
#..\. ..*\**. .*!\... ..**@@.. ..*. .  .*.. .*. ..\\. *\..*   * *. .\\ .** . .**\ *\ *..\!*  .\.@.**. . *..   \* .*.\ \ ...* \ *....*.\...\  \* ...*.. \*  *. * \. \.*\\.\ .. **. \. #               #
#..  \  . .\ . .*... ..*.*\..   \\..*.\ . ..... *.....\.\ \* *. ..*. *  ..**  .\ *.*\.  . **.** * .\*.* .\..    * *  \.**\.*.**. .*\* . .\** .. \ .\\. \.  *.\@ . * * *\\.. ..*\  .  #               #
# \ *.* *  . \   *. .  . * *\*... * \..\ ..*\ ...\* \  *.*.** .  \\ .* .\..\  .**.. *\. \.\**.*\.\ *.*.!\  ...R.. .... .\.*.!* \.\... ..* * *\  .*. .* *  .\\..   \...* . ..\*...\#\**#              #
#.  *\    *....*  \   *\ * \.*. .\*\. * ****.. *\ \. .**..\*\ * *.\. *\..\ ..  .\ \.*.*. .*.. \.  ** * .*.. * \*..**...    *.. .\ .... *.**\**...*.\*.*.\*. .*\   \ .*  \*.... *\**.##               #
#.*\*...  \*.**\ ...*. ...  ...**.. . \ . .*\.\ ..\.* *...**. . ... .......  \.  .\  \**.*** @*.*.*\.\ *.  \*.. .\..*. ..  .  . . *    .\*.**\ ***  .! *.\.\\*. * . *..*..  .\* . **#\#              #
# ...    . .* \..\*** \. .   ..\.*\  . \*   .  . . .\ .. \.*..\\**.*.*..  \ .**..\***.*. ...*..*\ ** * .* *.  ** .*\* ...\* .  ..\.\ *\. .**.*.\ ..  .. . .**.*. *. .**.  \.. ** .\#. \#             #
#\\\ *\..  ..   *.\.\..\.*.\* ....*@6  ...*.\* ..\ .. *  .*.  . *\..\* . .! .*. \ .  *.*   ..*\.* *.\*..\ .* ..* .*.. **. ..  *** . ...  *. ..**. \ .*.*  *.*\ . . * .*  .. ....  .*\\.#             #
#*.. ... *\\. ..\*.*...  . .\... *.\.!.. *.\. . ... * .  .\   ...\* *  *. .* .\@.**\.. .\.* * . .\.*.* .*.\.**.*....*.\**.. \* *** ...*  ..\. *...*. !\   * *.. \.\.@\*..  .* *  * *#*\#             #
#* *  .  * \* .*.   * ** \ ...\. .*.*@    .    @* *. .\..*..* .@ .. .\*!.\\....**..@**\*.. .* \.  \. *  .\@*....*\ **\ ..\ *.  \ . .\** . ..*\.* ..   *. *\.*\ \\ \.\* *\.. ..*   *\ #*#             #
#*    **\@. .*\.*.\.. *. *. .  .\..    *.\  *.\..\.   . *\\ .\ .\*  *.\\!.\   *.*.\..\.. .  *..* *\* .  . .\ . \*.\.**.*\ .** *. ...*\.. \*..\**...\** .  .*.  * \.*** *.   \.**!* . .#              #
#.*.\*...*\. . .*\* .*...**. .  ..*.@ **. *@.    ..   **.\ ** . *. \*....*..*...\...\ \ !\...***\.*\ *.* * .\*. ... ..*....* .\ **\.. * \ \.. ****..\. . .\.. .*\  *. \@. * *\.  .  .*#              #
#**\.. \*. \*\ \ *@ .  .*.\*\.\.* \*. *\.*.\  * .\..**\*.*.*.   .*.. . . .*.* .\. *. *  .*\. .*.* .  . **\*. .@.\   *..**\..\ . *\..*.* W .\ .\.*.\ !\.**\.**.!\**.. \.. . \ .\ .*.**#.#             #
#!\@ *..  \*.*\.. *  *. *....   *  **.\.*.  **. \   \\.* *..*\.* .. .  .. *...* * \. * .\**.\...  .. . \.  \..... *\.\**\! \*.  . * !..@ .**   *  . * **\**. .   \..*. ... ..*\. . ..\..##           #
#\.*\.*  ..  *.\ . .. . .\ \  .*..**.* \.  *.**.  *. .\. * *** ..    *\. .   *.\ .. *.\ *\.*  *\  .W*\  ...*.* .\ .. .\. . . **** ..\*.*. . *...\.\*.\.\ *.\ ***. .**.\* .  ..\.*\.. \. *.#          #
#. . \.\.\  ..   ** \*.  .* \.*. @*.*.*.  @.  *.\*...  . \*.* * .. * \..\\  .* \ .*!.* .\* .. ***W.*\ **\.*\ .\. ***.  \  .  ..\*. . . \.!.@\.... !*\ *. .* \!.. . . . *... .** ..\... \.# ##        #
#.*.* .*\. .* .* \.  *..\ *.\***.**.*   *\. ..*\.\*..*\.\.... ..*\.\\!* .*  *\*. ..*..**** . *. *.* \     .* *  *.*. . . ...  * .     .... *.*.\. ..  *\ .\**...*\. * \.\. . *.#\. \.*###\#. #       #
#*\ .\**. . .\..*.\\ \ .  .*\  ..** .*.\..* .\.\.\*.*.  * **\*\......\.*    ..   *\.. *\. *.\*  .* *. *.\. **. .* .***\.\*  . ... .\ ....\..\.\ ..\.. .*\  ...\ ...\*.   *\@*.@.. *.*..*. ..###      #
#. . .....  *. \\*. *. ... \...\ ..*  \..\ *.    *.  *\ .\*.... \..\ * . \ ....*  ..  ..  \  . *\*.. .*.* . .  .\.***. .\.*.****   . .\ *.*.*. ..   .. .\.**\  W*.*.***\.! \... .** .*\#**.*\ .#     #
#..\.\.\ . *.*  . \ ..   \.*..\*. .\*  \*** ..*  .*\ \.**...!\ \.\***.    . ** *\* *... .\.*\ *\..*  \*@**  ..*. * ...\. ..*.***\*. ..**. ..\..\...\   *W..*.**\...*.**.\.. ..     **\*..\...*# #    #
#\ *\@*\* . .*.. ***.    . ....*\.\.!. .*.. \.. ...  \ * \*. *.. *\ . *.. \ .. .*. \.\..\. .  \ .*  *\**.*....@\*.\\  *\*. .\.  . ** ..*  .\. . . .. . . .** .. *  * \*.*..\   .*...*.*..\. .\##.#   #
#*\\. **. . ... \ **\..*. *  . * **** .*.\.. *\*. *. \*.  ..*..*****.*\*  **\* ... \   . .* **   .*.\ !**..... .   .. .*\..\*\.\.*** .. .\*.\*.   *\. .\. ..   ..*\*.. *..  ..\\. .\  ..  .\. # *#   #
#.**\@\..\*.** .. *\.*\.*..\..\ .*\.   .**.*.*.*  .. W..* *..@* \..!*. .  ..*. ..\ .  .* *\ ..\*  .....*.   ..\.****** * *. *.  \.*.* . * ...**@\..\! .. .   *.*\\ .\ ..\      .\\*..... **** . *.#  #
# ..*...\.\..*\ \ **..*.\ *.** **.*     .\ ..*.*\.* *. \.  \*  *.***... .. . . * **    .. .  ..*..\. .\ .\*  .* ...* \** ...**\..*. .  . .**...*.@ *.\..\*. .. .* * . *. **....\ .\. ..* *..  *\##   #
#\... . \ .\ .  \*. .\..**. !..* ** *\*.... **.  ** .*. .@..*..* .\*.**..\  \... * ..*!.   . ... *.   *\...   . \. ...*.\ * .\. . .\ . . .*.*. *\. .  .. . .\\ *  \..*\.\**\ ..* \. **   ......##    #
#  . .* .. *.  *..*.*    ...\  . .*.* \**.\ .\*\*\..\...**.\. !.*. *\. .. .*\ .. *\.** *\ ..* *       * ......\.*.... \ . \.\.\.*. *.\.\.** .... *\.*.\...\.. \.\. **.!\ * .\    .*.***\. * *\.* #   #
# ..   *    .  *...*.\ .******* *\.*.   *.*\ .....  ..\*.*..\.* \**.*.. .\ .*.. \. \..\  **.* ..  *  .. *\.* ..... .. . **.\. .*\...\.\.\..\\\ . * \\*..* . .. . ....**.*..  .\.   ..\.*\*. .. ##    #
#.\\ . \.*  *.\ .  . \.\ \...*  **  \*.*. \\.  ..\*\.\**.  **\*.*   ..  * . ...*@*. .\ **\* ..... *\  \  !.. *. *  * .  .\ @.* *  \\.** .*..*..*.*. *..   .. .  *****.....*.* ..*.\* .*\*.* #.*.#    #
# ...    ..\. .. \  . \*\. \..\ *. *.**.. . *   ***.\ **..\ \... *.*\. ..  ..* . ..\*@.*.*\ .  \......    .*.\. *..* ...* .\ . . *. * \..*\   \\    .\ .\. *. .\. *...* *. *... . *.*... *\ #.##     #
#\. .   *.. .**. ..\..  .  .   *.* .* ..*..*. * **\ **...\..\.\.....\  \ \   .. \*  .**..  *.\**. *..**** . * * \  \* ..* **. .**.\.........*  *  .. .     ..\.**.  \*   *..*..  ..\*. *.*.  ##      #
#*.*.\*. \ \. *...\... *. * . ....  \\..\\\.   \..\ *..@.. .*. ..*\  \ .*\.  * \.. .*.\  .*... \.\\*\.****.  \.  .*!.. ..\*. * .* * *.. \ *... ...*   \  ... .*. **..\ .. .\.  * ....**  .. * .# #   #
#* .* ... * ..*C. .  . * @*.\\. .*  \ *!** . *\. **\ .*. .... *.\**  ....* \  \    @.  .  .\  ... *....\.* \... .. *! * \.*..**.\ **. . * .. *.*  . **..*\*   .\.**.\. .*.* * ..**.\*.W.. \*  *## #  #
#**\ **.. ...\.\.*\..  .*\.\. .  *.\..@ .*.....  .* \. ** *\.  ..\* .* \ .**\*  * ...  .\**.. **. ***** **  *  \*  \.*. ....*.\..... .. . *\.* ..* . .\*\.   *. .*. . ..  .\  *.\   .\ * * * \.. .#  #
#  * ..\  . * *.** .\*. !* *     .. **.  ..*  *\ ......\.. ..   . \ .. *** .   \  .*.   *..\*\.\\ ** .. **.*\. ..\..\.\*  ...\*  *\ .....\.. *\. * \  .*\.\* ..*\W*\\*.\@.*. *\* .\.** . .....*.!#   #
#*..\*... **..\ *...*...*..** .. *\.\..\ .*.  *.*.**. **.. * \    .*. \.*.  *.   .*..**@ **   .*. .**  \.. .\.\ **\* . .  @ .\.* .*\ \*\    .@.  \..\.*.*\*..  *. *.**\ .\**.**..   ..  #**. \.* .#  #
#*\..!*.@ @.   .* .\**. *. \.\. *.  . .\ .. . ...** \ .*.***  ..\* ..\  ..*..\ ***. *.\*\*\ .  \* .\.  *\*.*\. ... .   .\.. . *.. @.\ ..  .  . \.. . ** .*\.\ *\  *. .**..   .....** .. *.\* . *##   #
#.*..*. .*.** . .  *..**. *.  . .  .  .. . ** *  .*.\.** .***! . .*....*\ . \  .. .*...* ** *.*. ... \\. **\.*\* \ \ .\*..\ . . ... .*.\ .\*! . * *  ..  *.\. . .\  \ *.W\  *\*\  . *..*!*.. . #     #
#*. ..* ..*****..**.* .*  .*.*    * \*\  *\... *\..\.\.*. *. \.*...  * . .*    *.. ! .  *. *..... *****\.\\. ..*\  .** ..*.* *.  * .*.*.* *.  ...*.\.**  ... .\..\\. \. * *....  \. . .*...  *.#     #
#* .*...  \*  *.... .  .\..\..  .  .. ..\..*.**\*\ ... . *\ .  .* *  . * \...  ... ..\.\*.*\*.\*  .\ . * ..*. ** .\ !\ * \ . *..*. .\*  .\*. .*..*..  .** .\*.\. ..  ** . .*.\ **.  *.\.    *#. ###  #
# * . ..*... ..  . ...*\.\**\ *.. *  \*. *.***.\. * \.. .*.*.\. . . \..***.  \.\ \ .*  .* .*... * . * \.\  .. *\    ** . \**. **\.*...** *. \.*. ..\***..  *  * ****\.\ ** ** ..**!\. * *  ..\. ***# #
#*...* * ..   \.\ . *\. *...  \ @*. \** ..*\..*..*.* @\* *..  \.**\...\.***..** ..\ . .\.* .. \ *..  ...*. .. **.  **. . *\..* . *.!\... ..\.\.\.\ !...*****. \*. ...\.\.\  \..  .\.**\.#\* *  \*#\.L#
#  \.*\. ..**..\. .*... .\*\*\ .*....* . ****...\**..!*.  .**..\\*.*.**..\....  *  \ *\. .\!.  .. .\**.*.*  .*. ..*\ .. .@  \.\ @. .***..*\ .*.    \...... ..* .**  \. .\.\.. .  *. **.\ .\*# \*##  ##
# *.***\.!...*\ .\ ..*  \..* *.*. \**.\ *..*\...*.*.  *..*.**....*.*....\. . \*.\ .**. *. . \      ..*.\*\.\*\*  *. * **\.* . *\ .**..!\ . \..*\*. .   ***\....\..* *   ...*  !\*\*. .**  ... ##  #..#
#.!**..**.   \*... .  .\*\*.\ \*\ .\.  *\.*.  *!..\. . \ .**  . .***.   .   .\!\  ** \ **.*.* ..* . .*. \\\.\*\*...\  ... .   ...*..\*....\.* .* ... *.*... .\  .\...*...  ... .*. * * \.. #\.. #  ###
#\\ .***\*.*  .\..\ **... ..***..*.. *..**.\.\.\..\ .**.\.*\     ..*\ .  .\* . ...** \..\*.*\ *.. ...* ...* .  .\ .. *\..\ . ..***@* .  **...\ *.*\ *.\.*.  . *\ . .  *.. . \\. .\. ..\.#\ #....#    #
#\* .......*\\*  ..  * .* .*\.@....  \*\.. .  .. *.*......\ .. *\*. ... \.   .\.\.. ..* .. \*.\..*.. . *\ .\*\.\  *.\*..  . .  .. .\ .. W\  ...*.*.   .** ....**.. *\ *  .... ** #\.*..*## #*\.#     #
#*.  .  ** \.\. .. .** \.. \.\*      ..*@  . ........ \*!*.**\ .. *.***\.**\*..   **\.W *\.  **  *\* .*.*. .   ..*. ..\.*.* \*\ !. ... \ . *\*\***\. .  * **.**..* \.*\**\\   **\# ..\.# # ####      #
# .   \...  \.. .\** ... . .. * *\* .*\** ***   **.\  .* .\.* ..  . \*.!.\**\.*\ **.....W ** \.  *...\*\\...!.. ... * *. *.  *. \.\. *\ ..\  . **.*   .\..\. *. .  .* *....  #.* *** .#. .#          #
#\.\. . \ \   ..  . . .*. \  \.\. .*\@... \. ... .      * .   *\.* \ *.   .*.*.*.*.. *\.* ..@.** *....\....\ *..\*.** .*..* .\ ***.*.\* *.**.\.*.**\*W..\.*  *. * *.*..W\   \.**\. .  . *\#          #
#..*..* . . \* *..*\ .*.. .**.***  .\.*.*\\ . . * .*.. ***    ... .\***\@* *   **.  .** *.\**.....**\  . . . ..*...*\.\**..\*.  ....... \..*.**...\ .* \. * * ..*\. **.   . .*\*.   ...\ #           #
# .\*..    \.\\.\\*.\ ..\.**..\*   *.*.**  *.  \..*..*.\.\..!.*\*.  ..\. .**. *...*. .* .. \. ..\. * .\ .***. ..*  . **...*..**  *.\*..\ .*..\.*\. . **..*. .**** . **\..**  *#**\ * .  #            #
# .!..  *.. * .*.....  \  ... .**.  *..*\  .   . ...*.\.\. *..... *.\. \\. ..\\* .. * !\ \*. \.\ ... .!**..*. .\*. \ \*   @  .@\ . *\ *... ..\**. @ .....* .**\.*  *..  ... *  *. #*.#.\#            #
#\. *\ .* *... .\*\ *.\..* **\ *.  ..*\ .\ \* . ..9*.** ***  .  .*\. .. *\.\*. *  .*. *..**.\ . .**\.. .* .*.*. *  . .\ * \*.***. ..*\ **.*\  ..... . .\ .  ...  .** * *\  \ ..**  . ###             #
#* ***.\... *   \.. .. ..* *.*.* * . .   .*.*   *.*.**....**\**\**....*.!*....\ ** . \.\\..* *\*\ \. * *\*. *.**.  .. * . .. *\*.**.. .  \   *\* *.*. .. . *    ......  .**.\*\*. *##                #
#\...* . .  .\*  .  .    . .***...* ** . .\. *  *\.*. ..*.. *.* \. .*\..... \. \**..\.     ... **.** \..\*!..*.*\..*.  . .* \. *.*..\.**.....\ . ..\ \  **\* .* * . \*..\.. .#\ ..#!#                #
#*\  . .  .*..*.. ..    ...**....*.! ! . \. ..**\... .@ *.* *.. .\.*.  . . .  *..\** **..!*.\ ....\.* *  *\*** \  .**\*  . ..*.*  .\ ....*  \.\ .\.\ .  .\.\ *. . .. ***  ..  .*  .\#                #
#. \  \ .**  \..\.\**  .**..*. ..\  .. ***\ . ...  .. .. .*. *  * *.\.*. . .\ . *... .\. \* . *\  *.*..*.*\...\*\ ....**. .**.*   .. ... . .**\*. .!*\.\ .  *...  . .**.**... *.\.\#                 #
#*.* * .**.  *  .W.\.* **\* . * * .  . .***  *    .. .   * *. **.*\. ..*....    ....  . ..*\. *. *..     *.\...*.\.   ***..*.*. **   *. \*\** .*   **.. ..  .\ \ \\*.**..\ # *###*#                  #
#. .*. ..* * .. *\*\.. *... *. .. . . .*.\.\ .. *@.\. .*.\.\\. \*.   *..*\. *  * \* .. ..*\....\ \ ..*\. .* ! .@\*\**.!\..\. . * *\ ** * \. *. . \..*. .. .*..  \. * . \\   .*\.#.#                  #
# ** .  *..\* \**...* **\ . . *\..  . *\ .\..\  *.\  ...  * .\.*.  .* . .   . .* ... . \ .  \..*.... *.*.*   !.! .  .*** *.*\    *\ **.. .!*.\\\  .*** \ . \.     .*. \.*\..\\.\*#                   #
#\ .   *.. *. \...* ..*.*   \.* *\.*\...    .   .*  .* * *.   ...  *   .* .. . \   .. .   *\. .\ * \!\ .**\..  *.**.*.*.  \.. ...*.  .*..!\..* . .W ***...\*. .  *.* . *.** ..  \*#                  #
#..*. *\W.\.*. \\ . .**.. \.!\..** ..\@... \. .\..**..\*** ..**\\*\.. * *. *.\ .. **   .* * \ .  .   * ... *. *\..*.\*....*.*.*. *.*..\..\.\* . \*  \\.  ** .* .. .\.  ....*..*#..#                  #
# .* \... \ .\.. .*. .*** \.\...**.*....*.\ .   ** \ . .@. ..**  .@  *\**\.*... .. .\ \ .**.. \..  . .  . .*** * *\ @..\\\.*\ .\.*.\ \.. *. .     \ **** *...**  .. **# #* ..*# ##                   #
#* \... *\ *.  ..*.  \*..  ..\.* . . ** *\.    . ...*\. . .* *. \.  ...** .*. *\ \. ...  \.@\  .\.\..  . .*\.* ..\*\\   *\ ..  . ***. \ .\..**  * .*.... . .*.\. .#\* **...\. *##                    #
#\ . *.\...\.   **.\ .*.\\**   .. .\ *.*\.  . ..\* *\.. *\...* *  *\ .... .. *.*  * . .*..\..  \* . .\ . ... .**\ .*.\..\.**\ .   .!..*. * ..\ . . . \.  . \.**.  .*.@ .. ....\ \#                   #
# .\ . **..   @*.*!**.. .......  . **** ...*\..* .\  .* \. *\.* .  *  .  . \\ ****\ *\ \ . * .. * \.  ** **. . .**..*... ... * \.***\..\ * . .** .*. .\\ .  * .*   **#.  .#\..*. #                   #
#* *  ...*.\.**..*. *..     *   .  .\ .\*..\. ..  . *** .. **  *  .W\ .*. ..  **.* **.. ..\ **\ .. .*\.\.. \\!  .*  \.*\ .*\*.*. **\** .....* .\\... *  \*\  *\*....** * *##\*.##                    #
#. . ..*\*.. *.*...\ *...  ..\ .  .**\ .* *    .. \..\.. *...*. *\ *    .\***.* \.....  *.*.... .\**... ..\  * **.*\.\** ...!.\.*..**.\. \ **\..*. . * *..\.. *.\*. #.*\.#  # #                      #
# ..\ *.  .* .\. .  ...... .... .. .* \   ..   *. . . .*! . \**\*\*\ \ *  .*..!\.*\.\* *. ...*\******.\  * ..*... *.  *..*  **\ \.*.. *    *  ..*\. *. *.**\ *.\**.# ### #  # #                      #
#.\*. *.*.**\  *.\  * .@** \*\.* .  ..@. *. *.*.. @   . \*.\ ..\\*....*.   .*.. .\ . * . .* *. .\.\*\***\!W  ...  ***W*.    \ .**  * @.\*.* . .*!   .*.\ .*.. * .\#*.*# #    #                       #
#\ \\ .*.*...\ . .\*\  **. !.!.W \ *\ . *.\ \.**.*.\.  *\ **.*..**   . * \..\ .\ .\  ** ...\. .. .\  ...  * . . ..\..*..*... ***.. \ . **..*    . *\ .*.\.*\  * *..**# ##                            #
#*...\ .... \.  *  *.\\. .. *  . . \.   * *. \ ..\.*.*\.***\ @.. . * \ ....***.*  *.. . ..\* \* \ ***. *...* .\....**@**.  .\.*** . *  ..\*.\ @.*\.* *. .... .*. .... . \#                           #
#..\ ..  *  .*.  *..*. *. \ .\   . .\  *...  . .*. *\\. ..*... *. *   ** \ .*. .*.\\*. . *\.\.\  * *......*\  .*. *......   . \*\  \.  . ..\ ..*.  . .\ .. . ..\@.. .\ ##                            #
# \.!.!\\. * ** ..  @. .*  .. * *\ *.* .* . ** *. .\ .   *.\*. *. **  *.  .*.*...  ..!\. .. *. **. *.  .*.**  *.. .. . .\ .  !... . ..*\*\* .*@.\ \ .*..\.****\.. . *##.#                            #
#*.* .\*\. .  .. *** \.\* \..**\..\ *  ****....*.. .   *    . .\ .. \ *.\. \. . ...\*\*\  ..\.*.***.... .\.*****.\. *  . **.  \  \ \. .. . . ..... .\. * ***. ... .  .\.#                            #
#...   ..  . . . ..**.  . .**..*\  . . .!.*. ... .*.  **.*\ .  * *\\..\  . *\* . ***. ...   *!**... \...\ .\...*\   .*.. . .\..  *.. .\  *  **..*.*\ ...*.\..  \ * .  ##                             #
# *.*  *** * .\*.\*... .  ..\. ...*  *.*\ . \  *  @*.*.\ ..  .   **.  *.. *\ . * .*. *.*....*\.   . ..* ..  * .\ \*@**\ \* .  ... * .   .*\.\**..*\   .* .* \ ..\#.\#.#                              #
#...@ \.* **\. .*....*  ...* * .\.*. .**. . !*...    ...*.  \...\.. *\. .\*.*.\*...   .** * ..*..  ***.. .\.. ..*.*.*.  ..\.\ \.\*.. .  .*. *.\. . *.\ . .* *.  #### #                               #
#*\ *!. . .\.. \*. .\.. .* **. . .\.  .  \. ***  *  .*   ***. * *\ ..\. .* *\. *** .\ \*\ *\ **\   .*.\*\..*... ..*.** .! .* ..*\..  ..**. *.. .. *. !\*.\. .   ***#                                 #
#. .*..  ! **  .. .\ \. \. .   *** .. *\..\.*..* * . . \...* .. . * . \  .**  .....* \\...\ ...**\  ...* . .\ \ @**.... .. .* ..* .  *..*.*.\***.\.\ ..*  *\  * \ #                                  #
#. *....**...*   . . ... .    **\.\ \*\. .*.** \  * \. .\ .. *.* *\ . \.  *.W ... \ ..    .\.*.\.\ ..\.***. *\. *.*.. * .  .  \*.  * **\**\ **.\.. **.\.\ ..\.*###                                   #
#**.**  .***\.*\ \ .\     !.. .   *...*.\*@\.. .\ ..... ..\*. ** \. \ .\.*.. \. .* .\ .\* .*.\  ...\. ....*\ ..\.@.. ** * W.\...*\. *....\. .***...*.*. .\ \ ..#                                     #
#  ***\*\. *.\..*\.\..* .\ ..**** *!*\** \ **  *\.. *.*. * \!\*. \*   \. ... .. ..*. * .. ..\ *. . *   \. . *  ***   !.*\ \**\ *....\ .. * . * ..\ . ..  . ..#.#                                     #
#. .....\* .\. ...   ....** .!\. *. * .** *.  \.. \*... .**...***..\.*..*@**..\*  .*\ .* . .*.\* * ..\* .* *.*\. . * .\.*.*...*\*  ..\.*. *.\.\ \*.  *.***\*# #                                      #
#  \ .\. . \* .*  ..\.\*\*\ .*.\..*.*.\..\.\ . *.*..  *  * . \.*.*.* .  . .*.* .. *.   ...  \.*.** *.*.  *..*.  .  . *. *\\.* *.*  .\. .. .\#**... \\.*##...#                                        #
#.*.* E\.*. ..**\.*.   * ... .*.  ****.\*..*  \.\  * *\ .   *. .*. **..... .....* ..\* .***.... \* . ..   \.. . .*...***... * @ ..\ . D*.*..***\!.*.. *.\...#                                        #
#\..! .. * \.*.\  \. @****  *..   ......***. . .* .*.* \*..\.......*..  .\*\.@*****.  ...\.  ....\*.  *.  .\.. \  .\ ..*\*\.. .\..**.*.  * .\** .*..#\!. #*#                                         #
#. .** *.*\*....**. .*.\*.\.\.*  **\.*.*..  *.*.... *..   .* @.*  \*.*...@* .\ *.  .\* .\. \.*.\* ..\.. .*..* ..\ *.. . *  .   * *.**.\  .*.*\.\ .\**## . #                                          #
#** **.   . *. ..\..*.\ . .**..  ... .\..... *.\*  ...  .*@. .\.*...\ * .*..\. *  .*..\. *.  *\ ! *. . *.. \**.  *.* ** ..\ .**  . ..     .*. *. **..**..\#                                          #
#*.*@\*.  .* **.*.  ..** ! \.. .*\*\* *. *. *.\.. .* * * W**.   . ..* .  . *...* \**\ *......*. .\.*  ..*.  *..*\ .. ****\.  .***\ *  *.  ... *\  .\.\#.. *#                                         #
#*.*\ ..\..\ .*.. .*\...\ \. ..\...\.*.\.\**..*..\ .*.*\  *.*  ***.\.....\ \ \\* .*\...\\ .\.\*.*. . * *\*.\. \*. \......*..\**\.. **  .\  .\.\*  *.\# #. #                                          #
######################################################################################################################################################################################################

Water 66
Flooding 10
Waterproof 9
Razors 49
Growth 38
Trampoline A targets 6
Trampoline C targets 6
Trampoline B targets 1
Trampoline E targets 6
Trampoline D targets 9