################################################################################################################################################################################################################################
#*.\ * ..\\* * * . ...*  .\*.* .*..* \ *..*.\.*.*.\***\@ .*** ..\ ...@*.*\  *..  *\. \.  *.    . * * * ...  ..*  .  . .*.* **. ..\.  \.\\ ....* ..W\. \..  \*    . *\*.\  .* .. *.* ....\*..*.. *.\ * .  .**\ .. ** *\ #  ##.# #
#\* *..**  \.\*. \ \...\. ....* .  . ..\. . ... ...    . ..\..*...* ... .* .* . .**\. . .\ .\. . \ .*. . .*    .  .\ ..**. .\W**..  **  .. . .* .  .**.*.\**. .. .** * . *. \   ..\. * .*..*\.\**.  ..*. *.    ..@*..* *. .**.##
#*.\.*......\.* .**. *  .*.\ **.    *. * .*.* * \ ..  *.   *   ..... @* ..\..     *.    \.  *.\. ..*.\*  *..@. ....*.  .\.* .. .*.   *..* . .\.\. @..\ . W\*\... \. .. ....\  ***.. . ** \..*\*..*..**. .\. . *..*.\\. . # .## #
#**.*\ \* . *..\. **..* *\\ .. .  *..   *** .*  .  \* . .\  \ *.\.*.**.  . .* ** *. ***\ \.. *..@*..**  *. **   \. \. ..* .  \ .\ **\..\*.* \.  .\.\ .\*. ..* .\. * *.* .. .... !. .. \*\.. **..*.@...   . \.\.  \ .  .  .##   #
#..\* * ...\. * ... ** ...* .  \.*.* .\*\... . .   ...* * *** .* *  \. ..\. **.. .*\.*..*. .@.*..* .. .*.*  \ \ .  . .*.*.* \.* * ...*\ . \*.**\*. .**.!. *...*. \.*. \**\   * .  *. ..*.*\\* ...*.\**.  ...*.   ..*. *. \#    #
#. .*.  \*. ..    \...*.*.*\*..   . . \.* ..*. . .*.*\* *.*.*. .    ..\.*   !..\.  .\**.\ *..***\. .\@**.*.. *..*\*.\ . ** *.\\. @** ..** .. \.***  *.. *.** *\ . *.\.....  \*.   .\*..... .\*.\.\ ..*. .\. .... \ . .*. #     #
#\*..*\ *.**  **... ....\** ..\ *  \ . \... *  ..\. \..\.\** . .  . .*. . ..\.. *\* .*.*.*.**..... . ..* . \*.*\.*\.. *...\\.   * .. ** *.\*..*.. .\* \ * .\\***.. .* \.**.*\.* *. *\.* ..\. *. ..*\  . ..\\...  ** *\ \L      #
# . ..*.... ** *.*   *..*..*    ..*  *..  . \@ * *\... .. ..    .. ..* . .* .\ *.*.\ ..*\.*.*.\ .\ *.*.. .........*  .* *. ..*.*** *@.. .**.  \ *\  \.. .  *..*.. ..... .. .*\...** . *** .  .. .... *..  .* . * .\ #. #       #
#        * \..*.*.\ .W**.\..  *\. .\** *\*.**. *..*.... ...\.\ . .  *\** \. .. .*. *.\.\* *  .*  * .\...... *\ . .*\  . \.  .. ..***\ *\ **  *.\  .* \ .   * *.\.. \* \... .\.\...... .*.  * \... .*.* *  *\ ...  .*** ##      #
# *\\*.. *. \.  . ..*\ .   . .*.\*.*...*..\.\ *.. ..**.  .  .*\.  @ .. * \ \ .*..*...*\.* . **.* .  *.\.\ .\* ! \*....@. * \     .*. . .*\***.\.  \*.   \. ...*..  .\ W*.   .\. . .    \..\*..\.. * *.   *** ...*.  .#\. ##    #
#\@*\.\**\.. ..    \*\* .**\  .*.*..*.. *\**.** ...\..\ .  . \   ..\ * @\*\.* *.*\\.**.**\ ... *\ *.\\ \..  \ *.. .* ..  .*...\ ....*.* ..\..*\. *..\*.... .\ ... **.. *. \...*   *  . ....*..  .\\ ..\.*.\*\.**.. **..* *.#   #
# \.*.... *\  . .**..*. *.*.\..\ \........* .. ..... .\..   .. *. .  .*....\..\**\ *.**.!*   *   . * \.  \.  .** . . . .*\.*\ *   \..*\**..* . \ ..*.. ..@ *.!.*  .. **.....\*. . * *\   . \ .   ..\*!. *.. .*\. ! ..!**###    #
#    @..   . \..\*  **\.\\..* ... .\*.*  * .*\.*.* *.\. .. . .***  . ..  \ .*! ..* * .! ...\\   .. **.*\*.* \W\  . .*  *. .* \*\ .   ..**..    . \ ..\*  ...*\.*\ *.\       *. ....  .*..         . \ \..**.**..* .\ *.#       #
#...** . * . **.*. .\*.  .*\. .**  *** . *....\..* *. .*\..  ... \* ... . ..* * \* .\ ....  \**    .  ...  *..\.** *\..**\!\ \.. *  .*\*... \* *  . *\.*. * .  \ ...*. * .  *\.... .. \ * * * ..\.** *.\.. **. \.  . .*#       #
#.  \ *.*.** .**.\..* **\ . .  ..\****. !......*\* .\ . * . **. ..\** .*.*.*...\..* *  * .*\. .**   \*\. .*.**\ .. .*.\**.**..*  *.. .  \***..\* .    .* **..*   .\*..\**  **.\ \ .  . .....  .\..* .*\.*  .* *. *.* ..##      #
#  . ....* .. *. *\.. ..**\*.*.\.*. *....*  *!@. \*\** *    .*\  . \\* *\.\**.*  .*..... *.* \....  \** !\. .. \ \*.\\.**\.*.\ ..... *\. \..*\ ..\*W   \ .*\...*  * *\\.*. ** .  \ *. .  .   \* ..\  .* .*\ *...  ...\  *#     #
#.* *   *. *...\  . \.\.. \..   *..\. \.*.  *.\  ....*\*. ..*.... . *. \*\ .. .***\.**\ .. ****....\*.   ..... .\..\ \*\.. *\.*   .... \ ..  .   .  \ *.** .*.\*  .\... \ ... .*\. .\ . ..*.  * . . *\ \ .*.\.\  **\*  \*##    #
#*.\****.. *\..!.**.. .*\ .  * ...\..* ..*.......*...* .*  ..\*..* *.  .@* *** ...*\.\.* *  *\.\.. \*.  \...  W.    ! ..**..\*.\ .   *.*.*.***. **\.. .**..*.*. *.\   ...\.*  . ..  .   *... .*\.**\.*.   ** . . *.**\.#.#.#   #
#.* ..** .*.* ...*.* * ** ..*\ . \ *..*.\\..\ *\.*\ .**..  .\.   \ .\..*.. ..\ *.\ .* . \..  **..\.\.\* ..\ \..*\. ..\* *.\..**.\....*.**..**..**..*\ *.\  *.\.*\*.* @.\\  . ..  ..\  **\ .\..*  \. .\  .\*  \.   *.**..  .#   #
#.. ..*. \*\ ..* .   .*.*.\*\.\* ! . .*..*  ..\. \**.\  .\ .* .*. .  . . .  .*.\. .\..*.*  * \.. .*  .\ **. ......\..  .... .*..@*.. W . ..*\* ..\*..\. . \***.  .  \*@ .**...  .\.* *..*  .**. \*.* ** . *\ \\   * .\*..*@ #  #
#!\.\  .\.*.\*... \\ *.\*\* ** .  ... .*..*. .* ..*. .*.   . . * .\.  \...\*..*.*\.. ***. .. .\.   \. .*\. \. .\*.   .* **   .*. . .* !. \*\*  .. .. .*.\ .*...@ **.\..  ...* .  **.!*.\  *.** !....\*..**.   *.  *   ..* *#   #
#\!\ *  . *. *\**\*. ..\..*....*...  *\. *. *\..\.*.\   \.\  \..*....  * .*. . .. .  .. \* . .. *. .@ \\*.  .   . .**\.*..  *...*  .  * .. *. .** **...  ...****\ ...*   *  .** *.****.  \.*** \  .* *....**  .!..***\* # ..#  #
#*\..*...*\ . .\*.*\ \. .** .**. ** \.  .* \\  .  *\@.  !  *\*. ** \* .*  .. .* .\.**.\@\* .* .*.*\ .\.*. *.. .   .. * .*.\ .  *.\ \.  \   ...*.* .*..!*. . ..*.*   ** \ . .*  \  *\\.*.  ...*..*. **.  \.** .\\  *\!\#.. .#.# #
#. * \@\ . .*.\*\**.  *  .@\***\.*\ .  *.  *.**\\ ... *** .\ ....*\.*.@..\*** . !*.**\*..\...!*.\. . ***\.*.\.\* .. \. ** **\ *.\..  . \    . ..* . .  \.* * .. . \..\ ** .*.\*.\*\...\..\.  \  .*.\.*  \*..\. @ .. .. ..*   ###
#*.\\.*  .. .  .*. ...   *\...*.*.*\.\.\   **..@.  .\ .\* .. *. .*.\. \ ..*..  .*.*\*.. *\*   \*** * * .\ ...*..\.*..\.. ...\.*\*\....\. *. .  *****..    .*.. \ . \\..*.* ....\.   . . ** *  \ ..  .  *.\.*.*\@  .. .*  \   .*#
#. ...   *.*\....*\!   * .  \.. . \.\\ ...*.*  . . \ .  * .  .* *.\! . . \. *  * ***.. *. **.**..*\...*.  .  * ...* *..* * *. \ .*....  **\.*..\ *.\ *\ ..\.*.\..\.\..\ **\\...   .\  *\. \.! .\. .. ..*. *  .*   ..* . \   .\##
#*..**\. *.@   **. \ ... *.* .*\ *.\ .*. . *. .**    . ....*\.*.. .... **    *..\. \* .\ . . **....  ..*\ *\ .\. \.*\*.*\ \.\*.\*.* *   \**\* .**.\...* *..*... .  .*** .**\.**...  * ** . *.. .. .\ .\.* ..*.. .  .\..*W..\*# #
#..*.. *..*.\... .@  *. .!\. .@..\.*  ..\\ . .....  .  . * ..\. **\.. . .. \..* *.  .\  \*.*...***\... *..\!\.* *..****. ..*  .. \.\* ...*..*. .  * \*\. .*.*. * . \. ..*\. .*..\ ..  ..*.*.. \ .\  *.\.  .. \*@. .\.* \...*#  #
#. . \ ....   .. \ *  .\.**.\*\ *. . .* . * * *.*. *  . ...\*. ...* .  ..**.. \.\.\.   .*. . \.*.*\*\  . .. .*\ \** \.*\  . \.. \ \..   ... ...*  \....*..* .\. * *..\..*\ . * ..*.  \*\.   . .\**. \.   . * !.**..* ...***.#  #
#\\ ** .  .  . \  ****\*.\..\..**..*. .\  \ .. *.  * **.  ...\. .**. .   *.** .***.*. * . . * ..\. .. .\. *. *.\ .*\* . ....   ..   . .  . \\*.**\.* * ..  \... .. .* ..\.*. **** . * *.  . ** *\.*. ..*. .\. \#*\..\#.*#..#   #
#...*  ***..* \. \.*. .**.\  \.......*****. . .*\.  *\    * .. \!**\. .  . *. ...  \ \.. **.*.*\ ..@\. *  ..  .* @.*** ..\***\**.. *..*   .  .*..\.....   *.  .  \**  * . *\*.@!..**..\  *R... * .\** *.***. **.. ..*. ##*.#   #
#  \\.*\.*\ * .\..*.** **..\.**\*\* *..\.\ . . .*\.** *\** .    .**.\ ..*. . *...   .. *@  @. .*. *... .\...!**.*.*...\ \..*\...\*..*.*.*. *\ . ....\@..   . .***\*.  .   *   .\ .. *.*   .. . *.\!.. ..*** ..*\   \*.. ###    #
#**.\*....*.. ..* .\*. \.*  *.\..**\   * \ \.*.*.\ \**.*..* ** .**...  **.* *..*\ *\**\ \.*\ .\ *.\.*.\*\. \*\...*..*\ *\.\.\**\.. *..  .\ ..*\.\  *. .\**\ \ ....**\*  \.* * \**\  \.**\**.\. .**@.*\*@... \ \.*. .\  #       #
################################################################################################################################################################################################################################

Water 13
Flooding 2
Waterproof 4
Razors 8
Growth 39
