######################################################################################################################
#               #*..\   .....C*  . *. .*  ..   .\*. . .**\D.**\. . .**... *\.  * ..  ..** .    .****.*.** .  E.   \* #
#               #.* .* *.*\.. .    .@.\\ *..  \.****.  *  ..\ .*...\ .    ...\ ..  \.. .. .\*.*.*... . .. *.\.*** ..\#
#           ### # #*\. .... ..     *.*\. ...\ ... .\*  . **.** .  . *..** ...   *  .*\..** *.\  .*\.... *\* .*... \**#
#          #.*.### .#\ \ *\*\  ..  \. . .*.\...* *\ \ .* *. *. *\ . ..* \ **....\ ..*. *.....\** .**.\  \*   *.\ . ..#
#          #\# * #* #  . \*... . ... . \ ...  .\.\  ...\..*\.\ ** *.*  *..*.. ..*....!*.  *.\*..*.*\  ....*\.\.*. *  #
#           ##\*\. \.*...*.\*  .. **\**.*\***...\.****... ...  .\  ...\.* * *   * . *\. *.\. .. . .   * \\*.. . *\..\#
#           # **.*#\\. ** .*. . .\*....*.\*..\*. ...*..\....  *.. . .*..... *\ \*. ** \ .\...  *\ .\... .*\.*.... .* #
#         ###\*..*..  ...  **\ * \*. \\ \ .  .* .*..*..*...  .*\   \** .* !*.*. .  . *..  .. *.\** ..*. .. *.@  .   .#
#       ##\*.#...\.  .\.. @.. . *..\\.  ...   ..\*\.*.... *   .****...*.*.*.   * *\ .*. \ .*.. *..   .* \*\.*\ .!  *\#
#      #\##.*.   * .* ... .\ \...    \*\ .  *  ** .* ** .*.\* **.*\* ..\. .* **..@. *\.\ \ . .*. .. * !!.** ***** .*.#
# # #  # .*.*# . . .*   \**. **\ .*  .\. ..* . ...   .  *.*.\.*.\  .\ *. \**\**\.. .\ *.*.. ***.\*\..*.\ .* ..!*. .\ #
## #.## #\ .. *    .*.**. .\.... ...\ ..*   . ..*     . . .\.... .* . .. .. .****\ .. \*.*.  ... ..\****.*.. .\\.    #
##*\.#\\*#. \.@ ..  \ .**.*  .*.\*\.. ..! .  .\**.*.* ..\\. *  * \.  \.\ . *.\@*... .. ... .. . . .. .*. !.* * \* . \#
# ##*\ .*\  ... *\ .*\* .*   ..  \.... **  ..*..!*....  **.  . ..   \.  ..*.. ..* .\*   * *\..*\..\ * **.  **.*.**\ .#
##.. *\** * . \ * ..*.*  **1 *...  !. *\. .**  .  \ .\ **.\.*.\ * ..\  .*...*\ .*\ .* * \.* \ \ *!. *.**\**.\.. ..\. #
# #*.*#*..  .....\ \....*.*.*.*. .\*  ** ..*\.*.   .*. .*..\.\ *\*  .   .* .*.. ..*.  .*..\..* .\*  . *..*\...  *. . #
# #*\#*.@..   \*\  . . .*  \  .\.* ..*.*.*\*. .*.*. *\ *... ..\  .. . *\\..***.\... . . ..*. . *\. \    .\. .\* .  .*#
#  ## #. * .\..*  .. .  \  ..\..\..**. !.*..  \.. ..* *.\.* .*.\\*.* ..* \...\** *\     .* * .*. **...\.* . *..    * #
# # *#. ..*  .***. *\.* . . .. .* .\. \    ...\ .**\...*  *  .\.*.*\* .... .*.  .*.*\.2 * *.*\.\..W ..*..**.\*..\ **.#
## .. *!\ *   .* * .* .*\*. *.\******.* ***  .. \\..  . .\.**.* ....\ *\ .   .  \...*\\ . \....    * \* .* .  *  \..*#
# .#. ..* * .*.**....\!...\ W*.*. ..\ ..\.*** *..\!*   . ***....*.\*.*\. * .*.\*  \*\  .\.**  .  ... .*.   *......* .#
#### *. \*.*..*.*\  \* \  *. .*** *..*.   *.\. .*   . .*\ .!** .! *. . .\ .**. **..*  .\**.! *** .* .   **\.*..\.*.  #
# #* *. . .!.\  ...*.. .  .W*\.\* . * .   ..\****.**\* *****.**.. \.* *. *.\  ...***.   **\*\... * .* .\* .\ ..\.* . #
# #...*.!.\* *\. .\ \.   ..*.!*..\ ..  .*\   *.. *.. ..*.*.. *\.*.  *.\\.. \..\ *.W*\.\.*\   * * .\ *..*..\. *.. .\ .#
#  L* . \ #*.\ . *.*.*.....*\.*  .*  \  . \*\.  .....\**..\ !. ..\.... .!* * ** ..\. .  ..\.*\*.* \.**..  .*.  ..**.\#
#   # ...\#. .  .* . \** ..\.\ .\ .. ..  .\.*..* * .  ..  * * *   .\ * .\. * ...*.*  .* ... *....\. **.\   @.. .*..**#
#    ##.\  \*. ..*\.*.\.\  .. .. * ** \.\.. ** *\.  ...\.*. . *\*\\..\*. ..\.\...** *.. .*...\ ...*. . .\*\..* .***.*#
#   #.#B.# .....\.*. *   .. .\.*\  ..\ .. \**...**. .**...*.\**.\**\ \.   *. ... ..\* * .   .@*.  ..  . ..*.\.\  *.*.#
#  # \..  . .\ \  .!... \. \  . ..  *.  \.*\*!*\.. *.**. *\. .. *.. .  .\....*\* *..*\*.*\.***.**\* .. \*...  * .. \.#
#  #.##\.... * .* .*..      *..*\.  \*...\. .*\.* ..*.\   \ *\  *\.*\ *\ .A**. * ***.*\ *. . ...@ .. .\.. .   .\.9\* #
#  ###.* * \ .**. **. \.* . * *.4*.. *\ *..  **\* **. *.\.  . ..* .\*\**. \... .*\*.\.. .  .**.....* ..*.*  .   .  ..#
# #. **\ ....*** ..*.  .. . .\...\.**** \ ..\*..\ .*\**\  .. .  .*.*. *.**\.\  . *F  \ \* \.**..   .  \ *.!*    .*.  #
#  #\ #  .  .*..* *..*\* *.. . @**.*..\*. ...** ** *  \ *\..     . . .*\.......*  \*...*\. ***\ *.**\...** *.  *  **\#
#   #\.\#*...#*** *\*\ . ....* *\**.**\.\*.\ **\* *.*. .\*.\.. .. .* **.. .. .*.\ ..\.*.. \*.**.. .\.\ \.* .\  . . ..#
#   #.*.!*#. ..\.\. \ .\.  \** .*\....  *\.* ** .\. .\    ..* *  . * .\   \..\.\  **** . . . ...\ \   .....\ *....R*.#
#    ##. **..*... *. .* \  \..\ *.  .\ *\ .\ .*\ ..  *.**\ *\ ***.\. .. .  *  **.*\...*.  *. **. .. ..*  \.\.*. ..\..#
#      ##\.*#.#.  .  .*\ .\ .* .. .. ***..\.**\..@. ... @W\...*..\.. .\. . .*...  \.\*. ..*   .* .\  * ...  .\  *.***#
#        #\.\  *\ .* *.\..\ .*. \..\  .*..*  .** ..* *  * ..\*... **..*\*  .*.\. \.. . * \*\.* *\**. .  .*.*.. *.*...#
#         #. * . .**... . . *.W.**. ...*\*. . \.**\  ***.*.*.. \*.* . . *.**@\.*. .***.*\ ...  \ ..     \ ..*.*.\\ \ #
#        #*. #\ * ..*.@*.*..\ . .**\ .   * .\ ...\!\* **\.... ..*.. .*.*. .*. ..  .... .*   *... * . *.\   ...! .... #
#       ##. .. .\  .\\.\   \...\. @.*.***...\ .* *\..*\*...*\ .  \.*\  ..***\ .\  ..*.  *.. *..*.\** !\...****..  *  #
#      #. .  .* *.\.*...\.    .*  . \..**  .*.*.\\...*..\  *...*.. .  .\....***.  . .\.. *..\*\..*.* *\* .....\..*. .#
#       ##... . ..\*.**...*..... .*     ** .. * * !\....**.*.*..  \. . ..**.\*\ .\.** *  .\ *. *\..  . . .\..*  \ .**#
#        #..#*\* . \ .*   **. \.\*\*......  *** **\.**\***.*.*** **\ .*\  ...*  \.\.* ****.*\.*  \\ \** \  ....*..!. #
#         ##..  . \.\  *  **  .. ...@****. ..\.*.\.*.\*.@.*\  *. .\ ** \.*\.*.*..\.\.* *\.****. ..* *.  .*\.\.\.*.***#
#          #.. *    ....\ *.. \ *.\ ... .   .**. *..\*.\..\ .*.**  .**  . ..  ..\..*. 8. .. ..   ..\  *\.  .  .*.*..\#
#         #*\. *  .. .\.* .  . ... *\. . . .\*\.\. **.  *\ . .*\  ..*.*\*\. *\. .* **\.*.** * **    ***.*.\\ !*..*...#
#         ##  \. . \ *\.\. \....6\*. **  \\   .\.***.\ .***.*  . *\  *\.  ! *  .\. .  *.. * *..   .**\\....*...\    .#
#        # * *##**   . .. ...*. ***...*  . .*.  .*.\...\\**.   *\.......  . * *  \.*\.. . *... . . ... . \*\ .*.\ \  #
#        #.\.# #...  *.\..    . ..\..*. . . *. .\.*.*!\..*.\*.\*  \.\*. *.*\. . . .. \  .** \*\   ..\* .*.\ . .  ....#
#         #*.#  ###** #. \*.\ * * .*. ...   *  .  .\.. ... *.  . ..\ .*  \..\ * \. . .** .* .*\ *\*.**\.*. \\...\ *. #
#          ##      #.\.\ **.. \*..\.*.  . ...  .\ . .*. * \.*\ . *\*.*\.\*. !\..W   *.*. ..**\ .**  .   **\* \..     #
#                  #*#***.. ... *..@\**.** \**  *.. \....***\ . *@ *.  * **...*. * **...* .... *..*....*\*.*  \ . @. #
#                  #.**.*** .\ ..\*. *. ....*.*\.     * ..*.    ** ..*.* ***\ *\ .*..\....*\\   \..\. \   ...  ..G@\*#
#                   ###\**. .\.@.*!. *.\  .  ..  .  .\\..*W ..**.* *!\* ...\. *..\!*..\.\*.         .*..\   .** . \*.#
#                     #.\... ... \*\*. . .*\  \ @* .. .\ * .* . ...   .   ..\ .     .\ \.**\. * .\*\*   * \@\ .* ...*#
#                     ##*.\**. .\  *.***.*. ...\ *     .    . *  ...!   *.\ **.   .*\* ...@. * .  ..*   . .\.*  .* \\#
#                    # *!\.\ \.  \ \ .....*\**** .\.** * \ **.  *.\ * ..**    \*..*  \*\ ...\. .*.*.  **  *.!!.. .  \#
######################################################################################################################

Water 45
Flooding 16
Waterproof 12
Razors 25
Growth 46
Trampoline A targets 2
Trampoline C targets 2
Trampoline B targets 6
Trampoline E targets 1
Trampoline D targets 9
Trampoline G targets 8
Trampoline F targets 4