##########
#    #\# #
#  ##***##
# #\ R\.##
###..  .##
#.\##*. .#
##...**.##
#.*L .#.##
##\##\#*##
# #  ##\*#
##########

Water 2
Flooding 0
Waterproof 13
Razors 45
Growth 10
