###########################################################
#           #*\..*. ..  ......*\ .* .*.\. * \.**.\. \.*  *#
#           #\#* .  .    \  \**\   .. *.. .\ .\.\ .\ ..   #
#           #.*.  .*.*....\\  \.\*  .\*.    .*..\*.. *.** #
#          # #....*..**.\.*.   \ .\.**.\..* ... *  ...... #
#       ### #.\ * . .. . \**\  .* .\**\.\*.  \ \** **\ . \#
#      # *#*# ...\.   .* . . .. * \.@\** .\.    \. \. .\ .#
#     ##. #.. *. \  * *\...*  .*. ...*...* *  ..\. \*.**.*#
#    # .\*.#. *.\  \*.*  . * .*@  *  . * **.*. .*..  \.**.#
#    #\## W .  \ ...\*\**** \  *... **..*.  .@\ \* .....*\#
#     # ## ....* .   * .\ \ ..*\. \ .. ..* . *.\.\.*   * .#
#      #*. .\\ \!.  \\. *.. .....\*  *   .\  .* * ..* \. *#
#    #  #*.\**.. .   .. *\*.  . . . .* *\...* ... **\ \.*.#
#   #.##..*.#.  ..\. *\\.*.*\.*.. ** @.* *\ * * .\.    ..*#
#  # \.. ...  .\.*..**. *..\ @.*\ *. \ ..\ *.\**.\ \*. . .#
#   ## #.\\* .*  *. *\ \  .!. ***.*\*.** **** . ....\ ..*.#
#     ##..**. .*..! .\!.* * *....\\  **.\*.*   \  ..**  *\#
#    ##**\*.*\ ..**  .. . ..   *.\  .\  .R .\*\..**...  .*#
#   #\ ...\  .. *..\**.\. .. .\ *  *   . .      *..   \*\ #
#   #*.#*..*\*\.. .***.*   .. \.\.* .\..**\.\.  . ..*\.\ .#
#  # ### *..... .\....   .*   .*... **\\. .\ *     *. \.  #
# #.#.*.\.. *\  *. \..\ .... .\.*\..** * .*\ . ...\* \  ..#
# #.#\.. ..*\. *. ..  .\* ...**...* \\ .   . . \ ...\. *. #
###  ...   \.*.     *\...* .\ . .. . \* \..       *.**. **#
#.*** \..... * \*.*.*.. .*  *....*\.. ..  \  .\*.\* .\. .*#
###...#     #\\...*.**..*..*.* .\  ...* .**..*.*.**\\.*  .#
#  ###. . .* ** *\..*\ \.\*...  \.*...  ...*** **...**.  .#
#  #.##*. . ..\*** *..... *\  .\  .\*\\   ...\ .*\***.\.*!#
# #.\ *..#**#\.#\. * \... **    . ....\.*  \..****.**  .  #
# # ##**\#*##.#.*# *..*..*  ...\. \*. *..  W.* ..\. .\  \ #
# #\##..# #  #* .#*#.\* .... ..*.*. .W... ** .*\ **.*.\ @\#
#  #  #.#    #. ##.*.##..\.* .****.    *. ..  ..*..#..* . #
#      #      #\##..\ *\.  .W ..*..**\.*\ .*\ \ * \* ** *.#
#              # #*## *.\.#.\**.** .. **. . .   *. **\ .. #
#                #.# #\    . *. *\* *.* \*  .\ *     *    #
#                 # #L. * *\ * ....\\* ...\.\.*\ \ .*.\ .*#
#                 ##\.  @ \ \.  \\. *. *. #*#.\  .* \.\  .#
#                #*#. .\  .*..*\.\.\\*\*.*\.*\  #   #   ..#
#                #  . ...  *..*. \@..  \ .. ** ** . *\* .*#
#               # * \.#.*\...*\...*   . ....**.\. .. \.@\.#
#              ##\.\.\.\..  * .W....*.  .* @!**#*. ..#... #
#             #\*.\* **.#* \. .**. *\ ****\**..  \.*## #\\#
###########################################################

Water 38
Flooding 4
Waterproof 12
Razors 46
Growth 46
