###############
# ###   #*#   #
##*..# ## *## #
#* .. # .\**\##
#.#.*   \.*.  #
#   *.# .\.* .#
#L \#   *.\..*#
#.##.. .  @. .#
# *\ *... *** #
#   ..*\* ..  #
#.**...*. *4  #
#*A    \ *  .\#
#R      ** *.*#
###   *.**.* .#
#\ ..*.*...*.*#
#.  **.\ .*. @#
#*.6.\*.*  *\B#
###############

Water 1
Flooding 14
Waterproof 19
Razors 5
Growth 16
Trampoline A targets 6
Trampoline B targets 4