#############################################################################################################################################################################################################################################################################
#      #\ *.*\ *\** *..\*.*.\   *. \\** \.*\. .. .* ....* *.**.\****.. .\. *   *\ *\\ *. *.*\.\ .*......\...\* \ **..*..*\ . *. ..*...  .  .\.* .* .**... ...  .* \. **\.\....\ ***\  ..\ ***.\..... .... . \  * *\ ...* .*.*\.... **\..*\  .*. .\ . * *.*.*\...* .. ..* *  #
#    L# ..\*.    ...*\ .\*..*. *... *\.*. * ...\..\ \*\ .\.*\*.*\..\\ . ..  . ..@. !.** . .* .*.* .. *.  .*  .* ...\..  \.. ..*\ ..  \  ** \. *.* ..*\  . ..  ....W*...*..... * *\ ..  *.*.** .W\. .*. \.  *.* \.*.* ..* ...* ....  .. \*..  *\.*.\* .\.*\.... ...\ .**. .\ #
#   #*. .\  ..\..@ *. \\. .\*.........**..\ **. *\.\...  ..\*  ..\  .\\.*.. \*. .\.* *. *\ \. **. *. .\  *.  \.. .*....*.\.   ..\ * ..\ *.*..  *. \  \** \. ..  . ** *..\*..  .\\*..*. **\.... * *  .* .* .*..\ *..*     \  .\ ** .  ..  *  .\...*..\\** ..*\ .      ..*  ..#
#  #\#***!\*.** .\** \..\. ... . ..\  *.. * ..\ ..**.* .\. .* .\..  \.\.. .*... .  * . .  \. .*  ..   .\.* .*.*\*.*\ ..\ * .**\*! .*  *.....* ! *. * .*\ .  *\.. . ..*.. .**\*  .*.. **...*..\***\. .@.*. ...*  ..   . .   *\* . ..\**  *. *..\.  .\ ..*..\ ..****\.\.\..**.#
#  # .\. * *. *.. ** \..*.*.**  . . *  .* W\ ..\  \..***.*@ *.* *..*\ ..  *..  . . . *.. *..  \!.*.\..\.* .  \. * . ..\. \*\.. . \\.  * ..... *\ .\* .. . ...* ..\* .\..*  * .....\* . .\..*..*\** *...\... .*.\**\  .. . .  .  .* .*....  . ** !  ..* .* .   *** .\...* ..*#
# #*.\ * *\.....@ .* .* *.. .*** \..  ...\.*.\.* ** ***\  ..* .     .*  *  .\ *\*   ..  .. . . ***..  . .!@\\.\\*    .. .*..@ .  .\*. \ **...\ .. .. ..*.\*  ..W  *.  *..\ \. .   ..   \.*\**\. @.*.*.\. \. \.**\...*\ \*\* . *\ * ..** **.\ *\  \  \*    .. * ..*...\.****.#
####\ .* ..*  *..*\..*. **.*..* .  \.*.**.\.R.*. ...\.*...* ..*@***... .**  .*\.. . * **.**   \. .\\ . \..*...  .*.**.\ *..\ *\.\ .  \ ..*.*    \.. *..*\.\*.. .*\*.... *.*. *......\@*.\.....\ * .*\.....* .* ***\ .* \@..\.*....  . *.**...*.       *  *\. .  ...\ .*.*..\#
# * *.*. *  . \..\** \  *\.  .\ .* . . *@* .. **.\. ...   . .\. *. *. .  \ . \. * \*. \.*.*..*...   .\*  ..*.\ *\.**.   \ ..*\!\. .\.. **\.. .  .*\*\* .. *... ** ....  ..\...* . .  .\  ..\. \...\\.* *.. .*!.... **...\..* .*. ..\*. ..*\*.* . \*....* .. .  ..! .*\*.*. .#
### #\* .. **\..*.*\ ...\.. * .. ..\\   ! .** *.    * ....\ **  . .. . . .   .\..  \ \ \.*\. . .    ...\ *..*  .*\*\*..*\. !.!.***\***...!\.. .* * .*..   \*\. \.\.*\*. . ..*   \* . . . *..*  \.\ .***   \.*  ..\.\****. *. .. \*...**@.** *.!.\..* ....*.\\ . .. **   .*\.#
#  # #\ \ *.. ..    *\....**\. . ... .\. .**.**  .\\** \** ***  .\ @  *.. *\.\*  * .. . **. .*\ *.* \ . \ . *.*.\.. .**.\\ .\*.*.*\... \. . . W. .. \\* .**\ \*.** . .* *.***.. . .*\ .*.. ..    *.*.\*\... . . *.* \\*.\ ..\..  .*.\*.\ **.. * *..* .* *.\.. *    ...\.**.\#
#     #...\ \ *.*.**\.. \ ...  . *  .\.\   .\.....\* .* .\.\*.\*\*.*  .*\.*.. \* . **  .....*.*..\.  ..*..  . .\ ..*\ *..*. *.\. \. * ...*  \.*  ***. *. .. \ .*. . * **..* **\. .\. \.**.  \ .!*.* *. ***\ ..*.\*.*. ..\*!*  \.* *\**  \*.*  \ .**.  . .\*  \ . *  *\  .. .#
#     #.#..\ .**\*..*  .\*\@\** .*\* **.*\.. * \*\ *!** \ *.*.*...*...**..**\..**\ *\..\****\ \.\**.*  .\**.\.* .*\ .*..**\ ***.*.\*\.*\\**\ \* .\....\@.. \..*.*..*\*..*..\... \.*\..** .**   \. ...\. ...*  .\***.*.* ..\*..\ ..\ . .*** ..*\*@.\*...\* *.\!.*.* .. \.\.. #
#############################################################################################################################################################################################################################################################################

Water 0
Flooding 0
Waterproof 6
Razors 24
Growth 34
