##################################################
# *.... ..*. * .  .... .*..*.## #*#              #
#\..\ . . *  \.\.  \.\  . #.\* ..*##             #
#.*\ \ . .** . . *.  . \  **.\ .\.#\#            #
#.* \.. * ..**\. **.  ..*.\.\.\ ..#* ###         #
# .*  \..  .* **\..\ *.**\.  **@.\#\*#2 ###      #
#  .**.*. @.. 1. .*. * . .  \..    .## * *.#     #
#. ...\.* * **\ . .  *. ** *. *...    \ ###      #
# .* ..*.  ...*.. .     *\ .**.   .*. ...#       #
# ... ** ** \ *.  .\** H*.\..*\* .*.*.\##        #
#\*\.\.\... .**\ .**..\@*\**\\..****...# #       #
#\.\  . .   \.\.***..*..\*\  **..\*..*...##      #
#\. * .* \*\B* \\..*6!\.*.*\\.  .... \ *\*.#     #
#.   .*\...* ..!  \.A.. .*. \. @  .*..*.#\#      #
#..  ..*. \*      ..*   *   . .\* \.. .*  #      #
# * * \.*. .  \..\.\.@  \\. *\..W\.   .***#      #
# \.\. *! \ *****\.*\.  .\* .   . *.*  ..\####   #
#*. ** *    ..\*.\*\.****..  \ .\ ..\*...*... ## #
#  *\ .5. . *\.*  .*  \**.\ ... .* *.* * *\####\##
#..\.    . ....*\ .* ....\   \.... .*. .  .# ##. #
#.*.   \.\ .8  .. \.. * \*\\ .F .*.*.\. *.*##.\*##
# .**\*!      .\ .. . .\.\. *C\ .. .E.@.* *.* .*##
#\ .\. .!. \  \.  . * *..\ .. .  .*\. * .\.##*## #
#*\  .*\. \. .. .  . G*.\. .  .  .\ \ \..##  #   #
#* *\**@ \ *.* \ .**  *\  .*\  . 3.\\....#       #
# ..* .. ..*\ \ !\.***.. ....* \  ***. ..####    #
#\.\**.* \ **.*.*.*D.. .    .. \I.**  . .W*@ #   #
#. ***\. ..*...\. @\... ..*... \. ...*...\.##    #
# *.\.*   .. \. ..**.R  #\..\* .@ ..\\.\**#*#    #
# \ *****\*#.. ....\. *.* *..7 .! . .\.*\.  #    #
#. ...\.*.....*.*\..\.! ***\**....    #\  .\#    #
# . .#*. .\\ .***.* *.\\#\\ \#*  .**.# ##\.#     #
#* *\ .. ..\*\.*.** #......\ .   .*.\ #  #..#    #
#. .#   \#\ . .*\..# # **## #*\****###    #L     #
##################################################

Water 0
Flooding 0
Waterproof 19
Razors 46
Growth 49
Trampoline A targets 5
Trampoline C targets 3
Trampoline B targets 6
Trampoline E targets 5
Trampoline D targets 8
Trampoline G targets 7
Trampoline F targets 1
Trampoline I targets 8
Trampoline H targets 2