#################################################################################################
# . .. .   .*\.. *. **\.  B*\**..**\* \... .*\*.... . ****..*  ..\\A *..   . * *\. ....\.\ *..**#
#!   \  . \ *.*\\\\  *!.. \ ...\ .. .... . .***.\!*\ ..*.* *.*\ \  \.**** ** ..* .   .*.***.#\.##
#   *.\*@ .**...\. ...@  * ..\ *.*.. . \*  . * .* .. *\. . .** * *\.\*..*.*. *\. . .  . . *#* # #
#  .. .**.. .***..* *\  ..\. .* ..@...\ .*\*..\*.. * .    \.\* .@\ *..\.* .* **.*  *.\ * . *\#  #
#\...   *... \**. .. * .*\**.*.     \!** *.. *......\  .*.!\ *  .. !\.*.** *\.!.*...*...... .#  #
#..**   *..*\**    * \  \ *\ . *.*!*\*.* * . *.*   .  ..  \.. \**.* * *\.. ..*..\.  .  *.*...#  #
#  .. *\*. *.. .  \. .\. *..\ \*..    . *.   .*\*\*... . ..\ * * \..  .. .\ *\.**  .\.*# ..*\.# #
#.***\. .*\.* \ * .*.*. ..  ..*.! \* *.\.. ..** ...  .*.*..** \..*   \ .. .\ ....\ . * .**  **# #
#....* .\.. .\. . . .. *   *.*. . ..... * .* .\.* * *.. ..\....*\...* **..\ \..\.. .\  * .. #*# #
# \ \. \*...\ ****\.\. .\  .*.*\ ..\.   *.*. .* ...*. * ..\ ***..  \*.** ..\ *..  . * .*.\ # #  #
# ....**.    *.*...*. *\.  .\. .\.\.    . ..  *W*  **..**.* ...  *. .*** . **.\**..\.   . #     #
#.\\* *.\     ***.\** .*.\* .* .*..*  .\.*.\*\* *.. ...@...\**.\*.** . \.  ..\ ** .    * *#     #
#\.....\  .*  \.\* \*\*.* *..@.***\. \* *. *\   ..  *\**\.**....\... \* @ .\\ ...   \..*\#      #
# \  .\*.....*.* * .* .*. \  * .. *.. *. **...\.*  @**.*  *.***\. *\. .*.\\ *\. *  *. ###       #
#...**.@!..*. ***.\ . *.  .. *\   **\...\.*.*\**.  . . .*** ..\. .\* . .\.  ..* **.\.##  #      #
#\..*.**\\ * \*!.\ .  \ \ \*... .\**.... *.*. *\\*.  \. . *  .\*.\.. *\\  *.  ...\*. ..## #     #
#\ * .*.* \. .  ..   . \*... .*@.  .*  \. . ..\..****..   . . ..*.   *.\  * .  \* ..\* *. #     #
#!.. \.*...    \*. \*\  .. .\ ..* *.. .* .*.!*. *\*.*. .**.  \* **.\..\.* .  \ ... ... .# #     #
#..**. .**. *\*.\..\..  * . ..*.*...*    **\*.\ .... \* ..*\.*..*.\ ....*   *  . .  \..\.\.#    #
# \...   .... ...* ..*@\. \ .*.\* . .\..... .\ **\ *. .*  \.\* \.*@* !..\ .*. .* ** \. !   #    #
#@   *\* \..\.\ ..\.**\  * **!... ..**....\  .!..* \.. ..\.  * . .* **\ .\ .\.*\ \*\   ..##     #
#* .***.  * . .\.. *...**. *. \.* \ . \ \\..*.\.\ *.... @*  . \*\ ****\.. . * .*.\.*\  *..##    #
# . ..*.*. . .*  *..\\*. ... *. .* \ .2*.\.\.\.*  *.*...*.\. . \!..* . .  \.\..*.  *.##*L* .#   #
#. ...*\.   !** \  ...**.* ..... . \*\ . . .* *.* ..*  \.\ *. ***.*.\ . .* .. .\ ..*..@ \# #    #
#*...*\.*\. **... \**.*\**.. ...* *.... .  .  .*.  *\ *\.....**\. .   *\. .. .\  **...#.###     #
#*\**.  . *\..    . *\*.. .*\*  .***  .. \ * ..** .\.**   \\ *..*.\.  \*  . \.    \.#.  *.#     #
#...**.*...* .* .*. . *.* .  .  ..\. \.**. .  *.\ !.*.*\! ...*\*\    ..  .\\ ..\..\#...\.#      #
#\ ..*.*  *.* *..**. \ ..  .*     . .  ..*  . *.. . !\*..\\ ..  .*.***   ..      \ ...\* #      #
#   ..\**. *..*.\.. *..\... ..\.*. .**. .\.** *  \  . *.*   **.@*.*\ . \.  \. *  .. . *.. #     #
#. *.* .  ... . . .*.* ...*.  *  .\*.\.*.*\ .@\*..\.\**.  *\..*..\*.\  ... .\.* *\  *#.*\#      #
#..\ *. .. \***  .\*..\..\  .*...*.. * . ...\...\.*.**\ .***.*..*.\....  . *. \*.  *#. .#       #
#   . .  .. ...** * .   . .\ *!\.. ****. .*... ..\**\. *9.\* \*. * \*R.   *....... * ###        #
#\**** .!\     *. \  .*.. .*. *@@. \... \ *\.   ..*\.*** ..*\.* \*...\..  .@.. ..\.*.*# # #     #
# .....  . \..*. *  ....*\*.. ..\  !\.* **.  . ..     ..\   * ...* * * *.*...\ ..*\* *##.#.#    #
#*  *.  * .*... ... . * . ..\**. .  .. .\. \ *  **  \\.@*..@\.**..*.\..\..\ *.\*.*.*#!.*.*.#    #
#@* ... *.\\ *. .\. *\. *.   ..\...*.  * .\... ..\* @ ...\*..*. .\..  . ****.*.. **.. *..##     #
#.   \ .. .. \..*  ..*\ . \  \*... .\..*.  * \.*\.*.. * *..*\*..*\ ..**\ ...   . **\.*.*.#      #
#* \*.*. * *\.  ..  *\* \ *. ..\*!.. *\.. . .\.*. ...   .  * \  *... *   \...\  *.*..*.##       #
#**..\..\.\\.  . *.*.  ..*. \.*. ** ..   \ . * .** *  .\. ..\..***\.**.**.\....\.# .*.#         #
#*\ *.*  *.   *  ..*   ...* . .**\. .\.\  . ..  .* *.*  *** . **.  *. ..\..* .* *.\.#*\#        #
#.*.\ *  ..\ * .*...* *.**!. \ .\ *. .*..*.\ . .*. . *\   . .*  . .\* ... \ \ .. .#*.#*#        #
#*\*. *.*** . *.\..\.\*..\ \.. \ .*\.\.\..*.  *.*\..\...*\ . * * \*.. * *.. . ** * .# #         #
#################################################################################################

Water 0
Flooding 0
Waterproof 9
Razors 39
Growth 16
Trampoline A targets 2
Trampoline B targets 9