##################
#.*R.\*..  *.* .*#
# . .. .* *\.. \.#
#   .*\...*. ...*#
#.  .*. .  . * \*#
#\  *.**.  *.  .*#
# *.* \*..*  . .*#
# *.*\*.. .\. .\\#
#****.. **!\.\**\#
#.**@ ..**.. .*.\#
#\..   .*.\* .\. #
#@*  .*** ..*  **#
#   .\.*.*.*.*..*#
#\* .   *!\*\* \ #
# . ..!. . . \\..#
#\*\ \ ..  ..\**.#
#*.*\.* !.. ***\ #
#.*.....\.* *.. *#
#....*.\*.. *.! *#
#..* .!        .\#
#*\.*\\*\ *   ..*#
#.. .*.\.\  \**  #
#* ....*   *..*..#
#\    @.  .   ***#
#.. **.*.\  *..*.#
#*...\*. .\*..@..#
#... ...*  *. *\*#
#*.\. . !..\* *.@#
#.... ..@ *\.*. .#
#\.  \  .** ..*..#
#   .\...** *.*. #
#\. !    .*  .\.*#
# . .... ..*.   .#
##.. .. .*!  .  *#
#\* \*  ..**\..*.#
#..\#\.**#\**  * #
# #*\. *.#***. . #
# #*#\.*##.*...  #
##*. .*.####\#\..#
# #. *\\ \#\**.\ #
#  #\###.# #*#*#.#
#  #\#  L  #.**\ #
#   #       ###. #
#              #.#
##################

Water 43
Flooding 3
Waterproof 15
Razors 31
Growth 26
