###################################################################################################
#                       #.####                                                                    #
#                       # #\\.#                                                                   #
#                      ##*..##                                                                    #
#                     #   # #                                                                     #
#               #      ##..#                                                                      #
#             ##.#    ##\#\##                                                                     #
#            #*#\#  ##*\  \ *##                                                                   #
#            #.\**## #.\#  .#.*##    #            #                                               #
#           ##  .. ..\##*\ .#\*..#  #.## ###   ###\##                                             #
#   ##   ###*#\   #.   #**#*\...## #*\# #\. ##L  ..#\#                                            #
## # .###. # #\ * ..#*\\#*...*. *.##..\  *\.#\.  .. .#       ##                                   #
# ##.##\.!  ..     ** *..*** ** #. #  .\.*.#*.    \ #       #. #                                  #
# #. .*W*  *     **.. .*. .  \ .\...\\..*\##*\*  . *#        #.#                                  #
# #\.## W.#* .* **..* ...\*...\.\#* ..  *##***.#\ ...##     ##\.#                                 #
#\#W .#\**\***.\... #*\.***. ..**.. .\\.. \#****.  .\.\##  #.# *###    ###                        #
#...  \*#. ... * .. .\.*  .*.. ..*..* *\\ \*\.\.** .# ..*##. \ \\  # ##. .#                       #
#..* ..\*\ . * *.  **....\ ... . ..*..\. *!. * .* . ..\ **. *..\.. ##*#. #  ##                    #
#.. * *.. **.** . .*.  . *\. \..  *..\ . . \ *. *..**\.*.#* .*\...## **\ *##\.#                   #
# . \...* .\ .* *\*..*. . \*\*   *.\. *.\* ....*.. .   .* *. .*. *  #.**.*\.*#                    #
#.* .*  * **  .**\..\.\*.  .*. .!\* .  ..\\  ...*  * .. .........\ .##.*.####                     #
#\.!.*.\*.\* ...**.\  .**   . \*  *  .\.\* !. ..\. .  . * .        \*.\*.###                      #
#.\.* ..*  * .....  .*.\.*\ *    *.. *.  . .\  . .**   *.\*.  .. *@#....\.*.#                     #
#** *.*\   *\ .. .\. \ ...  . ...*\ .*...**@..*   *\.*...\.\  . .. ..\ .*W\\ #                    #
#*.\.**    \* \. \*\  .. ..   .\*\ *.. *..\.* \. \** .** *..*.  **. #  .#  ##                     #
#..  *.  ..*. .\*.*.  .*  \  . .***\ *..** .. . . .. *..@.. \ \**. .!. . #\#                      #
#\*...\. .*. * ..\..   *\.  .  \ ..*.*...*\ . \.. **\\ \...\..\.\... . * *##   #                  #
#*.  *.\.** \..\*.  *@ *   .*.* .*!* \  \* .*.. \ .@..  .. .  .\.** ...**.*\# #*#                 #
#.. .*\  .@.**. .*\.*.* \ *. *.**\.*... ..*  *\ ......*..\\. \.\. . ***...\..##\##                #
#..\*\ ***..*.   \*.\*. *.. .*\ *\ .* ..*.. *. .\..**   ...\..*....\*.*\  *.  *.. #               #
# .... *.****@ .. .\ .*  * . ..\*   \.*..*...\ *!\..*.  \***.\.  **\.@* \ #**\.*#\###             #
#\ ..  . ..... *.     \...  \  .\ .. .....\.. *!.*\ .* .*.\*  . ...\**\...\.*.##**\\*#            #
# * *\..*** .*   C.  \. **  ..**.  . .* \.* \.. .. \.\ ..**. . *!.\* \ **\ .\ .*.. \.#            #
#...*..*\..\.*  ..\.\.*....\*\.*..  \ *. *..***.** ..* ...\ .. .\.*\ .\**...* *.\. *.#   #        #
#. **... .....*\*....*. **  . .. . *. @*.* ..\. ..  *.* *..!\. \* *.\ ...\\*..\##\.# ## # #       #
#\....* ..\*....**  *.\**  *. \!\* .* . .. .\\*. *. *\***.. .\...** *.*\*.\.. *\. .\ .*##.#      ##
#\   *  *\..* ..*.*! ..*.* . *. *.*.. ** .. * .\ ..*..\.*\\.*. \.\.** .*.. .. .#  *.#.**.\#     #.#
#.* \ *\. . \..@.\  ..*\ ..  .  ..*.\*.     . .*** * . \\  .**.   ... .. ..*\   \.**\.....*#   ##.#
#. *.... . *. *. *\*  * ***\ *..* \ .. \.  . . .\ ..  **    .. *.\.*\*\. \.* \ ..*..  !*.#\ # # *.#
# .*  .. \.. *. ....\ \   .**.* ...\..\.. *\.*.* *. @\..\*\*  ..*  *. .* .\. ..... . ***.#\*#  #\*#
#* .  ..*\**\.\.*     .\ .....\ *.\   *. .\.\. *.\. .. *.*..  \..***. * \  \ * *. . .*\. . .#   #.#
#.. *  \.. *.\*.     *  * .*. . **     *  .\.. .* . .*. .\   * . . *..* .*\.*\*** .**. #*.** ###.*#
#*..* *.@..*.\.. ** .\.*** ..*. .*\**. ..*. *  ...*   *\.*@\...\*. ...* .  **\*.* .**...\*.  . # *#
#.**.  *\*....*.\.*\.... . \ .*  .. .  *... @  .\* . .*** .. *.  . .\*.  \\.\.\***\*\....**.#*\...#
#\.*.*\.*.   ...*.. .**\ *...**.**\.\.\.\ .** .*.. . *.*. . ***..@\. ..\ . W   .**..**.* \* \... *#
# *.*.  @.*. \* .\ \* !. .\..\.!\\  .... *... !.\.\. * *.  *. .* \.****  * \.*.**... ...   \.**.. #
#.\.... .   *..  *.....*\. ..   ..\. .\\ .   .\..*. \. .*   \*.\ !*..\. .**.\@ ****  . \.\ .*@ ..*#
#\.\..! \  .. \ ***.**.\.\**\*\*.**  *.\.*.*.   *  .  . ** .*..   ....\*...* .....*W* .**..**. ...#
# ..*.\  *    ***   .*...*.\ * **.. .* . .* *.\*\.*  * ...*\..*.**. !\.@ .*. .   **** *.# \* .. * #
#\. .@*  .\..*.***  .\. **   * .. .. *  .  \.* **...**  . .. *. ...* .* * .* *  *\*..\.*.  ..\*# *#
#.  **. *  *.\..*. . .  *   *..\. \ ..*..* . \..\\...* \ **. .    .... ..  . .\.\.\.\***\**  \   *#
#   .* \@.* *.\*. *. ** *\..*\  \  * **.. \.  *   \\***..*. . *! !.\. ..* **** \ ..\ .\*.*. .* .  #
#**. . .*.. *\***.** * .*.  .*.\*  *\***\..\ *\ . .*.** ........  . * * .*...*\..@\ . *.\. .\ *..\#
#..*..**\   ... * *.\  .. .* \.... **.* * *.*..* \.  .* .\ * \.*.... . * .. !\**\* .*\.!.\*.**\ ..#
#  *\*  *.\ .\ .. .\.\. *..\\. *.\.*.**\.\. * ..  . .... .*\*.*** ...  *\ .\* **....\.*\.** ..*.  #
# .\*. .. \...*. .@*\*. .\***\.\ .... .. .  .*.\    ... .. .. .\. * .**....** **.*.*. ..\.. . .\. #
#. !..\   ...  .\*....**. .\* .. **  \.\..  *.  \  * \.*.. \.. .\*!  ..W\... * ******. .  . ...\. #
# * .**.\* .. * .*  \.*\.* *.\. \... .  ..* *.\ .*.*\.**  .\ .   *.  *\*. *. ...\ ..\*@ . .. ** * #
#*  *... .  .*\ \..*. *.*..* *    \*. * .**.****\.. **  *\\ *.\*\.\.*\*.*..*  *\..  . \..  *... ..#
#. **  ..    ...*@ *. \! *..**\ **.. .*.*.\. .@..\*... .*.\ **.. *.....*..\  **. ***** *.* . .  ..#
#* *. . ...\!*\.\..*\ .\   * . * .  .* *...  *\.\*.\   .*  \.. .*\*.\**\. * \*\. ......... .\.**..#
#  \. \... ..*. *  *  **\  .. .. . \ *...\.. .  .*...*. .  .\... .. **..  \.W.. . .\*..W*\  . ..\.#
#**. ....*.* \..\ .. .....\. . .\.....* ....*.\. @..  .\ \..   *.*.****\....\* .**  *.*.. ...***..#
#...     .*...  . !\. .\*  .   \..\ ... .   *.* ... \. ....*. \. *...**..**.* **** \. .. \ . ! .  #
# .  **\  *..\*.  * \ ..* .\..\.    .*...\ * *.*   ....    \\*\ .*.*..*...*.* . .*\...*\* *\. . *.#
#*  .**. ***\.* !   .*  .*   *.  * . *..  *... * ......\.   **...*..**.\*. *\*  *..   .*. * \  ..*#
# *  ..   *.. *.\* \*@\ *... .**....\  *.*..* .  .\.**\ .*. .\. \.\ . ! .....\ .\ .* \ *  \\..\**\#
#\. **  . .  ...***..\.\..\ ....*..** ...\ \. *.\.\*...*..\\.*\*.\ ..  *..*.. . .. *\.\.\....!*.*.#
#.. *\.\..* \* ....** * .*  .. .\*.\   \*\...*.. **.*.*.*.*.\.     **  .  *\**. .  .. . *\** ****\#
# \*...!\.. .\ . * **\..\. *\. \ *..** ****\ *   .\ *.....* * *\...*. * * \ .*... \ *   \*.. *\..*#
#\  *..*!.**.**  .*.....**\ **  !.. .\..\ .   *\.  .*.*     .  .\*\.**\.. .*..\   ...   ** *.. *.*#
#* *\ *.\.*\ .*\ *.  . *..***. **\*   .\\   ..\ *   ..**\.\W.\.*.   .**..\ .\. \ **\**. . .\. **.*#
#. \*\.*  . .. * *.   .......\ *....*.. .** ***\.*    * @ . \ .\*** ****..* *  *\.*.*. . \ *. * .*#
#\.......*.\   . .*..*.\***\*\*! ..*. \* .*..*\.\** .*..*.@..\.*.*. *... ..\*@*\.***.\ . . ...   .#
#  ..  *.\.  \ \...  ....  .  *\.\\..*... \ ** *.\.** \....\ \. .*..* .*. . ..\* .*. .*.**  \ .*..#
#\ .\..!..*\*.\ **  **.\ ** .  ..*..\.   ..*\* *.. ..\    *** *   *\** \ .* *\..*..\   .*.\...*..*#
#*..* \ . @.*.*\.. .....\!. * ....\*.. .\.\ .... ..\..  *.*. *.\.*....*.\ .* ...***. .\ .\*** . *\#
# . *..\* .**\*.***   .\ * *. *\ .\   . @*.\.   . \.    ..*\.*** . \.\!   *. .\.   \ \*   .*.   ..#
#  *.*!.*\ .* \.*. ...**\  .  .*\. ..\*.\.\..\. .\.\. *.\. *\..\.\*\*. ** \** ..\ ..* *.....* . *.#
# ..\.*\.\. @   ...***. *.! ** .. *\..\*. ** . .* .. .    ...\. .*\ .**.\.!..\ \  * .\**\.\.*.*.\ #
#\ .. .\...** . * .\@..*\ *...*  ..**.*.. .\ .... *.*.*.*  * .  \..  .*.* *..* .. *  .*.W** .*... #
# .\.**.. \ * . . . .\ \ \.   .. .***.\  \*. .*** !..  . ..\ .  ..\....*.\.*.* \* .\  *. *..**\ \ #
#*..*   ..\.. *\   * *..... ** .*.**. \*\.*  ..*. \.\.*..\**  * *\. *.*.\**. ..!. *..*.!... .*.. .#
#.*.\.**\.*\ **. . . **.\.***@ \.** .\..\.* \. .  .*** *..*.* . .* *.*\ *\.*\*   *\.** .*.\ .*. *.#
#.. ...*.\.*.\.   * ..\.* W...*..*\*\.*....\** . ..**.....* .\**.... ..*\**.*\ *.**..\.*  .. ...  #
#\*.. .. .*\4**\  .\\. *.    \  *. .*\ .\. *.    .*.* . *.    .**\ * .\. .* *. .\* *.. .*.\..* . \#
#*.*.\*. *...... .. .*...  \ .. .***.\*..\*.\.\.\ ....*\. *. \.   ** . . @.*.\ . *\ ..**.*..**. \.#
#.*\. . . . .\** \!.  *...  .\ ...**.!\*  .\..** !*!  ..  .\ .* .*... \ . \.*.\ *..* .....** **. *#
#**@ **.*. ..\* @. .\*.. \...  *\** **.* .**\.\.. .*. ...   . ..*** .\...   *.  \*...*  * .*...**.#
#\.   .**.\.\*  *.   * \....* ***\.**.\ . **. \.*.\.**   . *\ .*\*.*..*. . . .*  .*\.\  *.\..\ *..#
#. .**\.. .. .!  *@ *\ ...* . @...***\ . . .\.*** *\**. .. \* *... *  .*  @**\   \. *..\... \.*.  #
#*\ ..  \\.\..\ *.. ***\.*.@*\ . .*... .\.*   .\ *..*.\   * *\. ..*.\. * .\.*..   *. .\***. ..\* .#
#. . * .* .*. ... .**.........  *. .* \.*\. .    . *.\. \.  @*.\ .....**\.**. .. \. ....*.  .\.* .#
#... . *.\\.*   @*....***.*..\..**. .\ ***..*  *.*  \*   *   ... .\.**.*  * *.*\\!.\    . *  ...\.#
#*\**  . *. .\.  \*! \*\... \.*...*\ *  *..\. \ \.* ... .\*  ..** . \*..* *..\*  . .*  *.*...    \#
#..*\ . *.*. *.\ ..**.\ ..   *.\.    . .* .. ..! \..\ \**. \  *.. \ * ... .  .*\ \. .*.*..  .\ .* #
#.!\. . . .. . . *. . . .\.*  .* ..\**\..  *..*..*.* . ..\  **. . . .*     \ .. .\. \.. . **. \ ..#
#\\  \ .. **.\  .      ....*..*\. .* \.!.*..!*\ *. ..*.\*.  .*  . *.*.  *! ...*.*..  **\ *.     *.#
#.  ...**\..\.. *\  *  .\.\*.\.*\ *\*@\*\.*...* **.  ...\   !  ..\*..  ... **.\..*\..*.* . *..\***#
#..*  \.*..*...*... **..****....*.....   *.\  .**.\.*\ ..**\.\  * *.\**..\\..  .\. .**..   ..W \  #
#**\**....\.* *.  .*..    ... .   .\ .@. ....\.*.\ *.W...*.. *  ...... *..*.*\...*. !*.*.*\** ****#
#.. .. * \. . . .. .! ..\*.\.  .*. . \..   \*. . . . . ... *\. ..*. *. .  ..   \ \ \.*.**...*. \.*#
#**. *....*\.\. \... *.\*. *..  .*\. . \ .. .  .* .. * .*  .\ *.\*  .*.* **.\ \...* *\ *.\...\.. .#
#\.* .*  .. ..*\  \*\.\ \**\  \  .  ..* . . \.*. *\..**\*   * . *.   . .\.. .\.**.. .*.*.    *\.\ #
#.\*. .. ..W*.   . . *.\.*.*...*  .  .\*.\..  **..* *.*.*\*     * .  . **\*.   *\    .. \..\ *  *.#
#**.*.. *. .****... .\..  *.*.*!...  *.\..*.. *\..\.** ....* . .. *.. \** .**\..*.. \.  \ \ *.. *.#
#..*.  .*\ . \ \ * \ . ..**..\*.\.* .*. * .**..  \* ...  * . .\** .  *. *.  .*\ .*. .\  . **.  *  #
#\.\ ..*. .**. .*.\..** \.\ . * **\  *  .\*.. * \.*..  *.*\*.*.**.\\\...\\ \.*@\** .  ...\..   *\ #
#*..\ ***..*\ *.*.*\ .\ .  . .*..\*. . **.* \.. *.*.  *..\. ..*.*.. .* ..**.\*\.\.\***..*.** **...#
#*. . \. ** . . \.* *.*.\ . **\  .\. * . *\ \.* * * *  *.*...\*.*.***.   *...\ \ .\ *. .*.** *\  .#
#.*  ..\*.  ..\  ! ..*.*.\.\**.* .  \*. .\...\... *** ** .\.\*. * \. \*...*.*!  *\*. *. .....*\\*.#
#.\\.. @!..   .\**\  * . .\ .  * *.\..\**.   . .* ..* .. **..   . ... .\. . .\ .*.*..*  . .. \. * #
#\  \.*...*\*   \. .** .***.  ..  .\.....\* \* *  .   .\*\.\..*\ * .*\\\ *\. .  .*. .* .. .* \.\..#
# ** *.**.\ .. . . .\*  *\. .\ .* ..*\ *.**.*\ .***.\..*    .* . . .*....*** .   ..\ . * . . ...  #
# ..  ...* .\*  \..*.*\  *  ..*\*. **.\!*..\ .. **\ *..*. \.*\*\. *.*.. .\.*..*\*  \ .*\*.\* .** .#
#\.  \    \ .\ ... **** \* ..*. .**\\ .\*   * . .* **\*.*  * .  \ .@*\\.*\ \*.  .*\ * . .  *\..\.\#
#**\. .*.***.  *.. ...* *.\.!..  *!.*  *..**W\\* *** . @.    **..* ..** *\ .*** .\ ....*.\ .**\...#
#.\. . **... *** .***\. ** *. ..\*   ..   ..   .  \\ *.* .* .... \*  *. \.*\.\**\..  \*. . \.   .\#
#..  . .\  ....\ *.**.\ .  . .\. .\.*..\.*.     . .!..\*.\.**. * .\.\.  . .   . **.\!\.**\. .*. **#
#.. . .  *\.  * *.\*\*....\* .*.*.. ......   .  \ \.  *\ \ \. **.\. *.. . *.. * \\. W*..*.\. .\.**#
#. .* . .... @\.*  * .\*\*...***..\... \*.... \ . . *\  .\ . .*..* \.   * *******  ...**\\. *  . *#
#\.!..*\.\\\.*..\. .\*.*W. . @*. \.*. .. .\.*  . .\.. ..   .\  .** .**  * \*... . .. ...  . .  !..#
#.  *.\ ..\. .\..*\ .*.****....   ..  ..* *\*..  \..   .\***..\ \. .\..*. .\ \ @\ \. \*.\*   ..\\.#
#******** . . * ......\\.\ \ \ ..@*  * .** *.  . .. . *\*....*.\. * \*\\ *.  \ . ..* .\* ..@ .*..*#
#\ *.\ .* .\. . \.\***.\\* ... .**.   . ..  \  \..**\..*.*\*\*   *   .  *** * .*  *    . . .  .. *#
# .*\  R. \..* .!   .**   * .*. !*.\.\.*.@. .... ...*\.* . * *\....*\. .....* .*  . .\. . .* \.  *#
#   . .*\..  .\.  \.**. . . *...*.  *  \.....  .  **\ *..\...\*  . \.   .*...  .  * ...    .. **.\#
#\.. .....  . . * . **\  \. * ....\.*\*. .  \ \!** ...**..\.. .  ..  ! ....   .*\. .\.****.....  !#
#..* ...\ \..\* \ \.*\ . .. .    . . .\ .. * .!\..\ . *..\** *  *\..*!*.\ . .\*.\   .. .\. \. *...#
#* . .***.. \ *. *.\.*..\.* . \@    \ .\*..\ .**\..* \*\* .A\ \ ... .\.\*. .***.* ..* \ . ....\\ \#
#. .  ..*******.... *     \   ..!....\    **\***. *....*.\***....... !\ .. *****...   ** .\  ... *#
# !.*.**...\.*\. ..*. .. ..  **.**   *.\   .*.\*    ..*.\ \  *..\  \. ..\..\*.\ .*\.\*\. *    .\..#
#\. * W *\ .\...***.*. \ \ .... *\... *. ** \**.*. . ..*..* .\*.*\..\.@ .* ... . . *.\*   *\ **.*.#
# *@* *... .   ..\ .\.*...\*\ . .    .... * *\** \ .....   *.\....  . .... . *  *. .  .! \**    *.#
#\*..*.\*..* . \\**\ .*..\..*. *.!.*   ..!.\* ... .   .\ **.  \..* .\ *.\.   . ..  ** \* . **.*  \#
#*.!\*\ \. .\. .\\.    .\.\*..*.**\.\* .**\.\.\ \.* *.*...\*.  ...... *** .\. .\ \ *.* **\ .*..*\.#
#..\.  *   .. \  .@  .* *.!*.*!*.**  .. *     .* *. . .*\ . ***  .*\  *.*. \ .* *...... .. *\*** .#
#  . .*.**. \*...*..**. .\ . *.*\.*\ \ ..  .**   .*.*\ . .\ ..\*  .   . .*... .** .**\..*.** * \  #
#.\ ..*...     \* . . *** \ ***\*\.* !\.\ W.*** **..*. .\  . . *  \ *.**.*\*\  . . .\ ..* . !\   .#
#  .\\.\\  *.*  .  .. *\ ....*\.*.*.\..*** \*..*..   ..**... *\*** ..*\.. ** . !.. \* *..\. *.* . #
#.\* .\..\.. .*  .  ...  .  .. .* ...* .....\**@  \ .  .****.  ... * ..*..*.* *  ...\   \.* \\ \\*#
#  ..    *** ... . . . **  .\ . *\.. *\  ..  ....*.* @* .*\.\     .\! **..* *..  .*..\.* ** @. ...#
#** **\**...\.*.\.  **.*..\   * **.\ .. .*  *\!  *\\..** .. .\   . .\ .**..*!\  \ . *. . ..  ** \ #
#\.. * *\@*  ..\*.*......\.   ....*\..** .. * * ..** .*. ...\ \...\  \  ..\.*!* .\.\..** ***  .\.*#
#.    ..*\* .\  ..*.  ..... . *\ .\   ...*\.. ..  .\  .* .. * . .. *\\.*.  \*\....*.   . ....\ .* #
# ....*\\*.. . **..*.** *\* * . .@**\.\ \ . *\ . *.* ..**\...!   . ..** * ....  * .  \..   . .*.\ #
#.   .*...\.\ ..!\..*\...**.**  *.* . .*.*\.** . \.\...*..  *\ *..\.*.* ..  *.\..* .\..\*. ..*\   #
#  **.*.   *\*.*\** . .\...\\.**.!. \. ..! *\*...**  *  .  ..**.\ ...* \*\.*. .* *.\.   .*\. ...* #
#\..*.*\*..** ** .. \.*.  ..\ .....  \.   \.. . ...\.. !. *. * * *. ..* *.*\*  .\*   *. .*...**. .#
#*\. .*\ * .\.*  * *.**\\..  * .*...\ **. ..\ *   ..  ** .. *. !\.\.. .\...*. . ** . *** .. .\.@  #
# *......*.  ..* .**\..*..   *  ..**.. \. @*  \*  ** . ..!**.* **\*@    \ .*.*  *. * .** ..\ \*.\.#
#\* .**.*..*\.\.**. *..*.*..\**.   *.   \*.\..*. *.\\ *    .\\*. *...\..  *\.**.. \ \..\\  . .*\*.#
#.   \  ***.*. . ...*** ... *. ..*.. * ... . ..*   .... \*. *.\**.**  . *\\. *.*\ .. . *    .....\#
#.\*.. .\. ..@.*\*\*\.. *...*. !*.\ \.\**. .**. * \ \.\*...* .. * .\..  \.* ...   .!.* *  ... * ..#
#\.*\ *.. *.\ \....*.* .\*.*\*\ *. *  .**   . * \.  *\. \\**....\. .\* .. * .. .* \*\.!*.* \\\. .*#
#.*..  * \..*\  .\   . . *..\.\   .@    *\. ****..\\..*.....* .*. ***..*\.*. \.*.  !* *.. .*\.  * #
#..\*\ .  \ .*.\   * * ***\.* . ***. .\\* ..*..  ..  \.   ***\*.\  \ **.....5. .\ \!. ..  *.   *.*#
# \.*** \ *.*. *.  . * *...\.\\ *\**  ...*! * .**.*. . .\ ..... .... \.. *  .  \* \ \.. *.\.*\..  #
#.. ..*..** *....\   \ .\* .\. *.*** *.*  . * *\* .*. ...*  \*.  ..*\.\..  .** .*  .. * ** ..*** .#
#. .*.  *\* ..****. ..   *\..   .*.* .\ ..\..\. .. . ** .. *.. .\.**..  . . \.\* .* \.\@\\** ...\.#
# ..*\. *** . .*.. *.* ***...* .....\*. .**..\** **\..*.\*.....*..*. .**..\..\** .\  \*. ....*\ . #
#.  *. ...*  .\**.\*\. ... !\.!\.. \.\ * \*.  \*\*\.\  ...* ...* *.*\.....*   ..  \  .. *\ *. *..*#
#  *.. \. .*.. **  ..***.\.   *.\ ..*.. \ ..** ... *  \ \ **.**....\ * . \.\..\ *..\ *.\ * ** . .*#
#.\  * . \ ..\*!*.\.\..\* @. ...*.. . .*.@.**..*\*.. . \*.\.* .   ..*.. ... .!.***\*...*\   .\\. .#
#  . . \.* . .*\. .*  ..****. .*\ \.. *.** **.**\\ \@*\*.  .*\.***.\*\***..*.  *..@\*. . .\*.*.***#
#  .\ *. .. \*.\*  *..* *....**..*...*.\..\*.*. . . .....  ....\. *  ** .  *\ * *.. *. *.. .*. ...#
#  .**..  * .. .. .... *....\* **\..** .. *. \  .\     . .*.. *** *  \** **. *..*.**.*.. ** !* **.#
#*@...  \..\*\. ** ..*....\  .***  ..! . *.. *. .*..  .  .. ..\*  * .*\\.*.* * ..*\**. .\.. .\ *. #
#*\\  .! ..\*  .* ..*** .* !***.  .  . *.* *.\...  **. . *\\ \ .*.*  . \ . .*..*.**...\.. . @.\. .#
#. *   .**. . ...  **.\  \.*\** .*\.  *. .*.\!..* ** ..****.\ *\.  \ ... .\ \  .\***.\.@ . *. * .*#
#. *.*.*.. * *.*. *..**  . **@ .. ..    . . .. .. *.    .  ..**. .\ . .*.*.\. * ***....\   * ****.#
#\ . . .....\*\*\ .\\** . \..**\***\*\.. *\.. .  ..  *.**@ ..* .*..\  .... *.*.*..*\  **. .. .\**\#
#*. **..\.  .*....!*\. ... *.\ \.*.. *****..* ..  *..***..\.* .***. .*\*.* *...  .\...  .  *\ . *.#
#.\.\.. .   ..*\   ..*.  . .**...\**\..*..*\*. * .** ** *** . ....... *..\.\   *  *  *..\ !*!\**\ #
# *\    * ..\*.. *.* .@** . *..\.  ***..*\*...\.*..\.**  .\ * *\* ...*.\.   *. .  \.... **.\ .. . #
#..  .*\..   !*@.\ .  ***..\..\* ...*@  ...  **.     .\. * \  ..*\ \..**\..\*  .\*.. ! ...  ..*.  #
#.* . * *\. ..\* .\.*..\*  **.*\  .*******.. .  . *.\  \ . .   \. *\ .\.  \**..  ..\  *..    \ **\#
#.\ *\..*. \.. **  * . *\*.**\.  .*....\*... ..*..\  ..   \* .\.*\*.\ **\*..    \ ..**.*..*    *. #
#*. ..*\.  .\! *. **     .*..*\*     * ..\     .*..*.*\. *. . ****. \ \. ..   \\.. ..   ..*..*\ ..#
#.\.\*..\ \ . ..  .*\@ .  *.\...\  * *..\*. ..  .  *....*.. * ..**.\. .** .. * .*\*\...*.... .* **#
#*   .   \ .\. **  *\  .*\.*!... ..* **.... . **.*.*!. *..\*. **** * * .\*  .. *..*. ***..*    ...#
#.*..** *\.** .**. .... ..*.\ .* * *.*\* .*... *.\. .*..**..\.. ..**\. *.*\ .\* ..\ * *..*.\\*. .*#
# .* *\ . \  !\.\.  *** ....*\.\..\*\ *B.  *\*.. *** ...\. *  \ *\*.  *.** . ..*  *..*\*\.  .*.**.#
#\*. .W\. ......**...*.*\*.*...*. ....\ \.*.\.......*  * .*......... !**\ .*.*. .\.  \.*  .  ...  #
# @. \   \...\. *  . . . .*..\.. .**** \.. . ..\**.... .. ...*....\.\ *.. * .. \* .** *  .*..  * .#
#\......*..\.   .\..\*.*\  * .*.*.\... .*..\ \ ..*.   .  * \ .*.*   *.\  *. .  .*.  *...  ...\*. *#
#.*. .\*\.*.\..* .\* \.  . .  .* \ . \. .   *..  * . \.\.    .. .!  . *.*\..\.  W.*\.*..**    *..\#
#*.*\*......*. .\ *.\.. \\*** \.... \ \*.**.\*@....* .* . .\\*\\.. .  .**.. * \ *..  *. .  *  .\!*#
#. . .\\ .  ..*@  .*.*\*.*....   . * .\..   \**.* .*  \*.**. .\.*. \*.. ..\ . \*. *  .**...\*.  ..#
#\ \.* *\.. *  .\*...  .*.. \.\\. * \..\. . ..**. *.  .\ . *.*  ..@..\ !\ .\.\..  .  \..@. .*  **.#
#.*. @ \  *..\....\*\.* .  \   *. . ..* * \.\**.. ...  .. .. ..*. .* \ \.\.*.. .*.* ..  . ....... #
#.. ..! \ *. .  .  *\... \*...\.\ .  .* \ .*....*.. **\*   . ..... *  .*.. . .  .\...*.\..*.* \.. #
#\  . \..* **\.    . *\  .*\.  \..\ . .   **\  ..@.\.. . .  . . .. .\.*.\*.  *..* .. .@. ..\. *. .#
# .  . **\.\**..* *  *.\* \* \...**. .  *\*\  .  .\.   . *   .*.. .\ ..  .***. .. .!\\**\.. ...*. #
#*.**..* . .....* \..*\...*. **  ..*. .\.\ *\.* ***.. \.** . .\*.**  *\\\ ..* . . .\. .. ! **.  !*#
#* ..**\    ..*   ... * *W.*\\\ \*....**..\****\* .  ..   .* \..**.\.  .!*.*.*.\. *.  * ***\.*\* *#
#.* . *.* . *\. ..*. .. \.\ .**.  *.. \**\..\.\ .\  .*@*\*.  . .*.*...***.\. *. ...**......*\***@.#
#..\.*.\..  * ..\.. ..\..\ . .... ** ..**. .*...\.*..***..... *.\ .\  .*\. . .... ....    \!...* .#
#*.. . . ..\\**..... .. .*.* ..***** ! *\* .... .\.  .** ****\...* .  .. .   ** . .  \  * . .***. #
#. *. \*  .. *.\ \*.\ .*\**.   ..*\ \* \.* ..*.. .*.* **\.*.*\  *\***. .*  ...\\  . \!\ .W.**\.  *#
#....*..*\@    * . \  *. ..*** *\! ..* .*.\ .\. . .@.. \.*.  ..  ..  \*** **.. ... . \.\ **!*...**#
#\   .\...*\* *.\.*   \.*. ..*.. *\. ** .* *\*\    . .. .\* *\**.\**..\. **..*.* \*   .  ...*. . *#
#* .***..\.*. *\...\**. .*    ...*. .**.***.*.....\. .* * *.* *.** .\   .**. ! \ .. .**. .\* *....#
#! .... .**.*.**  .** ** \ .\ ...@*.*\ *.\\.*\. .     . . . ..*.* .   \..* ..  .*.***...\** * .*@*#
#   \.* *.\... *\.    **.* \ .\ .\ ..**\.\* \  \ **.\\. ..   *... . * .!\.**  *.* .. ** . \*.  .*.#
# .  *\*\ .   .* . .\*.\*. .**  .. *. . .   .... \ ..\.. .\***\ \.\ .  . *\.. .*.. *. .. ... .\...#
#  . \... \.* ..@. .\. *. .\....*...  *.\ ***\... . . * .*.**\...  * *  ...  \*.  .. *  \**\ *....#
#*.\.  *\..*.    .\ .. .*... .\. . *.*..**\.....\! **\..** .. !*\.**. *\ **\...     \*\***  . **\ #
#.\.**.\.*\  ...  ..    .*\.*\ * \\ ... .\.*  .\.\.*.*\.*@* ..*\ * . \.  *W\* \  ..  .  ..\..*....#
#\.\* . .**\.\ \   . *.\***   *\  .* .*\\ *..**. *  *.. *...*.* *.@..\ \.*\** .. *\ *.\.! .* .\ . #
#\ .\ .* . *\  .. \ . .. .\* *.*\ \. .* .\ ***. *. ..*\  .*.....\*. ..*... ..\!* \ *\ .. .*.   .*.#
#\. @\ **  .*.*** .\* *.\ \ .*. .* .. *  . .*  .*.\.*.*.. *.. *    ....   . ......  *\.\  ....\ .*#
#*\ **...\**.\.**..**@.*.!*\..*. ** * *\\\ .*\.*@   ..**\.*..*.**.*\...*.\...** ...*\.... ..*.\.*.#
###################################################################################################

Water 101
Flooding 3
Waterproof 18
Razors 34
Growth 22
Trampoline A targets 4
Trampoline C targets 4
Trampoline B targets 5