##########################################################################################
# \. . .. .... .*\. ..\*\ .. *.\.\* *!** .\.\ *.** \.*.. *.*. \ .* ... .*\ # #           #
#\..  \.\* .\\.*. \*\. ....* .\. *.@* *\ . \.*.*.* ..**.\.\... ... .\ *. \ ## ##         #
# .\.!  * ... .....\**. * . ***. .\ *.*.* ..*... .  \..*  *\..  ..\....  \.\.* *#        #
# .  . D..\*  .*.*..*. . \   ....\ *.*... !**. .*..* . * ...\  \  .**** ....#.\.#        #
#* ** *    *\..*C.\*.   . .     \.*\*..\. **..*\.*   \**  .\**  .* .\** *.*\.\* *###     #
#*\..!*\ \ **.*..\ .   *\..*.*.\.   .**..**..\.*.* * .. *\ ...\*.* *. .  ...\.. ...\L    #
#... .** ...\ ... *.*** ..**.*. .\*.**. *.* .* .*. *\. **.  .*..** .... *  . .*. ## #    #
#* *.\.*  *  *\..\.*.*.  \.\ .*\ *.. .B W.   .*... ..  *   .\..  .*..\. * .  \. \  *#    #
#. \ * . **.*\*.\. \* ..\..*. ** . .\ \.**...\*. * .  ..  .\. .*.\W@ *.*.\.\*@.#*\*#     #
#\\..*  *\. @. \ \.*... *....****\**. . *** *... * *.. .\*\.*\ .. .  * *  ..\.* \##.#    #
#  * .  ..\*..   .\.\ *@...   \*.* .9 \ . \.\*.. .**.*\ .* *.** .\*..  ..  **\*..!#..#   #
#..* *** * ** ***\***.*.   *.\.\*.  . .. .. *   . ****!* * *.....*.  . .  .\. *.  .\#    #
#.** .*. \ ..\..*.\*..*   .. *.**\ .\   * \***.. *.. .*.. ..!***.. .. . @*..   .#  .\##  #
# *.@.*......*.\...@\*.@..*  . *.**\.   @...\. .*\ *@\ .... \.\*\*.\ * .*\*...\.\.* .@\# #
#*..*\ *.*.*\.. *. . ..  \.     ..\ . . **...   * *\A* *.\   .\.\*  .\  ...  \.* *   .#  #
#..\.. .\*\* ** @ .. . .\. \. .  \. **.    .\ * . \..*..*....*.*..  *\.* @ *.  * *.\**#  #
#.*.\..   \      * .. ..*.  .* ...  . **\*.**   * ..*   *...\. .. .\.  .\. . .\* * ...## #
#....  *\..*..\ .\  \\***\ *    .* * **..\.*\..*\ .**\*\ . \ .  ! *..   *\. *\.. #*#.\..##
#.\*.**.. ..   \  ... *..*\. \..*.\* *.*. ..*\\* \ **!. \  ..\  *\..\.. .   \*\   *. .\# #
#.*... . .*. *..\ .\ .. *  * ...\**  *..\ ..*@.\ .. . *..... *...* . . @\.*  **.\#.#  #  #
# ..\...  . \*\ ** *  *..*.  *  .\** ***..\*.*.  * ..  .****R...** .\\*\..\. \#  .** \#  #
# . .\\.\.* .*  .* *...* * \...\.....\..\\ \.\  ..  ... *.. . *\..\*. ....* \...* #. *#  #
#. ..*..**E.. ***.\....* ..!**..  *. .*. *. .. . .....\ ..\**  . .*.*\ * .. @ ..#. *.#   #
#..  . *. ** \**.**5 \....... *\*. .* .  *..  **.     ..\*..\.  . ....*  . ***.*@\\*#.## #
#  \.. .....\. \ *.\* .**  .**.. .\... \*   ....\.*\. \  ..\***..*   ..  2.**.  .*...  *##
#\.  !  \...* . \.. \ \. .\  **\ ..  *  **.*. .\ \*\  .. *. .\W.*.* \..\  \..*** *\ ..## #
#. . *  .. ...**...* .**. .* ....*\..@ *..*. .  \.*.**.\..   .* **. . \**.\ .*... .\##   #
#. .\.  *.  \... .\* \**\ . *.......*\.*.*\ . \.. ..*  .\. *.\\.\*   .*\..*.  .\*. *\ #  #
# .*. .\...*.\   . . **. \ ..*. *. ...\.*.**.*. .***..\..*\ .   \ \*.*!.*..*.\..*...##   #
#.*. \ *..**.\.@. *  .\.*.  \.* . .  . .*\.*.*. *.. \.. ...  **.*\.. . .\....* .. # #    #
#. . * .*  .*   .*.. *...***. .. .* *   .* ..\. ..\ ..  .  . \*.7.    **.@.  * .\* .#    #
#*.\\.  *..**!.\*...*!.* *\.*.*.. . * \**\   *\ \*\.\* . *.*. .. .\.......\. .*\ . .##   #
#. . .*. *..*      *    *\.*\*\ * . \. ...!.*..*....  *\ .  ....   *    .\ * * . . *.*#  #
#. \..  ***..*. * ..\ .... ...  \ . .\.. .\...\*\. . .\*   . .\ .\  . \ \ .*.\ ..  .\.#  #
# ..  *\...\ *\ ..*.* \.*\...* ...*  .* ....  ..* . ..*.. ...\**.* \ .**\*\  .* *\.####  #
#\.\**  .  *.\ \.\*.\.. * .\* *   ..\... .. . \..* . .  ..*  * .*...*..*  **.\...   .#*###
#*  .\ . \***.*\. . *.\..  ** ....*  ***. **..*.\\  . .*. . ..\**..*. ..  \*\ **.*\.*..*\#
#* *.   *.. \ **.*\ \.. **\ .  .*\ .*..*.\*.\..*  .*\.. \*  .* \* *.\*\ *\*.  *\*.\#  ####
#*...*..\.\... \.     .\.*W*\...*   . ..  ***\ . ..*. . .* *  **. .* \.*.* \*\* .\ *...# #
# . **.\*...\ *.*\*.*. \.\ ..* ..*. *\ *! .*.*\ .**.\*\*\\ \ *...  *.  . \*.\.\\*** **#  #
##########################################################################################

Water 0
Flooding 0
Waterproof 14
Razors 29
Growth 2
Trampoline A targets 5
Trampoline C targets 9
Trampoline B targets 7
Trampoline E targets 7
Trampoline D targets 2