###############################################
# # #   #                                     #
# # ####\#                                    #
# #\   #.*# #                                 #
#  ##. .!*.#.#                                #
#    ##\.\.*\ #                               #
#     #.. *###                                #
##   #\ .#\*#                                 #
# #  ##.!..# ###        ## #   ###            #
# ###*## *. . ..# ##   #. # # #\ .#           #
#*.*#\.\ *  ..#\##  # ##. ! ##.# *# ##        #
#. .#.*.#. \!.#\.. # #*.#..*..\.*# # *#       #
# \ . .\* *.\  ..* .##.*@.#.. *..\###. #      #
# .\. . *\* .*\\.* ..***.**  .. *  .L.##      #
#\ ..\  .*.\ * ..  ...  \.* **...\. ...*#     #
#..*   .*. . .\. ...\  *. **.  . . \. \#  #   #
#.\  ..* . *. .**\.\.  #.*..*\ ...  #  ###.#  #
#\\. .\..\\*.*.*.. .*\**\ \ \*. ...***.\*#*# ##
#**..  ..   ..*.**. .* ..*.  *. *\*..\ ....##*#
#!\.  * *..  *.***.*.. ..*.\.\. *..\\ \ .## #*#
#\ . *.*    .. ... . *..*.   W **  *. ... *#**#
#**...*.*\.. ..  *  .. \.\ .*\\ *... *\   .#*.#
#..*.\.\*\..    ***..  .. . ..  .. . ..\.   *.#
#\  ..  .!*.    ****...*.*!*\*..*\.**\*.  ...##
#\* .*\  ..*  .\ . * *..*\\.*..\.\*.\...  B.\ #
#*.  .  .  . .  .*.*.*\ *.* ... .....*   *. .##
#\*.*. ..   * . *.**.*. *.\ .**.\ * \*\ .\.* .#
#.\*....*\ *.\ .. .*.   **.\  *.*  . ... . * .#
#. . .*....*\  ..\  W**\\... . .*\* . .. ..* .#
#.\..*. \ .*.. \*...*. *.*. * ..*.  . .\ \ .\*#
#.  *. .. \****.**A.\* ** * W\  .\ \*.\.*. . .#
#  *.\   .\*. \ .... \  .\*.  \  ...*** *\  . #
#*\..*.\..*.* *.*..  ..   \..*. **  W.\..*. * #
#.....\. \... *\ .\. \ **!.  .\...\1....*.**..#
#\.**\ * !*   .\\  * . *. \*\.. \   \@  \..*\*#
# .. . \ *. ..\ ** . * . .*\**@*.\**! *... *..#
#*\*\.\...\ .* ... .....\..  \....*.  . *  \.*#
#  .**. \**. ..*.   .    ...*. .  . *..!. .! \#
# * *  *..\. *. * **\*...  .*.   **\*\.*  \ \.#
#*\*. .\*.**..\*.\.. . . .... *  . ...\ *\.*. #
#\.* *...\.\.....* * * . .  *...  . .*\ @. *\.#
#.\*..  .\.  .\!\ .*  .. . .  ***\* . ...*.*.*#
#. ..*** .@\.\*\    . .\..* ....*. \.\ .*.*   #
#\. *.\*\.**\ .....\!..**.@ \ *\.  . *.\* . . #
#.*.W*.. \.*...*.*\.... \ .*.\*.\ .*.. *...* *#
# .  *.*\.*..  . . \..*.. .**.\.**\....\.*.. \#
#*..*.*\*\* \.\ *. .. \* ....**...  *  .\.* ..#
#.\ .*\*.. ..\*   **. .*  . *. .\...\ ..* .\@*#
#*. \*. . \* ...*..*. **  .**\ .**.\ **\. .*.*#
#.*. *. ...**.\*\.  ****\ * *. .*\ W*.\ ..*\*.#
#..  \*... .  **..\*\. * 9.*.*.*.\..\. *\.*.* #
#\**..*.\ .   *..*.* . .. ..*..* ****...** .\ #
#*.\*.**   \. *... .. \.\.  .   .**. . \..*@.*#
#** *.*.\ * .*\* .\..*...\.* W ***.  . .. .*..#
#\ .. . .*.  ... \.  **.\.\*  @*. \**\ \ .... #
#...*...* .\ \  ..*.\\  *.*..** \...\** .*  . #
#\. . *\*\ . .\ *\.\. *.*\.*\.  .** *.*****\ *#
# **  .. *\.     .\. .\*\  .***  .*.. ..*..\ .#
#.\.\* . ...***\** *.*..*.*..*. .\..\..*.\ .\*#
#\*. . \* ..* . \.\. *.\**\ **... *\ *\.  \*..#
#..** *... *.  .  ... **! !  *\* **. ... .... #
#\.\.*\..*..  .\** *\ *. \. \. ...*.. ** . .\ #
# * ...*.** ..*..\  . @ @    ..* .\ *.. * .*.\#
#\... **.*.\  \  *.   . .. .  \  .*.**\ **.*. #
# ..*...*** **. *\ .\.*.   .*..\.* *.\  ..\.*.#
#\* ..  .*.\..*\.. **\*. * .\  ...** .*  **..*#
#*.. *** \\.*... \ .\ . . . .    .   .*\*** \*#
#.   \.\. . \**. .** * .***.*.*\***..  . *.\W*#
#\  . *...   ..   *\.\ \.. *..*...  \*.\..\ **#
#.*** .*..** ** ...\***.\.*.* .** .  .. *  ..\#
# .* .\. ..@ ...  *@*\!.*.\ .  ..\ *    .\* .*#
# .. **..\.. .*.\*\..*.\* \.\ ..**.. .*.\*.\ .#
#*  ..\ \*   . \ * *..****...*\ *..* ! . *\..*#
#   . . ..\*.. ..\ * * *\.\ .* ..**.. \  \.**.#
#\.  .*\  \.****........*..* . *\*.. ...*. *.\#
#.* . ..\ .*.**.@\ *\ !. * . .* . \    .\ **\*#
# *. .\. * . ....!*.*.*. .  *  . **.*\.\ * . .#
# . \.....  \* .* \.\..   .**\.* . .\  ..\ .* #
#.\\  \.        .\....*.* \ W.  *..\.\*..  * *#
#*  *\*  \  .* \*  .\ .*.*. .*\.*\ ... *..*. .#
#*.** ..*   ... .. .   . * . !   ..*.  \ **. .#
#*.  \ *\ ..\. \ *.@.*.\ ** \ .. \..**.\....* #
#**.   ..*.... .*\. ! ..\..*..**\. ..\.*. \.*.#
# . . **...*.*  .  .. *\ \.**\*.!***\. . . \. #
#.. . *.. *.... .  . \@*. *.  \*.*.**.\. !..* #
# ..* *.*\.   \  \*. . \  \    * *...\** ..*\\#
#**** \ **\ .. * .*.*\\ \.. .* * *..*!.\ *.. .#
#\*.  .\ *\ \*\.*\ !..@.\    *.* .... .  .*.**#
# *. *@\    ..*\.  .. \ *\  **. . \..** .***.*#
#.* ..\*.* **  *\ .   ... ...... *.**.. *...\.#
#\. * . *. ..*..*.* \  * * *   *.. .\ .....*. #
#.* .\ .\.*.*. ..**\ .*  \*.\.*. . . *\  *.\*\#
#.. ! *  .. \.\ \..  .\.*..*   **\*\ *  *..\..#
#.\. ** ..\*  *.. .*  *..*..\ ***... . *.*.  *#
#...***@\... *.    *...* . ** ..*.\ .*\*\.* * #
# . *.*W.*.\ ** .\\.. *.\*\*!\ .*  \ *. .\  *.#
#. .**.* .\.\...*..\...\*\..\ **.* .*...*.. *.#
#.*.* .*  ...* *\  ** * .*\*. **\.......!***.*#
# ...   \. *\.*\.* \ *.   *.\ .\..*\. .\ .\***#
#.\ \ . *.... ***.\*    ..*! * .\*. .\...*....#
#** .*\... .**..*\*..*\**W **\  *.. ..*\*. \.*#
#**\..* \. ..\... **.*. .\ *.* *... \ . ..*.**#
#.* \*.\ *\.  .. *\.**@.* .\*\ . .*  .* . **. #
#\... *.. .*   . ......\\. *\ ..\ *\* \\*  . \#
#\* \. !. **\.\*..\@*. . *...\  .*.\. .. \. ..#
#.... *. \.... \   .\ . .**.\*\* **.\**  ..  .#
# *\  .**.\.**. *\.\. *. ..\*.*  ..*.... **  .#
# ...  ....*.*.\* \*\ \ . .. .. ..*\ . * .\.\*#
#**   .\ \*** *\ *.  ...\.    * **. \* *  * **#
#..\.*  \.\*.\. .\!\..**..  **  .** *. ..** .*#
#  ..\**  \. .\  ..**....*  ...@  . \**\*... .#
# \.**..*  \ ... .  .*\*..\.**....*. ...\ *\..#
#.. .* \\ **\.* ...\ \..*. .***\*.\ .  *. \.* #
#. . *..* ..* . **   .\ ... .*.*. . * *.\.. .\#
#..  *\**.  ..\* .  *** . . * **.  ... \*...  #
#.\.!. *R..\ . .  **\..*.* *..\.\ ..**.** *  .#
#..*\. .*\  ** .  \... \ . *. *   *... *. .*\ #
#.**\*.***.....  *.   .   ** .*\ ..\ . ..\.* \#
#.*.\\*.. . *.\*.*.  \ ***...  .*.\.. .\ \ \..#
###############################################

Water 0
Flooding 0
Waterproof 18
Razors 38
Growth 46
Trampoline A targets 9
Trampoline B targets 1