###########################################################################
#                #    #\#                                                 #
#               #.## ## @##        #                                      #
#              # ..!#.# *..#  #   #.#                                     #
#      # ####   ##* * ....*.##.#  #*.#       #                            #
#     #.#\*  # ##*  . **#*W.*\ #### #       # #                           #
## #  #.@ .. .#\*.\\   ....*. \. \* .##     #..#                          #
#.#.####**.. . #\#*\#   \ *...#.#. ##  #   # . #                          #
# ..* * *. *..  # .*\* ..@**...##. **  #    ##**#                         #
#*   ..  *.*.\ *.*\. .\*..\** **.*\*.*#\###   #\.#                        #
# \** \#\. . .\...... .. \....*.\. .*\#*\.!##  #\.#  #                    #
#*...\!\. \.. ...*#.#  *.. *.  .*.\!\*\* #*#@##.*..## #                   #
#\.#*..W#.*\*.\. .**** * .**.***\..  *#.\. #.. \..#\...#                  #
# . @ *\. **.* *.. *.\ \  . . \.* . **# *.**.\* * ##.# # ##               #
#*. . ...* *\*. * .  ..* \...*. ..    #  ....*. .**. # \#  #              #
#\  \. \ . .  *.* *... . .. .\* . ....#\*\**.@...\.. *.##L *#             #
#.   .. *. .  ** ..** ....   *. .  .*  .\*  \..\** * *\#.\.#              #
#   .*. \*  * .   \.\ . . **  \*.**\ \*.*#*...\ ..*.... ...#              #
# .*\. \..*. . * .. *\   . .*.. *\* ..*\.***\.*   ..#.*! .*#              #
#..\* ...***. *\ .   . .* \ *\.!\** *. . \* \*  . * @..*.#.#              #
# \ * ...*.**.*. . \.  *\ .**...*.*....*\.*..*\*.\\****...  #             #
#\..* *\*..*.*** *\.* *\  .... *. #.*.   ..**\. * ...*** . .#             #
#..*@* *...*.* ...**\ .\.*.. **\ . .  . . *.*   **.*.***##\#              #
# *. * . \.     ..**\* *...\..\*.* \.\ \ ..** ..\\* * ..**#   #           #
#... ..*..**\..\  *. ..*\ * **.. *\.* ..   .**\ \.***. \.*.###*#          #
# \. *\. \.*.. ..\***.***\.***\\  . .\*.*\**.\.  \** \.\ \. .W.#          #
#*.\\\*  ....*.\ *....**.**.... *  *. ...*R *.*. \** ..*\## *##  #        #
#..* \.... . *\.* * * .. *..*.** .*..*.\.*.....  .  . ...\  * # # #       #
#* *  *... *..! ..*.* .\ .\ .*.* ..\ ...*.\. *\.  *.* *..**.A#  #.#       #
#\...*    .  .\.. . . . ..\\*.\\..  . \!.\. !.  .*..* .. .*.*###**.#      #
#.*.*.  **.* .W.* *\*. .\ ***   *. *  ! *   .  \.\ *\. *.\.*.*\ .. *#     #
#\. ..*\.\...*. ..*  * .. *\*. .*  *... *  ***\.... .\ .*.. ..*.**\####   #
# \   *\ .\\ .*\*.*.*\.*.*.*\* *\. . @\* . *...\.. .* . ..*.. . ..  *  ## #
#.. . . *.*\.\. .@\.\..!\**.* ....\*  *** ..\.\*\  .\*  * .*.*     *.\.  ##
# *.. . ...... .\\ ..* **. ..\ *\\*.\ *.*  .*.*\ . * .  **. *. **\\!.\*. ##
#..  *. **.\ * \..*\ * \*\..** **\.*.  ..\* *\. .\.*.. .*.* \\.*..*\..*. @#
# \. \ ..\ ..*  \ .. *. ..*\.*.**  .\..\ .. ****   .\.* ..*\..*.. *..#.. ##
#*.\..\\*.   ..... * .\ * .. ..... ** .* . .. *.. ***    @.  \* . \*. !\*##
#2..\ . ... *** .\ .. .\..\.*  ..  .. *.W..* .* * .* .\* .    .*.\*\  . .*#
#.\ . . \.*\*.*\ .. \ \..*\ \ . .*. \ .* ..**\...  *  .* \**.\*.*..*     ##
#\..  .\.\....\ .*.*. *.\\..  \. .*..  .* *..* ..\..\    .*.\. ..\*.\.* *##
# @*.\*.. .\ \.* . ..\.\\ ..\ .\.\*.*... ..**!**.! ..*. **. .\*.*.*..\*\\##
# \.@*\..\ *  *. \.  ..*  **     .. \ **.  . @.*.\ .\ * .   .\  .*... #  .#
#\.**\..**.\.*...*..***.\.*. ... .  .. . \*\.*.*.*    * .* *\ ..**# . ##\##
#*.* .***.*. \ ..*... ....**.\.. .*\  *  ...\*..\* * .. *.   *.*\ .  ##.# #
#* .*...\   !...  \  .*. **.\*.*\  !. . .*.\ . ..   *   *.. .. .\ !* .*\# #
#@  .*.@.*\ *. \.  \.*...*..*.*. \**  *. ***. *.\ ! .   .\.. . .. .*\ *#  #
#. \**.*\.*...**  .\* \*\.\ .*.   .** *..\**...*.*. * **  *\.*\ * .*@..*# #
#.  ..\*. .\.*.   \*. ..*.. \. ***.*. ...*@.\  . .... ...*.\. ..\ * .*##  #
#....*.\. \ *\ *. !\. .. * .  ***... ..\.***...\ ..*.   . *.. .\.!\\ **#  #
# ..*\. .. *. ... .W..*.** ....\..*.*\\. .*. ...*...  \. \.\  .*. ...##   #
#\\!..***\.\*. .!.\. *.\.\**..  * . .\ . .\ .  *.* .. \. W.  \ ..\.\#     #
# \  * ..** \ .  ...*.*. .... *.*.*\ .*  ..   \.*.\ . .\  \..  *\ .*##    #
#*.\*.  ..\ \ *  **\*..   *.\*. ****\**\**  **.**.. \**..\.  \.\**.*  #   #
#*.* .*  .*\*\.. ..!\**  **\. \ *.\.\.*.*..*.* * .*  ..       * *.\.#..#  #
#.\.. .\.*.*.. * **.**!...*  !  \...** \.\ \..*.. *\.*.\..\ \.. *\*.\ *#  #
#.*. *.\.. .\.*. ..  . .\ .*. .. ..\\....*  ...*.*.  * .* . **  .*.  ..#  #
#*!.. \.   . ..*.\...@..*. *. * .***.*.\ *   ..*.. \.  .* .*.*.\**. .*.*###
#. **. ** * *.*..** ..  .* .\..* \.****. .  **\..* * ** \. .*. ..   \...\.#
#***.\*.. *.\*. .**. **  .\.*.\ ..\*...  .*\ @. .  **..*\.*\..*.   ..\.*.*#
#...***..\ ... * *.** * *.*...*.   *\\ .*.** . ** \ *. ** \.*.\*\ *\*.*.###
#  @. . .*.\. ...*\.*...*.*..*..   *.*.* . *\ *.*\..**.*..**. ..*.. .\..#*#
#..*... \..*\**.    * * .**...* .... *. .  *.. \.\*\ \\*.@\.\ * *.* *.* .\#
#  .\.*\. ** ... .\.\.\.....*.\.\***..\\.\..*\ ..*   .*\ !*..   ..*\*\ ..##
#**...@*  \..\\.\*...\.\. \ * . *.\\.\.\. . *@ *\..*..*!  *\ .  *......\.\#
#.\. . \.*.* .\.* **. *.  ..* . ..**.*  *** .. ***\*... ...  \. .* \  \...#
#*. \.**..... .* *......** *    \ .\***.*.*   **.*  .  **..\ .\\.\...*.*..#
#* * *.... . . \  \ ... *\.\ *..!* .\.*\.*. .!*. *\ ..\*****... ..*. .\.  #
# **. \     . *** .\.  **.... ...*    .. *.*@*...***  ...\.... .* . *..*.\#
#**\\\..\**\*.*... *.**\.. .**.\*** ** \ .**.. *..\.@..*.* \* *... .***.. #
###########################################################################

Water 0
Flooding 0
Waterproof 9
Razors 23
Growth 4
Trampoline A targets 2