################################
#  .**@. .. .  . .\..#.  \. #  #
#.\  * ..*\.*.*    .. \... \.# #
#....*  **  ***.* **.\.  \ . # #
#. *** \..    .\. .****. . .#W##
#. .\.\..\.*\.* *\  .\..\  ##.##
#  .*...  .**\. ..\ .*\  #...\.#
#   .  \* ..** . *   *. .\ #####
# ...\* .*. *. ! . .* .    *\*##
# .    . .\ .\. ..  *. \. \.*# #
#  .. . \.\ . \. .*** *.\.!##\##
#  .**...  *.!. .\ ....**..#**##
#\ .R.  * \.. * **.*.* *\ .**# #
#*    \..*.. .  \\ * . \ ....# #
#*.. ..*\**. . ...***  .  * #  #
#..**\.****. * \ .  ..* \ \ #  #
#@.*.\*.*.\  *. ..**  .\ . *#  #
#..\. ...**.\..\....##* . #.#  #
# .. .*\.!. \* .. .*  \ *.##   #
#.\*. . .  *  ... .*...*..#    #
#*..\.\** !...\ ..*.*  . #     #
#* .**  .  .... *.*\.. \#      #
#.. .. ...  *. \.\** \. #      #
#. !\.!*.  .*. .....\. .#      #
# .*....W  . *!  \* * **#      #
#  *.*.*\. * *.*. #\...*#      #
#.\...*.* .. . \... #\..#      #
#...  *.* *.*. \ \ *#  #       #
#.*  *.*. .*...#*##\##.#       #
#.\*..*.\* .... .##.# #        #
#. *  .* .# . .**# #           #
#\*** *.*#. \\###              #
## #\ # . #L .\ #              #
#***# #*\##\..##               #
##**##.\##..#*#                #
################################

Water 0
Flooding 0
Waterproof 12
Razors 33
Growth 44
