##########################
#. ..\*....\.. .   .**..*#
#\.\.*.   . .   \*\*..*. #
#... ..R.  ..*. .* \\ \ \#
#..* .*..*..\  . * # ! *.#
#@..  .*..**.*\ **  .....#
#* \ \.* *\.* ..  **\  *##
#    ..* \*.. \ ..*....# #
#\..\...!...*  .*\.\@ \*##
#.. \  *\  \.\. ..*\..#. #
#\...**\..*.. ****..    .#
#  \\! .**.. !.*...*#*\L##
#*\   * *  .\ \*\  *###  #
#*..\ **. .  ....#*#     #
#\. .*.*\.\. * . #*#     #
#W . @...*    *\.*#      #
##\  . *\ ****.*..*#     #
#\.\... ....\ .\..#      #
#*\\..*.*... \ . \#      #
#. ** \ \.!...\**.#      #
#.*.. . #* \** \.#       #
#*.*... .. * ....#       #
#*#* \  \. .  ###        #
#\** .. . .\.@#          #
#.**. \ #   .#           #
##...*.# ## \#           #
##.\#.# #.**#            #
##.# #   ###             #
##########################

Water 0
Flooding 0
Waterproof 6
Razors 45
Growth 23
