#################################################
#           #.\##    #  .##.#  #                #
#          #*.*..#  ##\.\ #.*## #               #
#          #.\*@#  # .*. ...**# #               #
#          #*..\*## \# \.B*.... ##              #
#      # # #..*C..# #. #.\# ## #*.#   #         #
#     #*# ##..\.  \ .  #...*..* #*####.#        #
#     #..*.#\  .*...#*... *.\.*.#.#  * *#       #
#   ##  *\ *.#\**.** \  **.\**\\  ..\.\ #       #
#  #** .\D*..... *. .\..\. ..\.  \ ....# #      #
####*..#. #*.\.* *.\.. .. .*.. * *.  *.*# #     #
#..\.#*. \ .#*..* .. ..    . *...*\... .#\.#    #
#\.*. . **.\*.* .\\\.*. . .. . * . . *#*..*\#   #
#### .\ \\  \   \*  .*\ \.  .  . .**\...\.##    #
#.#\.3**..*  .\....\.\...\...\\  ***.**.!\*.#   #
#. .  ...\. *\.  ..  .*..* * *\   ...*\ *...##  #
##\..*  *5.* .!.*..A...\. ...*..*\ **. .*.# **# #
# #*#* \.*.\**..\**\*..** *.*. !\. !*\. ..*.**# #
#  ##*\.*\ *..*\..\.*. .. .\**\ \ .\..**  ...*.##
#  #\* *  *.... \*... R.\*.*. *. ... \*.  \ \*  #
#   ##\...\\*\**..  \.\*.\.@\.*.**\...\* * .#.###
#   ##..*L. .*\@****.. *. .*.\.. .*..*.**.  ...##
#  #.  *. .. * ..*... .*\  ...\. \\.*.\... . .\##
#  #....\ \. .*\... \*..\  *.** .. **.*. .* \*# #
#  #..\* * 4  . *\.*...\*. * **  .1.* . . *\ *# #
#################################################

Water 9
Flooding 0
Waterproof 10
Razors 49
Growth 11
Trampoline A targets 1
Trampoline C targets 3
Trampoline B targets 5
Trampoline D targets 4