##############################################################################
# .* . * **   \ *.***.* * .\. *** *    ** \.\*  **. .   .  ....*. ..*..*W\ **#
# .. \ *   ..*..  ...\.\..  .\*\ *.\...**..***  ...... .\.\*.@\. **\* .. . . #
#  * .\ *..\.*\..*\**@...\ .....***.. *..  .\*..*.\ ..   .*.\. *\.*..*.  \. \#
#* \ ..**  .     ***.*. . .***.....* \@.\ * ...*..*. \\ .@.*.* .\ . *..*..\ .#
#. *  ...   ...\ .*\.* **.* .\. .**.@\. .**  ...  *\*.   *. \.*\. . \.*.*..\ #
#. *..* . *\. . * . *.....\ *\ .\...*. .\ ...* .. **.\*  .\*. \*.. *  *. ...*#
#. .\ . *@\@    *\.\. . *.* ...\. \. @  *.\....   ***.**..*. . ... A. **.*\ .#
#  .... * .*. **..!..  .*   .* .\ .**\*.*..   !.. **\*.*. *.. *\.* * *.. . *.#
# *...\*\...*. \ ..* *....** ***    .** ...\ *.\.*. *.....\\ \* . .  . * \.. #
#. .  ..  * .@.!*.*.*. ***.*.****.* *.**\.** . .**..*\  * .  ..\.  \..\.* \..#
#* \.*\   .. .   .. .**. .\  ..*.\.*.*\.* ***. ...*.\ .*. *  . .*..*...\.** .#
# \. @.*...   *.\ ...*. *.... .. . **.*  .**W* . .\. . ... .*.* .  7**.\ \...#
#\. *...*.**..*\* . .*  .  *  *\.\.. .*.. *..*  .*  * **.\...*.* . *..\  ***.#
#. .. .*...  .... .. * *.****..*.     .  * *..   .*\\ . \ \ ....* .**\ ..*.\*#
#  ..*\.  * .**W...\ \ . .*W*.\.\.* * *.\*.......**  **.*.. .*\ . * .* **.*..#
# .* ..\ ... .*\**.*..* W\ *** *...\...  .* *.*\* \ **... *\...\. \  . .. . .#
# *. !\ \  ..***... **. ....**  *.*.\ .  .. *\. \*..*.\ * **\.* .    .\... * #
#!. \..  .   *. .\* \.\ **\*\* .  .\ .\*\.\....  *!.*.* @.  *\. . **. .*. .\ #
#  ..  **\.  . . ....**  ..  \.. . . ..***.*@.***@. ..\\*...* \  .*  .**!.\..#
#\.\\.**.. .\ * . . *.. . \\.\ .*.*\*   .. .*.* \.*** **.. \**. \\. *\ \.\. *#
#.**. ..\**   .\   ..\ .*. .  .  *. .*.  . ..\.\. 4*.. .*.*\..  \ ..*.. .**.*#
# *.\  *... \.* .\  .  ..  * . . ... ***.  .**. .*\. \  **.*.. \* . . \.\W.*.#
#\..!@\..  ** .\ * ...*\ * *...*  \*@.\** * .\. \. \...\. .* *.   \ * .*. .. #
#.*.*.*\. ..   *. \ **. . ..\**. .\.**.W.* *.. .*@   \ .\ .....*.***.. *. .  #
#.\ *....\*. . *. .  .*.* *....\ ..*.*\\ \ **  .**.* ** .* \  ..*\*\....  .. #
#\.**.* *     ..*\ *.. ..  .\ . *\.*....  ..\*. *..* .***... .*.*.\*..C\ . \ #
#.* @ .\*  * *.*. .*\* ** .* ..    *.. **\*... .\. .\ .*\..\ .*.*.  .\..\*..\#
#\* *\ .\.\.  \.  .. .. .**.*\  .... .**..*.  *....\* B*.. *. .*.*\* . * \...#
#*....\\ .  .*. .*    . *.  *.\. ..  *\.*\... *.. \*\  **. .*. .  ..  @.\**\ #
#.*  *..**.\ .*. .\* .*..   *. \.. *.\*..\    . *\ W. ... .....\ *\.\..*.** \#
# !\*..\ \ *.\   ...  .\.**\.  * .*.* *\.*\ \.     *. .   *\***..* *.*...\.. #
# .*..  \ ..\*..*.\ .\ . *\.. . .*....\.\*. .   . ** .* .*\ \\ * * . \* \.*.*#
#\ . *  ..*.*****\.\. . .*..  ..\**. *.....  * .*.**.\.\... ...\ . * .. .\   #
#. \. .   .\*.**.@. . ..\.*. \\. .. @*..\*..*. ****. *\..  .*..  * .    *..\ #
#*.. *.\  .\..*.**. * **..**\*  \ .... **.\  \ *..** @* \ \ . .*...* *..* *.\#
#. *. .. ...  .\. .*\.*..*..* \.\. *...\*.. *.   @ **.\ .* *  .***.5*.  **. .#
# \ .** .   . .*\...!*...*...*W *.*\ . .@.*...\ .*.*.  .*. * *\..\. . \..  . #
#  *.... .\*  . @  * .*\.*\  . *.\. \.. \ *\  .. \* . ...  \... \. .*.  *\ \.#
#\** ..*.  .\\* .*.   \* \.**..**. * ..  \.*\  \ .* .*.\*  .\* ...\ .  .!.  *#
#.\.  **...\  ** . . ... . ....*.@\..   .* .. @ .\** .* .\.   *.!  * *.. * \.#
#**.* *....*.\ ...*..*.  *. \.*****\* .*.. *.** . *   *  . @**!D.  . **.*  .\#
#.. \....\..\ *** *\ .. . **.\... . . **\.***\ \ .  .\*  \ .*. ..* . .! \. .*#
#.\ .* *.*.\ **.. *..*..*\*.\!.* *.\. .  \.. * *.@!\. .*  \.**   .*  *  .\.\.#
#.....\*.**. *.*..\  \.\. \ . .. . *.*.*! * .. ..  .*. . \.*..* *\..*\.  *.  #
#\  .*  .* **. ..*** * *.*..* \*\*. .\... .  *** .   .  .. .*. W .\..    ..  #
#  . *.  \ ..W.. .. .. ... *   **.\.* . .*. \.....\ *****.\ .. *\.* **. .**..#
#...*.** ..\.*\ * *\* ..  ..  .\  * *.*. .. . \* .*.*..*....\  .  .*...  \  *#
# .*.\.\  ..  \  *..\.   . *.* .* ****\. .\    ..**.* .**... *.* . ***   ....#
#..\\.*.. \ ..  .*  .     ..@.  \. .... .*  * **...\*. *.@. ...\*......*\.   #
#.\ * .. .. .. .\* .**.. .  *.* .*.\ @... .\*..* .. .*..***\.*. ..\*\  . \ . #
#\..**\**. \ .  .*.* .  ***.\.  \.*..  ... \*  \*.\. * *.*.@.*.\*\.* *.*. .. #
#*  .\ .*\* \. .\  .. ...\ \.* ..*.  \\ *...\*.\.  ..*.\.\*... *..\**. .*  *\#
#.. **.\.*.  **\ *. . .   * *.\* .  *. .*. . *\.\. . ..*.W.*\ ...*... \*. .**#
#  ..... .*.....*.\.\\ . \... ***\ \.\.\**** .*..\.  ...*  \ .*.  *\  ..**...#
# .\ . \*\.. . \* . **\\ . . ..  **W..!\**\.  .*.. .  . *. .  .** ..\  \. **\#
# *#....\.... ..*  \*..... *.\***..\ * ...*\ \**. ..* .*..*..  .  .*\. \ * . #
#*.*  ...*. . . .**.*....*.\.. *..*\ \ .*... .**\* .*\*...**\ .\\. . \!*.  # #
#\! .* ..**   .*.\* .*. @ \. ***\*..\*....\.\.. .@ . ..   .***\... \.\ .*  #\#
# .. .*   .** .. ..  .\ *..\....** \.*..*R*   *.*... .\.*. ..***.\.. *.*. .###
#*** .. .   .  * ...* ...\**\..\*. . *..* *..*.!*.*.*  \ . ..***\.*. .*@\.#  #
#\*** *   .*.\***.*.\!.**.*. . \*..*.\** .*. .*@\ *.*.*.. . *...*.*. *.*.#   #
#..*  . **.\***..\**.  .\\*   *.\\.\...* .*   .. ..#.*..*.  .\* *... #*.#    #
# ..** .** ...**.@.**.@.*.. \..*\...**.*\*.  ** ** * .**@.* ..* .*** \*##    #
#\#\**\..\ *\\.\*.*..*. ..\ . ..... .*.  .*\*.*  *\*. *.*\.  *. \.#.\*.*\#   #
#.***.*.! .  **!* .*.\ \.* *   ***   \. *...*\..###\.*. \.  . ...*** \**#    #
#\*..#.@.\. *\*.\*.*\* .** \.** \. * . *** .  *#*.##*.\ .*.*.*\ . .** ##     #
#*.*** *@* .. \** **** ....*..*. \ *.* **. ...*.. *. #*#\\*.*\    *.** #     #
##*\.#*\*. \*  .. . ... .\..   \*...\*  *.... !**\.#**  ..**## .****.##      #
# # .. ..*.. ***\...\.*.*..**** .. \ *\.\ .\ . .*  \#. *\.## #*. ..*#        #
# #\*@\  **..\  .* .***... ...  \  .\ .\ .**  *.# ###..# ..# #.. ###         #
##!*.. * **\ . \..*  .\.. . ..  .* *.@ . . ** . *.*#  .\ ..# #@***..#        #
#\**\ .\...# \. *..* ...#  .\  ..* .*.** #\\ *\##...   #*##  #.\#*##         #
#\.   .#!*\*#*     . \  .  .....\#\  *.\**  #.. ###*\..#.#  #.\ .#           #
#* * . #*. *#.* \.*. .\. .*   . . ##**##\. *...\#  #*.#.*#   ####            #
#*###..###.*##*\ ##..*   ##.. .  # #.# #**.#####    #*###                    #
##   #.#  ##\.** ## \\.*.##*. \#*# #*#  #@.#         #                       #
#     #    # .*#\.##  .#!#*\.\. #  L*#  #*#                                  #
#         ##*\. . # ### # ##*..#.#  #    #                                   #
#        #**.##.#.#         ##*\ #                                           #
#         #*..\* \#           # #                                            #
#         #*######             #                                             #
##############################################################################

Water 75
Flooding 7
Waterproof 9
Razors 1
Growth 38
Trampoline A targets 5
Trampoline C targets 4
Trampoline B targets 7
Trampoline D targets 5