###################
# ##\*. *\  .... ##
##.L. *@** .  *.*##
# .\* *..C**R*\**.#
## .#\   \..**...*#
# #  #*#*.*.!*.  D#
#  ## ##\*!* *. *\#
#      #*\.4..\ ..#
#     #..*.9... ..#
#     #..*.\. **\.#
#      #*..#* B2.*#
#      #A## ##.*# #
###################

Water 0
Flooding 3
Waterproof 17
Razors 43
Growth 13
Trampoline A targets 9
Trampoline C targets 2
Trampoline B targets 4
Trampoline D targets 9