############################################################################################################
#\.\.. *..  .. .\.\*\\... .\    *\*.* .*\.  .  . ..*. .A**.. !..*\*.. .\.***\..*  *  **.  ..\. .#          #
#  ..\. . *\ *. . ..   \.\\..** . ***\\..   .*.*   *  * .*.** \.. *\.\. .D*..\*  ****..*  .*. *..#         #
#  . . ** .*.***  .  . \R*.\. \**\*\...\*.*\**\. .\ .\.  . @.. ...\   . .\**    .. \.\ . .\ ..# .#         #
#  *. .*.\ .. .\ .*. .....  *...  *  \.*\ ..\. .. ...* .* .. .\*.  ..\**\...  . * ..\..  . .\#.\ .#        #
#  .**  .  .. *.. ..*.* .**.\. ..!\.\.\..* **. *. .   .*.  **.. *   \...*.*. *\.. *\...**** * .#\*##       #
#..*\ . .\@*.  ** \..*\* *\ *.**..  .  ...\.W****...**\. *\ .  *\.*.*   . . .\**  ..*.  . !*.\   . .#      #
#  \ .. ....\. \...\ . **\  \...*****.. *...**\ . .*.... ..*\ .* .\ ..\!*.\  *.\ \...  .* *.*. *  # #      #
#*   **..  *.W*  ...**.\. *  . ...\*.*..  *.*  ....  * .*\*\*. \ \.. * *. *.*.  **@ . . ..\....\..##       #
#. .*..\* ****\ *\*.. .*.!\.***.\*.....   ** *.    . .* .\. * \***  \.* *\*.* .*... \4  .  .!\.*## ##      #
#.  ..  *..\.*.!....*.. ... ...\**\.\... ** .W*  * **  ...  . ....   .........**.*\*..*  ..** .\* #\*#     #
#* .  . .. *\*\ \*...*.\... *\*7**. . **..\ !.*. *  . .* .*\*  \@.  .*. * \\*..\*.....* .\**....  *.\## ## #
#. ...  . ..  . ....  *. .  **.*.**\*..\ *. \ .\..*\* *.   * *..***. .. .\.  *..*.  ....* ..\ !*... .  #\ ##
#.*.!\ *  ..... *.*.\.*   .*..\. .* .*.*\ *  *..*\* *\*  *\.** \*..  \..\ .\.\. .* .*.\\..  @ .. .@.* **.# #
#*.**. *\**.  \ ..*.  \ *.* ..*  ***.*........ .\.\   .. * .....*.\.**E..\*\*.   .. .....  .. .# .  . ..####
#**. . . .*.*. *  \. \... .   ..\**\*\*.. . ** .\.....!....* .**. * \. *\ ...5.\\.  . \.  .*.  *.. ..\ . .\#
#.*..*..*\*. **.*.... *.  . \\ \.\....\..\. .*.  *\ . \. \  .  .*... . * . *  **..      .. .. *@*\. \..\#*##
#\*.  ..**. ... ...** ..  .*.\. . .* * *\  . .. . *  *.  . *.\. ... . .\*..\ *.**.\** \*.    \*\.! .#..# # #
#.**.....\\. ... .\.  \. ****. \ *.  .*.  **. *.\.* .\.*..\@.* . *..   *. .  ...\..\. * .*  .....**#  #    #
#*..*.\.*. .\\  \ .   . ..\.**. **\ @* \.*\   .** \.*. ** ...*\ *..* .**.**  . . . *@ .....\.\   \.. #     #
#..\.\ *.\.*.  *..* *.. ..* .F    . \. @*..  . .. . *.\ * .\.. * *.B.*\* \\.*\  ..\.*\... \* ... ##*#      #
#  .. \ *. .\.*\.\. \*\ .  *!.... \..  *. ..\.  .**\. !\\.* !.\\\.\ @\..... .*. !\  .*.*\..\ *\*.\@#       #
#. **...   .*.**. *\ **\  .\\.\ **.\ .    *\ .\ .\.*..*.* . *. *.\...  *.. . \*....****..* **.**..#        #
#  *.\**.***..*.***.  * *\   .*.*  *   *\ @*..  .... **\..* .*****.\   !\\ ..\.! .*.*\.  ..*....\.#        #
#   . . ...****..****\* ..*\*\.*. \*** . *\*   .* *\... *\\**.. \. * *. \ .\* .. *. \. .\ *..   @#.##      #
#..      .  . . \*....   .*.   .* .  *. *. .\   .**. *.   .\.\ *\*..\** .***.* ...... . **.\.* .* .. #     #
# *\. \   *. .*... .**. .\@ ... *   ..**.@. *  * .\  ..\ .* ** **... *** .*..*..*..\.\ ...!... .\ .  #     #
#\..*     .*. *\ .\.*..**.\  . *..  .**. \*.\.\.  *   \ . \  . ***..*\ .  .*.****.*   \! .* ! .  \ \* #    #
#*  .*.    ...\*.** @..\* * . ..\  ..@.. * \ . .. . ..* * \ ..**\.  .    \*. *..*.. .**.  .  \  !.\.** #   #
#  \ .*\.  .*.   \.*.9\@.\. .\. ..@*\....W *. .  * ... *.\*.. *\. . *\*** . ...\\ ** **  ...   **. *.* #   #
#.. *.\*.\*.*\ .* . *   .* .  . \.. .*..\  \   . ....\ ..*.*.*... *.**.\@* ...*.  .\ .. *\* \  .@. .*##    #
#.*.\ .*.\.*  . \.**  \ \ .*. *\.*\. *.   ....* . *..\* *...*.*\ \.*  \ . \.  6.\..\  W\..*.  *\. #*#      #
# \.** **... .*.. \*.\ *.**. \.*...\*\.\**.. *.  *.\..*\.\** .\... .*\... ..**\. * * \  *\! *### ##\#      #
#\..\.\*....  ...  \* .*.*. \.**** C. \*..* *.* ..\... *..\.*\.  ..*.\ .* ..\. *\. .   .@..#L#  #  #       #
#  .  .\  *.. \ * .*.....*......**... .*.\... . * ..* \.\ .\..**..**.*\*.   *  ** . ** *.*\ * #            #
# W*\* *.\.* .W...*\**..!.\.. \*...  ... . \\   \..*\.*.*.\*.\* ....**..!*. .* #**.\ .** # #\#             #
#**\ .....\\*\.** \*.**.*\**. .\*..\ .    ... *...*.  . * .*\\.   * ...*.**\.\2..* *\ .. #\##              #
#.*.*.  ..  .   .*.\ .* . *\**.\.  *   *..   ..*   ***..** ...* .*.*  *. .**\.. *#.#..*.\..#               #
#*  ...**  .\ .\.*\.. ..\. ..\......*  .*\  G\....*..*.\.\\.... ..\.. .** .\.\..\*. ..### **#              #
#..  **.\ *. @*.....**.\...\  .*.\.*.* ***\..*. **\* ..\ . *\.. *. **   . \.W\.\*\*.**\ ###\.#             #
#.*   *.*..  \ ... *\. . *\.!..*.*\*\.\.*..* \.*..**. .*.\  \..*. ...*\.*\   *.*.*...*.*#  ##              #
# .\  . .*. \.\..  *\ * ...\ ..* .....\ \\* .  *\*. . \\* .*.\* *.\  *. .\*...\**.*. *\\#                  #
#...*. *... .\!*..*.. . ****  .* *   \!\  . .\ .. .\*\ ..\ . *\. \  .*.  .***.  .*.*.\.#                   #
#\*.\. \ \. . ..... *\ *\\.*.\. W. .  .\*. ...  .  * .  .*..*\.  \..*\\*.**....*\.*\  #                    #
#*.\.\*.*.*.*.*....\.*\*\* *..\   \.\*  \**..**\. *\.\.\*.* *.\ . *\***!\.\ .\\.* .*.#                     #
############################################################################################################

Water 0
Flooding 0
Waterproof 11
Razors 13
Growth 28
Trampoline A targets 9
Trampoline C targets 5
Trampoline B targets 7
Trampoline E targets 4
Trampoline D targets 9
Trampoline G targets 2
Trampoline F targets 6