################################################################################################################################################
#          #### ...*..  *  .*\.@ . \.. . !  !..* . *   * . .** *\  .  . .. ! **. *. \  @..*  .** \. *\\ *.*\  .* *.  ..\**\ *.\** .**\*.* ..\.*#
#       ###* \ . * . .. ....\. *\.. ... *\** *\.*.\\. \...  *. ... **\*\\.\*** \ .\ .. \*..* !*. .* . \*.*. ..*  ..*\..**.* \. \ . *.\  .\.  **#
#      #..\.\## *   .**\.  .* ** .\. *\\. \*. \ .*.*...  *.***..\*.* .**\ .. .*..\* \*....\* . \.\.**\..@...\\.* ...\ * *..   ..   *\.*\   \ .*#
#      #.#.  * **..\**. .\  * *.. ..\* *.*.... .*  ..*\ . ...*\.!*..\  .   *\!*\. *\ .**. \... ... .\* .*..*.*\.\@*.* .\.. **** **..* .\ ..  *\#
#    # #.\  ** .\*.*.\* .*** ** \* .!\ \ **\. *..*.  \ .*. .\ .  ... .**\..*\...* ..* .\\..**  *.\.**. *.*.**! *  \ !.. .\..  . .* .*\** ...\\.#
#   #.##\ # .*#*.*.*  . *.*W .*\.    *   \ ** **\. .*.*  ..**..*.\ \ *.. *\. * .*. .   ..\...  *...*..*\.*.. .\....  .. .. . . ..*\.\\..\\* .  #
#  #\ \*\. # . *\. .*.\.  .....   .. \*. .*.. .* \.  ..  . \***.\ ..\.*.* ..**** .*\ *\\. . \.\... ...*.**...   *..*@. ..*   ..   * .*. .**\ \*#
#  #. .\ .#\*\  . \W.*...\. .*   \**  *  *. .* ...\  \* .** .... \.*..*@*  **.\.  . .*. .*.        *****!*  .\. .\ .!.\\ \..\** *..*     *.  *@#
# ##  \*\    *\****  \ *..* .\    * *.....\*..  .. @*.. . **.\  .. ....* .*.  .**\ ...* .\.  *..**.@  *. .* . \ *.. . **... *. \. \...  . \ *..#
##. ...\.*\ .**. .*\* \.\\. * \\**\ \.....*.. *.. *.... .  .*.*..* .* .*\..*  **.  **.\ .  . . . .*..* .*.\.  ..\.  . *****..*\.  ...  ..*.\.\.#
##\ ...\\.*  *. .**.. .....#..*\..* .\ .*\.** .\ *...* *.\**. .\*\ *. \* \ \ ...\  *.*****. ***\...\ .    *.* @. . *.*.\ .. \    * **.  *.\ ...#
# #. ... *..*..* *!.   .*\*\* . \*..  .\.*.*. !*..\....* .    . \*..***.\.*** . . \* . * \.\  \* . ..\.*.   \ * .*...*\*.    .. ..\... *.\  \..#
# #*# .*   .. \..\  ..\...*.\. .*..   *\ * *.***\   .* *.*  .  ..\*.**\*  **..  *\ * *.\ ..\*.*  \    .* .\ .**. .\. ...*....    *. \  .*... . #
#  # ##.  *.**\*.. .*\. !.* *  **. .** .. .  ***.****. *. ..  ....*\.. .* .\.***. ..*. .. \*. *\ .\ .!... *\* \\*  \.. *.\ !\.....* \ . ! .. ..#
#     #\  . ***.*.\ .W..\  .\ *.\...*\*  .* .\**  ..* . *.\**\  *** * *.*\. *....* ....\ *\. \*.. *.*  ..*.* \.**.\ *\ .  .. *..*. .  .*...@.. #
#      #*#..*****.*  *..  **.**.***.... . .....*..\**\*.*  \ . . *.. .\*\.**. \*\\. .*.. ..\*...  . \   *.\..   \**** . *\   \ *..\*. !.*.\.. \#
#       #  **.\**\. .... \.. *. ... **\.. *\ ..*.\* \ . .*    . ..\  *...\ .\\  ..*\  \..*\@ ....*   .***  .\  ..\..\.\. .**@  ** .\*.*\  ..* .#
#      #.*.\..!\. .*.. .  .\ *\ *. .. *.* ** . \.** ..\...!* *   *.!.*    .*..*  *.   ..*.*.\  \.\ .\  .\ . .\ \ * .  .  \..!*\.\.*.*.* .. .*\ #
#      #..... .*.\ .  *     .\  \...\.* \.\..  \.\.*..*\  *. . ...*... .* .. **\..@\\ ....* \.  ..*..**.    * \.** .*.\ \.*. .* ... . . * . * .#
#      #.*.. .*. .  .*** *W** .\. ..*\\. @.. \..*. .*.*..**.   \.*. **  \  * ..  ....\ *     .***.  ..  ....*.*.*\.*....* ...\** ..  \ *. **..*#
#  #  ##.... \. **\    . \* ...   .**..  .*  . \* * . .  .   *. . * .*.. * . \.\ *. ..\.*.* .... \..*!  ***...*..   .\  . \.... .\..\... ..  \ #
# # L# .. *  ..\.. . .  \... \ **  \*... *.* * .  ..\  .\ .* *. .\..   \*\.*!***\*. .* *..*\  ..\..* * **.**.*\  ..* \ * . \ .\.*  ..@*.*. **..#
# #\. .\* .*..\  \  **. .!.    * *.\ .   . * \. !  . *. *  * *\.  *   **......\. .  .. . \ . .** *  \. \.\*..* .*......\*\*..\* .*...*..* .....#
#  #.\.##*\. . .... \**  \*. \\. .\.... @.\.*. .. .* .\ \*.  * .*\. \*..    \  *...*  .\ ..* .\. . **.* \**\@.*.*.***  .** **.*  *. ..\ ... * \#
#  # ##  #. .  .\ **\...  ...  .*\.\*.. ... .   *.*\  *\   ..\  \. **. *...  .***. **\!*.\ . ..\  *** . .. .. \!*\.*... *.\.  .  .   \.**.  .*.#
#   #    #  \.*#.*.\   .\.    *..   . .  ..**   \ \.  .*. \  .\*  ... .*.*  . .\.*  .\.**.* ..  .*..\   *\* .*A.* \\ . \ *. ... .*... .\.*.*\.\#
#         #.#.#.\* \.\ *.*\ **. *.*.*. *** .. **@  \..*.***...*\    ..\* .\*.  . * .\. \.\.. \....W*.*.**.\... \. *\*   * @.*\.. *...  . ..\\ .#
#       ## # *.... \\** \.  .*\** ..@.\.*.. \**.*\***.. *.*\\*\\.*.   ...   . *. .\..\ ..*   . .. .. .\.  *... .. . . . ...\.* .*.*  \.\... \**#
#      #.\##\...  **  .\.* . ..\.\\.* .\...\..\** .  *\. *.*\**  . .  \\  \*   .**\\*.  .*\..  .**...  . .\*\.\.\*. \    .***.. . . *. *\*   ..#
#     #.   .    \  *\ ..\*..* .*\ .*.\    *..  .....\.*\ **.* \**  *.. * ... **... *\* .\*.**.  *.* ..\ ..*\.*. ..*\.  . *....*\   *. \\**\ *. #
#     #....*\.*\*\  \.  . *.*\.**\.\. ...\.\ \.. \ . *.!****. .**. **\..\ .. ..**..\**\  *..**.*. \ .**.*\.**.*\\.**\. **\ .  .\.. .\...*...R*\#
#   ##*....* *\ *. *.\. \  .*.. .  ***..  ..*\  ..* .\.*..\ . * .  . ..*  * \. .. *.\.*  .  .\. *..  .*...  .\. .\ *  \*..*\.. .. ..*  \.* \.*!#
#  # .* .  \\.  *.*.... *   .*\.\. .*\. *\\*.*   .. *  .*. \* ..**  .\..*\ * ..\  . . ..\ .* *..\ \.  ..*\** ..  **.\ ...***.!\   . . *   ..\* #
#  #  *\.. .. * *..\. *\..   .. . **.  *.... *..*.* ...*.   ..**.. * . \*.*   \*\**. .... \. .*! . . ..\*.**\*. ..\.   . *\.*.* *. .  . .*\ *.\#
# #*\.#.*.**. #.  .*.\*. . ..   .*..* \* . \.\  .*.* **.*.\.***\ .\* *..!.\......\.\.. \     .\..* *. C.*.**...  . .*  *\..**  *\   . ** ...* .#
#  #. .*.\*\...  ...* . .\.!***...... *\ \. *  \*..\.. .. !*.  *\ .\..\** **. . * ..\.  .. .* \  *..* . * .\** **   *\ .....*..\ \...*..\**..*.#
#   #\.!  *  *.*  *...\  ...*.\..*\.. * \ . * ..\.*.  *  ..* @ *.\.. .\*.*.*.*.\  ... *. .    .\.\*\.* ..\. .. .*. ... ..*.\*\ ...\ .. .W*....*#
#  #\. \ *.***. . \*   \*  9..*.*.. **.\.*. .     \*.\  ***.\***   ..*@\ \.  **    .. ***.*    .\.***.*  **\* . ..*.!. *.. .\   . .. . *.. .\ .#
#  #..  .. . .*.*....\  ..*\..*\.. **. \*  \. .  \  *..\*.....\\. ..\..... .... \.\.. .*. * ..*..*...*. \ ...\* . *\  ...\...\.  .*. **  *.*.  #
#  #*#\* .*.* *  .*\  .***.*. * \* ..\..\\\..*\ *..*.*... * *\.\*\*\.**   * * .*.\  \  .  ....\*\  .*..\....* * .\. * *\  . \*@..... .  ..*...\#
#   ##....***.*\.**. ..\ *...*. *.\.. .. .. .*  * .*. ..*.\ .*.*. .. .*.**\.* \\ ***.*..\...... *. *.  **. **..\***** ..  *..*.. **.. *..\.. .*#
#  #\  * \\..  .\.*     ..\*...\.\ !  .!**  *\ .* .\.* . .*  . . .. .\*.\.. *..  *...\.    @\. !.* **.*...... * @.. . *  .* \.*..*!.\  .\*.  ..#
# #**  #\... .\ .*. .*\    *.. ***\..\ \\ ...\*.\.*. .\..*.*  .. \*. **. . .!**   \ *  .*  .*\ .......* ...*.......  . \.\. .... *..*   .**\ *.#
##\.\ .#\**. ..*\.*\.*...**.......*\ ...*. * .*\*\*. *.\ .  ..**. .  \.\*..  ** \ .  . ***.*** .* *\  .*\\ .  ..  ..\.\. \  *\   * .. * \*\*.*.#
# ##\#@# #.  **.\   *.**...  ......*\..@   .\*.@\ ..\. \*\\.  .*\ .*  ...\\...\.  .*\  ..**..*..* ..  *.    ** * .*.. ** ** ***\\. .   **. ..\ #
#  #.*   *** \* . **... ** .*.*..**..\*.\ .\ ... ... \. .*.\ **.* *. ..\*..    .**.... \.\ .*.*.. .... *\.....*.  *.*.*.\.  *..\.*\  ..*..\\** #
#  #* .##**.\* .\.*.*. ...  .\* \*.*\...*  .  \.  *\ .** * .*  ** .*.*..*\*    .*\*\.\  * * *..\..  .* \* * *\* *.\*.**..  .\*\  ....\ .@**.***#
#  ##**#.*\*.* * .\**.* \. .\.*\ . *..*     .\    ... **..    \ .**...*\*.. ... *.* \\* \ .  \. \...  ...\ \*\   .* *\. * \*..*... . ** . *.\.@#
###*.\. \# * ...*. \... . .*.\.! .*** *   *. ..\ **** .***\\.*. .\\ *.. .\ .\.* *\*..\   \. *.** \.**. *.*...** . \.*  \.. . **\**\  *. ...  ..#
#\ .\.  ..\\   .*..  ! *.....  *  \ ...\...*.**. \. ..**.\ \.  .  .\* * .*. . ...\.*\ . ..* * **! \* ..\*.. ... .. *\...  .. *. .\ ... . *.  \*#
#####*\\.* .* .. .\.. ..!.. . ...*...  *\  ....*   * .***.*..  \ .* .  .*\. ..*. .*..  *@.W *...* !. . ..* . @..  .*\...*.\ *.* *.\ .. *.** ...#
##\... .  \. . \.\.. *  . \   .*  \*. .**..\\.*.  *... .... .  .  **.*   **.***\. *..****.@..**..  ..**..\*.**\ *. \ \***.*..*. ... **\ .*..\*.#
# ##  * ....*.\. * *..\ . \ *.*..**. .\..\ ..\ \  .. . *\*   . . ... .**\........\\...   \\..*.  * .\ @ \ . *.*..* .**.\* .\*  *\.\**\*\ *...*.#
#  #**..   ..  * \ .. * *\  !.*.\.*\\ \ **.* *... *..\.. .*...* *.. * .  \*\*  .\..\..\.\ .\ .. .*.*...\.* *\!\ \\ *\ .\*. *.\..  ...*.. ..\ * #
#   ### .*..*\ .  \.\ \ *.    .\ ...\.. .. ..**\.\.*  ** .  @\ **..\..* .\*.\\.  .\. *   ** *.* *@ . \.... *...*...* \*.\  .. . \**.\.. **\. . #
#   #.***..\*.\*  ..\ ..**\.\ *  *  . ..\..* .*.   .    . * . * .*\ ... ** \  ...*. \*.  ** . .*..   .*. \ ...*\ . .*  ***.   .*..\.*\.. \ \\! #
#    #####* *#. .. **.....\ ***. . .... ..*.  **.. !.\\  *. .\.**\. *.  !...\**.**  . ..\. ....*\.  *** .    \. *. *..*...* *.W*   ..**\\.*... #
#         ###. .*. .*\  *\ .*..\.  *\** 6\.\.**** * @..***.  .\.\     \*  \ . .... *\*   * . . . **  .*\   .\.  .\ *.*\.\.*... @\ * ...** \..* #
#        #.\ * **  \ *\. .  . .... **.** *  \*..  .*  * \.. . *.*.* . .. **\.*. **.. *.*.... \  *.\ ...*.* * *  .... ..\. .\ *\** ... .*.......#
#         #. *...* ***  *! .* *.\*.**..*...*..*. \ .@*  .. . .... .\ *\\ ...*.  ***.. \.. * ..  .  ..\.\ .  *\  ..\. .  *.*..  *\ *. *\.***\\* #
#          #*   .* .\** .  ** .. ** .... ..*.*... \.*. **  *.*.*. *..!.\***** \..*.  .\*..\   *.\ . ...\**\...  \*.**.*.\*\**.*\ ..  . . *\*\..#
#          #* *!\* .*..\ * .*\\\  . * .\*\.* . .  ..**..*\ .. .\\.\.*. * .\ .*.**..\  *\**..*\.. .      ... . .*\. *.\ **. .  *.  \*.* .\.. . \#
#          #.  ... \** *\*  . . ...**.\.. *  .   .**..\... .  ..* ..\* @    . \. .  ..\ **... .. ***  .*  . ...W*... ..*.  *     * *  \ *.\* ..#
#          #\#.#.* .\*.\.. .. \ .*.\  ...... ...  *\*.*..*  .\*.\. *..\! \.***.* . *. ...*****..  ..*.  ..  .\ * .* ..**** ..    .@\. * .  *  *#
#           # ##\. ..*#* * .\*  *..* *   .  *  .@*..*.\ .\ .. .\*.*..\  .\..**\.****..*..** *\*.\.*.. \\.\. *.\. *\**1..**    .\.\*\* . B*   *.#
#               ##   #\ .*  ..\...\..***. \*. . * .*. . *.. **..*...*.*.\.*\\* **..\***..*.  ..\ ..* *.. **...*   *.. .*.. .\** ...*\ .*    .*.#
#                #.###!* ..\. .\.\  ***\. .***..\*\.*.. *.*..*. **\. .\  .*.**.\*\ .\*. . \ **\.*\ .*..\ .*\@ .. @.. ***..*.....*.\   * *  ***.#
################################################################################################################################################

Water 0
Flooding 0
Waterproof 4
Razors 19
Growth 28
Trampoline A targets 9
Trampoline C targets 6
Trampoline B targets 1