###########
# #*# #   #
# #\..#   #
# #.  *#  #
##* \ . ###
#*. .\.   #
##*. *  *##
# ##\.R.\##
#   #*.#.L#
#    #.## #
###########