############################################################################################################################
#                                                    ##.  * .\.**\**....\.\.***.*\   ..*  .* *.. *. .\ .. \*\ \ . .... *.\\#
#                                                 ###.\. ..**.\  \*.\ .  \ .!\..* .. * .     .\  . .*. ..... .. \  \* ..* .#
#                                              ###*\. ....\... *.  .\. *\. . .\.*.*. .***.\. .     .***W\.* \ ..  ...\ \. .#
#                                             #\.\### .  **.  .\...\** ** *.\*. .\..\.*\.\.*. **\. \. .*.\@.. ..\   .* .\..#
#                                             #.\ ## #*!..\. . ..   *....**.*. !*.  ...* .*.*\.  .. .*.*. *.\  \..\@... .**#
#                                           ## *@##\\ .   !* * *.\ **  *....******\ .*......\ . \ ..*...\..*\*\..*.* *.. .\#
#                                          #\.*.*#*  #\.*. *\*\... ...**   .*..*..*@ \.*. \....***. .*. .*\..\.... . *.\. .#
#                                        ###. #\*.. \.  .*\\ .. . .  .***  .*.@...... . \*..**.*\ ...*.. ..  .. \..\. .*.\.#
#                                       #..\#.*##.  .   ... . \.\.*..*..   *@*!**!*.*\\@ **.*\**.\ ..** * ...*\ \* . *  *..#
#                                       ##*.#.  \ . *  * .!\ .* *\.     *\ \*..**.*\....**.*.*\.  .\*. \*.\.\* .\. .\. ..\.#
#                                      # *.@   **. .\ *.\** **.** *\..*.! .!.  ...\  \. .*\*....*. .*. \..  !*\* ...*\ .*..#
#                                      ##.*..  \.  ***.\. \..*\\* \ *.*\.\.\ *.* .. \.  \.*\..    ... \.\ .  ... ** \*. * .#
#                                     #  . #\ *. ...*\. \*..*\!** . .*.** . ..\ .***..*  *.* *. \.. \ .*** *.* *\....*.\  .#
#                                      #.*\**..#... . .#**.... *\.\@.**\.  \...\* .*. *\*\.* *.\. * *\*.*. * .*. \.  \.. *.#
#                                      #*. \..*....  .\ **  *.\..  *. ..*\..\  ..* . .\.\.* .*.**\..\*.*@. .  \.*. ..\.\  .#
#                                      #*.  . * .*.\*\*.* \*\* **\ .. .**  . ..... ..* @ *\.*.*.*.\. .  *** *.  ..**.*   \.#
#                                      ### .* .  .**.*.\* .. .* \*  * ***.*\ \ .\ ..\*\* \.**..* . **\ ... \. *.\ *.\..\  *#
#                           #         #. .. \*\..*.*.. .. **...\.  \ ....**.    \ .*   .*  **\ . . *.. . *.\  ** .* .* .**.#
#                          # ##      ##\*!. .    .*.** * ..*..       .\\ *.. **\.. . .* *.*. .   *\**. *.* .. . .....* **. #
#                          #.  #    #.  *...*.\.*.* .* . ..\. .. .*...*\ .* \* ...*.*..*..***  *.@...*...\ W. \  .\ \. . \*#
#                          #\ #\####*#\ . .\..*\**.  * \*\ *  .  *.*..\ \ . ..  . *. .   *\..  .*.. \\ .. .\*  .. . .  \ ..#
#                          #.#  #  \.\  .. . ...... .. ....*\... \* **\ * ....\\.*...  \ ...\** *..*.. *.**.*\   *** . .. .#
#                         ##   *..*.* ...** ..* *.\ \..*\. ..!..!   \. *\ A . ..\...\  .*. ...   ! *.... *\ !.. ..** \..\ *#
#                        #.**.*.. *\.. .**.\* .\**. ..\*.*.\.... **...*.*\.**\*  *\*.*....@\  .  .*..*..*** .*... ..   ..*\#
#                         ###\.*..\*#\  ...*.***.*.* . * *** *  \*\..\. . *\*\! \. ..**..\..\. .*..*.......*...\   *..*  ..#
#                      ##  #\. *.\.@*@   \ . .\. .  *\ \ * .    ...  \ .\\.  * * .\. .**.**... .. ... .\  *.\.  .* .* .\. .#
#                     #\.# #.**.. \... *\. *.\.  *\*. . *.\* @***\ *.. *. .* .\ \*..  .*.*  \   *\**. ** .*.*.@..* *\*..*..#
#                 # ### ..##\.*\\* .....   ..* *\  .* \ .\.\. . *.*\  \.*. .\ .*...  \..*. * * .* \ **....  .\* .\*. *. \ *#
#                #.# .#\ *\#\. .* *\ * \*. .\  * *  . .  * ... \.   .\ ...   !\.\.\*  . .. .*  *\ .*.*  ...*.*. * ** .\*.*.#
#                #.# ...!\ .    * ... \.. \...*\ .   *  ..  . . ... *.* *\.... * \.* . *.\* *  .. \ *..\ . . **.. .... *  *#
#               #* \. . \.*  *.**\.   W.*. \* . .. . ...\.\  \ ..*.*. **\**.  \!\ .... \. .**.  *....*\..... \*C..\. ..   .#
#                # ##\*\. \.  * .** .\....  .\**.\    @**.   .*. \.\ \...*.*...\.  .   .\\. .   . * \.. * ....\* * \ *.\ .\#
#                # #. ..  *  *\.*\.\*.. \ .. ..*  *\..*.*\**..\ * \. .*.*. * @*.. \*..\.      .\  .....\....* ..*.*\...\.* #
#                # #* * *..  \!\.**... * . \.*.* \*.  * *\*..   .*.*.*  *. . *.**.*. ..\.* .*** .\. .\*. ...*. \* . **\...*#
#               #*\ . \*\.* *.  .\\* . @..  \* .@*.  \  \.* *.*  *.* \ \.  *..  \.. *..* \..\*.. ..\.@.. * . \*\**. . ..*..#
#                ## ***\ \.\.    \ \..*.* .  ..... *. . .** ..*\.\.*\ *. * .*. \.*@*...\ \.. **\**\. .. \ .   \ .\**\ .\*. #
#                ##*\. *....  ... . * ....  . .  .\ *. .\..   .* * *  \ \.*...  .  .*.*. **\.*. *\**. * .* \* .\* *.!\.!.*\#
#               # #.*\... *\..  *\. ....*.. ..!*.*...** . ..*.\.  ..\  .*..*...* * \**\...\* *  ..\.\!.*\. .\  .. .*.. ..\*#
#              #. . .\.\.**... * . . .\*.*..\ *. *\*. ..** .\ !\.\.\ \  .\.. **. .! \**  .*..\. .* *.. * W*  \*\* *.*. .\ *#
#              #  *.  *.\.     \*\.*\ ..*...\*\*..*.** **  .* .* \.  .W\ **..*.... .\..\.*   .*  *   *.\\*.*\.\*\ .  .  * .#
#              #\.*. *.\.. .\ ......*.  .  ...\.  . .* .\  *. \.   .!  *\* .  * .... ..*.* .  .*.*   .*.. *\.*.*..\   . ..\#
#             ## *.\ .**.*\..***\..*.****  .\  *..\ *.\@.* ..\. . . . *.!\ .. .    *.\ *.. .\ **\.      ...... \*. *. * **.#
#            #* \..* .\ *..\.. ..**..\*..\*  ..\*@ .*  ..**. . *...  \* .!  *    **.  ** ..\@.\. **.\**.*.. .   . \*  . ..*#
#            #.2..   ..\ *\ ....*\*.\...\..*.* .\.\ .** ...  *....\ \.\ * ** ..  **\.\\. .*.\ . .\****\..**  . .*  * . . .\#
#            # #*\@. ..* .. ..\ *** .**. \!*\.  . * .... . ....... .. ... ...\ \.... * *. ..\.*.\ .W\.* .** ..*. . . *** .\#
#     ######  #*\ .  .\**.*.*\.*.**  ..*....  **. .**  . . .*.\. .*  ....  *\*   . *.\ *.. . * **.*.* .   *   .! .*..\* * .#
#    #.*\...# #. *. * .\.\.\ ...  .\ .\** ..\...\ ..  *** ..*. *  ... ..\*.\ .!*  \.\. ...\.\*.**.   \\.  . \ .*\\ *. .* . #
#     #.\\*.*#**. . ..**. * . . *\.*\...* ***   *.. *\..*. \.**\ *. **...!\ *  * * . * * .  .*.**. * . *   *.*  *\.**\.**  #
#     #. ..  *...*.  *.\.\.**..\. ***.\. **.. * * \. ..\...  *\*\.  ..*\\* .  ....\ .* *  \ *.. ....* .\. ..\. *   \\.... .#
#   ###.\ **.\*\  .. ..  .*...* .\..... \.\  .... .* *\*.*** \*.*    ..*.*  .. .  ..\*\*   ..\  .\ .\. . .**...\.......  @*#
#  # *.\*. .. \.\ \* * .*.\..*..\.***   ..\..\*.   \...\ .\.... .@. *  . ..  . ... \ *...*\\ ..*\.. .\.... \. .@*. . .\ .. #
#   #....*.\*.  **.. . ... .\  *. \.  .. *   **\.* .. \..* *. ***. ..@. ** . *** *   .\ \..   *\ .*\.. ****.  .\*. ..\ *.  #
#   #*\ *\ #..*  .\      .   *\.\  .    **.\.*\. .W*  !..\*** .*..@. **.*.. .*..*.\..\ *.. *.*  .\ . .\..  .* .    *. @  .*#
#    ##**.*.\.**.\ *... \..* .. .\ . * *.* .*\ **\*.  \.. * . ....**..   * \ .  ....*..*. *\.*  \* **..  .\ .. \*... *. \*.#
#     #..## *\.. **\*. \   .   . . * .** *...*..**.! * *\ ! .* \ .... .\ ...\..\. *.\.. *\* *. *\..\ W* .  ..  ..*\* *  ***#
#      ###**.*\..*.**\  .. \ \..   .  *...**.*  ...  *  .**\.*\. . * .. **\*.. *\.***\* **..\**..*  .*.*. !..* ...**.* . *.#
#         #.\*#*  *.. *.\*.**\* \ \* \*.* \ .\  . * .. * \.*\ \. * ...  .!*\\.* **..*.. .\...... @\.*  *.\ .* .  *.. . \.\.#
#         #  * .  \*. **..  .. .@**.  . ****  .* .*...\..** .*.* .  *  ****\.  ..  ..*. ..* ..*  *  ....\ .*  . .* \   * .\#
#          ## \ *\..**\. ..*.. .*.\.**. ..\* . !\*. \ *\*..*\.\  * *.  \**..*.   *.. \  \...*.*\...*\.** * . **.*\...  .* !#
#          #....* * .. .. .\.\**. **.... *.\   .*. *. .*\ \\ ..\* ..  ..*.\\.   .* . **. \....*.  .**..  . . * *. *. ..** \#
#          # * *. . \.\\*..  ...*\.*.\**.\. **  \..*.  .. .. ! ** .  *\ \. \  \*.*.\. \..*\\.  . ..*.*\**.. \. **\.*.\..  *#
#           ## .# ** .* .**\. \....**3.*..*@*..  **....*!. .\*.*.* *..* .  . *. .*.. \.*.. \*\*...*.*....\ .....**..    *\*#
#          #  *\..\...*.*....*.\..*\\. .. *\.*.\ *.. .*\ \.* . .\... *. . \  * ...*  .*\.\*...  \.. .\..**@  ..**. *  \* *.#
#          #*** \**...**. . .\ .* .*\ .*\! ...\.\.* . . ..*. *..W\.. .  *.\ ....\.\ .\.*. . \  ... . .\..*\*..**. .......\ #
#         #. .*..*\. \*..  **.\ .*.\.\\.* * .\.\.*\ \...\ . ***.. .*\*..***.* . **\ .. .*.* .\.\ * * \*.........*.** .*. ..#
#         #\. #*\ .. ..  **** *.\* .  * .. .*. .*. . *. *\*  ..****..\ **\.*..**...*\   \*. .* . * *.*..  \..*****\.. \.   #
#      ## # .\..  .\ . \\*...\ \..\ ..!\ *\ .\.8. .. **...\@   \.*...*.**. \.**...\*..@..*.  ..@*..*\ .*.  .\*.*\..\.\ *..\#
#  #  #\.## .. **.. .*. ..    .\*\ ..\...*!***.*.. **. ..* *. \.  *\* \..** .\..\\.****\  *.  \.*  .*  .\*..*\** . .  .**\.#
# #*#  #\##\.  . . *.. ..     \.\**.  \ .\ .*. . **\.*.  . **.... ****.*...\  *.  \.  . . .... .*\**\ .*\..\*. \* .\.  . . #
###.#### .**  . * ....\!\  *\ . *.  .\.*  .*.\.**\. . \\*\ ... . ..* .\.    ..\.*\.  . * **\  * .*.. \*..\. ..***W. * ..***#
#*....*   *.\ *.. \ . **!.***   . * .*.\ .\\ ..*.\.* ..\.*\     ..**.*.  **  .. .... ...\.* ..  W. ! .*\.  ***.*.\. ... ..*#
### *#*  \* .*\ ..\..... .*\...\*  ..* * . .  **\***.*\..*\* .*\ . ...*.\** * . **..  ** *.   .\*.**.. ....D*..* . .* .\**.#
# #\. \   ...    !** **.* **    .*.  ..* .*. *. !.**... \. .**** *\..  .. .*.\ .\.... ..***. ..***..** . *.\... .\. \  ... #
#  #\  .\ .  *.*. .\..*.*  .\\   \.. \*....*..* .*.\.*  ..\ \****.**.* \.\*  * *. .  \ ..*@...**.**.....\.*  .   **...*..\*#
#  #.  *.  . * ** ..*\... ....**\. .\..*..  *.*  *\.*. \ **. * *..*\**\..*...**\\\  \* \  .   ..**. \**.   \..*  ..  \*\   #
#   #.\. ..\ \\*. **.. . .* ..*. ** .  \ \ .!.!\... *....\.    W  .** .*\ .\ .... ...  \ *..  \ *. *...** ..**...* .* *.*  #
#   #.*..*. *.**\*.\ ... *.*..*.\\.* \... \** \*.\. * \ \. * * \ *.\.  .*.\ . \*. .\\* .\*   . \.. . .\...**.\*  .@*..\** .#
#   #\ \ *. . .**....\.W \... \. .*\   .. .\.  .*.\   .. **. .  ....\ *..   ...*. ...\ .*.*.\*. .* * . *....**.. .*.\......#
#    ## .*  . *\...**.\   .* *..* *\*.\**  .. .*.\...*\* \**   * \* **.\ *.  .*....!* *. ...* .\ .\. * * \. . . ...* .*....#
#     # #\.\**..* **.*..**.\ ...\ . ..\.* . *  .    @* \  \*..*.  .*  *...\ .   *  .*  .\. .\ @\* \.**.*\..\*.  .  .  \.. \#
#      ## *.*. .***.\@*\.. .*....   *\....  ..*.\.\. . ..*. **..*@*..**....**\\.. \ .\. * \ . . **  *   *\ ...\ *\ .  *  ..#
#    ## # . *@*..\..**. .* *...\. *.. \*** *..*..\.\. *...*  ***..*.\...\  ** \*\**...!.\..\  @ ..\ *.\. *.   \. *.. .. . .#
#   #.*.  *..\.   *...   . .*..  ..\** .\. .  .*.*.*\. * ..  * ..*!. ..** .**.\...\.* ..  ..  ..** *.. . .\. .\. \* \ .  . #
#    #*#.    .\   \.*.\.\*  . .\.. .\\.. \..  *  * .  *.. \.*. \*. \  ..*  ..\.  \..\..\     *\...\*\ ..* *. . .  ....*.\ .#
#     #...#..   *. * . ****. \*.*.\.** . .** ..*\. .  .\**  ..* .. .*. .*.***.\ \.  * * *...\*. .\ !. * . .  @...\\* ..\.@\#
#     #*#\*   . *. . . \ .\. * *.****.*..* . *.\*  ..* * . \* . .*\..*. * ..... . * . .\. @ ...***  *.... . **  .....R..\. #
#    #\*\.*.**.\!**...\.*..* ... ..*..*\*.\ \.\ .. **. \  ..  * .* \*\.*..  . * . ..*\ . ..** \...*\*\ ....*..*@    .\. \ \#
#   ###.\  \ . .*\*   . ..   \*\. ..\*.*...*.  .\ *\\.\. *.. .\\ * .*. \*.* ....  \...\ .**... \ *..*\...\\.**\* .\ *. \   #
#  #*\#\.....*..*  *. \.\    . ..* . . * ...@*. .*.*... ..\    .    ..*..\.\.... *.** .\\*.*   ...* . . \*  .. . **.    \..#
# #*.*** \. *\..* .. .. . \* .\**.. .* .***.\. ..*...\  ..! \*.*\   *\.  .*.\!*.  *\* *. . . @.**..*\..*..*.\ .  \.*. .* *.#
#  ##.\*\.\. ...* *. . \*  .\.\..*.. \* .*.!W\ **..\\*.  .  .**.!.*   . *.\.*.  .....\ .  *. .*.**.\ *  ***  **.*.*.....*..#
#   # .*  . ..\..**...\.\.. .*! *.  ..\.*. * .  *.*\ ....*.* \  . ...*. .\ *W *  \. * \   .*\ ....\.. ! .. \ . .\*.*\.. ...#
#   #*#  .\.** .\**\...   \\...\....*\.  .\. .*.*\...* *... \.\.* .*..@**..    .. *\* **.*****\*. **  *.. ..**. *.. .    . #
#   #.#\# ..\* . .\....* ..**\.. *.....*.\**\ * . \  ...    .    ..*.*.\.\. ... \.* *.*  .. ...*.\ \  **    ..** \*  *.. *\#
#    #   ...*......\.\ . .*.*. ...\  .\. ..\*** *.. . .**\*..  . \.*\. * .***.. .\* **. ..\. ...\.....\.**..\* .\*.  .\  *.#
#   #*  .\***@\      .*.  . .\.   .\*\* *  ..\.*..\ *  .**\**. . \...\.**  ..    \.**\ *  .. . ..*\\ .**.*\* * . *.*. \  ..#
#   ##. *..\...* .***\. ..* *. *.* ***. ....**.  .. ..\..*  .   \ . *.\.  *. . . \.*.\.. .  .\ .**.\.... . .*. .**.\ .  * .#
#  #.\.#.*   \\*\*.\**\.  . .\*. .**.. !\ *.**  *  \   ...\.* * *.\ ..*. **.\\..\* ***   .*.***  **...* .*. *** *.*..\.**. #
# #..*.#\*.*.. @..W.....* ***... \..* .......*\ . .\!.. *\.*... ...  *. ..\  .* *.*.W. . ***. ..*.**\\.  \.....\  ..\. *.  #
#  #.. *#\*.**\...  ..\*\ *.\.*.*.\*.**..   ..* * *.  \ ...\ *\.*.....   \.. . .\.....*. ...*\ *..\*.*\.*..\ \ \\..*  *.\. #
#  #****.. . .*** ...**\*.... *  *.\**.  .   ...*..*. . .  * .****\****.\ ... \...\    . *\ ...*\.*\.\.\..\.  * .\ . . *. *#
#  #..\.#   .\....*.  ..*.\..\.  **.**.\ .  ... \\ .  ..  .....\ \... *. * . ..!.   .  * .*\\ .\ **  . .**\* .*.  . .**..*.#
#  # *  .#\*.\ *  *.  .... *    **....@ .* .\*\ .*..  \** * \ ....*.* \* .\*. .  .* .**\*...\* .*****..\**.*** \..    *. . #
#  #\### ..#*...*\. * .\\.**W\.*..   ..   *. .   .   ....\* .  \*\ ..\..***.*!. ..\.  **.. \**.\ \... **..*.*  . * .  * . .#
#   ##\.\ # .. . *\*.  *.*.. . .  .*  ... ..\*@*. \...  .. .*. . *. ** . ...*.. .\ .*.\. *   . .* ..* . ..*.\. \ .\. .\ * .#
#     ###.# #*.**.*... .\* **\  *.. \  \.!.*.*.*  .*    *@ \.!*\ * *\.*\.\ \.\*\  \*    *.*.. .\. \.*.\ .\ *..  ..**. .\. .#
#        ##  .\.**\.\** *. *!*  .*.  *..\  ..*.\.. \...**\ \*.\!***. **  *\..**.*.. .**\*.\* . **\. * .*.*  . . .\! ....***#
#       ## #\.*..***.*\\.*.*.*.* .\  .*. @.  .\ . .\ * .*.\.  *\..*.*.. ... .  *.  ****...\.  .\..*\* ..*..*..*.*. .  ..*.\#
#      #  ## \*.  ***.**\\ .\.... *.\. .\.* .. ..*\ .\  . .  .\   ..*.\ ... \. .  *.. \  \* .\  .\*\* ..*!\.. .  \*..**..*.#
#      #  .. \.**..**..\.\.*..* *.... \**   * \..*.   ..\.\ .\..  ... *.\.W   . \*.... ..\\.*  .*! .*\ .****   . .\..*.. *.#
#      #*##.\. .* \..\ .*. ** \ ..*...*\ . \* *.*.  @ .*.\ ..*. *\.  **\.\..**!. \. *.. *!....**  *\..  .**.*\*..*.. .   **#
#       #. ##\ .. .  ....\ *. *  ..  .. ... *.**.\... ..\  ..*\**.***.*. .**  \\ ..*..\ *\ .\ .*\... ... \. .**. .*\ * .\*.#
#       #..# . *# ..\ .. \ \  .*** ** \  .\ \ *.*  ..\*.!..\.. ..*..@*.  .... \*.* * * ..*. \  **\*.\ .\*.*   ** .. .*\  .*#
#      #.. .... \.  ***.*\ .* *. .\..** *.* ..*\.\... ... *** *  ..  * .*  *.\...* !\  .   .\ \ .* **.... . @\..  . ..W .! #
#       # * @*\. *  ***...*\.\*. . *\.. *.. *\\ *.. *.*.* ..\.  ..* *\ *\ *. ** \.. .*.*..**... *.. \...   . \\ ..*.. \\ \ #
#      #\*..\...   .*.\. .\ . @\*!*  *..*..... .\ ..\ *..    ***. ..\    ...... \ *.\.\..\    \ \**.. *.**  *. .* **\\. \ \#
#      #*.# \. \*.#*.   .  .**.\**.*\*.  *  *\...   . .* \ *  *.  . *\. \..\ *\  ......*.. \ \....* ..\**..*.* *\.**.......#
#     #*.#....* *** .  *.   .**...*.*.\*.\ **** \.\  *..*. *.*.. *\.. . *** .\. \*.\...\... ..** ..  *...  . \  . .*\.  \. #
#     #*# #. ##\.. .   . \*\  .. *... .. .. *..  \*  . \ * \*  . ...*.  \...   \..   \.... .*..\  \**\ *..*.  .. .*...\*. \#
#     #.# #.# # .  .   \\.** \ .**..\  ..  .. ** ..*\   .. ... . \.*\\.\ ... . \.. *.  *\**..  \ ...*..****.  . . *.\ **.*.#
#      #  #\# ##. *\\. ..\  *.*..* *.  . .\*\* \ . \...*...** *.*.*....* \ .* .. ..*. . .****.. ..*\** \.. *...\  W\*\ * . #
#          # #*..*.*. *  ..*\** .. .**   *. *.   \ .\....\.*. ..  .*..... ..\  .\ ..  \.***..\..... * *..*..\ *\*\*.. * ...#
#             #  .*.\  \.\ !.@*  ....\.\.*\  \* .. *** .!*\. \ .\*\. \  \.**.\.. . .. . .\* \ *. *\...**.  ** ......  ** .*#
#              #.* .*****.. \.  ... .. . . ....*. \*.......\ . .**. \..   .**  . * .**\  *\ .****.  ...\ .*\.  ....  * . ..#
#             ##\.**\\. .*\.\.*..\** .*...\  \*.* ..**\.*. .*.* ....*..* .*..\@ !\ \***. .*.. .! ..\.@\*. \.**    \   \**. #
#            #* .\*...*\\.*.. . \*.* *...  *\.  ..... ! **  *..   ..  \.* *.. *  . ..*..  . *.*.. \ \.  ..   * .\.. *.*\. *#
#             ##\ *.* * ** .  **.  .\.   . . . .*.\. .. ..  . *.**.  \. . **.*.*  \...\ ..\...\* ... .*.\.   .  *.*.. .  **#
#            #.. . ..* ... *.  **\...*....  .!\..\  .  * *..\*. *\.. .* .W\\   . *. *.*.\ * ....\.. ..  .** \*. \*... . ...#
#            #..\ \.\. \ * *.....   ..\ * *\..**.... **.\. . .*\ *. .*.*. .  *.**\*..\.\*.* ..   *\ .*\ .\. .*\..*..\ * ...#
#             # ..L. #*.. **..*  .*.  @ .*\.** \*.*. .....*.\ .!*. **\* .... ...\.@*.*..\.\..\ .\   ..*\.\ \.**.***\ *. \*.#
#            #.**# \* #*  . *  .\* .*.*....\*\. **..    . *\**  *\ ....\. ....*\!**\*....*.* .\  *** ...*.*. .**..\. ..\ **#
#             ### .#.*.***.\**\  *.\ ... .@*.*\*\.\\**. * @!.\.\ * ..\... \\**..*@* . .*.\.. .*. *..\. .*\*... .. .\ .\*\**#
#              #*.* * .\. *. **.\. \.*\\ ... ..*..  @.! ** *\. .. \. ..*   *. @\..**  \.  .*  * *. . ***\..*\.* **\ .*.* .*#
#             #.\..*\. #***.*\... .......\  .*****.*. . ..\ ! . *\ * .\*****   * *.* \*. *\*.** .  .*. . *\*  *.*.*..\.** \#
#              ##. .**\**!*...  \ \ .* .. ...*.\*\*...   * *.\..    ...*  .  ***\\** *..*.   *   \* ..* ** . \ *.\. *\..   #
#               #. #.\*\#...     .       . ! . .\!.. .\*.* ..**. \* ... **. ..**.\.  . .* .*...* .* **.**.*\*.*!...  .. **\#
#               #. #  * \.... ..*. .*. .  .*..*.*...* *\. \ \ .. .. **\*..*.* *  \..*  .****.\.** ... ...\* .    .  ** .*..#
#               # #*\. . *..\.*\*  *.* ...*..***.*.\!\    ..  .*.  *..*\  *\. .**. ....\*\.*.... \\.*    ***.**.*.. .*.\. .#
#                # # .  \.*...**.. .  .* .**.*.\.* *  .\*\. . *B\. .*..**...*  *.*.  .* \.***.. \.* ! ..*..* ..... ** . *  #
#                  #.#. # \\.*\.\..  .*\  *\ ... *.  * ..*.  \*  *.\\  ***\.*.*.\ \ .....**.* * .*\.\   *. . *  **\.\.*....#
#                 # \**. * . * .  \  *\*\... **..* *..  *..\..*.**.*  .....\..**. * ..\ ... .W.\.  *\.\....* .  ** \  *.\.\#
#                  ###.\ .  .... . *......  **.. .. .   .*..* \.\. .... .* .. **. * . *  . * .    .*.  **  .. \..   .\.*.\*#
#                    # #\ \.. \\**.\  .\ .\..\* .  \.* ...  .*.\. .  \  \* .**.\\*.  *...*    *\.*.\*.\*\** ...* .*. *\*\.\#
#                     ##..#* ...*.\ * *\ \.\..**  .. .*.*..*.*..*.  * .\..\*..*...  *.*..\ *\**.\..\*. .**.*..**  .. \ *.\.#
#                    #.   \ * .**.  * ..\. ... .*.  ..*.\ ..*.\*.\ .  ..*.  . **. *** ! \ .\..**..** . *.**\.*.!.@..  .*\ *#
#                     ###. *   \\*** \*\.  .. *\  . *.. * \!*.***.. * *\.* .....\\..* ..*\. . \.*\*.\. *\ ..* \ .\..\\.*...#
#                       # *.  #.\.*.. .*..* *\.* **\.*@.\.  .*.* .\ ....**.*\* .  \.** * .*\***.*. * . * .* . .\ ..*...**\ #
#                      # #\  .\  *.*   ..*\\..*\*..***** \. *.*\ . \ . .* .\*\.  ..\ \*.***.*.  ..* . *. *\.\  E..\.** .* .#
#                     #*#*..*\*..*.!..*\...\  ......*...\.\.. *... .\ *@.\.* *  \ . *..**..*. \*.\..  !. *@\...*\  \.. .. *#
#                     #. \ \*...  .\@\.   \. * .\** \\*. .* .\.  \\  **\*!  *.  .*. .\\*. **..\\.. *  .  *. .*\. ..*\.* *\.#
#                      ###..\ .*.  ..  .....  \.*.. ..\ \*.. ...\.**\.*..\\  .\*.. .**..\.........@. .*** . .***..... **. \#
#                        #..*.*.   .*.*..\.**\. *  .* ..\*\.\. ****. .\*   ..   **...\ *..\\* **..*  .\*\. *\....*   .\. . #
#                       #* *.**\    .*.. .\\*.... \.. *\.\.*W ...\.\ *.. * \.  .\.*.\ *\@.*.***\..\ .  *   . *\... * .*...*#
#                        #\#.*\#.\*\ . *.. .*\ \   .\ .\  ..\*** .*..\.\.  . .*  \.. ..\ *.*..* .* *   *.* ..\  *\ ..*\.\\*#
#                         ##.  .. *. . .. \ \@ ..!\* .   ..  *... ..\  .**. * .\ .. . **\**.  *\  * .\*...\\.\* *  *.\.... #
#                          #*\   .* !*\..\ .*...\..\*  *   * ... ..** \\**.   * !!*.* \.**\**.* * . \ *...* .*.@.. . ..\ *\#
#                         #.*.#..*\..*.*.*.... *..*    .\  ..\ . .*.    ***..  **.\@ \ . .....*..** *\...\* .*.*. . **\....#
#                          ##*#*\*..*.*\ *..   .*  .*\ ... .. \*. . ..\* .. . *. *   .* **\..\.* .. ..*** ..  ..\** ** *\  #
#                            # ###*9\.*##..  \ *.*.*.. ...* *... *. *\**  .\  ...\.. *.. ... .*. .. ...\..\ .. ..\*\*\ ...*#
#                                 #@* . ##! . .** .*.. * * * .*\ .  ..*\  \. .@. * .* .* .* . . .\* *... \.\.. .  .\. . *..#
#                                  #### *#*##\**.* \** \..\*\ .  *. @..*.     .\.*  .... *.* **.. \ *.. *.***\!*.* .* * ...#
#                                      ###..#.# .... *\W*\..*  *\.\@.\**.  * ***\.*\ .*..*. ... .**\.* *\..... . . *. .\   #
#                                         #.  *. **\*\ .*.\ .\\. *..   *. .\ . . .  W.** * *.\.  ..* . \.  .. .. \ *..\*.* #
#                                          # .* .*\*#.   \.***.. ..  . .\.  .*  *\* *.\ .. *..   *.\.\   \*.*\*   . \ ** * #
#                                         #  *!  .*!. \. .  ..*  ..*.*.# **... *. .... *\\*.*\*  . * *.. .*..*. * .. ...\* #
#                                          #. * *#*** ... *\    . #. . * *.*\**.. . .* \. .*.. *.\..* \ ***.\.. !\    *\*..#
#                                          # .. ..*. \ .*..#\...*\#\ ..*\. *.*\ .*.. **. * * \..\!. . *. *...*.#\.*  *. ** #
#                                         #@  #  *\\ #. \.#.. #* .*##  *.. * ...\..\*.  \  \\*\ .* ** *. . *.*\. .*.*\\ .* #
#                                         #*\\  *.. .** . .\##\. ###\ *\*  *. .\ ***..**W**....*.. .\. ** ..\*.*.**.*.  ..\#
#                                          #.*# .###.##* . #  #\.#  #.# .* \*\ *.**.  ...\ *!.*@.* \ .* .    .\\**. * .*   #
#                                           ###\*# # #.*.**#   ## ###*.. * \@. .....**  .*   .\.*  .\*  *  \*\ .#*.*.\.***.#
#                                              ##  #.##.#\*#     #. *. . ... .*..*\ .  * .  ****.\  *... \!**.. *..*\  \* .#
#                                                   #  # ##       ##**.....**.*.**..\* \ *.\#.**\.\**.*.\ \*\#\  *\*\.\*.. #
############################################################################################################################

Water 0
Flooding 0
Waterproof 9
Razors 44
Growth 27
Trampoline A targets 9
Trampoline C targets 8
Trampoline B targets 2
Trampoline E targets 9
Trampoline D targets 3