#############################################################################################################################
#*\ *   ..!  ..\..*.*  \**\. * ..\.*   \*   .. *.. ..*\.* \**  .*.  *.\*.\. \..*\.  *. . . *  *..  .\\*..*....   ..*.  .*\..#
#\*...*. .\ **.. . *.  .** \*..*\. . \ **\..*..*.    *.....*.* .*..*@ .  .*...*.** * **\*\ *  . . \ ..*   ..   \. *.\.*\\*. #
#. ...**\*   .**. * ..** * .\*\.\*. \. \*   ** .  .**.*.*.*. ..\.**.*.**..\\*\\ .* ..**..\\*  *..*\* ..\.\*  .. **. !..* * .#
#...\ \*.. \*.@*. .. ..\  \ .*.\..  * *..* @**....*!\**..\**. *\..*\**.* *..!.\*\.  \*. . .. .*.. .. ..  *  \!*\\.  \ .. ...#
#   * .\..*.\.*.\*\..*.  *.. *.**.  * ..**\.***..... ...*\..   *  .!..*\*.\ *..... *.. ...**  .. .   * *.. . .  ..     .** .#
#.*\  \*  .  ..* . .  .\ *\* . .* .\.. .*..**.\**. \*.***.** .\.  \**.\.*\*.\* \  .. .  . * . . \  **! *.*.   ..  ..*.*.*.\.#
# *. ....\..  ..\* *..\ \..\.**..* * *.**  * *. **  .*.*\.*  .*\.\... .@\* **.\ *\*\  *.*\.  .*.  *  .\.*\*  . *\. *. . .*. #
#**.  *\@* \ .. ..   *.\..\*.. **\   \ .\ .\ \*.. . \* .. ... *  *...***.\.\.***. .**  *...*. .\  . *\... *. \....\..* ..*. #
#.. \ .**.  . .. .*. \\.* *.**.\.*.   .**\ ...\ \...*** \\  \* . *... *. . .\.\.  \.. *..*\.\*.  .*..    .* ..**W.\@... .\..#
#.. .*....*  **\.\   ......*.\*. .. *. .**\@  .    .....\.....\.. ..\**\  .....  ...\ .* ** .*.   .!   *  \   \...*..\.. . .#
#.*   *.*\*  *\.   \@*\ .. .  .\. . . .*.*.! * .. \.\ * * ...... ..*.\..  \. *  *... .*\...**..\*. .\  .\ *.\.. \..*\.\   . #
#  \  .*9  .* .. *\. **..* ..*...* .\  ...  .\* ... ..\....*.*.\\* . .*..*.*...**\.** .**. \...  .. ..\. . .\  .   ..  ...**#
#\   .\*  * *  * . ..*.\ ..  *.  . ...\*\ ..\.    .*. ** **...  .\   . . . .\ .**. .**  . .\.\**.   *       \. *.** *. \ .  #
#\**  .****.. *.\*\.. .*.*..\.*......*..*\.\ \ * *  \ *.*.. \..\. .\**. * .*\ * .** .* *.\.* .*....  *.  \ * * ...\.\* ..\ *#
# .. .\ ....\ .\ .  .*.\ *. . ** .*.!\**. .....**... .**...  *.*   .* *.*.*.. .  .\ \.\.****...\  * **   .\.**\** ..*. ... *#
# .* *. **.\..\.\* **.\. .\  .*. ..\......* . ....*  .*.*. . ...@. **..*.\..\ *.* .\.*...\.. .\*..**.    *..***. .\*\. .*.**#
#* \ .* **..... *.**. **.**.\ ** **..  .\*...\  . . *..\.. .   \** .* .* .  ...\.* .**\* .. !\*   ..  *.\..\........*\. .* *#
#. \\***.\ *   .  .\.. .  \*.\*. ...!....\* ..**\. **...\ ...*  .  ..*.   . *..*..*. *.\ \..*@.*. . *..*  ****.*\**  .!!...\#
#  .\.\.\.\.\.\  .  \.\. .\.. .\ *... .*\ ..  *.* ..* *** * \.  .  . * .\.* *  * **.....\ !..*\  *.***\.\  .\*.  ..*.* ....*#
# \ .*.** . .*...*.\.... *** ...** **\.\*\\\....* . \ . .*.\.*.\  .  \..* . . *.\.*\ ...*. . ..   .\ ...*.   *.**. . .  * . #
# ..**\*\. .\.*\\*.  **  .*.*  ..*\!..\.. *  .* .. ..\  ..*...*  .\ \  *\..  ... \*!.\*..\ \*   . *.. **......@*. ..\ \ .\*.#
#*.*\\*..  *  *. *.\ *  **..\*. .**.    ..... ..*\ *!*.. .* . *\ * ... .*. \ ..  .. *.F. *. .\ . ... *.** .. ..\  . . ......#
#.**. .\. ...\@ ....*. **..\.*.\  **\  **\\..\. .*. .*.*  .\\.*\..  *\**.*\   .*...\.\  .*\*.*  ...  .** . .* ..* * \.\* .\*#
#* .\  *.**.....\.*\.. .\. * ..*.*\.*. .  *..**\ .. .  \*.. . .  .*.*..*\.   *..*\. * ...**. .@. *.  \**.\...\...!. .* ...*.#
#.\. .@....*.  *. \*.\   .\.. ...\* .. *\ \. \*.*\.**.*..\.*. \**..***..* *  .* *   *  .\...  ..\.**. .. .*** *..*  *... . .#
#* .*.\*.* *.* *.  .**.\\\.. .  @..\* \*.*.* *. .**..*. ....\ .. .\.*. *\.\  \...\ .* ..*...\  **...*  * **.. *\ ** \.  ....#
#.  * *  * *...\   * .*.\*.\  . . @ . ..*...\ *!*.*\..*  .@ * \*   . \ .* **... * .   .\.  *  ..\ * .\.*.\.  *\ **. . *..\* #
#.. ..  .@  * .*. ****.*.* . . *\ !*   .*   * * .*   *.\     *.** . *.**\ *W  \ *\**\ *.\**..\.\ ..\\.*.* * \.* ..*... ....\#
# ** * .**.*.. .....\..*.. *  *..\@\.\.\*\  ..*\ .\ .  **..  ..\.   ..!\...\*  .\...  ***.\*. ..  * **. . .*.  . .*.*. . **.#
# ** \  ..\\**.*. *   .  .\.. .****...*.*.\\ *.  \..*\..*.  ....\ * *\  .\. *  .   .. *.*.  .  *.*. .*   \\..\.  . .. .. .*.#
#*.*.*\.*  .**..*! ..\ .   \** *.@..\. .! . **  *W......*.* * *  ...*. .\..*... \..*.@* .\ ...\****\.*  * .*\ *  *\. .\...\.#
#. ......  ...\  \... \* ..\..**.. \...\.\ ...\ .\*.*.*\ .* *\. . *...* .. .\.\ ....*..   * *.**.**...\*.*!**.*.*..  **.*  *#
#.*@*..\* ..*\ .\ .*  .***\. .*. * \ **. * .**.*.   * * . . ...* .. * *\**.**\   . .. . . . .*. . *  ..\.. ...  *.*\ .*...@.#
#...*..\*\*.*.\\..*. *\ *.\ .  * .*....\.*..@*.W..*.W..   .  . *  \ . @*.**. .\* .. \* .  *  *.   **  .**.\ *\  ..\.* .  *.\#
#.*\.\.*...\* *.\... .  .\. \ *.* **... .*. ..  .*\* *..\* * . \*.**\ *.\.* \ .. . ..... .. ..*...*\*   \. **..*.*** . \ ***#
#*.*   ..*.!. \. **\* .. .\ ...   . **.\.\ . \ \* .*. \  .\.*   * *...\ **.* .* . ... .  . \**..* \. ..** *. ..*...\ **. .\.#
#.* **. .. ** *\*.... *   . . *\ *.*.\ *.. ..W ....**\..... *\  . \*\\ .\.*. ..* *  .*   . ... .* .  **....\  .**. . *. * \*#
#.*\* * .\..*...*\ \* ..*.*.* **... .. *. *.. .  *..*.       .**.\*..  * .\.\* \ *.\.@\   ..\A*...   ..*.* ..  ..\...\\.  .*#
# .. ..\ . ..*@  .. ..\ ...*.!*..\ *.  .. ***.*.*...  *.. \  \*.\ . .* .*@.. .\. . ....  .**..*.  ...  ...\  *.**.\* *.** *\#
#. .. @.!*.  .**\.*.\.  .. *\.\.\ ..*.  *.....\... * .* *. \...\*. * * *.*\.*.*\ .. **.\.\.*... .** .   . .\ .\.\ ..\. ..*.*#
#.*.* \..* \  *\. ..   * .** **. .* **\*\.*\\  *. * *..     \. .*\ \ .@..\\\** *.*.!*.*. . *..\ *.*.\* *\.    *.\  * ..*@. .#
#*.*. .. .  \.\ .\*.* *.\. @.* *. \ ..*.* .* \ .... !.. . .. .\.. **  ..*\.  ....\  *....* ** . ... . .. *..*.. ...***.*..\ #
#* . ..  ***.\*.*..*.\...\.*.. *.....\* .* ..\.* .*    * .  *  **..**.  .* * .* .* \*\.*..*...  * .\**. *   .*.\*\.\..\   .*#
#*\*.**. .\*. .***.*\*\* . .  *.*. \*.. .. . * . *..\ *\.**\..\..*.* ** . ....\  . * .\\.*.\ \.\.\.*\*  .\.* .\ .**  . !*  .#
#.*. \\*  .**.\..  ..**..  * .*\..\.  .*. **\.\.\.\ !*.* \. * . \*.** .  .** .. * @@\ *.. . @**.\.  ...  . *. .*\\ .*.    \.#
# *.. **   .** ** \ .* .***. *...*..   .. ..\. .*..W*\**...\*  * . *. \*\\..\ .\. ...\*.\*. .*@.@..\***   ..  **.*  ..  **. #
#*.\.*\* .W\**\ *\W.*. ...\ \* .. \.\**\ \ .****  * . * . * .....\.*\*.. **\..*..*\.*  \ . ** *.. .*!..\.   *.\ *.\   .\** *#
#* .  ...\ .*\. .*  ..*..\.G . . .\*..* . . .*.   .*\ *.  \\ \ .*\. **.. *. .**\..* *.\..*... . \  **\ *.\.*..  . . **\. * .#
#.\ .  **\..*.*\\. *      .** ...\.\...*.* \..\*..\*. *\**. .\* *.\*....*    .\* .*.****...@\*.*.*.@ ..\ *... .*\    .. ..\.#
# **  .\\** ...  \. *..    @\ * .*\..*   \ . \ \. .*  . . **. .*.. **\  .\..*  . \.*.*\\**\..**.* \.  * *\. .*.\. ** *  .*.\#
# ....** .*\.  . \. ...\* \...\. *@.\.\.\.\ .*..**\*  \  * *\   .*.*...   ....*. .\. * \...  *** ..**.**. \.*  .*..\*.\ .   #
#***\*..\.\\..*\ .\   *...  .   .....  **...*\....**. !...\. .\*. ***\\ .....*. *..* .\.\ ..\.\.* **\ \...\.  ....!...  ... #
#. . . . *.. \.*...*  * .**\ \!\ ***\@*.* ... *\\*.*  ..\*..   \\ \..* *.** .**... ** ..*.\.*.\..*\* \. \.\.* *\.  \.**.* ..#
#*  .*.. .*  .*.  *. .. ..\ \ . ..** \..\.* * .. *..   .. . .*\.*\   * .\.*.  \! *\. .     . * .*\*. \* .\  \.@.* \......\. #
#\ \* \.. . .*.. \*..    .  .* **.\*..*   . ..\.*..\ *\.*\.  *. \..*..**.*..\.*....\ .  . **** \..\. .*. **...\ .... *\..*. #
#....\.. *\*** ....! .*..\. *\*... *\.*. .\ \.  .*.  .* .  . \*.\..\.****.. ..\    .*\\.  *..... \  .\ .\.*\*!*   . *.. .\..#
#.\. *\* * .\*.\ ! \ \... ..*\.*  ... .* *  . \.***\ *.\.*\  ..@ .. .*....    .*** *...\. .\* \.  *.  . .  \.**.*.*.. ..  * #
# . .\.*.*. !* .**..*...\.  .* ...\. .*..*\.* . ... . .. !**   . .  *\.* ****..... .\.   \**.*\ ... .  .*....*...\\*** .**. #
# .\ .\..* *. \**. .*..*  *    *. .  . . . ..\\* !.\.  *\\** *   \. \  .\\.\..\* . * *     D .  ... .***  *.\  * *.\** \**  #
# \.* .* .\.....  **..*.\.** .\.\* .  \** **.*    \.\..* . *.* @..\   . \*\   *\.* \ .\***.. *..* . * ..!\..* .\ .\..  .... #
# .*.  *  .@\**   . *..*  *...  .. *...*.**.   .*...\* .. ....\ ..*.*.*.  . ..\..**..  .**.   *.*. **.*...\*.\.      . !\*..#
#  ..*.\...*.. *. *.** .\...*.. . *. .*.* .  .\ .**. . *.. . .*.**. .. ..*  .\..**....*  .  *. .*.\ \.* ** *..**. \* !  * ..#
#*  \..**..... *. .*\**. *..** ...*\.... .\.*\...*... .* . .*..\.*   **.\.* .* .*.. \ ...\ *..* \ . . .   \***.\. . . ..* . #
#\ \ .\*.\. * **. .   .* * \... ..**\*  .*.*8*.* *     *. * . *.\*....**** ...  **  .\***.... *\.*.\*..    .... *\\*\.  .  \#
#.  * *.\*W\\ **. *  *. *.\\ . .** .*... . *..\. .\\ .\.... !.\..*.. \...*.\ . *...*...* .\\.*..  ....\.  ** .\...  .  *  . #
# .\! \.*\.*. . *..  **.. .* ..*   ** \ *. .**. .** .. . * ... *.!\ *.*...*!*.\. ...\.  ... *\*\.  ....* .*...  ****.*\.    #
#\  . . * ..**\ * .* . *\ .\.\\* .. *.. . ..\.   *.  * .@*. \  . \. .. .\ ...\.*\\ . * . *. . ......* ..\... ** \.. ..*.* .*#
# .  *\... **\**. !...*   \  *.. .*..*\. *.   . *.* .. .** .\.\ .   \ * . . * *..*..  *. .\ * *.! *.\..**.*..\!     * .*\*\.#
# *\.\*. .. *!.\  \ \.\.    .*.*\..\...**.. E   *.! .*  .*    *\.*\ . **\   **.\** *.**. \. * *.\.\ @* ..**.\.\*.*. \*1. *.@#
#*\*.**\* * .   .*.*  .\\ *. *\**. ...**\*.**.* \   \....*.   *.*.!*  ..  \..\* .  *\.*....*.*.* *..**.\ *\!  ..*..*...*@*. #
#.\. ...\.\  **.\..* .*   . *.***  * \.*.. ** **.*  . .. *.*... *.***. .\..*.  *\.*.\. \.... *..\.***\\. .. \ *....**\ . *. #
#.  .*\\.!.  *. .* . *.. **...\* .  \..*.* .**.*\. \  .. .*. ...\.  **.   .. ..!  * . \ .**.*.* . . *.\.... ..****..*@   .* #
#. *..... .\... ..   . .**.\***\. .    ...  .**.* *... *    \ .*..*..   *\   .  \..   . *.\ .*.\   \. .\ \  .\.*.  \..*\*.. #
#  ...*\   .. .  \**. .**\.*...  .* *\ .  ..   .* **R.\\  .*. **..*** \\.**** .\.* .  *\.\   !\  *. \.. **  .  .*\* .\* *..*#
#  * .* .\.... \*..*\. \..*  \... \\.   . .. \.  \ \....\***. **  **\.. ..  ..\.*...\ \.* \*\*....*. * \..\.  **. . .*.*\* *#
#\ *. .! *... .. \*.. \ .\.  .\*  *. . *..\* .    .. *.. .\\*..  *!. *. *   *.. .*.\* * * *!\* .\ \**.  ...\*** * \*..* .*\*#
#* **  .*...**.**.*\*  *..***.... ...\*..* ... . *.   ..* *.*.**.**  \\ * *..*.  .  * \**..**.  *   ..*@.* * .* **** ..\. ..#
#** .*\ . * \* ..* ****.*..\**!.*\  \*.    .  .\.\.!* \**  .... \ . ..\ **.**.*..   .\... ..*\.\.\. **.**\ ..\.\...\ \.***.*#
#.*. ..\*..\.!**.** ..  ..*.*. \  .* .. \*\....*...\ *..\\*. . ..  *\    . ... ***.*** \*..\..  **  ..***.\*\..\ .   .*..* \#
# .**.*.*. **\..**W\.\* \ ..***..  * * *.* .* ..*  ....\.* ...\.. \*   .....\\.*...**.  ..**...  .\.****. *. * .. @.  .!.\. #
#*\...\.*\ . \   .  ..**. .....\.  **.  ...*. ...\. .  .W. *.*. .\.!*\.. \ \   ...*!  ** *.\ ..\. * *.  \..*.*..  .\..** .. #
#*...... .. \. .*\ . ..   * \ \.\*\...**.\..\.**\  . .**.  ....*** ** .*  .* . ..*.   \. ..  .**.\.\.       .*. \ *. ..*... #
#.* \.\..*\..\  .*.*.*. **\ \..\ ** \..*\ * *\.*....***..*.** *\...\. .*  *..*  ** .\.. .  * \*.\. *\ .*...     ....\ .  .  #
# ...  *\..\* .. ..\...\ ... *\ . * . *  *. .@*\   ...\..  ...*. *..*    .* *\@* .*...*... . .*.*\...* ** .... .  *\.\  *\**#
#. .\ . \ ..*    .  *** *..* ..*.. ..*\ *... **. 7. **. **. . \...***\.  *...\ \  .***.. . . \** !* \..*. . \ **......\. ...#
#\.*.*. .*. .. ..* **\....\ ...\!\ *. *.\  * ..***.......*. \...\ .. \*.\ \.\...* .!*** \.\.\ .\ *..   \**  ....\  .... ..\.#
#..*.... \*.*..\. .*...\* \. * *...\* W*..\... **\  ..\  *\\ .* . . *....\*.. .*.\.  . . .**.\.***\\ .\ * \\ \ ..*\ . *  .* #
#* *. *.   ..**.\....   .*  \.*.*.\*. \   \ ** *. * *.!\*.*.. .\..... \ ***..... ** .\..* .**.*..* *  *\. . .!.*.  .***. ..*#
#** ...*. .\*.*   @**\.* .*.* . * .**..\\.\ ..**\*. .*\ .  ..    \   ..*..\.  * * \.*. .*. ...*\.*..\... .** *.... **...\\*.#
#. *..... .*.*.\*.*\.   ....***  . .\..*\*.. *\**.*.*..* ..**.*\  ..\ *\ ***. .*..  ... *\ *.\. ..*\.\ \. .. ...\! .\.*. . .#
#. * ..*\.\...*..*.*...     *.**\**  .\.*.*  ..... . !\  . ***.   *.. *... ..* .   . **.  *. **\. .*.*...*.\. * * \!. .** ..#
#  .\**.\ .*@. ...* *  .\*\.\...  .\**!*.*.*\ *. *\. \*  . **...\.. .*..\. *..\\ . *..*\.*.  \.*\*....  *\* ..*\  *.   ** . #
#\*....  **\.  ..\..*\ *.*. ** \  *. *\* . . \.* **\*........\. .*.*\*\.*...@***\ *.. \  .\... ..* *.\.** *. \.*. ..*\\\..  #
# .**   .\*!. .W\ ***\.\*.*.... . .\  .... **.\ .*.\* **......  ..*... *.* \...*@\* .* .* *..  *\* ... *..\* .\*\ .*\...\  .#
#  .*\* *..** ** ..*. .  .* ..  ..\*.** \ . .. *   .. . .* .*..*  * *\.@ *. .   **.*.*@.... . ...*.. .\* ...@ .\*..**..* .* #
# *\.\  .*.\\  .   *. \.\.*\* . ....*...*.  . *. . *..   .\*.*.* ..*. ..*... * \.. ..*... ..*.   *... *. . *..\ ..*..  ..* \#
# .  *\* .\. *.. .**.*.\.....\   . **\* ... \ *  .*.*\* .*.. *   .\.\.*\.* . **\ \   ...\ . .* \ * **\\*.  \ **. \.*\   *.\.#
#\  *...\.*.\..\ ....*  \.\  *.*\\ .\ * \** \..* ..\. *.\.\*.*  ..**. * *..*\C.. . \*.. ....\  ..W.\**\.  .. .. ***\@\**.*..#
#* \**   \* * .. \\ \  *. **...*..* * \ \.\ ..\. *\.*\ *.. . *@. ...\\* . *... .. \*....*.....\ *  *.\...\*. .\.*.. .. \*.* #
#.\ !**...\ . .\ .\.  *  .\..\*.\ . .. **.**. ...!  .*\*  .* *. *\*   .  ..\.* ..*.. ..\*. .*   .*.*.* .. ..*.  .... ...*.. #
###B *. #* .*    .*   ..** .  *. \** *..***\ \W  . .*. ...\\ \.**.. .\*. .*...* \*.*\*. .**\\\.  .*..*.*\ \.**\.**.. .. * *##
#   #..**#......* . . * **\  ****. ..*\  .\*.. .  .\. * *\.  .\.**..  * ....**.... * . * *. *!    .*\. .* ..*..\. .\!*.** ..#
# .  .***\ *\. .  ...\.*\*.\ ..** .\.\ ..** .*. * *4  . *. ..** *.\  .... ..\.***.... .* .. . ..**\. . .*\  ...*  *  .*. .\##
#\#...#* # .# . . . ..*  .  ! .\.\  *. .**.  .\..\..  * .  *.\. .*.**.\.*.*..*...  .     \*  . \*...*. \.  ...\  *****.   **#
#.## .#\\#\ .\  *.   .\\.\  * ..*.. ..* ..\*..\  .  \ *.... .\.\. .*. * \..**@. . **\.   ...   **\ .... \*.  *.* .*.... \...#
##  #!###*.*..#.** * *W\...@.\ .  **\ !.. .*.  .\..\** .   .*.* * \. *..*\ . .\** .@* .*\ \.***.*..\.* \ \.* . *  .. \* .#..#
#    #  #\#.#\.....*\. .*...\*\ . *. .\ *. .*.  ..\ . . \ \ *\.**\.**\ \..*\ ....\\.\  . \..*...*\.*..     .  * ..* ..\ *#\##
#       #.* ###!. ..\ .#. *.*.*\**** .. *.*\*    \ *\.  ....\.**..*.**.  ..*.. \** \ .** *\ *   ..\ \ ..**... * . .  *. ..# #
#        ###   #**\*.* .  .*. .*\ ... .   .. \.  ... *  !**.*...**.\..  ..**..\ .. .* ..\.\ * ...\.. \. . *.. *#.*.  *..*## #
#             #. ....* . *..\ .*.\.*.\.*\* .....* * ..*\.*...\ ...*  \***..\.\..\ * ..\\.*. * *\   ...\    ** *.  . *.*\\ \##
#              #* .*\ \. *.\*.. * \. .*  ..*. \ * * **.. *.*\  . ..*.*.**.\* . .  . *.. *..*. *.  \.   .*\....*\. .* .*#*## #
#               #\ # \ *.\*   . **\*W ..\ .. \. . ..*.\...\*.**.*..... ..\.* * .* *.*  *  *.. \..\ \.\\\. \.\ . . .\### #   #
#               # . \  *.#\  *  .\.*\.  ..*.\  * \**. *** .. . . **\*\..\. W#** ...*. \.*\\*. .\@. *.  \ *#\*\\.*. *#       #
#                # *\ ..*  *\.  \  ** .*.**.*  ***....*.\ \\**.. .**\* \***. .\.*.\.* *\...*.** **.   \. .  \...####        #
#               #*.*#* !.. ..\.*\ *\..*.\.*W\\\..*\* *.... **.  **. .  .*..\#\*\.  *@ \ \*\. ..... .  #... \  * \#          #
#                #**#! ##. .W*\\. ..**.*.*..* *. ..\.. .\....\ ...*\* *\..* .. .\\ ...\ ... \* ##.\...  . .#\!.##           #
#                 #.**\.##. *. *.\ *..\.  .\*\..\ \  * \.*.\. .  \.*. .*. .***. . . \.. \.\  .*# ##\.  . \*\  .#            #
#                  ##*###.*.*.** *..\ \.\ \  . \ *. .. ..**    ..  **  #**!*.*.* .**#**   * .  # #.*\.*\. ##\#L             #
#                   ###**#.\.\\. . *    . ..  *. .  *... .* *.*. . *.#.\*\*\###.#*#..# * \.  .*#  #.\ ###*# #               #
#                  #*\....  *..**..* ..*   *...  * ..*   * *\ .*\  ** #...\*#\*\.*#. . #...!*#.#   #.#   #                  #
#                   # .* \ \.**\*.......  *..   \  * .*...\..*  *\  *. *. .\\#**\.#  \.#\\. \\#    #.#                      #
#                 ##* \ ..  #\** *. \ .*.*\.   \ .\!  \.*.. *.*..*  .*\ #.### ##*# #\. ...#\##      #                       #
#                #.. .##***.. .#*  *.. **.\  **.  *\ *..*.\\ *..  .# .#\*\*#  #.\ # # #*# * .\#                             #
#                # .### *...#*...#\ .** .** *\*.*  . *#..*.. .*  *  *.#####   #*.\#  #.*##\.*#                              #
#                #**##. # \.#\## #*.*\. #\. *.\ .*. **.. *#\  **.#**##         ##.#  # !# #*#                               #
#                 ##  ## *## # # *.*#  .\ *.. .. *.!.*\  . .*\*#\.##             #    ##   #                                #
#                    #\ *#     #! \ . *##.# .\ ### *\.*#. # ###  #                                                          #
#                     ##.#      #  #  \#*\*.###  #... #* #\ **###                                                           #
#                       #       # \. .# ####     #\  *###\  .##                                                             #
#                               #\##..#           ####   ##\. *#                                                            #
#                                # #.#                    #**##                                                             #
#                                   #                     #*. \#                                                            #
#                                                          ##*#                                                             #
#############################################################################################################################

Water 1
Flooding 4
Waterproof 2
Razors 0
Growth 33
Trampoline A targets 1
Trampoline C targets 9
Trampoline B targets 4
Trampoline E targets 4
Trampoline D targets 9
Trampoline G targets 8
Trampoline F targets 7