############
#**  .. .# #
#*.\R..L*# #
##*.*\ @..##
##.**  .* *#
#*. * ..*\##
##.##. .\# #
# #  #*. # #
#     ## # #
############

Water 7
Flooding 14
Waterproof 1
Razors 0
Growth 33
