##################
##.\.. ** .*  #  #
# *.#*   . ....# #
##*  ** .    ...##
#   . .    *.. R #
##*.\.**\.#.\*\.*#
##** .* ...\ . ..#
#.*.#..\. .\ *\  #
#\ #* .  *\ .  *\#
##\ .\***. .  * *#
#**.\.***** .. L##
## ....\** . ...##
##** *.##.   *#  #
# #####  #.### ###
##################

Water 12
Flooding 9
Waterproof 15
Razors 39
Growth 30
