#######################
#  #*. *.L**. \...\ .*#
###.*    . .. .*.\#. .#
#***#*. ..**   \ ..\  #
#### ##.*\.. .\..* . .#
#   #***.R..**.\ . **.#
#    ##*  *...* *\..*.#
#######################