##########
#..#*.  *#
#  *. \.\#
#.\# .\*.#
##*@  \**#
#*\##*#R!#
####\.. .#
#   #L.*##
#   #*...#
#   # .* #
#    # ###
##########

Water 9
Flooding 11
Waterproof 11
Razors 35
Growth 16
