###################################
#           #                  #*##
#          #.#                 #*.#
#          #.###               # *#
#         #*.# *#         #    #**#
#    ##  #\ ...\.#       #*### #**#
#   #* ##..#.*\#  ###L   #..  # .*#
#####*.#.*   ...\.# \.### # \.  . #
#**.*#*\ ..@ *.  .. #\ *#\#..**\ *#
##. * *. *.!\*\ . .*\* .     *. . #
#.\.* .. .\## * .\.*W\  \.*. .\ .*#
#\. .... * ...\.**\**.# . ..#.*  .#
#.* *.\  .....  *. *\.*.* ....*\* #
#\. .. *\*@***\ *. *.*. .**!  .!.*#
#* . ..\ . \... ...*. ....\.* *\..#
#** \.. *..  * .  * ..*  *. .\.. *#
#\*\.  ... \ .\ .*   *.\*..\**\ *.#
# .  ..* . .*  .   *  .*@  *.***. #
#.* ** . * \*.*\**\.\*.. *.. .*** #
#.\ **\..!..*.. .*.  . . .\. ..\..#
#.**. ...\..*\* .... ....*...  *.\#
# .\.  ....\ \.**.\.* *\..*. ....\#
#   .    .\**. .......@*.*.***.\.*#
#  \* * .*\.**.*.\ .\ *\!...*...  #
#\ .*\*.*..  .*.\ \ .\. ..*.*.  .\#
#*.. *** .. C..*... .***...*.* ...#
#* ** .*..@.....\.  ..\**\ .\.  * #
#.......***..  *** \ .*..*. .\..*.#
#. *.. \.  *..\*... .\ ..** . .*\*#
#\ \. * . ..** !.* ***\  ...*\.. .#
#..** .**. !*..\.. *  \... *.  \.*#
#.*.\..*.\ *..@ ** . *.. ..\..... #
#*.\.* *\. @.**..  * !\.\   *.* *.#
#\. \*\. ..\.*..\..* @ \.** . *\..#
#* \ **.* *.! **.* *    \*\ \ .*. #
#* .**.*.\. .. \.***. .\..*  \..*\#
#** .\.*\* .6. .....\*  *... .. *.#
#. *..*. .  ..*9.\.\*...* .*   \.\#
#. .. **.W\.**. .....\ \.\. .*  . #
#. .**.@ .  *.. \ \ \.*  ..  .* * #
#.. **.\**\*.* *!*.\A * ..\** . \\#
#\  *  ......* *.* **.. \  .*  ...#
#.  **. *. *\  ... \**..\ *\**  *.#
#.\**\* **.. \ ** . .*.\. *\*. *.\#
#  \ *\..*.. .\..**\.\.* .*... * .#
#. . .\...    .*\ .... . \.\*\.   #
#\......   . **\*.  .*.@*\. ..* *.#
#. \.*.*.. * **. .*.W\B.\ *\*\....#
#*@.  ..*. .*.* ...\ .. *...\.* \.#
#** *@.* *. ..   .\* \  ... .*@..*#
#.* \...*. . .*..* *  @*...  .*. .#
#. *  *..\*   .**.@* ........ \.. #
#.\**....\**!..*  \ \ ** ...\ .  *#
# ..*.*   .. \...\.   .. \ ..*..**#
#\   *..\.  . * .*. \ . .   .. ...#
#.\ .. ..*... \*.*\    . .\** \. *#
#. @ *\  **** \..***\ .**...** @**#
# .. ***.*..\ ..*..@ * * ***..*\.*#
# .* \*. *   . **.\**. ..*.\*..**.#
# \.   \**.\ !.*. .**..\ .... !   #
#....* ..* *\\ \*. .*.* . *.   **.#
#.\*   **..... .** . \.*.\.**..\. #
#\\.\....** **\ .*.   .*** .. ... #
#.  * ****.....  ..  ..**.\  . .*.#
#* ..\. \..*.\ * \**\  *.... .*. \#
#..*. *.. ..  . ..**  **!  .... R #
#\*. .. \.  *.* *.**  *..*. .*    #
#*.* .. **.\.**. *.\ \*  ***...\ *#
#...\ \... . .. .. .* * ..\..  .!\#
# \..***    .* @ **\ ..* .*  ..*  #
# ....** .*. 8*  .. *...\*. .. * *#
#.\. ..*.** \..\*   **\..* .  .* .#
#\.  .*.*.... ....\.*.. *.\* *.. .#
#*\. !*\. *.  .  \.*. . .*.. .  ..#
#..  \*. !\ .\*  .\*  \.*\   ...  #
#*\.* .  .* *  .*.*.... .  ..*\ \.#
#*  . . .\. * ...\.*** \.\* \. * .#
#...**. ..*  . .*...*..  ..\.*   .#
#@.*\\* .* .* . **.*@ ...*.*.\.*..#
#**..*!.  * **   \. . .\\. .\!\...#
#*.*.*.*....\*..  *.\ .*\*.***. \ #
#. \.*..* *\***. \*. .\\.**@\*.* \#
###################################

Water 0
Flooding 0
Waterproof 12
Razors 45
Growth 37
Trampoline A targets 8
Trampoline C targets 6
Trampoline B targets 9