##############################################################################################################################################################################################
#\ ** \.*.. G . *..\ \. * ... .\. . .*\  *..*  ..\ \..***\. ...*. . .*. ..*\ * . . **\  .*..*. ..  . . *.* *...\*. * * *.*\ .. \ *\**.* . .*\.  !. **\*.... . . .*.. .**\  .....\..\**  .#   #
# *\*..**\.  **.  ..*. .\\\ .  .  .......**.* ..*. .* \*. *..  ..*  . @*. \... \*.@.\.* .. *.\ ** \.*  .\* .\.*..** *!.* . \@\......\... . . ... ...\..\.*.. .*\ .**.**\ !  .  \.\\*\...*\#  #
#\**.  **   .*\*..*\..   . ... *. .*.* \.\. .. . * ..*\****..***** \*\.. **.*\ .* *.*\..*. .  ..  ..*.**  . \ .\ **\.  . *\.*.   *\ .@  *..*.   .\.  \**\. \. .*  *. ...***.\. \*  .*..**@#  #
#.....*\  *  * .. ......\ .*.\ \.\*\*** . \ ..*    *\.*..\.*...\*    .  *...* \ . .* ..*..* \ * .*\.\*... *\...*.!.*\ . \.*   ..*\*.\. . *\! . ...   **\.\ *\.@ .   *\*\. *.  #\** .. ..##   #
#*. !\\.**.  ..*.\   \\\..*..   .** ..* .*  *..  . \.*. *.\. .*.* * *.* **. . ...  ** *.*\. .*.!** \*** *.\\ ..... .*. .!\.\ .  *.*.*.\.*. * \   .   .* \ .  .   \ .**.  ...\ \\..**\* \##   #
#\*..   ..*.\. . .\*\ .*.**..* .    ..*  .**.*.* \ .*****.**\ \.*\**.*. \....** .**. *.@.* .\*\ ..\ .\.\*..*  * * * .   **... .*.\ \.\. .  .. *  .@\*\*. .... . .   ..*.* ...* .**\ *#\*\.#  #
# \** \*  .* ***\\**** .*. .\. .** .\*.\. **.*W.\*..\ *..\.. \. \.* @.  .\\. ..\. ......\.  .  \ @..  * *. .  . **.\. .*\.\*\  ** \..\* ....... **. * . **..    ** . .*\ .   *..*  \# ####   #
#..B . *. ..*. .*....\ *.  \ ..@... ....* ** . ** ... ..***   **.\* .. \\ ..**. *  .*    .\   \... .\. .. . *.\.\**\.  .** *.\..\*.* .. .\ . \.  ...\!  .*..* .*W. *****..** .**\.\##        #
# **  .*.. \.*.  ..*  !.   . .  \*  * ... ..*..\* .*. . \.* . **.*...  .. * . . .\!..\\*\ *.\*. \.\\.!  .***.\ . .  . ...\ *\.\**...  \.\    .. *  .. .**  .. *.\* ****..\*\ \\..#\@ #       #
#. \\.\***..*   . **  . **...*. **.**.* .    . ... .**.   *   *\.*.*  *. *.\  *.*  *  .* **.   .   \.. !.*.\*..  * **.*.** .. ..*.\ ... .\    * ...  . ...*....\ \ **.*.\*.**.. .. . #       #
# \ . .. . ** . \... .  *. **.\\..\! *. .* *\ . *..**. .\.. ...  .*\ *\..\ .  . . \. * .** \  .. ....\. .* **\ *\.*\.\@**9   * * *\* * * ** . ..\..\  \  **\*\*  .....* *.. .\.# *\. #       #
# ..*.\.\*..\* **   *\ @.\ ..\ .*\ *... *\ \* \*.* .**  **.*\*. * . *. .\\. *. .*. *...\....   \. *. .  *\..  *.***. *...*.  * *@. *   \.\\ . ..  **.\. *\*.\...*\..*... *  * *. . ..#       #
#.\.  .\   .\..*...\.  .**\.. @.*...*.*..!*.@!!.\... ..*\. .*. .**.   *.*.. * . .. *.***. ..   *  *\.**  .\..\*\.\.  *..*\ \ ..\** .*.*  *.\*\.\*..*.@.*\*. .*\..*. ..*..*.\**\.\*...#   #   #
#  . *\.*\..*  *..\.   *.\...**.*..\... .. ...*\*\ \ *...\  ..*...\... .. \.\.* ..*...* *\ . . * *..*......\\....\.\ \ *\.* ..* !\ ..*...\**..***. * ....*  \.. \*** !* ..* ..\.***\# ###*#  #
#.*\**.\  .\*.\   .. *** ..\ *.* .\ *.\. \  !\....* .  *\...****   *\ *  *\.*.* *\...* \\ * * ..\*.\***.\.\. .*  .. *...* *  *.\ *\.*.. **\.  .*. . ...\*. ..   ..*\.\*\*  .\* ....**#..#.L  #
# ..*.*.   .*.*  \.**.. *...*\.. \.....* .  \   *\\.\. ....*.*.. .*** *.*. * .\.\*.... . ..*.\ * . *\.*** **..* .. *.  ..\. **\* \*\.\  *\   \.  ..!\...\*.*\**.@.. \..*...  * ***..\  ..\.# #
#* ..\.*.. ..*..*.\.\.*.*. *.. *. \*.\ \ *!  .* . .   * * \* . ....* .. ..*. *  **..\. . \ *.\ **\\. \.\* *. *.... . *\  !   *@. .**.. .\.  .. * **\..* ..\*..*.....! .\..* *. .* .##..### # #
#.\*. .. ...  .\*..*..**.*.......\**\ *... !\ .\*\   .\ ...* *..*..**.* ... ..\ *.\\ *\..  . . \.* .  .* *\.....\*  *..  ..\.\.*. *.*..***.*  . \..  .. . **.\* * .  \. * .\..*..\.@*\ *#.#  #
#\*..   .\. .  .  .. *  \*\ .\... ...  .\. **.*.\*.. \**\.*\.*.\. *.\ .\\.*.\  ...*    *.*.. .*. .*.*\.   *\  \    **.@ .\.. .*\ . ...*...\ \.\..  \  ***.**. .\* . . * ..*\ *.\*  \.  .* #  #
#* ..  .*...*..*.. \.   .. * * *..*.*\*** ..**.. .. . .....***\ ..*.** . .. . @\. . *. *  .**...*\.*.. .. .. \  \.**.*..\.** *  .\  ..* . ... ...*.. *..* ..\.*.** ...\  .. *  *. ..*\  .*.# #
#.\.    .*.*..\* .\.*.\\...*\. .*\.. *...*  .** ***. **..\..**.*. \**\\**.   *..*..*. .....** \ .** ...... ..**\.*. .* .  ** *\. .**..\. *.*.\*  \ * .*\..**....\* ..***. * ...!..*.. \ #\#  #
#\* ....*\. . @\ *   *. *  ..  .  **..*.\*....\*.... * *.*\ .\ * \ \.. ...\ .... .*. \..*\..\.\..*.\ .\ .!. ..! \** \ \   .... \. *\..** \.**. .*. .* . * ..\.      **\.. . *\.*..*..**. *####
#..\ *  ....  .  . *.   ..*. ..  **.*..\ .**\. .*.@... ... .*.*\\.   *. .. .* ...*.** \ . .  .*.\\ .* * .\* *  ***..\  *\ .**\*. *. .*..  ... \*.*\..\ \**. *. .  W .. *\*.\.* .\. * *. *. *.#
# .* **.\  .\*@  .\..* \*.   .\ ....* *.\.*.*.* *. .  * \  *.\**. ..**.  **.* . \.\.*\ ..*.*...*.\.*. * ****.!..@.\**... .\.\D. *\.\.. * * **. \ **. .. *.**\*.  \*\.\.\..\*. *.  *. . *#*####
# *\ *.\.**\ .* *.**..*.. *.   \... .  ..***... . . .. \..\.\... *.**. .\.. *\. .*.\ .   *\**\* .* \ .\.\.\.*.. \.*.   \ ... \ *\*.  \**. ** .\  *.\ .*\.   *.*.. .  .\ \ **..*\. .*.\#\##   #
# .\*!  *.\. .*.\ *\  *\ *** * ..\ . . \ \. . ..    * .***.\. ..\*.*\* ..  ..*.*.*\. .*  .... .. .. .@*. .. \ \.. . .  ..**  *\**\..  *. .\\.\ ** * *..* . *.*..\*\*.*.\.... ..  .*. #*#     #
#**.  * ....   * ...  *. ..* . .\. .\.\  .\   .  ..**..... \.   *\*!.\ * .**\* \ .*....\* . . *. \.* ...... *...\! .\. *\.. *.*.@ *\...\..*\! **.  \.. .\  ...**.. . \ *    . . \*** #.\#    #
#\*\ .\ *.\...*\*** *     *\.  .*.\   . \*.. . . .**\.*\.* .   .... *  .. .* . ..\..* \..  . .  *..... ..*!.\**. .\.    **  . @*\ . .*  .*.. A\..\.  .\*. ..\\* \**...* *.  .**..**.\.**#    #
#*.*. *.. . * ...\\*.  *..*** .*.  . \\. *  ..\ .  .  *  . ..*****\   ***\..\ *\ ..  @.** ** \**.***.\*  *\\... * * \\* **\ * ...\..\.   .\ \.  *** .*.** @....\.**.. .\**..  *  .. .###     #
#\..*\  ..\ * \*.. **... .  * \.. .\ .\  . .*..*.  . *** *. \..\..  . *** \....*.. *.\**\.\.. .**\..\\  .\. *  \.  7...  \.*..       *   .*. ** .*\.**.*\ ....\ ..*  . .  .. ** *.\ #.#      #
#..   .* \*..\.  * \.\ **  *\*.. *\....*\* *...\**..*\*\..** .\ **.**..\.   .\*... . ..*. ! **  .. ..\*.* .\  .\.. *. \.\  * .  .  \**.\. \. .. .. .\* . .   . \ ..  **   *.**.\.   .\##     #
#.. . .. ...* .\ .\   ..@.  .*** \**\\..*\ . \* ..*.....*.**   *.  ..\  .  \. \..!\ \. @..  ..*\*\..\..\.  *..****\....  .\.\ . .\..\*.**\   .. *\.\ ..\  \..\**  . **.\* * ..*...**\ *.#    #
#**  \.\ \! .*. . * .**.*. \.. .*.. *   ...\ .*.. *..\  \*.\ . .\*.*. .\.\. **..  **W...* ..*.... . *.\    .\\.\*.\   . .  \..*.  *....*\ .*.   *\. *.* **.\*... . .*. **......*.**\#..* ##  #
#.*\\..    \ .* \.*\.* ..* *! *..* . \ \!\... *.*    .\. *..*.. .\..\..**.\ ..! @... .\..\.** \* \ ..  . \*.   .. \.  .*.@\.  .  \.\ ...\* . .*\.* ..*.\\** *\.**.** . .  . .. *\...* **.\*# #
#* **   ..*  ..\ ..* **\.*E. *\* .\\ . * . . \  .* .* .*@*..*.* .\ \ *...\*. . *\* \. !  ..** .. \.!*\  .... * \ * .\ *.*\**.*.*\.\  .*\. **..*. .   * \ .. .. .* *.*.  \.  ..\ ....** #**.# #
#*\\**.. \.*\ **. **..*. * ... * * *\.\****\*. ***.*.\*.*  .*\**.... . .*. .\*.. . ..  *.... *.. .\..  **.*.  .\ .\!*...\*.\*. .*..\.  . ..* \ **  * !*....\ * . .@..\  *\ *  ..  .  .  *..\##
#.. ** **. * ..\  \***..\\  \..*.*    ..*.\ ... *\.! .*..   *  \* .\. * . .  . .*...  . .\*.  .* ..  ..\\ *  **.  ***... * *. . ..  . \  * ....* .*.\\.**.\. . .\..** . .     *.*\ *\ * \### #
#..\ ...*  .\\. \* *.\\*.\    .... *  ..\* \!.....\ \.!.\  ***\ ** .. .. * \*   .***\.* \ .*. *\. * \  . ..* . .. ... *\..*\*  *. .\**.\ ... ..  ..\ .*\.*  ** ***...**  \.. .*.* * ...\#    #
#.*  .   ...     .  ..*.**.  .*\.. .\* **.   * *\* . ..... *\ . ..  . *\ ..  * ...* *\.... *\ \.W\**    .  *\* . ... *.**..*\ *..\. .*.* ..\ ..  *.   . .   .*.... .*..* .\*!** .\* *#.#     #
#*  *.....*\*. \*  * .* .*.* *\ * .  ..   *  .*. **   *.**..*\*. \ .. * \\ .\* ..** ..*  . .  .\ ..*\*.   ..* *. \ \  *.. ..*..  *.*.\*.  *.* *. *\ \ . *.*.*\ .*.*..  * .  .#**##.*\##      #
#.. *.*.* .\.. .\  .. \*.*.\ . *.... .* **\   .*.*... ..*\ *.*@***\  .\.. .\ * .\*. .\. . ..\*\...** \  .\.\*\..  ..*.*\*   .\ .\.\\ ..\... . *. ....   *...  \  *. .\.   \. ... #\.#        #
#** . * \ * *.*\  *.  .**.***...*.*  **.*.  ...\ *\*\.*.   . .\.... .\***..  * .\.\...\* \ . \  . .. *\ ..*\. *...*\.*..\...@.\ .   ....    *\ .*\ ** *\.\*  ***\.\ \**  .#  **.##**.#       #
#*..*\.....\\. *....  *\....\....*..*.. .  \.....   **..\ \. .. .\*  *.\* ...\ !  ....** * \ ..* .\ \ ** ..   \*.***.*. .\ . ..*..*. *  .\. * ** . *. .!  . *.... .. *.*** .* . . #\#        #
#.. ..  \.   * * .@.\.*   ** *. .\.*..\\ ..! ..*.\ \**\*   . .\..*.. ..*.\...  .. .*@.  .... *\..*\.. .    \ ..**.\ .*. \ . ..\. .*  \.*.. ..**   * ...\. * *.*.\**. \... ...  \ .##.#       #
#.  **.*  .  .\ .....*. . ***.*...* ** ... ...\*.\.... .*\   *.*.* *. ...**. ..* *.*** .  . . ..\*.  .\@\.. *\ \*. *\.\ .. .... !!.*\.**  \*.**. \**.*.  \. .\. * .. .\*.* *. ...*\. #       #
#.  .... .@ . .*.. . \ .\.*.\*.\ \.\.*..\*. .   . . ..\  *  .**\!*.! .   \. .*\..*\\.. . *\... *.. .  . \* .   .\   * W*.\.\... *\ .  *.  ..*... ...*.    *  .\ \.*..@.  . *...**\* #*#      #
#*.*****. . . .!  * *.  *....*\ ..   . \.  .\ .\ \*\.*. *.  *..* *\*\..*...*\*..\* *\ **.   *\.*...  .*...\.  .*.\  .\ **  ...*....*...**.  *  .*.\ \ ** ..\ . * *\*\\ . *.#. \#*..*.**#     #
#\. **..\. \. . .*.\  *.\ * *\.*.. * \..*..*. .** .* *. . .*.*  *.*.*  ... !..\ **\ *.*\... .....   *.\*   \**  ........  ...\!.\ .........   **.* . . * ..   ......  ..\\. #\. . *\*##      #
#..*\.!.  ..  * \.!. ...*.     ...@**..\..\* . @* ...*\.*.  *..\**.*.*. .\..\  \\@... \  \ *  *.  **...  *\.\. .\***\*\ . . ** \.***\.  *. *\ ..\   ...  @. .. *  . *\*. W\. .\ **.*#\.#     #
#\ *\ *\\. * .! ** ..*  .!. . . .*..*  \.*@ \**.* \  . .  .* *.*.....\.. ...***.  .\ *.    *.*\......\   \..\.  .  * . .*  *.!. .*.. *.\*\.\.  ***.**.* *.\ *.*  ** **. *\ \ * *\#.*\*#      #
#\    \.*\\*\*...!\*\  *\*\ .\.*\..*.\ .\*   ..\* .. .. * .*\*\. *   .\  ..**.\.. \  \*. * ..!.    . . **.*   . . .. .**\ .*. \  ..\\*  \. *.\*. .\.\*.*\ **\*. .*@ .*.**. . * \..*. .#      #
#.. .. ....* ..**..*.*. *\  .. . .*.* .*.. .**\**\.** .\*. ****\** .\.  ..**. ...\ *\*.. \. ... . * *  .\*....*. .  .* **. .. .\ * . * . .*....*  W*.**...\*\.*.*.* .!!.... *.  . #.##       #
#. *.*\ . \.*   \ \* \**\.\*. . *   . *.*.  .\   *. .   .* ..\ **\!\ . \..\*. *.**.*.*. \ !  \   .. \*  ..*  ..**. ..* *.. . ** \ * . \*..!\ ** .\.* .. *.... .*\*..\. \ .*... . * *.#       #
#*.*.* .* . .@ ..*..*.*\..*.. \** \ .  *\...*.*... .  . \ \.  \.* \.\.\.*  . ......\**.  .\.\.\****...\.*..  .\*  .  * **\....***.*\ * ** . ...*.. .* *..\ . .\*..*.*\. \*.*\.  **\\*#       #
#. .\ .   \\*. .\!**.\ ...\   ... . **\\. \ * .. ***. \*.\. . .*\.. . .*.  .. *\.*\..*.\. . *.. ..*.\  *..  ..  .**\*.*..\. * C!.  . *\* \.*..*. .  . .\* . \. *.*.\. \..\.\**. *.**#        #
#\. *.*\  .* .\ ...** .\ .\* \. .!  *..  .\ *   *.W  *. *.*.....*\ .. \*... \... . *.*  \. .*. **. *.\*. .\  .** ..  **. .  .* .  .  .**..\*. .**@. \. .**.*.\*.**\ **.\.* .*!\ #.#\#        #
#*...\ .  W *.     .\. .....**....\**.* \ \@\. ...*\.*.*!*\ .*\ **\. *...*.\. ...\ \..  !  **..\.  .*..\**. * .\*. . ..@\ ..**.\.* \  ...\.** * .  !..\**\**... ..  .*\.\.\*  *** @#         #
#.\. .\*.*.\**.*. .*.. .. ...\*\.**\*.*..*  *\ **\...****\.\*.* .**  \..\* .. *     *.\.\W**.*.   .  .*** .\.  *..*.   *.. *. \..**. . .   \.... .   . .**..\* . \..*..\ . ..**.@##          #
#. * . \\*  ..* ..*  \*** . .***\***\  .\. *.. *.W ** \.\**.\\*  ..* . .*\.\*..\. **.  .*..\..\**.*\ *..\ * .\ ...\ .\..* .**\...*..   .\\\  ..\ \.  *...\. .@ *  *... *\\.**.. .#\#         #
#. ... ..* \  ..\  . .* . .* *\. .\  .\ ..\*.*\. . *.*.\  . ... * \\ *.*.*. ..\ ....\ *..*   .*..\. ..**.*  ***..\  ..*. . .*.   .*. ...*.\..\ *..*..\   .*  .\.\*.  ..*.. @. ... *#         #
#*\** . ** ..  \ ***   \* . \.W\.\.   .\.\..** !.* **. *\**. **\ \ *\..* **..**. ..  ..\..\. ...\** \ !.*.  .* .\*.\**.\.\*\. ...*.   *.*...*. \**\  ..  *.\..*****\ ...\\.*\.#\**#          #
#\ \.\*....    * .*.  * ..\ .** .* *\*.*. . ... *.***..@...\ *.   . ..\. ***\* *\  .. .* W .\.   \...!\ .. ..*  *..!.. *\ *. . .*..**\..* .*..* *\. * .* ..  ..... ...\*.*. *.\.# #          #
#.\. \.. \  .    .\* ..  *.\..*  ..\.* * * .   . *.\.\ *  *. .\.    .  . .!  ..\ ..*. .\. . ** ..  ...****\* . *\ *... .*@\..\. *..*\..* .*.. **..\ . \. *.  *\* . *\*.* .. *### #           #
#**.\    *. . *   *. .. *.. * .  .\*\@. **   \ *. .  . *\*\*.*.*  ***.    \   .\*.**\ .* *......*.*.. *...** *..  . *** ..**  ..\.*\ *..*\..\\.*. *...*\*.. .....**..*\@**.!#                #
#.*\ .**\ **\ . **.\.\ \\.\.. . \**.**\ ..** ***\. ..*.\....\.\\.\**\.*   .\.  *!..**..... ..**\.*. .  * \ *..\.*\. .*.*. .    *....  *.*.* *  *.*.. \  \** .*   .* ...\.*#*#                #
#\\.. *....*.*\*!\*. ***.. *. .\  .*\. ..  * .\**. . \. \*\ . *. . *..\ *... .*.**   * *.* \*.\.* **  \.  \.* *  .  *.*.* .*\ ** .* .*. \.. . *\*\ .*..*\..* . ..** .* . ..###               #
#  ***.   *  ......\ \....   .\*..*\ \* *.. .**\*..\*.*\.*.* .\  *..\  . .\*  ...* .**\... ..***.  . ..\... . *.\.. **..\  .! ..  ***..* . * ..\*. .. .. *\. ...*\. .\ ... \ .#              #
#\*.*** **.     \. * ... ...\.*.   **.* **\* ..\.*..*...\..\\.. ... ***\  *.  . **.*. ...\ **. \ .  ..  *\  @.\     *.\..*\..* ** .*\.\*\      \...  \....*.\. .*...\**#\ \#\#               #
#.. *..*.* *\*.*.\...\**  \ . *   ..**..\* .* **.\*..* \ *\**... .* . .*..! *  \..  *\*.**\@**.*. .*..* . .*\  **.  . ...*.   *.* .*. ... *.**\.\  ..\   ..*.\  ..*\.\..\ *##                #
#...*. *\ ..**  * ** .\... ... * .*..*  **.*.  .*.* \...** *..\...*\.\ **. \.*.. . \. \.. \..**2.\ .\*\   *.*.\ .\@\*\*..... . *.\ .\. ...  ..*...\ \..\.\*. ..*\  . *  *.#                  #
#**.**. *.   .*\....! *.**.@ **..\ . *..\.\*...\ ** *\.* *..*. *.*. \ \ ..\.\. * ..  W\ *..\  .**  . .* \ .*.. .\*. *.*.\ ***\.\.\. **  . *.\..!*. ...\.  *  **... *.. *.\#                  #
#..**.. *. .. *.. .*. . \..  .*** . ...\ \*.@\* \.*\..\.*..\. ..  \*..  * .**.**\.* ..  ** **** *.. \*\... ..*.@.\**\..  .*...**...*.***. .    **\ ** **..\   ..  .*. *.#.#                  #
#\ ** .*. *. ...\. \\   .  \.*\..\*.  \.*..@...  ..@*.  .. *\. .\* *.\*...\.....  .  *\.****...*..**.*...* ***.. *.  \..* . .*.   ** *\.  .***  *..\.\ ..*.*\..\**.. .\.*# ##                #
#   .    .. .. .!* .* *. ...**  . ..* . . *....    *** \..*.*\* .......   .    *\   ........ . . .*...*.....   *.. \ *. \*\.**. . .. .. H**\.\  *\* ..  ..\*.... *.  .*** #  #               #
#    . ****\ \ \ *   ..* \   .*  * ..***\*.*\* . ..@.* .* * \ .    **..*\*.   .*. *\\  . *\   .. *.  \..  ..\ ..*. .*.*..\*..     * W*..\.* *..@..*.\..\. *  F* **\..**.  .. #               #
# **\  *\..  .. *.*.** .* \.  . . .  . * *.. * *    !. .. *...  *\ .* *.*\   \*.. \**.... ...\   ..*\ .\.\.* \.\.  ...... ..!*...*. ***.*......\\* **\   .. * .*.** \*. .*\ .#               #
#\..  \.*  \*  ...**.\ ..\*..  .  .*\  .\..*.  . @.\... * .\  .\.****.. *  .* .** ..*.*..*.**..*\*.. *.**..\...*. .  ... *\\.**.\.***..*..**..*. .. \ \.. *.. \**.. ...  ** .#               #
# * **.. .    .\ \.*.... *..\\**.*....6 ..\... \.\ *** ..**  .** ..**.. \   . *.. .*\*... \!.. .\.. \**.....   ** \   .!**  \..* **** *\  !.. . .\. @..  ...* ...  *....\ . .#               #
#.. ..    .  . ..**.**\ *.* *  **..\ \ .**.. *.... ...   ** \****  !\  *. .*\ .*..\.!.  *\ ....*..\.*.\*.\. .* @.*\ .  .* *\.*.\ .* **. ...  .* *  ***\ * . \*.\ * ..*   .   #               #
# \.**. **\ \.. .*\ .\..\  *.\..!\** .@ .\*. .. .. .*. ........\.\. **.\.* *.**.  **.\.*...... *.\* .*....** ...*  *.  **  .  ..    . ..\*\ ...W *\..\**.   \ .. *\.*. .. . \ #              #
#   ..  *\...\*. .. R.*. ..*..    .\\\ ***.* *.*...\. !  . ..\* \*.\ *. ***\**\   **\ \*.\\.   . .\  !  **.. *.*. .*@\... \.\.** .  *W * .*  \ ** ... **\ . *  !\....    *   #               #
#.....* * **. ...\ * .......\* .*.\  \.. *.... *.  @.*.\. .  ****.\.. \**. .....\*..** ..\.\..*. ...*. @.*... .\.*\...* ..  ....\ \ *@.\.\.\ .*..* .\ .*. * \.\ .. .. *  **..#               #
#.* ..\*  **   *  .. *.**.  .  .. !**. .*.. .  .. *.** *.. . \*. *.** *....@. ...\ .\*  .. *...  \**..\. .  * *... . **.. .  ..\  *\ .\\*..\* . W.. * . . \ *. * ....\....##.#               #
# **\.. *..\. \ ** \.. ..*\..  . ..*..*\*  .\** * ** *  .. .     * .    \ . *.*.\ *\ *\\.\.*. \\\**\.*.  .. . **.. ..\*  .. .** \ *  . ...*...\ ..\ \ \.....*. . .  \ \.!\###                #
#*....*@*   *.\..*...  ..**..\. .  . .. . . .** *..** .. \ *..  *..*.\ \.  ...@* .*..\.*..\.*\* .* . ..    *\ *\ ..*..\**.*...*..*.\.*\ * .\ . *  ... .***.. . *     *.W  . .#               #
#\.\ ..\   **\.\*.   * .* *  *.   ....* ******  *.*. *.\*.*\.....  * ** .*\ * .*. . .  *..*\\ !\.     **.....*.*. .. ..*\. *  \  . . \    \   * .*..\...\.\.*. ... * \.*  *.\*#              #
#.  .* *\.*.*\ .. *\.*  * . *!\.  **. *.*.*** .*..\...***.. .\  ..\ \** . ..*  .. . . \*\ ....* **\****. .... ... * ..* **.. *. **.\..*  .\@\... .   *\.... .* \ ....\*. .*  \#              #
#. *.. .  .\*    .* \\ **\* ***   **. *...*.. \*** **@*.*\.* .\*\..!.*.\.\ ***  .\@.....* .\ ***.\.*. ..  . \*\. ..\** .*.\.\*.*.... *...   ** *  \  .  \  \ .\.*\. \.. \*. #  #             #
#. .. \*\. . \.\...\. .*..\.*.  ***. .. .\. \ .. * .**... *  .\.*.* ** . **.\. \ . \.. *!\* .\... . **. * *. *.    *.\*\*\.\.**.\.\.... * .\   **\ .**.\ ***..*.* .. \ \ \.** #              #
# .*\..    *\.* @*\*. .\ .* .* . .\ . ***....... .* *.  \.   .   *. **\. *.!.  .  *.   **... .\*.  *\.\*  . *\.\ .\....**.\****.  .. . ..*.**...   ...  . ..\\. ..\@. * \......#             #
# ... . \..*.\**..****\\..  ..* *. ** .....\*\\* .. . *  **\.   .. .*...*.......*... ..*.* *   . * *.... ..\\ \\.\. \*\... @.... ***.\.*.\ ..\....\ . ...   .. *. ..\**  ..@\ \ #            #
#. ** **\...  *. *... . ...*\..*\\ .*. \...  .!.\ \ *\*\*.. .  *  ... * . \. .. .. *   \.. . ..\ .*. *.. . .!... **. \. .  . **. **.\*!* *\*\ * *  *.   ..  .\.#   *..##*\*# .!*.#           #
#*..  .\ .*.. *. * *. *.** ..\*.** ***\  \.\*.*. .. ..\* \..\*\.  .\  .\.\..*. .*.....*.. \\..  .  . ..*\.  ..  *\..*.   \  ... . *.**  ...  .  \...\  \* .*\ . .. .**. \. .\###\#           #
# \   ..  .. *.* *.\  ...\ \. .\.... ..\ .   .\  **  *..\  *   *\. *.    ........*..***. *. \ *\..\*\ ..  . .* .*.\*..   *..\. ...\*. **. ** \. .*.**    * ...\  . \. *#. 8 #   #            #
#\ . !\.\.**...**.  . * ...  . . .  **.    *. *.**\.**.**\... ..*****. \.\.... *\.*..**. .** *.  \ @ **\. *\.. .\* *. .*. .\ ..* .\ *.\..*.* . *.***.\  * *..*..# .. .. ..#\#                #
#*   ..  *...W\.\ ...* * . .. W .* .\ . *. * .\ .*. *....  *\.* ..*\.*\   .*. ...... ..*. .\.... . .* . * .*\. . . ..  . . @  ..\...**  \.*... ... ..* ... ...\**.*# .#### #                 #
#..  .. * *.\..\   .**... .* **. ..**.. . \**.. *.. .. W.**. \. . .* .. *\ . .  *...***.  \...*\  \ . .*.* ** .*. \.\. *.\...*   .\* ... . . * *......*\@ .*.**.*.*.\#*...#                  #
#. .*. . *  ** *...***\ *...\..*    .  . \ .\  .\\.. \ ..* * .  .. *  \..    *\..*\.*. \ . \.  .\...  *.\.\..\*\ \. ..\. *. *. *.\ * \\\.!. .* .\.**.  *.  *.**..**. **\ \# #                #
# ...@ **   *.*\*.\..**\*.\ **. . . .\    * .  *.\ \. \*. .\ . **.*..*.. . .  * .\.\.*   .!   \ *. ....\.\ * **.* **\..\ .. .  . **. .. *.  *.\ ..  .   * .. ..*.\. .*.*.*.#\#               #
# *.\\... . \ **  .\.*..... .* @   .*.\ . . .  ...** \.. . ...**. .**!.*.  .*.. .*\*..  *..\  ..\.  . .\\\...\**. * * \ .*\.\* ....*.*  . * .*\.\. .    .*  .*  *** \#. ..*#*#               #
#.**! .*..\ ......\ \* .**\ !.\**\\.**.   \. .   ...\  .*\ \. **!  \.\*.* * . ..\ \.\.*.. .. *.    \**\@ ...\ \.\ *\..W\.\ *.\.*  \* ..** ..*. \     .\ .*.* *\ \*.\.**.. .#.#               #
# \\.\ .*..* ..\\\ .\*.\.*.\ . ....**. *....\.* . *.*...  ..  .\. \.*@**.*\   . * . *\...\.\ *. \*. . \..\. . .\*..**.\   .**\ . *.\.   ..\.\ .! .*\*. ....\\*\.\ ..\.\##*.!\ #              #
#..\*....*.** *.  .**.*..**\. * @  . ...\.. ***.*.\....\.*.. *\  .  .\.  ... *.*\   .*   .*..**... .**.. *. .*.*@.****.*..* W.*.*...\. \.. \. .\ *...\.**.\...  *. . *# #.\..#               #
#\     .\.... .**\* . . .**.\....\.*\  .* *.\....@ \ .\*\\  .* \**.W... *\!\*\...*.  . . *.@\.\* .\.......  . ..* .*. *\*...\ .*.\.....\!*. * .....*.*....*. . **.#\.. ##..##                #
#\  *.@**\  ..\...  ..**\ *\ * \ .\ * **\ *\.*.* \..\ .\.***.*  W.\\   .*.. ..\ **.*.* *\.*. **.\.. \**\* .*..*\. \.**\..*\.  .\.* **. *..@    *\ .*\**\\.*.*.*\*. ##..# ##                  #
##############################################################################################################################################################################################

Water 32
Flooding 8
Waterproof 15
Razors 21
Growth 31
Trampoline A targets 9
Trampoline C targets 2
Trampoline B targets 2
Trampoline E targets 8
Trampoline D targets 7
Trampoline G targets 2
Trampoline F targets 2
Trampoline H targets 6