#################
#     ###@ #    #
#   ##  .!*# #  #
#  #... ..**# # #
#  #...*.\#.. .##
###.\3 *.**.\ ###
#** * *.\.. A. \#
#\#L#R. .. *..###
##  #\ \.*\*\ # #
#  #* ....#. #  #
#  #*.  \.*.\#  #
#################

Water 11
Flooding 0
Waterproof 10
Razors 7
Growth 30
Trampoline A targets 3