####################
#.*  ...    .* # # #
#.\ *.  \  . .# #*##
#.* \.*...*R. * #.*#
#**\.* *\*\ ...*..##
#\.. **\... #.*.*# #
#.** .*\.\*.#.###  #
#L.. *#*.*..\#     #
# ##\#*\.#.*  #    #
####################