#####################
#.*.\*  ....** ...\##
##*.*..*\.\ *\.\*  ##
#* \. ...\. * . . L #
# ..*.. . .. *\*\ *\#
# \..... . .*. . *\*#
#####  *\\*.*R. ..*.#
#   #..#.  ..   *\*\#
#   #*#\  ...\*.#...#
#    # ### \#..*    #
#         ###*\###**#
#            #  #. *#
#            #\#.\ ##
#             ## #.*#
#               # #.#
#                 #.#
#####################