###################
# *  *... ... \#  #
#.* . L .\## . .###
#.*** .**.**. ** .#
#\.**R. *\..*######
###################