##########
#...  *\.#
#. .. .!.#
#\ * \.8.#
#.**    .#
#*\* ...*#
#*..   .\#
#*\.  ...#
#**. \ .*#
#.. \..  #
#..\. *..#
#*\*   **#
#*** * *.#
#\** ..  #
#...*\ ..#
#\... .* #
#*   .  .#
#*A .\*\ #
#*\. ..*.#
#. \**.  #
#   .\.\ #
#\.\  .. #
#**.**.\.#
#. *..*. #
#*.*\ . *#
#\....\ .#
#\\..\.. #
#. ...\ .#
#\...  *.#
#9 * .*..#
#\  *\.\ #
#B.W..*.*#
#*\@. * *#
# *....\.#
#\. !* \ #
#.\. . . #
# * .. ..#
#@*\ R.*\#
#.. ..\..#
# .. . ..#
#\.\\....#
#**.*.*  #
#..\. .*.#
# *#...*.#
# # \*\# #
#*\ ... ##
## .*.#\##
##. *# # #
# #**.#*##
# #*#\ *.#
# # L#.###
##..##*# #
##.#  #  #
##########

Water 0
Flooding 0
Waterproof 5
Razors 21
Growth 11
Trampoline A targets 8
Trampoline B targets 9