##########################################
#       # ##. # !\\*.\   .!\* ..\** * \.\#
#      ##*#.*...** * \....  *  .*..*.\.* #
#     #. .\*..* *...  * \. *. *\ . *..*. #
#      #   ..*. .. \*\.* . . .   . \..*.*#
#     ##*\ ...*!*.* ..\..*\....W* *..\  .#
#    # .*..... ** .  * .\.*\*\ ...   ***\#
#   #*.\*..*.. *.  * *  .   .*   . *\ *. #
#    #*.\. *\.\.   *.* .\.**.\. *  ..\  .#
#     # #  *.   \  .  * .**   .*.   ***. #
#     #..\..*\**..  .*\  ..\ \@..**\**.  #
#    #. *\ \.  . \\. *  .*.*..\..*..... *#
#   ##.*....*\*   .*.... **.* ....  @.  .#
#  #.# .\ .@ ..*.\ .\..\*..\* * ** ** .\.#
#  #\*. .*.R \ **!*\. ...\*..\.\   **. *.#
#   ####\ . *..*. . .*.\....   \.\*..  . #
#  #*. .*\. ..*.* .*.*.\ . .*.    .  \. *#
#   #**... .\ **\.\...*  *.  \ *** .\. ..#
# ## ##\*\     .. *..*..*..* **..*. !. . #
##\.# #.*.*.*.  \*\ .** ..\. .*. .* * .. #
##* *   .  ..\ .\**.*..   .   .*.\.. * * #
##\*. ***  \\*..*...\  ***    .\....\...\#
#\*.*...\ *#...*....**....*  \... .   \* #
##*.. . ** ...*. .****.. ... .  **.***.. #
# ## ##.\.  . .\.\.*\* \* .. .\\.. .* \*\#
#  #\# # \ \ \*\...\.\. * . *..*\.\ \.   #
#   #  # ..\. . .\ ... .* \...   @  .....#
#     # .... ..  *. \\ .. .  \...... . .@#
#     # ###..* ..* \*.    . \.  ..**!  ..#
#      # ##..*.** ...* .** .*.. \  \**..*#
#       #.\ .*  .\**\   *. ...\* . .\.**.#
#       #\ .*.   *.. .* *..    *..   \**.#
#      #\!.##* \*....**.*  ..\ \. .... ..#
#       #\L.   . . * ..*. *\  .. .  . !* #
#       #\### ###**....\ ..  . ***.. \ @ #
#        #  #*\##..\.\\ . .\* @\..* .. .*#
#            ##  ##. .. .*... . ..*\* \ .#
##########################################

Water 1
Flooding 7
Waterproof 12
Razors 5
Growth 44
