###################
#  .*.*R* #\ .*#*##
#*  .\.*..#*.*.*.##
#. * *. .\. #\.#..#
#\ . .*.. * **\*#L#
#. .\\.   . .. #  #
#  .  *.\ *..*. # #
#  *... . *. *##  #
#**\*#..  .*\#    #
###################

Water 8
Flooding 9
Waterproof 15
Razors 36
Growth 10
