#################################################################################################
#..\.*...\. *\**. *...\. ..\* ** .\*.*.. ... .@  .*\. . *  * .* ..    \. .*\...# ##             #
#   *.*. *.*\W..\ !\.*.*   .*\.*.*.  *   . *\ ** \*\* \. .  \..*.*.*..... .  #\ #.*#            #
# ..   ...*. . .. .** *...\..*  * **\*\ .  .W *. . .. ..*   . .  \.*. *.\ ..*. .. .*##          #
#\****   **.  *.* ..\ . *\. *. ..**.....*.  . *.*  *. .*. *\.\ *  .\**\.*\**. .\*.....#         #
#* *.\  *.@.. ..*.\  . W\.\   . *.\*....*. .. !.\.* .* \ *.. .*.\. .\  \*..*....#\ **.#         #
#..\**..*.*.*. *..*.\.*.**.  ..* **\*\  *\* *  . *** *.*..*. \*   .  .... .*\\. *  .**#         #
#\\ \. . \...\  **. . *\.*.*..  ..\*\. .* .  *.*.... .... \ .   ..****\  *..*. .. .*\#          #
#\  *\ .. .  ..*... . .*... *. ... *. .**... . *. **\* . \..\*...\.....  **  *\\..*..\###       #
# ..*\.\ * * \  .* *  \.. * \*.*. ... \...*\*\ .*....**\ .* \.. ....\@* \.** ..\* ..  #*.#      #
# \*\**\\. \ .@**... .*.  .**. *.*.. \ *. ... .  !\. * . **....\*     \  ..*  \...*\ .*.\#      #
#\.\*\.*.**..*..  .\..\ *.*..\ . .\ .***     . ....\*\.. . *.\ .* . *\\.*\.**. .....**  .# #    #
#   ** ..*.* *.***.. ... @* *** * .\**\.  !   *  .\**..\. .\.  ..  **. \\ *.\ . *. \. .\\.#.##  #
#* *\. . *.. .!. . \.\* \.\ .*.* ** . **  *.. \.....**\. .   .. \*..*..\.*!*.**..**.   .**..*\# #
#****\ ..\\ . .\. .*\.* .\  .\. *..\  .*\..  .  *.  .. *...*  .... *.\.. *\* *\.\.*..... *# ##  #
#*... * \   *..* \.*\**  . ..* *.*.\. ** \ * . .\..*  \\* \  . \** *.. .\*....*\.  \*.\.\ .*L*# #
#*.\ ** *.@ * *. .*..  \.. . .*. .. .\.* . .\* *.*\*\..*.*.*  *.*  .*.\* ** \.. \!* ... *#*.**# #
#.***.. \.  ...*.*.*\*.  * .    . .* * . *   *. ** ..* **... \...***  . ...  *.** .  ...****..# #
#\ .. . .\!... .*...*.. .\.   *.*.*   \*...\\..\*\.   .** .  .*. . . . .  ***!\*\.. \ .**\*\ \# #
#. \ ...  . .* ....*..\.\**\ *** *.*.*\..* .* \...  .*..*.*. .* . * \*. \ ..*....\* .**\.  #*.# #
#****.*\ ..\ \*\.  ..*. * **.*.. ***.**.*..\.\.... ..\...*.\ *..  . ... .*\*..\\***..... *..\ .##
#*.** *!\ \ ..\.  * ...\.*...** \  . ..\..*.* \  \ . * \ . *@\.  . *.*. ... . ..\.. . .\ \... # #
#. *. ..*  . . ..**\ \. **.\\*\ . .* @*    .  .\  \***.*\.  ..*    * *  .\* . .\ .*..\ . # W\#  #
#...*\*...  ..  ...\\ .*... * . \  .*.!.*\   *.\ \....*.   *.......\ .. . * . .  .\...  . . *#  #
# . .....\* **\**. .. .. **** .. \. .*  ...  .\.  \ *. . \.* \.\ *\.    . . **\..*.   .*.\*...# #
#* \ .\ \ .  ...*\  .  . . *\**.\. *.. *  \ . .\.\. *.\ * ..* *W ..*     *  @\. **\. ...\ *. #  #
#*W..\. *. * ..*..*..*  .\.\*.\ .**\...*... **** .*\\.  *** \ .  \*. **. .....*  .. \. \.***# # #
#. * \ *.\ . \ *.\* .... .*\. * *.* *.\..*** .\.  .*\. * .. . \  ! \*\.\\ .  .* . * **  **...#\##
#. \ **. *. .** .\**\ . * . ...* *. . .. *..\\.\ *\. ..\** .   *\ ..*.\. .  \*\..\.*\\ .*.\ *  *#
#\.  .\.\**. *.****..*\.\.*\ *..*\ . .\* **.*\*...**\.\..* .  *\ .** \. .    *. .**\  # . . #\ ##
# *. .**..\@\.*..*.\. *   *.*..\... . *.*....\\..\.. \ \. .   ..   *\.@*     *  .*.\ *.\ .\.### #
#\*\*  ** \\. *.\\   .* .** *.\**@  *** **.\*. .   \..*.. !*. .* . . * .*   .\   . .*.  .*\#    #
#..\  *\.*.. ..\. *  \.. . .\\...    .**.*...* .\. . . .\*.**  . .  .* *. \. *.*. \\....\. #    #
#.* .\*.*.. .*\ .\.* .*\  .* .  .  .. \ ... .. . \.\** ..*.*. \.\.\ *...**. .**** .** ..* #     #
#.*.\.*   . ..*. * .* .  . *  .. \. *\*.W\.***  ..* ...* \*.  .\.\  **. .\ * .***\  *. .##      #
#.* .   . .. *.\..* \ ...  *.\ .  R*.... ** *.. \.. **. *... . .**\*..*\ ..*.*.. .\**.*  #      #
# . \.\** .* ...*** ..** *.. * *. \.. .*\** ** \ \ .\..*\\    . ..... ..  \. .  . *...\.*#      #
#. ***  \  *.@ ***.. \.*..\.\.* \\ \ \* .\*** ** ..*** .* **.*. \ \.***\* *\.**.\.. *####       #
#################################################################################################

Water 7
Flooding 3
Waterproof 15
Razors 25
Growth 22
