###########################
#   *   \.. .\   *..    *\#
# . *\.\ ..@F .\..\\ **.**#
#* . ..   *.\.** *...  *..#
# .\ A\ .*. *.*\ \.   *.\*#
# ..     **.. ..\ .* .@.*.#
#*\.*\.*\.* \*\ .  * *. \.#
#. .. ..  E.. .**\..**.\.\#
# .    .... *. .*.**..   \#
#\   *\*  ..\** . .\*G  \ #
# . \...*.* .....* W\!\...#
#* ...... *  . !.** \..\**#
#*   .   \  ***. *  . ...*#
#.  \** .\ *.***..*\.\ \ .#
#.**..\* . . ... *.*\ .. .#
#*\.  .  . *\*  .\.*  .*. #
#. \.**..  * . ... *\ \*..#
#.\.**\ .\ *.*\...*.....*\#
# . .... .\. .. *  *\. **.#
# .**   \\.  .! .  *..*.. #
#* ..!.!. .**\\ *  *. *.* #
#*  \ .\* ...*@...*.\\.*.\#
#\.\ * . ** *** \.. *.*. .#
#.  .  . *.* .\...* .*...\#
#...  .***\   ****. ...  .#
#\ ..**\.....\...* * . ..*#
#*.  \..R*\*.. .\** ..  *.#
#*\..* *.* .. * *.. *   ..#
#\   *.**..* **.*.*.. **.*#
#.\ ..**\  .\ .\. .@\ *...#
#\*.*\ \   . .   \  **.\.\#
#.  .*. ..**.\ **  ...\. *#
#. . \.. .@.   . .*.\...*.#
#  * .5*. ....*\*..* ..**.#
#* .. \.   .*  ..\.*..*.\.#
# . ..  ... \.\ *..*.*\\*.#
# . .*    .** @***\. \ *\\#
#*.**..\.***..\.***\.... .#
#...\ \.  ...*.  !.*  *  *#
#\    . \. *...*  .  .\*..#
#..  \ .. \.*\.. *..*. .  #
#\***\*.....**  *\**\.\   #
#.*.\*.\.* \..* \..\.    .#
#  \  *.@. . *.  *    *. \#
#\*..*\.*.*\  \ \*... .   #
#. .\.**. .. .. .** .\  * #
#.  .  \.\ .*.!\.. ...*.*.#
#.\* **. .*4 .. .\.***@*.*#
#    .*. *\. . ..*.\...* \#
#*. ..*\. . .  ***..***\\ #
#..  *.*. *** I *\.*\*  .*#
#*  ** .  *\.  *.. . *. **#
#*  \.. \ * .*.\...\ ...!*#
#\ *. * .... \ * \**.   \*#
# ..\ .\*   ..*.\ ...\ *..#
# .  . *...\  . *....* ...#
#.\\*.   .\ *.**.* 8.. ..\#
#. .**.\. *\...*\*..\.\*  #
#  ...*.\.  .* ...* ...\ .#
# ** *. . *\.. \\* **.\.*.#
#\..**.**\.*. .  * \.*.\*\#
#.  .\*.  \..\ ***\\  **.*#
#*..*.!.*...\ .  .**.*\.\*#
#..\... .\*\..\*\ .*\*** .#
#\ \*!.. *\...\**. *.* ...#
#*  ..!\ .*** .. ** *..  *#
#* ...* *.\ ***.*..\..  .*#
#. .. *\.\.. .* . . \*... #
#   ..\      .*.  .  .*9* #
#\\*. ..**.** .... *\**.* #
#. . .\**\... .*.  \*..*W #
#\  \ ...... *\.. **... . #
#*.. **  .\.*.. .* **.. ..#
# .   \ \  ..**.*.\. ..*. #
# .**    .* .** . *.. ..*.#
#\*.  .\. * *..*. ..*\.\.*#
# .    ****...... *  \\ ..#
# * .\ ..***@\. * \ ...   #
#D * .. .. ..  *\*.** .6 .#
# .\.\. *\**\\. *.\..H  .\#
#\**. **\\.*. ..*  .  *. .#
#...! . @...\ . \..* ..*  #
# *  . ...\    \..\.. ..*.#
#.*.  \  \ ..\...... ** ..#
# . .* . .   . *.*.**.. \.#
#*. * .*.. *** . ...... . #
#\  .* .. *  *\***.\.. ..*#
#**\. *\* *\ .**\*  ..\.* #
#\ .**.*.  *  ....\*\..*..#
# \.\..*.. **.  ..*..*!. *#
#.!. \.*\.. **.\.\!C* .\B.#
#..*\...   .* \ ...  *..*.#
#.  *.\* *\.... .**. \.\*.#
#*  .. ... \.*.* . *. . . #
#  \ .  .. ..*\.* .** .*  #
#.*** *  *\. .* . **. .*. #
#....\. ..*.  .* . .*.\.. #
#\ *\** .*\. . \.*   .. * #
#.\**.*. .*...\. *.. . *. #
#**.\*\  *\.*. .*\.\\.*.*.#
#*.* .. *...\.\*.#..   \ .#
#.***... *\*. ..\*.     .*#
#...\.\   *.*  @*. .*.*. .#
#*\   .  *. *  .\ . *...  #
#*..** *\.****\ ! .\. *   #
#*.....\..* 7.* .\*  .*  *#
#.* .\.. .*....  .# .# *..#
#\.***.\ *.\. * .* .##\# *#
#.*.!\.. \ #..\ .*\ # ##\.#
#**\* \* .\*.\*.. ..*#  # #
#*.  *\.\  .**. * . #  #.\#
#* .  .*.*\ *#*.# #*#   # #
#@* \**.*. ..\ \*# #     ##
#***\#.\..*#*#..#         #
#*.\. #.\.. * *\#         #
#\**\.  \ *.*###          #
#*....#* ..* . #          #
#*      #*#@\#\#          #
##*\.*#**.#..##           #
# **#*.*#\ ##             #
####.\# ###               #
#  #.## #                 #
#  #\L #                  #
#  #*#                    #
###########################

Water 76
Flooding 15
Waterproof 1
Razors 41
Growth 10
Trampoline A targets 5
Trampoline C targets 7
Trampoline B targets 6
Trampoline E targets 8
Trampoline D targets 6
Trampoline G targets 5
Trampoline F targets 4
Trampoline I targets 9
Trampoline H targets 4