######################################################################################################################################################################################################################################################################################################################################################################################################################
#  .*. \   \ **\ .  *. *\ *\ *\ .W\  *.*.**..\..*.\..@*\ ..\* *. .* . ..*.. .@*  * . .\.. .**.. *   **.*\..  . ..* \..*.  **.. . *....*  ...\  .....\.@.... ..* *.     ....*@..\.\.\ W \ .* .*. ...  \ @\.  . .*\*....* * * *.\\ .   *\    .**  **. *...* . *...**.. ... \ *.\  *..*. \!!* * * .. .@.** .**  .. . .. . ..    .\.. *..  .* **\.. \*.*.@.*. **.**\\*\. .\*\  *. ..* **.**.. .\@*.. ..** ** .\ \..*.#.# #
# *..*.\. **.\. .*...  *...  . **. *.. .  .  .*. \.\ ..*  \ .... *.  ..**.\* ..*.\ .**   \** . .*   . ..  \ .  * .*. . *.\*.* *.\*!\ .\***\\ .  . . ..   .\.  * ..*. .\.\ .. !...\**  \.. *. .  *\* *.   ** *.\...\. ** *.. .*.*.  *\*..   *..  *\* * **W *...\ .**\     ..*..  .....\.. **\\@*.*.*. *  ...*.  ** ...\*... *.A     . .....*.* ** *.**..** \*\*.*..  *. ..  *. *.. \.\.*  .*. .* *.*.. *\.*  *.\*\#. ##
# ..* *. .\*.... \.\   .** ...\..  ...\ \*\ * .  .. ***. ..\ .  * . .\. *\   *..*. *..*.. ..*..*.\*\.. **. * . .* .**. .. .*...* ** *  \ .  .\  * *    .*.*** \...* * **.**.  \\ ..\. \  W.** . * ...\*.*.* ..*  \*\*\......*@...* *.\...  * .*. .*.\..\*\*..*..**...*.* *.*\ .. *. .*.  .\\ ..****.\..*  ..\*.*. . ...\ * \*  . *.  \ !\..*. .* *  *. *.*** ...  * .*.*.\  \.\*....*.*. .**.** *.** @.!..* .....  # #
#**..\. * ..  * .\**\ **.\ *.  ..* .*\*  . ..\**...\..\.. .. \.*..*.*.*\.... ..*\..* * ..\..**** *.*  ..\\** . \..* . \  ...  *.. \ .... * .*...\.* .\.. \\..\. .\**.*. ..\.*\@.. .. *\ .\!.* *\*  \*.. * .\  *.. . .W.. .\* *.**.*\..* ..*.. .**  \***.. .   * .\ *\. * .*\...\  .\ . \  *.**. \..*\*.**....*\..  *\.\  1....*  .*\.....\.\.\*.*.\ ..*\.  . ** .. . .*....\.\ . . *.**\.\.\...*.\..\.*\.*  ...\  . ##
#\....  . .\..* .**. *.!..*..  .*\\ *.*. \..\.*. ...  ... .... .**.\.\.*\ .\.* ..\*\..** . *.\..*.\  *.\   .\  . **\**. .*.  .*.\...*  \*!. \     .* ... .  ***. .*\ ..\.   .*@  \ .*.*\  . . ... *.\.\.* *.... .\*  * .  ..**W.** *\.. *. ... .*!*..*.\. **  \\ * ..*..**.*\ *\. .*.\* \.*  *.**. ...\..\\ .*.\  ..* .\..  ...   *  **\ .* * .\..  *\*.\ \. .   \***..  *.. *. \  .. \.* *.* \. *\ .. *..   **. # ..#
#.\* .*\. .*.*. \.*  *....* *  *.. .\.\   . . .*\..\*   \. *. \ ***.....* *..\ . *.  *!.\*.* . .@*.***. *.   *..*.\  .*.*\. .\.\ * ...\  * \  ....@**\.*. .\ ..*  **. *...**  .\ .  .***..*   . *..\* *.. * !*. \.** .     ..\. ..  *.  \.\ \.. .\.\ .B * ..\ ...*\*..**........@@..*.... * .\***.\* !\  .* @  .. ..* .* ..**  \\\. ..**. ..  .*  . * *. ..** ..\ .\.*!***\\. *..\. ... .\.  .!.\* .*\!.. *..*\W #*L##
#  .*.\ *. *..\  \ *.**\ \...* .* .... \ @.*.  *\.. .\*\  \ \* .*\.. *\*\ *   ** .*\ ..\*.\* *\*.**\\.\*  *. *. .**\* . *...  ..** **.. .  .. *....*.**.. .. .**\**\. \*...* .*... . .\ *** *\. . . *.  . ..  \..*.@\ *.\ \ .* .\ *. ..*.\\.  \*.*. .  .\... * *.*.\  *\*.*..\*....! *\.\.\ .. *** .*** * ... 2 . \..  * ....*..\.... ..  .R  .**  ..*\*\..***.\.*\. .\.**\ . ..  .\ .  \ ** .. .. *.     * @\*.*.. ##
# *.\ *.\..\ \*\   .*.*   .\\.\.*\\ *\.. \..   *.*.  \.. **  \\ *... . * \**. *\**..\. . * .*\.. \\*...*... *\   .*.\.*\..*  \ \*\ *.\** \...\.  *W*   \*\ \ *...*.*..*.* ..\*.*\*. .* *\*\* * .* \ ***..*\*. .***.*...* ****\. *** . \* *..*\**\\\  .\ ***  . *\* *. \*.*.*\*..\* ..**...******\.* *. *.*.. ..**\ ** \. ** *..* \ **\. .\.**.\..*\*..*@. .. \.* \. . **..*\.*  \..**.* \* *\ \*  .**.*...*\..\.\  *##
######################################################################################################################################################################################################################################################################################################################################################################################################################

Water 0
Flooding 0
Waterproof 3
Razors 38
Growth 44
Trampoline A targets 2
Trampoline B targets 1