#########################
#  #.#       #    # #   #
# #.*#      #.####*# #  #
##\\.L     ##\ .* ... # #
## \.\#   #*###....\##  #
##* .## ## .*##. \ **# ##
##. *# #*#*#*#.. .\ \.# #
##* *..#\ ..*.\ .. #...*#
##**.# \. \#. .@ * .\.\.#
#**E...    \*\.** .\  #*#
#*.#*.\\*.. .....  *.. \#
#.*#. .*.  \ * **. \!@ .#
# .  @\#. \. #\. \.. \. #
#.* \  * .. **. ..  ... #
#\...\ .  * \*.   .*.R\.#
#. * . .**.* .**.*\.  C*#
#  ...\*.... \.....\.\.*#
#  ** .\ ** *.\.**.**.\.#
#\  .. \... . G.@. .**. #
#.. . \. ..\ *  ..\ *.* #
#\..  \ ...*..*  *.  \. #
#\.\..   ..\ ..**.*..  .#
# .\ \ \**. .*.\***   \.#
#..*.  .. .*. *.*\* *..*#
#FW.    .  ..1....*.\.\.#
# \ \ .\ *. *\. . .. ..*#
#   ...B\...\...**. . *.#
#      **9 .... ..   ..@#
#.* . ...*..* ***... \ .#
# **\. . * \ \ *.. .\* *#
#*. \ .\.   . * .    ! *#
#..  **  \  ..**A.. **\ #
# ..*.  .** *\.... **.*.#
# **   . \ \..D** .*.\  #
#\.. .\*\   .\ .. .* .\*#
#  ..\ .....\.   .\*.  .#
#   * .   .. .\*  ....\ #
#\ ....\***\ \.*\ \.***.#
# .4 ..  .  *.*. ....*..#
# **..  .  . .*\... *.*.#
# .* .   .\ * *. *..  ..#
#  . .* *......*.\..!.. #
#\..  *   . @**@..  *@ *#
#. * .. .. *\ ..** . . .#
#..***\ .  \..* .***... #
#.\*.... *5.7.*3*. \*\..#
#########################

Water 0
Flooding 0
Waterproof 1
Razors 46
Growth 49
Trampoline A targets 5
Trampoline C targets 9
Trampoline B targets 3
Trampoline E targets 1
Trampoline D targets 4
Trampoline G targets 7
Trampoline F targets 4