##################################################################################################################
#                                                                                     #*#                        #
#                                                                                 # ## .####     #               #
#                                                                               ##.#*. .# . # # # #              #
#                                                           ##                ##.**\!   .#*..#.#\ #              #
#                                                          # *#              #..#*..*  . ..*# .#. *##            #
#                                                   ##    #*\#           #   #.*#\ \.* ..  * .  . #..#  #    #   #
#                                                 ##. ##  ## ##         # ## # . .*..  ...\*@*. \  **###*# ## ## #
#                                                #!..\*.##*..  #        #..\##* **.\. *\. *.. \ ..#\##. .##\# .*##
#                                          #  ### *#.*#\. \***#   #    #* .  * * *#.\\\.# *. *#*  *.*#*.**   ##.##
#                                         #.##.*.*. ..*@.# *..*# #\##   #\\#..***.  **.*. **\..* \.. .\\ .....#*##
#                                         #*.##*#\ *.. .*.\.. .*##  .##  # *..#. ... **  ***.\..  **\.  ** \#* \*#
#                                        ##.*##.# *\*. .*.*\* . ##\*##!## ! .* \ *\**.* *\ .*\*.* .... *.* ###* *#
#                                       # .#  *.. ...**.*...\**\*** .\ ## *\ .*. .\ **.*.\.\..* . .\.. *@. ..*...#
#                                      #.#.\ .*.*   .....* .. . * . ** .#  .\**\*\.*.*..* **.\.*  ..  *.\*...* \ #
#                                  ##  #.  .\\\..  *!*.. *   .*..  **.\   *\....*. @*\*\. *\..*. .*\  \ ****.. . #
#                                 #\.##\.**.. .. *  \..**.....*\ **. *.#\ ** .* . \...* *\!. ..*.** **....\ . . .#
#                                 #* **.**\ \ ....*\.  !\.. *.**.\. .*..*#.*...W*.**\ ..*....*.. .* ..\.. .*\#***#
#                                #\.##.  \*\. .   ....\. \ \* *  . .@... . **.\ .*.\.*.* .@... .  .!   **.\*  ...#
#                  ## #         #\  .  \# #..    ..*... *@*\  ..  * .....**..***..\... * .!.. * *   . .\.. \. \\ #
#              #  #..#*#    ## #.#\.@.*. ***\*** *\*.*.  \*.\ .\  .*.   * *...***. . ..***.** . . \ ..*.  .  .!\ #
#             #*### * ..#### .#* \.*.*.....  ..... ..  . !.*. ..*\.*.\\ !*. ...*.****\ *. .@ ...  *. ....  .\.* .#
#             #.#\####  ..* * #*** ..** ...*\ \*.\ .\ \   *.. .**.*\W. ..** ..\*.*.\* *. * !   . \.  . ...\. *.\.#
#           ## . ..##\ ....*.***.. ..\.* \\\\.  ***..\.\ \ .\* ...\* *. \..\.  * . ..... *.*.**@* *\.\.*\.** .\ .#
#          #.##\ \ *  \\ #**\##... ...*#*  !\.\*..!.*\* *..*. .  \..\..*. \  ..*...*\ ..****......**...*.. .*.*! #
#          #\# .\.\  *\* *.\*....*  ...  . *...**.**\ **..\.* \  *\\ .***\.. *.**\.*    .\..*  . \ \@...* .\* *  #
#         #. **...#  ..\ . .*  .*.\ .. *   !* *...\*    *.*.*\.\.... ***\.\   . \*.*  W ..* .\..  \ .*. . \** . *#
#         # #\#   *\* ..*\.*. .\*..  **. *..*.. \ ..** *..**   .\  ... ..* * ..\ . ..  .. ....**. .. *. .....\***#
#          # #*\..**  \*\ ** . ..   .*\*@   **... .*.. \. .\\*. \.  ...  \  *\\ \..  .**.    *.\** \*.. ***\. *.*#
#         # #\*.**.* . .\\.\.\@  !. . .**\. .*\  .\  .  . ...*. \..\ * \* \*..    \. *..\ ***.@ ..\*\.*.\. .!*. .#
#    ###  #  .# #@\*  \**.*..*\   . .. . \**\*  *\. * . . \ **.\  \..* \**.* * *.. ***\...****\ \. * ** . .\**** #
#  ## .*##.##.. *. *\ \.* ..**. . \.  W **..... \!. .*.  @   \*..... .*..*...*..\*...*. ....**.\ \.\ \ *\ * *... #
###\#.##L#**# .\ *\* *. \*.\.**..\.\ ...! \. .! .. .. .* .**\.  .... **\*..***\   .*.*  *. *.. \\.*...*\.*. .*\* #
#*..#\** #*@ \ \**..\ \...\.*.. . \..\.! .. .. . * ..  .\*.\ **..* .* .....\.\  *..*..*\...***\  ...*\ .*!. .. ..#
#.*@.\#\.\#\.\\.*.. .\**#. .. .\*...   \  .  * ......\....* . .**\.*.* \.  ** .\..*.* .   ...*. .. .*  .. . .\ .*#
#.....  .*..# \*.\.\*..\ ...@ ..**\ .\. \.   \ \.*. *  \  . * ... .*..\...... ..*.  ** \ .  .\ *****.** . .. *.\*#
#*   *..*.* .\...  ******\  . ** *. *.  . .\.. . * .. ..  **..* .\*.**.\.*.*.* \.   *.\.*\ *\*\**...*..** . *.* .#
##  *.  *.*.    .*.\*\.\.  ..@**.****.*!...\     ..\ *.\  ..   .*  ..!...*..*.\ ** @\\*.  .....*.*\\*..*.. ....*\#
#.\ **. **.\ ..*. ..*.\. ** .*\.\....\.  **. . .\\*\ *.*.   .*\ \.   . .* ..   ..*.**.\...\ \\ *.* .... .  *. \*.#
# .***..*.@.\ ** \ .*\. .\*. ... .*\ **.* * \.   .!\*\.\***\ * \.\.* **.*. . .\*\\ .\\.  ** .* ..\.  .   * *.*.. #
#.\ *.* . .. ..\.. .\**   .* .W\...! ..* *\  .   ***..*\.*\*.\...* ..\.*.  .* ..... . ..\..\. . \ *.**....** .   #
#*..*. .*.   ** ...  .\ .    \ . . .....\. * *  *. .. .*\  .\**  ..* *.\  ..**  .*.\. ..  *.*\.\. !\.***. *.**.*\#
#.\ @*. .\  .. . *. ***\ .*.. \...**\..*. ..*.**.*.    \*.  *..\ .\...  .  ....\...*. .  **.\.   .\..\ ** *..*.*.#
#. .*.*.* ** \.*.\ \*   . ..*.* . .*..*.  ..* !. *.. \...*\    *\. \ . ..  *..    **.*.. \  *. .  * **... \. . **#
#**\..*.\\*...*.**\ .\. .\*.** .   @\ .\*.**.  . .\.*. .\\.\. *.  .*.\..\ ...     .. . \\.* .*.  *.\.. ***.*.   .#
#**. \* . ..\ .*... .*  \ . ...* *. .. ..\*.  \. .* @ *.*\.*\ .   **\   *\  \* . ..\ ..\.**\*. .** .\ *.! \. *.*\#
#.*....  *.. . .\* .\\ ..\   .\ \. \ **  .*\ . ...*\* \ *.\..! * \. . . !* ...... *.. .. *...\.....* .\.  .* \ .*#
# *. *\ *\!  ..*..  .. *..*\..**** .\...\ ... . \**\.  \*.. *\.*.\ **...*.  .* .\**.\ .\ .* *. **\..\ .  \***\. *#
# .*..**\*.*. .!*\ ... * *. * \*\.*. *...    . !... ... . * \*.!*..\..\ .  .*.  ....*   ..\ **.*. .\  .*\.... * .#
#\ ..\*.** ..\.**.* *  \ .\  ***..***.\**..\.  .*.\* *.\ .*\*.. \   . *.\..\......\.***..  .\ *..*.* .***.. *    #
#..  .\*\. .  ..\\..  . . *.  .*  * .* ..      .   . * .*..*.\*.. \* .\..      *...*.***\*  ..W. * ...\..** .  \ #
#  *\  .* **..*  .**  **. .. .\*\..\ ..* .  * ! . *\    .. ..  * *....* .   *.*.  *.\....* .**..  \    *.\. .  ..#
#.\*  .. ..\  .    .. * .** \.*.* \* ..*..* .   ..* . *  ***. *     \   . *.**...*.\ ..\*.. ..*  *.\ * \ **\*\***#
#.*.\.. **   . . ***. ** .*  **\.*\. \\..  . .... .*...  * . **   .. .  \..*.\. * \* .** .*!  * .* . .*.W*...*.\.#
#*. *...\. *\ . .***. *..\.\ ... *  . . . ** .. .  .** \ * * ...\.*.*\.\. .\ ..\.  ..  .*. ** ....  * .. ...\**\ #
#\* ..\\** * .\ \ *\.*. * **.**\   *. ****.!@\    ***.     .  ..*..*....\.*..\..\. . .*..** .... . @*. ..**.   .*#
#  . .*. . ****. .\*\.. ! **.* ..* \  **..**\ **  \**.**\\*!... .\. . * *!*\.** ... \!*  ..\ .  * *.\.* ***\\* .*#
# *.*.. .\*.\*.*\**\  \ .!. *..*\.\.\*.\\...  .* *.*. ..!... *. **  *\.*....* . ..*....\ \*.\ *\.*\\ ....*\ .*.* #
# !.* .  *..*...\.* .\..  ....* **.*.**. ...*..  \...  \* *. . ....*.*.*.  **.  *.. *.\   ! **. .*.*  \.  .. * \.#
#   ..*\ * .  ... *..* ..* .*.. ** ** .. ! .. \ * * *. . **.  .\.. *..* .  *\ . *\R*\\  . . \ *.*.... ** \**.. \.#
#\..   ..* . .. \.* .*.\*.* .*.**.... ... \.*\.** .\..**\*.... ....*.\* .*\*  *.....***.   \\.*.....**..*..\. . .#
#.** .*\.\.*  .*.\\. .. .*.  . .***..\  . . \....  .. *** .. . ** .. ...**..\..\***\...!  ..  * . **.\...\\*..  .#
#.*\. . \  .** .. \ *\\* *...\.**.....*\@. *....* * W* *.  .. ...  .. *\.**.** *.\.. **.\ **.....*..\ *****   ...#
#...\....*.....**.*\. *. ...* .... ... .\....\ \  ..\*\*..* *..\  **\!..*. ...@\ ... *\ .*.*.*. \\ *  . .\* *. \\#
#.* * \ ...\ .**.\ .\ *****.**  \*.\ .\ ..\*\  .   ..**. .  *.* ..*.\.\. . ..*. .* ..\.  ... ..  \ * \ .!..*\* . #
#\*.....***  \...\.. ..\. *\ ... * * ..\   .. *. ..\ .*  \ .*.\\.. * \.**  .\**. **.*!\  . \.. . . \* .. \.* .. .#
#\@**.\  .....  * .  ** . ..\\..\..@ .* \. .**\.* **.** * **.\.. . ...*....  .. \.* ***\*....\ ...* ***...\*\*.*.#
# *...\..*\.*\ *\.*\.**    ... **... *.\ . *.*. ..* .*.\. .\. . ..\..*\  *..**.*..\ ..\ .*\.\ ...* .\.\.*.\.*.*..#
# * \..**  ..* \ ..  ..**\. ......  ... ** *.* . .*. .* ***.  *. **..*....  .. ..*  .*   .*.**  .*..*.*...  .*.! #
#\.* * *.***\ @.   ..**..*.   .**\\ .*  .*...*..\ .\.\  .*.**  \ *.  **..  ** \**\.\ .  .* .. ..*. **... *.\ .\..#
#.\* \ *. ... *.*  .**\* .*.. \. .*  ... .. ...*.* ..*.. \..  .*.* ** .\\ *.. * .**.....!*  ** .*.\ \... * *. ..*#
#\.*  . ..\. .!\.\  \. .. *****..**. * \\*.\.@*.!*.  .* *.\ . ... ..  . *\  .  .\ !@\**..***.*\..\**\  .\.** \ * #
#..\\ \.. \\. \*...*    ...... \...  *.* . *  .**..*\ ..\... **.*.**  . \.\ \\... .  **..*!...  ..** .\  .\\ W.**#
#\\.**. **..* . .. .  .. \ *.****   *... ...**. .\* . \.\    **.*.*.    . *.  *.\.... \. ... .**. ..** * .. .* *\#
#. * .\\*..*.\*\* .\.  *. ... ***  .\.\ \ *\.. *. .\.*.. *. \\.*. !\*\* ***\... \***  ....*\ \*.**\ *.*.*   .\ . #
#   ...... ...  .. .  *.  *.\ *..*. . ..  .*..\* . *** \ **@.\.* \.*\. .    * *.  *\ * **   * \......**** \ .\.*.#
#\ \\. .. .\.. \  @\...*.*...\ .\*.   .* .*. * .   ..... ..*\**. ...  . . .  *. ** * *\.*.**\. .  .   ..* .\**.. #
#..   *.. *. .  **.*. ** \*...\**. . * . .\**..**...*.. \ .*.**  .\..... .\\..   . * .**\*...   \  ** \ .\\ .* ..#
#*.  *..  *.  .\...* .*.*.. .**. .*  * \***. . . .\ ... .  .\  \ ...  \ *\ *  .. *\***. ...*@\\..\ ***.\  \*...\.#
#*..... *... !**. *\\..\..  .*.\... .\ . ...\*\. * ** * \..**. . *    .  . ....*..\*..\...\..  \ *. ..\. .  * .. #
#***!**. *  .\*....** \..*..\@*.*\\  \ *...*.. **....*. . \..** . . ...  .*.*.*.*\ ..\ .\* ** ...* * *.*.. ** *.*#
#.....\.\. *.\.**. \****.*....   ..   ..* \.   \.*\\.*!** . . .  .   *\.. *.  *..*. \.\... \. * *W ..* . \. \..*.#
#.  *\ *. ...**..\...* *.**.** .*\.  ! *.*.. . . \. **\... .* .  .. *\  ..*\ *@. ..*.*. .  .**..\ @.\.. ...***.\ #
#   .  \ . *...\ .\**...*.\ .*. . *.\*.. **\!!. \.  . @.*\\\ .\! .\\..**  .* **\   *....*.\ * *. .... \.. **\  !.#
#*** ....  . * ..*..*. .**.****.*\\.*.. \.*  .*\.*  .*\ .   .*@ **. .@.\!. . .\.*. \*. \..... *. ..     ..*..   .#
#.. **\*\.\.\   *\**.*.\ .\**.* ..* .*\....*\... ...  *\*  . .\  ..  .  .\*\.\ \.*!*. ** . . *. . .. *.. ...\.*. #
#*. .*..  . ....*\***.\...*.\...  ..*. *.\.... .  * .....  \  .\*\   .\.  .\*...@ .\*  . *. .\*  .\ . \    ****  #
#\*. *. *  * ** *@..* .\* ...\ .\.\.!\  !*. .   .***\ *.   ...***.*  ..\.  *!....\\.. *\ **    .*.*\..\...*.**..*#
# .. ** .  * *\ .\ *..\.. *. **.*\*    \* *\..*  .*.*.**  *\.\..\.*    .**.\.\. . .**  ..\.**\  ***\..  \ *\.@. .#
#. *.\* *..*.*. .*..* . .*.\.\.\..   .@.. .* * \.*\ *\ ! \...  \*..\  *  *. *  .\.....  . .\..   ..\.\  .*. ..* .#
#. .\  *.*.*\. . . *.*.\** .*..\.* **.** * ...\ ... \. * .   .  *..** **.   \.\ **.    . *\.\\ \*...*... . \*  **#
# . ..*@.. *** *.\ . *\..  ...\...\*\  .\*****.. * * *\.*.* ... . .*.*.\  .*...*..\ * .* \. .* .\* *****\.\.**..\#
#. **.\ *.. \*  . .. *\..\ \.. ..  **** *..*..\  \*. \. .\.  *\ *...*.***...\ *\.. **  *.  . .  **.\..*\.. **\  \#
# *... .    .*..!* .\. * .  \** \  .* .\......\*. *..* .  ..\..\\.*....***..* ... . .!*\  *.\.....\.\*.*.. ..* .W#
# *. \ . .   ..   . ..*. \ . .\\.. ***.*\ .\  ** \\\ ......*..\*. ** .**\.. . *!***.. .   ..*..  @...*.*.\. \  . #
#....*.*\.. * .  .. \ ....\ \ ***.\..\  *.  ...*\.  \* \ ...*\  .....\... *\. \....\*. .. .\. ...\**\  @*....    #
#..  \.*. \ \ *\  ...*..*.\ . ..* .  \ *. ..\\ .*** *  .      \. *. *.\ .    ..  . ...@.  \. .* ...*. . . ..   *.#
#.* **.. ......  *  ....*  *.*.......*\. .* .. \..\* ..*.  \**.*..\.**..  **.*  .... .\ .* .. .  .  . .\ **  \  \#
# . *. ....*.*\ *.. .\ *. .\ * .**.\ . .  *..*.\* .*\*\*\ . ..*.*\.\*\*  ..***\. \ \ .* .\ ..*\ *\.  *.* .\*...* #
#....*.*..\.\.  .\\  .\..   .. * \..\\.*\*...**.*\ *.\ ..\ \ .*.*..***.*..\ *...\...**.*    ..  * . \\ . .*  *.\ #
#\** \*.  *\.*   \. *  .\* .\  .*  .  .. \ \*\. *\..  *.* . . \..* .*\.*  .*W\.*. ** . .  *. * **..\  .\. . **  *#
# \**.* .\*.\..\    * .*.. * .  ....*  . . .\.. .. \  .\*..*.  ..  .**!..***\   * ..**..*.**\...\.. .* * .. .. *\#
#*..  \*\..  ..**\    *.*..\ \ .**.\..\... *   .*. . **.  ..  \..\. \.   ....* ..\. *\**.!...\* .**..  *\ .\ .\*.#
# *....\*.. . .\ .*. . .*....   *\*\...*\ . ..\.* . *.* .. .* .. ..*.   *. * .\...\*.\.  . * .. \. ...\ *.\* *..\#
#\.. *.**  ! .. .*.. \. ..*\  . *.* . *..*  * .. \ @  .\  \\.*  *  .*  *. *...   * ***.\. .  *\\..  \ *\.\!.\**. #
#*   ...**   \.  * . .. \ **...\....\ . . \..\  ..\*\*.... .\.**.. . \ . **.\. ..* ... .  . .\  *. \ \.\.* \... .#
#\*\.\.*.. * ** *\. \  @.. !.     *.. *\**. *.\*. *..*   *.** *.\*  .*.*. *.....*!   * \ *\ *. *.*\. .*... ...\ .#
#  .**!.*  .  .***. . *. \. *  *. **\!..\  .*\ . *...* .\. ..*.\ .\.*\ .  . \  \ .\ ..\.****....\..*  **.\. * ..*#
#\***.. .!\..\....* *..*.. ... *. *\    . *..  .*.** *  *\...  . .*.*.    ! . *.\.  . .\*.**\..*... \**\* ...  *!#
#*.\.*.\ .**. ...*.... ... *\..\. . \...**.* \**\  . .\\.. ..\*. .\...* . . \ .*** *   ..\..* .* *\...\*...* *. *#
#   *.*.. ..\..  .*\ .  **\* *\\ .*. .\....\\ \\   .**.. ..  .. *.. . . .* \**....  ...\*.*\.* *\*.. ..W..*. *\.*#
#*.*\.\\ \  *.* * \  ...*\*.**.   .** .*.**. * \*. *\. .\.@*.  *\ *\ * ***.\**   \.  .*..@\** **.\ *** ..*. \\ . #
#.\ ..* ** *.*...\.         ..*    ...\. . ...\..**\. *  *.*.*\*. ...\.*** ...  *.*\**\  ...* ..*..\.. \.\**! . *#
# *.... ..\..**. .\ . \...**\*..   \.*\. \.. .*. .**  .  \**\.*. . .. .\..* *\  ...... .. * @@.\.\..*.\.*. .\ \..#
#*\ \  .\* \.*..*..*..* .... .*  *.. \   . .**. ...*   .....  **.. W *. ***.*@\.*.   .. *.* *  *..  \..  ***  .  #
#*.*.  *.. *\.\*@ ..*\.  \   *\.*\. \ *\   ...... .. * *\* .....\ .\*...***\****.\ * \.**\\  *..\.\  \ .\..*\.** #
#.\..*.. *  *. ** .*** * ..**......*..\ .  .\*\..\. .\ *    .!   .*.\ \ . .   .....\. **\*...*  .*.*.*@\. .. ... #
#..  ..**. .\ \ ..\.** *   ..\.*..\.*\ . .\ ...   .*\.@  .*\ .*\\*.\*. .. . **\ .*\ **. .*\  *   ** .*. .* . .\..#
#..*\....  \ . *.*.\*. . *.\. .\ \. **     *  .*** .  .\...*. \ ...*\\   * .. .. \* .....\*  *   .* ***.*\*.. .  #
# ..@\.\ ... ... \ ... .W.\.\*.. .**... *... *....W \*\ . *.*..\ .*\*.\.. * *\ *  *\ **.\ .****   ***. *** .*.\.*#
# *\.* .    .  .!..\*\.\ .....\*  .. .  **  \* *  .. *..  ..*..* .*\!  *  * *.*  \.*\**  . ...* .\*..**....*... .#
#\.\ .\ . ***  .\*. * \. .*..* \  .\ \ *.**. . .   *\. ..\**.. .. .*  **  . ..\. ..\  * \**   .* .....\ . *\*.. .#
#..   ! *.*\.   .. *.\. *.*.\*\ *. .  \\ \*.**. *. *.\ \.*.*.*..\* *\.*.*...   .*  ***.  .\ . \. \\  ** ..\..*. .#
# .***  ..*.. * .. * .\*..*@*. \ \ .\....\***.  \.  *   \*.\\..\  **  *...\**\.**......*   *....\   ..*.*\* . ***#
#*.*..  . \\*.\..  .*\*** \..\* ..*\ @\.* *.\. \   ..... .....* .**@ * \***.   .** \. .*.\.  *  *\*.*.*..*.. .. .#
#\ .    **.*. . **...\**\*. *** .*.*   . *\*   .   .*.* * .*.. *..**. ..*... .* .... **...\... ** **. . \!\  \   #
# .  .  *.*. .*\** *\. ..*..**. *.*   . .**. .... .\.*.\.*.. * .. ..*\* .... ..** . * ...*.  .*.. ..*.\* .  \. ..#
#  *\***\. .*\..**.* *.\... ...*. ...\ \*.*** **..\** .*. ..*. .**.*.   . . . \..\.\**\*.!   ***.. ...*\**.  ..  #
#.*  **.   .\ .\.. . ..@\  * **. .* .* * .**......*.. ****\*\...**\...\.\*  .*.*. .\.*** *.*..*.* * . .. **\. *. #
#.. *.\..*. * .*\ \ * **.  ..\..\\.  . ..*.*. *  . \.....\ ....\...... ..  \**..   *......\*@ !. \@  .  ..\. .* .#
# ...**\ .  . **. ... \.*.  ***...  * .. .\.... .   *  ..  \.* ..*  * . .*...**.\..\ .\*.\.*.*\  .. ..  . ..\*.\ #
#\. \.. . * ...* .**.  \.. .\ \. .. \   * *  .    .   !***\  . *\**.\  * .. ..*..* .* .. ....\..\\. .\.* *\****. #
#@.*. . \ **\*\.\  *..   *. .*.   .\. .... . . *. *. . ..\ \. *.*.* ..*.\.\*\!.*.. .\..\*     *\*.**.  . . .\. .*#
# .*.   \.*.**.*.  ...*. \*. @* .\*.*** .   *  ...!.*.  * **... .  .* . . W.\  \..*\ .  *.*\.  !.*.*  . \\ ..*.**#
#.  .*\**\.\***.  * ** .   * ... .*\.*. ...*. .. .\*. .  .*.\*..*\.\.\.\ ** ..*  * .....*\* * .\ ..  . !.  .. .. #
# * \...... *\.*\..*..@   \.\  \ !.\\..  .. .  .* * *\* .\***! ...  *.* ..\   .**... .... . \ .  \  .**  * .. *. #
#**..  \.\. *. ..* .\* \* **..\. *. .* .\*   .\ .. . .**...\..  \  \... .**** \...\*. .\ *..*. .*..  **\ . *.\.* #
#.* .\ .*.  .  ..\  ....\ ***.*\\.  *..\..    *. .*! \.\.\!***. ..\..\*\ .*.... .. .* *\!* *** ...*\ .\..  . .*. #
#*\ * . ** .* . *.        **. .*. \ **.    ..*.   \* .\.* ... \  . .. *  \..\. *\*..* . **.. .. *.  @.. *\*  *. .#
# *.* .* \\ .. ...*..\  * .!.*\    .**  *\* .*.*.!*\. ***    ..    \ .\.*!\.***.   \. \ . *...*** .*.** ..*\..  .#
#*. ..\**\*\ \.. .\ *.. .\!.     ***.** *  \.*...    .**\*..* * *....*....**\..**  .  .. .\  **..  \.*.  *..*.\ .#
#* * *  .\..    \  .*. \*!. .   * \ .*. \\*. . ......*\.*\  **.  .. ..  .\*\*.\*.*   . * ..\ . .  \.*. . .*.\.   #
#W***.\..*.    \ . \.*...\.* ....**. .*. .  . \  **\.\. \ * .. .*. .** \ .. .*..\\ \*.\*  *\ \     \\. .\**.*\.  #
#.... *.*.\ .*   \ . .  \ *   . \.\  *\* @  .  . !\. .\ *.* *\.    \. * \. . .**.* ****** \!\...\.. \* ..\. ..\ .#
#**..*.....  * .. . ..  ..*** .  * ..*.\. .. \*\  .   . ... *\.\.  ..*  .\*   **\**.. ...*. ...**\.. *. ..* *. .*#
#..**.. .\  ......*   * \.*..  .*\. \*\* *. * ....*. ......\. .   .... *. ..\..**\. . *\..  . \* *. ..**. **.\  .#
#*..*.. *.    *.* \   .  ..*... .. ..W.* .  . .\*..**.\. .  .\.*..\ .  .** . \*.\ .\ * .  .* @*. ..\** ..\.\ .*..#
#.. *\ .\..****.. .@\ . .* . .*\..**  .*\*.\\  *. \...*.  .\..**  *.***  . . .  ***.... *... *\.. *. * *\. ...\.*#
#*  . . . **\.\*. ..*. .\.*..\.\\.. .\ .*.\ ..**.\W**  *. . *..\  .  ... .*.*. .***.    .\.\ . ..**.\. .* . * *\ #
#* .  *  *\. * .**.*!  \  .*\ .\* *\. .*.* \*..\  ..* .**.  * \.***.* . *. \ ..\.*..*.  .* . .  \.. ..\ .  .\.@  #
#..... *.*   \..\.*... .. \ ..*!..*..\*... *. *.. *\   . *\*\.  .\  ..*\ .*...**.*...*.* . *  .\..\   *...    . .#
#  .*...\. ...* .... ... ...*..*\\*.* ***\*.* .*\*\.*\W\..\..*.*  .*.*....!..   .. *.\ *.  .*.\ . .@*.  . .*. .* #
# * .**.  **. .*. *\.* .*  .**\.@..*..*.*** ..\*.* .. * . .. . ...\.*\ * * * .\  \.\. .*... .**\ . .\* ** *. \.*.#
#*..**  . ..*    .\. ..\.*. .. .\.\.. . \...\ *. . ** *\......*.  ! ..\  . * ..\\.. . \.\ *  .*.* *.* * . ..*.\ *#
# *.\.\.. \...\ \. ..... ..  \.. .........\  .\..\ *.*...\\ .\.\.\.\ \. *.!.\ **.\.\ .***@*\ *\!. . **\.*@  . .* #
#\...*   *.   *. *. ..***   ..**  * .*. . .\.\ * \ *.* \*.     ** *.    \* ..\.*\.*.*.****.\  *  .*..\. .    .\.*#
# *  . ..    ... ..  ...**. \\** @**\..\. *...*\ *\. .*\...*.. \* .*.*.* *** ..*** \..\\. .*. **. !.. .*..\  **\.#
#.. . ** .  *\*  . ..\\**.*.*.***.*.   . \.\. * .* .*...**..  *..\.*.. *  .  *\ *. .* .. ..*.\*\  *\  ..*.\ *\ . #
#\..*\..*  ..*.\ * *... ..**..*.\.  . .*.. *\ * ..\ .. **..*.\*...**.  *\.**\.....  ...   @. .! **\...\.   *.*.. #
#*\. **\* .  .. *\ .* \.*.\. !\..\.*. ..\.  \ * * *  \*\.  *. *.\. .\ ..**\*.. *...*. * *...*** ..  *. . .\*..*.*#
#*.. ..*\*. ..* ..*. ..\*. *.. .  \*.    *. ..  *.* ....***. \\*.  *.*.*..*..* ***..*.*.. \.*** .!  .. . ***.*\ *#
#\ .\.\\*. \.*.\*..*.  \*.  .\ .\**. *   ..\*. *..\. \ ** **..\.\ *..\  .\...\.. *.\.. **  * .* *  . . *.\**.\.**#
#\*\. **.\ . . . *\.\\  . \.*.\\ .\ . . .....*.\\ *...  .\... .. .\.* .. ... **.*\.* * .*.*.\*...\.  .\.* .\ . .\#
#.*.  ..  ..\   \.. ***\ .. ....\   *.* !.\.*\ *!...  ..\*....\*\...  . . *...*** .\..  \...*\* .*  .   .\\   .*.#
# .\ .   ..* ......* .\* .\..@\   \\**. *  \. *..\*.* \*...\.*.*   . .* *\.\..... .**\.*.*    *. ** \\ ....  *\*\#
#\ ..\  .. ...* **\....\ . \..**.. \ *\..*.  .. . \*.. ..**. @ .  **.*.\.\...\*.\ **\..**\*.  .**   ... *\**.*.*.#
# *\.. .   *..* **  \   * \. *..*....\  ****. \*. .*\. \ * . . .\ *!....*. *.*.  .*\*.\*  *  ..\***  . ....\...*.#
#.@**** ..*\ *.\.. \\....\..***\.* .\*@....\.... *..  .  *\  .*.*.**. .....\*. .\   *.*. *. **.**\..\.\*.\\* .. \#
#  . ..\*.. ** \ *.\.*.\* ..\ \.*.\  . * ..* ....*....\**\..  ..*.*\. @\.. ... .*  **.*. ..\*.\.\.   .*. ..  .* W#
# \...\ ** *..  .....*. \  \ *..*.. .  . . **.* ...***.***\  **   . . ..\   .*.@*  *..*  .**..  .. **** \ . ...* #
#  **\..* \..  \ .. \.\\!*   * ..  *!\ .*. !\.. \ **..\.*.*. **** ** *....***!.*.\.*\ . ....\ ..\ \*\.*.\    .\* #
#**...  .* . ...\*   * .\. . . ... . .* .  .*.  ..\. \*...*\..\\. .. * \\*.*.  \.**..*..   ..* *...\.... .* *... #
#. \.** *..  .* ..\* . * ..*.  * .\.\*.*..  .*.*. . .*. ...* \\** .*... \*\.   . .. ...*\**\ .\! . ***.  . *.\*.*#
# \..**  *\ . .\ ....\ *.*.!..  .. *....   .*..   * *.  ...\..**\*\. ** .\ \ .\.*     ****. .\ . ..\ *\.. **.*.. #
#....**  .*. \.   \ *  .****\  *\ .  *\. .*..\   \. ** \*...*..**. ...*\@* . \ \.!.*.@.\**. . .\*.*. \.  ...\.. *#
#.\ *  ..*. .\....***... ... \*..  \...  . *\.\ .*\. . .** .* * *.*.*....   .... @\.\. ..\.\.** . * ..*.**    ..\#
# ..* . *..\.  \ *....\    .** ...\...\ .  \.\.* * *..\.*  .* .\.****\. . .  .**\.. ..  *.**\.*. *..** .*....  *.#
#  *.\.*. \ .*.. *\  * ** .\..***\ . *.\.. \.. **.* .@..* *..**. *\.\. . . .\  \.!  \\. . *! **\**\...\ ..\  *\.\#
# ..\.*. .\  *.*\*  **... ..*..@* \**  .\...*..*.\.  . .***.*....\  *. * \..\  \.*.. \  . \..**.***...*!* .\.\. *#
#\   .  * .....    ..\  \ . \..**.  * ... *. *.  .. *.  . \**.*.\..*. .. . ..\*.. .  ...*\.*\.\.\*\*.\.*. * \.\*\#
#****.*   !    *...*   \.  .  . .  ..***. ..* \*..  *\*\ \*... \.. ...*. ..  . *\.  \   .  .** .\.**.. **.\ .  * #
#*.\.\..*  ..\ .\  . .\  .*.**.\\    .\**. ..\..* **.. *....  . ..*.  .  . .*  \.. ...  \    *.*....  * * * . .. #
#.. * *..* ..*.... .. . * *.. ...\ \*.\..**\ \....\ .**... *\. ..**  *\.. .*\....* . *\.* \\* \.\.. * \ \.. \.*\*#
#  *..*\ .*\.*.* \.\*.** ..  \.\*.*.* *. .**..*\ . . .\*\. .. \  ** . . *\ **.. **.**...*.. ..\ . *.. . .    * .\#
#  .  * .****\.\    *  .*  @..  . ...***\\.. ..\ .. .. **. .. .*\.. *  .....  *\.*\.** .*.  *\**..* \...*\  * * \#
#* .. . ....\.\. .\.\*.** ..**\*\*. . .*.  \..***\.* \  .  \ *...**.\. ..\*  *\ *\* .* . \ .. .*  .*.@.  *...\. .#
#.  \.\   ...**\\**.*.  *   ...* **..* .@.  . * .. *\.*\\*. .*\. .. .. * ..   *.. .\ * *...*\.. ..****.* \  *.  .#
#\ \ .. .*\...***. * .    \ **.*...\ \* *.**...*.*... .**.\. .*  \  \* . ..\*.@.\**.**\*\\  ..\. \*\ .*. \  ** **#
##################################################################################################################

Water 3
Flooding 13
Waterproof 12
Razors 1
Growth 39
