###########################################################
#**\.\.. .*.   *. .\     . ..*\* \ .....**\.*** *. .*.. .*#
#.*.\.\  \.* \    *.**...**. .**\.\ ...*. **W*  . . . .. .#
#... * .\.\.*..*\*..*.** !* .*..*  .** *\ *****.\  * .  **#
#* .*. *. ...* .*   . \.. . . *..   * ..* * .**\ *!\. .\.*#
#..*... *\ \*.*\.* .!\...  * .. \*.*.* ..\.* *.. ...\..***#
#.\.\\.  .***..    . .*  ..   .\ \. .*. \...\.* ..*..   \*#
#  *.\. . .. \ .\. *\ *.\* *\.\ \   ...  . \. .\  .. *....#
#  .*. *.\.. .\.*..* .  . \..*..***. \**\ .A.... *....** .#
#.**\.  . . .  ...*. **. ..* .. ....\.*.**...\ .. **.*... #
# ...\..*\..* \W  \.**.* ..  **\*.* *.\\..\ \..  .*. .* \.#
#.!*\.\\.**\*.  ... *..\..  ..... ..\*\.** . .  \.* * . *\#
#.  .  *..... .  *..**.*\.  .\*.. . .*.\*.  *  .W\* * .. .#
#... ..\.*.....*.** * .* \\*. *....\ . * *   *\...* .  \..#
#.*\\*..*! *.\*... \. \.. \.*. .  .**  ..\ ..   \.*\.....\#
#  ...*. * *\ *\.\**.\ ..\ ..*.\.\***...* ..   *...**..\ .#
#     *\ . .  .*.*. ***.*..*\.* *@*.. \ .*... .* \ ....!. #
#\..***..\  . \\..\ ..*   .*\*.\* . .\ .**.*. @.... \\.** #
#..*\.. . .*.   \.   *.. *.\.**.\.!..  *...*. \ *\\   \ ..#
#*.**\.* \ .*...* **.\* \.\**\.@. *.*. ..* ..\.*.... ...\ #
#!\*.*\ .*. . !.\ ..*.*..**..   .\\ ..  .. . .. **. .  ** #
#. *.*.. .*.*   . **.*  *. .*\ \ .*. **.  . ** *.*.. *\.\ #
#* .\ \. \.  .\.\.\ . ** ** ..** .. **!*..*..\ . *.. .....#
#\ ** . *...  . *... ..  \* * .*.*\ *.. \.*    .*.**  .. .#
#* .*.* . ....*.*..*.*\*. . * \\. *.**.* *. .. *. *.. \. *#
#\.\..! ***.\.\ *\..*\.\  **\\. *..*\*..  .\*. .\ .  ..@..#
#..  *\*.*\  **.. \ *\  . \. .*..* . * .  ...\ \ . *. \.\ #
#\ ... * ..  ...\.. *  .\ .* ..* *. .\.@*.**  ...*..\ ...*#
#.\*.*.. *. ... *\. .*\\.. \ .*. ... .*. *.. \.\..\*. \*. #
#*.@ . \*.  . *...**.\ .    * \.***.  * .\.**.\*.*..\*.. .#
#..*.*. *..\*...\ .\.. ...  .\...*\..\. ***.*\.. .\* *... #
#  ..***.* *\*\ .* ..   .*\ \.**.*..\.. .*. .*. \*  **\.  #
#* . . ... .**** ..*\.....**  ...\* \ \*\.* *. .....*.\ \ #
#. *\ .. . \.***\.*..**.....**.*... ..... ..\*. ..*..\....#
#  .   . *.\.**. ..\!.\.*.*\. ... \...\ .  .* . *.\.\.*.* #
# \.* *.\******\*.   \*.**  ..   \ \ *.\.**** \.!\...  .\\#
#\.\. ...*..*.*... **.\..\. \.*\ ..\... . ..  .. *....   *#
# *** .*    ..* \.\.* **    .   \  .  * \  ... .*.* *..**\#
#.. .*\. *\. ..*   *..\ . \. *..** .* ..  \ .  \.\.\...*\.#
#. .\.* .*..\   *... .** \ .\\ *... .\ *..   .     ** *.*@#
#.**.... **.* .... \* ...*\  ..\  \ . !\*\*  **. . **.\**.#
#\* .  **. .\ .. .* . !**  ..\ .. *.. ..**..*.\    ..  *. #
#*. ..*.. *. .\  ..\  *.  ...    * **     * *\*  ..*\  ***#
#...  .  \. .\.*** ..*\ .*\.*\.  * ..  .* * *.. ..\*!\**\\#
#.*.* .\*   *.\.\****. **\*.\*.     @ . \...*.*  \.. *\** #
#.. . *..*  ..*.*\* * .@.\ *.\* . *..\.  \ .. .\ .  .\*.*.#
#**.*. *\* ..*. .\\ .*.* ..* .\ * .. . .*.* **.*.. **.. *\#
#.*.**..*\ \\... ...*. *\ @.!\ .W   . \ .@. *.*.*\ **..*..#
#..*.\  ** ..*... ...  .*\*.***** ** ...*. **.*.*\*\* *.*.#
#  \.*.. * ...\ * . .*\*\ ***\ .* . . .*.\  \ .*...*.   ..#
#..  *   . \*\.\.*.**. . .*\.. *\  \. .* .\ .. .\  \ \ ...#
#.*... * *. **. \*.\.\.. *  *.*..W\* .* .  *\*** !*.*. \*.#
#*.. ...... ..* .***\. ..\   ..\....\.. .  ... . *.*. * **#
#*.... ..***\ *  .\*.  . .*\ \ . .\** \ . *.... .. E*. ..!#
#\ .\ *.*..**.* .  *....\ .! *   ...*.  *\* ..** .* .*   .#
# .*  *\*. ** ...  . .. .** .* * * ***....   ...  *. ...\*#
#\ *.*.*.@\.*.*...*\ . **\.. \ .\.... . \ *\*\\*  . ...   #
#. .\.\.\*. .@..  . * *\* \ .....**.* .\.....    .** *\.\*#
# *\  *\**\.*.. *  .\.*  *...*\. **\* * .\* ...!. \.* . \*#
#.\ ...*.***. * **.. .\**.   ....\..**... . . .  . .  *\. #
#.**.\** *\.\ . *..\****....* ...  *..*. .*\*.  \.\.\*. * #
#..\ * . . ..  *. * .@.... .. **..\.\  W  .*...\.*. .  *\.#
#*. \. ***\.***\.. *.*  *. .*. .\ *.*  * .  .**.*. .  *. *#
#*\*.\ .*.\ *...**** ..\..*..*   *.*. **.*.....** *....  .#
#!..** **.\*.\. .... .  *..\*@    .*..*.. .  *..\ . .* * *#
#*.... .... ..\.** \*   . *....\  .\\ .. .**\.\\.... *. \*#
#. \.. .*   ***.\\\B.\  *  .\*..* *. .\*. !  .   ***.! . .#
#  .\ ..\.*  *\.@.   .***\*  .. ...*. ..*.*. \*....!* * . #
#.. .**..*.  *. **.  . *\ .\*.*.\.*.\. .. @.... \. \*.*.\\#
#. ...* R\.... \.\...\ ...\..   . ***@.*... .. \.  ...\*.@#
#  *. .*... *    *** .\*\. ..* *.*...\ .* * .   *\. .*.* .#
#\.. \.*.\ .*. *\.\*.*..** *.**   \* ..\!\. *    .*.*...\.#
#    ..*  ..\. ..  . .\.*\\   . *  .  * .   . \...***. .. #
#\**\....\.W. * *.\\. *.**  *..@.*\ * ..*..\** .....\**   #
#......*\\\ \..  .   ..  . .\..*    .. .*   ..*\.\ \... .\#
#.. .. *..\.. ..  ..\  \**   ..*\ ..  .\.*\. *..\*\ *.. *.#
#* ** \.\.  **..\ *.*. ..! * * *5.  . . *W...*.\ .*.*.* \.#
#. . \  *. ....   .   \* . .\\\.**    *\!\.\.!*.* *\* *\.\#
#\  \   .*\ . \ .. \* ..\..**.\..     .. . *  .*\  .\..\.*#
#**\..    .* . .   .. *  *.** .....\... *. * .\.**  .*  ..#
# *..*..    \    \  \\.*.....  *....*.  **\. .  ** *\....*#
# . .***\  *\. ** .** .. ... .*. *.\..   .. . . ....... ..#
#@*.*.*\. *.\*.*\  \.. **.*\ .*....** * ....  *\*\***.\.**#
#.\ . \\  \. **..... \ *.\.* *.*\*..* ..\*..... ...*. . ..#
#.*W \.*. . .\.*. . *.*. . .\ ** * *.\   .  \*. .. * * ..*#
#*.\.*  \.*.\.* . * .  ..**.\ . .\*.... .\**...\\.*\ ..\*.#
#.\.*.*\ *..*.*  .* \.*..**   *\  .*.. . * ... *. \** \.*\#
#** .\*..**.*..*. *\*.\*..  ...    ...*..*.. \ ..*.*.  *  #
# *\.*.\. . . \*****. *.  \  ..*\ . * .*..\.\** .W .  ... #
#\ *\*\.  * . *\ .... * \* .  ***. *.**.     *\** .  ..   #
#. .*.... *\.   * . \*. .*\ .*.* .**! \*.! \  *1 \  \*  ..#
# .**    ..*...**.\ ... \.*@*\*.   *.*\ * \.   \ .\*!. .**#
# .*  * .\.*. ...* . \... ..\.** \ . \C..* \.\*\.**  .  !\#
#\.* .  *\ .\ \  *.  .\* .* ....*..*..  *.*\. .. \* .* .\ #
#  . \...* * .\ *...  *..* !**.\   ... *\\\.*..*. .\....@*#
#..* .  ***. *.\*.   \.. *.*....@.***.\..  *. . .*...@. **#
#*...  . ! . \\     \ ..**\. *  .\ .*\.\. \.   * ..***\ \*#
#  .. .*\.\*.. *\ *@*  \ **  .. .  .. ..\*\.. *. .*. .!\ .#
#.  *. ***..*\  .!\.. * *\....\. *  * ..*\..**.\.* .***.**#
#..@* .... *. \..\* .\. . .*. \   ** . ...  .* . *  .. *.*#
#\.*. *.\....\.\**.* \  \ *..*..   ! *..\...**  ***. ..\..#
#**\** \* .**\\.*.*.\.\*W..  **   \ *\ .*. \* *..*.*    *.#
#* .!*  .*... \ .*.   .* ..\*. *.!.... .  . **. .! . *  ..#
#.*.*. * ...* . *.* \**..*  .* *   **   ... **.*..\ .*.*\.#
#.*.\ .* * .*\ *.*!\.. **..\** \..*** . .\. *.\. ..*\.*.* #
#... ** \* !..... .**.*.**\..*\..***..* . *..*... *.* . **#
#.\ *...@*..\.W  .\.... .*..... ...* .. * *.\*..  .*.* \#.#
# * * . .. .** *   *\ *...*  .    *....\   \.\   **.!.  ..#
# * .* ..W\* . ..  **.\ .\*@. \*\*.\\*.*\* . * .* *\\*\ . #
#*.. \ .\. .   \*. . . . .***...... ..\ .  ***.** *.*\ * *#
#* *..* .* ..\* .\ ...\ \..*  ...*\.*\.**..*\.*.. .\.  ..*#
#.*\  *..**\**.\     .  .*...7\  *   * ** *..*.  .  .* ...#
#@.**.****..*.*. . .  ...\ *\... .   .\.   .\...\. \#* . *#
#* .. .....*W*\*.\..  \.\9. *..\  **  .. ....   .* ..  *.*#
#.#  .. ..\ \ .\*. **\ ....  .\. ..  \.\. *  * .\*.  **\..#
#*!.....\ .*  **.   . . \  ...  ..\*..*.. ..\.\  .# *.\..*#
#.  * *....\\.... *\.   ..   .*.. ...\..\*@\ *.\.#*#\*.. .#
#*.#***.\   \   *@.*\\ *\.**.*...\ *. *\*.*..  * \.#***\  #
# *..  *. ... . .\ ...*..\*...*\ .\.. .W*\. \  \\#\ #######
#.#* **\* *.*.\. *\ .\* . \*\.**   *\* *.**.#.  *##*#     #
#* *..\.**\ .*#.@.!*!*#*. .* !...\.. @ .\. #.*L #  #      #
#  .  . ** .\*\###..*.\*   .\   .. *\. . .\ *# #          #
#... * #*\.*!\.##**..\.*. .  ..!\ \.*\.#\ .##             #
##* .*\#.... .#  #*.*. . .   *\ #*.*.##\* \.*#            #
# ###.##.*.*.* #  ####*.\*\* #!*\#...\@#. ###             #
#   #*.##  \ . .#     #\#\*\ \.#.# *. *#\  .#             #
#    ###.\ ..\*#      #.#.W.***\ **#\ .#.#\*#             #
#       #*## ##      #.. .*..* # .\ .###\.##              #
#        # #*#        #. *##\.# #D \* # ##                #
#           #          # #  #*\##**.. #                   #
#                      # #   # # .\###                    #
#                      #.#    # #*.#                      #
#                      #*#       ##                       #
###########################################################

Water 0
Flooding 0
Waterproof 16
Razors 45
Growth 26
Trampoline A targets 9
Trampoline C targets 7
Trampoline B targets 7
Trampoline E targets 1
Trampoline D targets 5