########################################################################################################################################################
## # \... . *\.. .  ..**. \.  ..*\**..  .*...* * .  *  \ ... ....   .**\\ *.*. \\..\.\..\*. .  . ....\ \. \ *\ . * .*..  . *.  @.\*.  . .\... . * .*\. #
# #. \   ..\.*....*.\.  *.\*  \ \ . \.*. .**..*.\*. *\*.\ . .**\.*\.\. .. **.* .*\.. **\.** . .* . *\ .. \..* *  ....* ** .  . *\ . \\ \ \.    ...\..# #
#\..*.\..****. .!.* ...\. ..  ....\.....****.\  .*. *.*!.* .*  \ \.*.* *...*..**..* . .. . ..  .*\*..R    .*..\\ . \*.\ *.*. *** \.\. *.  *\* *.\*#. ###
####.*  \..\..**.\\*\ ..*. \.     .*\ .***. *  .\.. * .. * .   \ ....**. \ *. .. .*...\ *.      . *\ .\.  *.\  .\ \..* *.......* .*..  .. * *\\\.\ . # #
##*\!..**... .. *. .!\..*\..  ***. \. \.*\ *...\ .* **** .   . .. . \.\*....*..*\*. *.***....*.. ...@* .. .*...  *. ***.\\ *** ....\.   *.*\ !..\.   @.#
##*#\...**\ * \ \*.\ ** *.  \  \. .@***  .\* *  .*.*\.. .\.. *\.. *\ .****. .*.*.*.\*\.*. .**. . ..  .!  . \**.. .**.**\*.**.\** *... **.*..\  *# ..*\.#
#*. *.#\***... \. .***. *\ *. . ...*.\. .* . .   *.  \*.*  .\**   @ . *..*\ \.\.*.  .*.\***.*   \    *. *\.**.  . *\ \..**.*...* .\.. \. *W . *. \..\..#
### .***\*.**  . *\...   . ..**@ . . *  .** .*\*@\*\*.*.. @  .* * *   .. ....\. . .* . *.*\.\.*.* . ..*..**\.*..* * \.\  ..! * ..  * .* ..\..*\. ..\* *#
#  . ...**.. *.. .* *@..\  *.... \*. *\.\.@  . ....!*.\*  *... *\  * .    \.  * *  \ *  @* \ .**.. .. .* *.*.....   .\ .. ..\.\!.. *\..  .* * *. .. *..#
##  * . . \\ \ ..\*.\   .\..  .....\..* . .*..!\....*\..\.. *  \ ..... *\*..**...   ..**.**..\..*\* * *.\. .** . *.   !. ..* *. .. *...*. .  .  *.*  **#
# #.. *.* . *\*.*...**.** .\\*.....  .\  \*..\.*\ .\.\  .** * \. .\ \   ***.* **....\ \. .*\*!\**.. *\.! ..\*.\!.**** . .\ .*** .\. \*.*.\ . ***\*\*..*#
#*. **.*. \ \ ..*.. ***\. .. . . .\.   * .\\..\*....! *.*..*....@ . . .*.\..* ..\ *.. .\. .\*.*\*\ *..*   *   *  .\..\...*\ .*....**.** **..\...\..* *##
# #\ .**... ...***\. *.*.  .     .*\. *\ .    * .\*. **.\W**\ .*.\..\  ...    *  ... .   .\ \ ... \*.   *.*  **.\.  **   .*  ..* .** *\ *\ *..*. . ....#
##\.\ .. .@\ ..*..*\..*.* .. ..*.*. * .*\.\.  \\ ..\* .... \   ... \.. \   **.\**.W .*\ \ .*.\.* \** .  . .**\*. .*..\ *    ....  *  .* .*.*\ . .   . \#
#\. *\@*.\.*. \.. . .  \.*   .\.*.\ .\..*.* . .... .\   . ...\. *.*\\  . ....**...\.    .\.\. .* .\..*. .. *..\.*.  \*.*\ .***.\**.. ..  . .*..  ..  . #
###.\.*\ .... .**\* \\ ..\ .   . \.   .\.*\*.\...*. *  .* . *..*\*.* \ .  * @*.\ .*.\*  *...\. . ***.. \.. .* *\..* ..... **....*..*. *.**\.*\.**.  *###
##*. \*... . . ..*. .\* *.**..\**.\......\ .*.*  .. *.\ .\. . .\  \.\\ ..*.\.    *. *. *.\.. .*. . *..*..\**.\...***\. *.**. *. .\ .. . .*....*.\..  #.#
# #....* ...\\**.**\. *. *.*\ **\.. .    .\*..*  **  * .. .\\...**.*..\ \ ..\***\...* **\  *.*. * ..  *. \*. ...  .*.*.*!*.....\*.\  *  .. .*\\*.**...\#
#  # ..* \.\ *.*\.\ \.   . **\*.. \ .\*\.. ...* *..* . \.. *. *\.. .\   .\ . ..  . *. . ...\*.*\.  ... \.* . *. .* .\.*....  *. .. \ \...*\ \..\*.\.*. #
#  #\  ...  ..\* **.\. .*\..* ... ..* . ** .. *.\.*. .......\ *   .*** *... \.*  **  \.\.. * \..  ...\ .  \ .\   *** . .  .. .*..* *   \\.. * . *. .. .#
#   # \.*   \  . *\ *. *.   @\ \ .. .\. .. **. ..*      ..\*..*.\*...* ... .*\\ \*.\..  ** . . *\ **.*\  *** *.  *..\*  !.  ....* *... .*.\ ***..  .\ *#
#  #.\ \.\. .\. .\  .\. .\.*.. .    *.\*\ ... .\* *\ ..  \*.\....* *\..  ***. ** . .\ ** .. .* .* .  *\.* *...   *   .. .. .*\ ..*\* ** .. *\.* .*** .*#
#### .  * ..\* *\.  \.** **. *  .*\*! *.* * ** .\\.**\  .. \* .*.**. .!..*..* .. *\. **.W*.!*.\\.\ *.*\. *\  .*  ..*. . .*\!.*\. *.*.\.*   .**. .W.. ..#
#.   #  .  .*.*.   .!.\  ...*..**. *\. \.\.**. *.. .\   *.*..\.. *.  \*\*.* ...\ .** \*. .\..\.. .  \.*  *. .\*** .*   *.**.** \*.  \ \*.***!\ * ....\ #
# .*.\....\ *!**.*    .* . \...****\..  *. *...\ \.. \\..**. * .*\   . .\ * .\ .\**@.@**  *  ..*   \ .. @** **.**  . .\.*.. *..**\  . .* * .\   . *. ..#
#\.\ .. \.*  .\.\ \ **...**.\...\.\*.. .. \..\.. .*...      .@.\*.. .*.* *\ .***... .\.** . . *.\ ....\.... .\ *\ \ @ ..*.* *\.....* ...**   .\..*  \ *#
#*     ... .\. *...*.*.*  *. *\*. *... . *.  **..*\. .  *\.. * .* *.\...\.* *. . .*. . . . .*..* .** *.. *   **.  * . ...*.\...*......* .*.*... *.!\..\#
#  .*..#*.\  * ***\.****...*.. . ..\ ....   ..\.*..\.**..   \ **.!*\..  .*... **    . .*. *.. \. .*  .** * *. .*\!***.*..** .\ **..\...... ..\*.*.\*\. #
#  ... \.. ** . *\.*.*\*. ..*. ..  *\*... \* *   *\ \.. \ \....\.\..**   **.. *.\  *.* .. .*.*  *!...*  *  \* ... *.  .*.\.*.\ .\*\. \. * \*.*\..**.** #
#.* . .  ....  .* ..*. **. **. *   \ * .  .. .\.*..@..\*   . . * .*\. .**.... ..* *. *\ *@.. \..*  .*. .. *.. *..\\  .\..\.\. *.\.* *.  * *. .*. *\*. \#
#.*\ *\..* !\\ .*..  ***.*.  **\ \W. *.* **.*\*... .\* .  \*\.**.@\ .  *.* ....\. **\**\@*  .*.*.  \.. . .\!*@!*.*.  \*. .. \.. ! ..**\*..   .***...*\##
#.*. . .\..\.*.*.   .. .\....*** \* **.  ...\ ...** .\.*.* . \.* .... .***...*..* \..*.*.. \   .* *.\***.\* \* *  \.*.* *  . * .\ . ....\ ... \  ** \. #
# .*\.....\*\..***. *\. \*\ ****.. ..\\...*@.\*.**.\**..* .\..*.@. .* ..**.! *\..\. \.\.* .. .\.*. * **.\ ... ** *.\..*..  \ .*. ..  . **.*.\ .**. \  *#
#.*.*\ .  *. .\....**      . .  ..** ..*.*... * .   @....\*\ \. \**\* \! *.*.* .*. *...*.. .*  *** *. .*  ..*\ ...\* ***  ****.*.  . * \. ..*. ..\.\*..#
# ... .\ ..... *    .* .*.. ..**** *.\**\ \ .*..**..*@ .**. ..   ..*. .\***.* *... \ .\.    .*.*.*..\\\ *..*\!.*.\.. \... ..*\ \ .*..** .*....\* *..## #
# .*.\ *  \* \ ***.\*..\.\ **.\ ..* .... *.. *\* .\ *.* .\*.*\   @\** *..***...\.*\*\..** \  .**\  \ . *\ ..\ *.*\ . \.* . . ..\. \.\*.\.\.** ...*.  ###
#*. * *  .  *\*\.*. \. **. !\  .\..\  * .*.\.* .*    .*.\ .*\...*\.*.\\ .*\*.\.\ ..\ . .* ... . .*@ *.  \.\** \* *.* . \..***.\.* ..   ..****.*\ . .####
#* .\*..\   * ...  ..**\. *.*\ ...**......**...  *..\    W*.*  ..  .  .*.. ...* . .* \....* .... .\*.\ ** .*.. .\.*. * .*\.\..*\..**.  .*..*..\.  ..*\*#
##*\ * !. .* *.*  .  .. .\...... *..  .\*. **.  \.  . *.\ !  \.. \.*.* ... \*\* .. .  \   .\ \ .*....**\*. *.\* .  * **...**\\. \..*. \. ..*.**. .  *..#
#\\. . .  *\ .\ .*  **..*.\.  .* *\.   **.\.*.*\*...* ..\.*\\.*.*. . ****. .. ... .  @*.  .*..\ * .\*...!\..*. \*.*..\@\**. \ .\..*.*. * \.*\*..\.\..**#
##*  .   ... *. *.. .W! .\* ...*....*  ....\. . .  .*.**  *. !\.*.  ... * \...\\\  .. .****.    . *.\.\ \. *\ ..\ * . . *.. . **. .*.* .....*..*.. @\###
#*..#*.**\*.**.*. \    \.** .*.*  ..... . . **.\ .\*..*\.*.\**.*.   . ..*..* ...  \ *\ . ..\ *.*  .*.**..**.**..  *  . .** \. .*\ ** .\.\.* . .*. .   ##
#*  *\ .\*\ \   \*. \.\ *..\.\**\ *\....*\...*. \ ..  *.. .\.\.*.  ...... \.. *  . \.. \..*. . *.***.\ .. \... .* .!*\.... . .***\**.\ \*\. \. **. .**.#
#*.*  **.!  .***..\  ..***\..*.  \.* ....\      * **\.. .\*  ..*... . . *..\ ..   *..\* * \*\.*W .....\ ...\  .\*.\. .  ..\   *..\.\. \. .. ...\......##
#....**..*.. *\. .*.\* *\* ... \ ..*\. * .*  **\.\.. \.  ..*.  .* \ .@  *** . ..\.* .\.!*\. .*.\*\  *\ \.\\  .*..**.*..\.* .\.*. ..* . \* ..\   \  @ \ #
#.    .*\*. ..*@..\ ....**.. . .\ ....*\ \\*.\ *.!  ...*\. **  ..*\ \*.\!*.\..*  ..\.*. . . * *.. .\.  *. .*..*\  \\** *\.*. \.. *\*... .*  .*\ .* .\. #
#\   \*.*.**** *. .. *...*. .. *. *  **W\..\ ...*    *.*.*@\.\.. *..*.***.*..\.\***. *.\* .*.*.\   .* ...***.\*.. \.*. *..*  ..*\ W.  . ***  *.. *  .* #
###\*   \..\..\ .  *.\ * .. *. *  . *\*\ . . *  .  ...* .. ..@\*\.. ..\.\  .!* ..\.*\ ***.  *...***.. *  ..W\*.. \.  . * .. .*.*** ..*  .!\  ..\. .\*..#
#*..\..@  . .\ *  ......     *.*\ .**@ * .* *..*  *.\... \.!  ..*..\. * *.*\ .\.\. *. \    ***  \.*\..\.*..\..*\\. .*  *.  ..\ *.** .* .*.*\ .#.*#  \ ##
##  *\  ***** *.* .. \ **.\*\**   *..*.... ..*.* **.. ...!. * .  ..**....*\*.*  .\.*   .\* .*\ .   *.* .* .*.   . .*\\* * . *. \*.. *.\.... *. .. \*.# #
# \.\ ..* @*\ . **  .* ..*..!.*\. .* * . \.*.\**  **..   \* . . ** .. *.*\*.*.**  \.. .... !\ . .  . .* . \.*\ .\\..*.\..  \* *..... . \W!***\*  *#*\*##
##\*#\ .* .**.*.\..@  \..*\  ..   ..\....  . ....**.W.\.\...\. \.. *.***...****.\  *. ...\ ** * ** .\. * ....** .\ *..\ ..\.\ \*. .*. \. .......   *.#*#
#..\.....\ ..* *  **  \*... .! ... ***\ . \. *.******. \  **  *..*..**\**. \** \*.\.\.*. *.......\!  *...  \...  ** ... .\ .  .*. .** . .* .***.#*.. .*#
#***   .*** .. \. **\..*... . . .\ ***. .*...* *\*.*.*...\..*.  .** ..*.\....* \! . ....\.**  *  ..* .\ ..  \ . .\ *.. ..*.\* **  *.  **... *.\*\.\#\**#
#*.* *  **\\*\*\.... . *..* .* .. *...* \. **....**.\*.\ .. .**.*\. \ ... **.* *.\*  ..  *.!\*.*   * ** ....* . **.. . ***\ *\..\.**\..!.*\@. .\..*..\.#
#.! *\*\*. *.*.\ *.*.\..*\.. * *..!!\**  . .. ..\.\ ..... **..  .**  \.  \....\* *\\ .!*\*..   . *\.\* .. *\. \.. . ...*... . \ *..\ ...*.*..*!.  ..\*##
#\ .* .. *!.\.!  \**.\...***.  ..... .. ! \*.   *  *.\...*.*  .* \...\.  .  \.  .. * ...*.\ .\ \.\ \.. *    \*.. *\ ....*  **\.*.. .\   . .***   * \.*##
#*\*.\ * .!\*\ .\.*..*..\... \  .*. . .\ ..*** *..*. .. .* \. \* ..... ...  .  *...\   .*..*    **.   \.** \ ... **.. . .. .\*..*\  * .   *... *..*##\.#
#  *..*.    @. \. . \***..  .... .*  \. @ ..*. .\*  . \ *.* \. . \..** .*....\ !* *.*. ..\...\.*.\. ..  *. *\ \. .*\.**\ *....\\ .\* . .  .  @** .*\**.#
#.* . .*\\ *.*. ...\\.** . *\.*  ..\*.\\.**\..... .* \. . .**  .. .\.\*...*. .. .*..*.\.\    ** ...    ..\ . *.   . \.* .*. \*\  .  *..  *\. *..* *#..##
# . *\..\... *..*  \. \* ...* !.*. ....\.**\*  .\   \.. *.... \... *.... \*. .\*\ *.\**.\.\\. **  * .**\*.... \.. ... *\ .*..  .. *\\\ \**... ***\.*...#
#   ..\ ..* ..\.*. . \ *\  .*.  ...  *..***. . !..** .\...\ .. \.*W \  \....*\** .*... *.* !*@\.  .. \**.  *.\..*\. * \*. .*. . . .***. \.\. ..\. .. **#
#.*.\\.. \.**  .*. *   .\.\.. .* ..*.. .\ ** . @*\.\... .\*\  *** *.  \. .**.*...\*\* ..  \.... .*.  . **  ... ..*.**....* .*.*\  \.\.*..**...\  .** .*#
# .*...  .  \ . .  .\* \*\..* *.    **.\.***....\ * * *.  ... **.  .*.. . \ \* \\ \ . *. .. ..*.*.. *\ ..\*.* \. **..\.. .* .!.  * . .*  .*..*.  ***.\.#
#*\**\ \ * ...*\*   .  . .\*@\. **. ..\*. *.\. *  \ **.\ *.*\....** .. **.. .. *. . . ..  ... ** ...***\* .\. . \.*  **...\ ...  . * .**... **......  .#
#**.. ..    \.* .@*.  .* \..*  ...*.*\* .\...\*. . \ * . . ..... W\ \.. . *! * \\ **   \* **.*\.  ..*. . .*...\.  .*\.\\* .*... *  .\.**.   .\. *   *. #
# \ .* *  \ \ . ..* . .. *\.*  .\....*. .\  . .  . .\. .\  **.*.* .*  \   .*..*.*..  \ . *.*   .. **** . *.  ... * .. .*.\. .*.**.....@\*. \*. **\.**..#
# *\*\.*.\ ..  .* *..** .. **\..* .\ .\\*.\. * @**. .  . . . ..  *..*.   . !. .*.\.. *.*\ ..  \.  *.* \.!. . @*..\\.. ***.\  * .\. \*\ ..\*.. *.*  *.#.#
# .**. . .*..\\ .  . .\..* *\. *.\* **\.. .**..*\! *. *\. . * .* .\*\..  .\* * *@***..\.  .* \...*....\.*.\* @.  *.\  *!.  . .\.. ...  \* .*\** *\\..*.#
#... *  \.* . ..  **. * ..\**.  *.*.*\. . *. ..  .*.* ..\***.*\.  ..*\  .\.*\. .  .... **. ..\. .* *\\  .***@**\ .*.*. ..\..\*. *\     . ..**..*.*.\..##
# ..*.* .   . . * ..  . .\ .\*.\.*\.. .  ..\ .*.. *.  *. *..*.*.. **..\  . .. . .\...* .**\ .  . .\ ***\.*. ....  .*.\  ...\ .*... .  ..*..*.  \* .*..*#
#.#\ ...\ *.*.  * ..*** * \*.*. .*... \*. ***\.\ ..\\ \! *.\.**** .*.* *\* . \ . **..\.  .....**\!. ..\.*.  **\*..\..*. * *.\ *. ..**.!*. *.* ..\ .@.*.#
#*.. .  .**...*\ .**..\..  .. .* .\.  .\.  ..\.\*   . .\ ..* .\.\ . ..   *. \. **...* \  **.\*.\    *\*.*..\.\ ***.*.!.***.\.  ** ..* ....\*..   .\* .!#
#. \ .. .\.**. ..*.\ \.\...* * \ . *\..    *.. .\.**.*\ ..*..  *** .* \\ ..*.!.\.  @.*\. .. *** .. \...\!*\   . *. *.\...\* .\*.. * . . \* .  \* #*.*..#
# \ .\*  #\ . .*.\***# * .\. ...   \. @ ** . .\ .  **. .\ . ..\**\**.  .\..\ . *.\.* *W\. ..\..* .. ..\. ..... \ *.\ *.*  .**.\ \.*.\*  . \... # #  . .#
#*. ...* .*.*.*\ *...\..  .\ *..* \**.\.  *... ... .. . **\ *.. ..\...*\.*. \   .*\*** .*.** *\W  .\  .* .* *\   .** ..!..*** . \#\ * .  .#  \ \ .#\** #
#. .*..*.  ...  *..*.. .*  *.. .   *. .*.\..\ \ *.   * **.*.. \.***.. .  **. ..*\. ..*  ..\* . .. ..\* ..\. *.... *\     *\*.\ .\*...##. . ..# ###..#. #
# #*..*.*\. * .*. ...  . ..* \ . \...* ..\.. \*.**...*. .**.*..@.*\ !*\  .\.**.\ ...\. .**.. .**\... . *\.. ..\*   . \.\ . .**....  *....#  ..#   ## # #
#\.\ ***\*..*#\*.. *. .\ @ ...\.\. . . *..  \.\.*.*  ....*\..*** \*.*.....*..*.    \* * *\*.* **.\  *\ *.\.\***. \* .\ .\** .. \  .#\#. .*.***#      #*#
###*.. *.#* . *..\ *..* .....  .\..  ...*..*.. \* . \.. * * ..........*\  ...   . \.**..*. \.**.*. .\* **\ .*.\..*..\..\ .*.\ .. ***#**.*#.*##        ##
#.. # .#..\ . \ .*.\\.\*.\..* .  ..*  ***.... **.   . **. ..\*.** \** ..\ ..\*      .*...\ ...*\ *. ..*\.@ ..  \.  .. *.. \... *\.*\##\*# *.#          #
#####*#  #\   * .* *.* . . \ .*\  **\*....\*\  . \ *..*\... * \ \ ..*\.  ****  *  *  .\ * . ... .**  .\... *. *.*..   *.#*    ....##  ## ##.#          #
#    # #*##*..\ *... * ..*...*.    .* *.*\.*. .* * \!\. ..\.. ... .*\.\ *..** .\* !\  *\*.*.  .**\..**  *\**.*! .\ .*    . **\***#         #           #
#      #\# #*.**  \ ...*.*. .*** .\.*\. ..*..*\*@..**.....***. \ *.!..\. \ .* **..   .\.@* \.  **.\..\ .\*****.**. . .. ***.** #W#                     #
#       #  #\*.. . @ . ..***  **  * . * . ...*....*\.*\ !*..\....\.*. .\*\. . .*!. . .**...*  ... .*..* .... *.***.  * . \#*  .\.#                     #
#         #.**  *. . \. . * ! **. ..  \.*\\.*... .*** .. * .  *@      .*.. *.  .* * !\..W *\ . \...   . *... .\\*  .... *...\# ...#                    #
#          ##*..\. .*.\. ...*.\... * *.*... \*\.\* *.*  \.. ..**   **.\**. .. *\\ . *  \ \\ ...@**.    ...\ ****   *   .* . ...\###                    #
#           # *.#\...  *\.* ...\*    **\\*\    . **.*.  . @*.*.. \ *.\...* .\*..\\ .\ .*..*** *..**. *..*. ..**.  \......#\*.#**\* #                   #
#           #\#\*** . *\*  \..*.\. \... *\.**. .  . ..  * ...\ *\..\ .* .. * * . \.\@\. *\.*** *\    **.. *\ *... .\.* *. .*.######                    #
#            # #..#*\** .     .\**\   \ \..\*.  *\   .\... * .*. ...*\. .*.* .*.\.  * *...*.. .\.  .\..\ .*  .. .. ..! . .##\#                         #
#               ##.. *..\ ... \..* .  .     .. *\ *\  **..\...\..@*.\! *... . *.*  . . .\.@ ... ..\ * \.\ ..**  .*!* *.. ...  #                        #
#                #*#.\ *     \.* ..  . *\ * ..*\*..** **...**\. .*.***\.   .*\*..\ . .**. .*.  .*.* * * .. *.. . .\* .#*\  # #                         #
#                 ##* \!*.. * ..\.   \@*\. \.* .*\ .. \.   ..* !\* .. ... ***... ..  ..*  .*\.\\.*. *\. .\ ... .*\ .\ *  . *#                          #
#                   ###\ .\*.. .. ..  ... .\ *\..   *  .\ ....  *..  * .  ! . .**  .* \ . .*.*... ...  * ***#\.\  *. *\\  .#                           #
#                    ##.\ . \.\  .*.*   .  \***   \.  .. .. ..**.*W *..\.    . .. ..*\..*. . . *.... . . .  ***.\.  .\. #*#                            #
#                   #* *#*\*.  .. !\**. .\\..\. .*.. .*\** *.*.\**.\\ ... .   .* \. .\@\.\     .*\.*...    \...  \*.###.##                             #
#                    # ...*#\ ..\..W**\  * @. *  . . .*.... *W***. .. * *. .\ .  ..*...*..\\. . *... *. *.* . **##.#   #                               #
#                    #\*...**. .\.\**.*..\.. ..\*\.*. !\. ..*..*. . \ ...  .*  *\  . . .   \.* . .  .**\.**.. ..L#*#                                   #
#                   #.#.**#.. .*. ....*..***\.. ..* ***\.\...  * \..@   . ..*. ..*. ** * **. \. . .*...* . # **.##\#                                   #
#                  #. *..*. *.\.\ . .\ * .. . * .  \\..   \** .\  . .. * \ *. .. .** . . .\ *\.  *\*..\*  .*  #*\##                                    #
#                  # ...\.  .* \ . \.. *..* *\.  . ..*.. .... *. *.. **\*  . **** .\    .   \  *.. .*.   ...*.\#*#                                     #
#                   #*. #\ .* *.\ ... *\ *\  *.\..  **\*.**. . \ .. **\ \   **..*\.  *.*\. *...*. . .  #..*#.. ##                                      #
#                    # .... . .  .*   .**. . .\\ \*..\.. ..\   ..* *..... . ... !\....\..**!* \.. .  .*...##\*  #                                      #
#                    # #..*  \*\ . .. **. .. \ .\ .* ..** *..**. .\ .\..* .* @.**....**  ..*\\ . ... **#*#  ####                                       #
#                     ##\#.. ... ..*   .!.* ...*..!. \*.**..**\ .**.. ***\.* *.\   *  *  *\.  \ .** *###.#                                             #
#                    #\ .\**\!.*.... . ..*\ .  ..    . \** .* ! *..* .***....*.. ....\.. *#\*.   \. #.\ ..#                                            #
#                    #@#**#.##..**... * \ .. .* \..\*\!!*  .\ ..\ . \\ .  * ..*  \.*..*.\.#. **\* # * \...#                                            #
#                     ####.\.#  \.. **.\ . ..\. .* ...* .\  ...*\.\   ... .  .\ *. ...\*...\*..*\.. . . ##                                             #
#                     #\\* . .**#*.*.. #..*. .#  .\ .\.\\** *\ **...**. .* .. **.*  \\ ###**.. ..*\  .@#                                               #
#                      ###..\**.\#*\.  #\ .####. \..*  . . *. *.*   *...\*. \ * *.\.... \#*# *\  #.##\#                                                #
#                       #\ \.#. . ###@ ..\***#\#*.  .#**.*.** \..*  \ *\#\#\ \* *#*#\ .\# ##\#*.##*## #                                                #
#                        ##. .\*\ #  ###.*...\. .  \. .\..\....@.# .  #*## ...#.#\..#*##    # .#  #  #                                                 #
#                          ## .*##     #..## #\ #*.  * \**.. .**..\. \#. *## #..##.*##       ##                                                        #
#                          #*\ #        ##  ##**.\ . \ .*.. #.# #\* #\###.##*  *.##.#                                                                  #
#                           #\.#              #\\...  **#*\ ## #\.\ .#   ## .##.#  #                                                                   #
#                            ##                #. #.\!# ####   #* #.#      ##  #                                                                       #
#                                               ###\  #.#      #.*#*#                                                                                  #
#                                                #*. ###        #.##                                                                                   #
#                                                #..\.*#         #                                                                                     #
#                                                 ## *#                                                                                                #
#                                                  #*#                                                                                                 #
########################################################################################################################################################

Water 0
Flooding 0
Waterproof 6
Razors 43
Growth 5
