###################################################################
#. *  *.****.* * .. .*   \.  *.\*.. ...*...  .  .\*\.  \ .*#      #
# ..* .*.*.  . \ **!\***. * .*.*..*.**..**.\. .\.\. \*...**.#     #
#.* **  .* \....*.** ..*  ...\**.*....*\****..   .@* .*.**\# #    #
#\* *...*. *.* \.* .  \.\\    *@ *.\.\...\  .*. *  .. .\..   .#####
# . .*W..\\. *\  .\\.. * .* *\.... \ .  ...... ..\. .  .... L****.#
#* ...  *\.  . *   .**.*\*.\.**** ..\..*.  **.. ..#.\.#\*\##...####
#\  . . .  *. ..  .**\ \ .*  *** @.. *..*\ .* . *\. ..#.#*\\.##   #
# \.\ \.\.***\* \ .\*\..**.*\***. * . \.*R\ ..*\*..\ # #.@ *#     #
###################################################################

Water 0
Flooding 0
Waterproof 17
Razors 14
Growth 7
