###################################################################################################################################################################
#..!..  .\ \. . .  \  *\ ...*..*.**\...**.  \*..   * .W *.. .. . . **..\. \...\  *.\**. . .*\   ** *.. .*\   *.*.*.\ .    . *   . \**  *.*\.* \.. \.!.*...\ .*** .#
#**. . . ! .*@.*. \ *....\ *..\.*\.   \...* \..** \..*.*..** *    ..*..*.*.*. . ..*\ .\.*. .*.*.*\ .*.... . *....\@**  .* \.*  \*..@.\***\ .*   W  * \..   *.\..  #
#.*\*.  ....**\.\*. ..*@** ..  .\*  * .. ..* .\. .W\ .*. **. .  **.\**... *\* \. \  * . .\**! . *.  . \.\.\..... .* . **...*.*.\..\ **..*.... .*\. * .\.* . *.** .#
#*. \ . .\* .........\..** . \ ...\....\.**\ ..*\\.  *. *.\\....\.*....\ *... ..\ *\ ..*  *\@!\*! . ...***  ...*\..   **.  \**.*\*..** .\  .  *...*. **\...  ..*..#
#.**.    W*..  *..* ...\..  *.* \.\ .. .\* .\**.. *. \ \ ..\. . . ..\*  .**...*.* ..*... .\ @  .  *   .*.\*\.  .  . . B**\ .* .\* * .\*\* * \..*  *****.*\*  .  \.#
#...*\.  *.***\. \  *.  .**...**   .*.\*.!\.*.. *..**  \. .*\ . \ \.*  * .. *....*. \ ..  .* *\  ..\*..***  .\. ..*  **\.. \*     \ .....*\*.*.*  .. .\ .W*  . *..#
#\ *. W * \*...*....**.**\. .**.**.  .* *\*... *..\ . *.*\*.   ..* ..  \*.  *.\ *.*.**. \ **    ** ... *.  *  *. *...*.. . **\**. ..  *  .*  ..* *.** *\..... *. .#
# . \.. * ...*.. .\!..\*\ .  *.* .*\.   . .*  \. *\ **.\.\. .\\ \.\ \.\..\...\*..*. ..*\. .\. . \\ ...*.. \..\ .*. . ..* **.*.*..\ \... \*\ .\\. \.*\\...*  * \ *.#
#.\..  ..  .*. .\ .* \ ** .\\*.\ \  . *.*.**. *.. .*! ..** .**...   .  *. ..*.!..*  **. .**\*   .*   .\.*.\  *  .\ \*.\..***.\* .*   .  .\\.. * *...** .*\. \*.**\#
# . . \*  .*..\ .. * . ..**.*.. .. ! ..*.....*.**  . ..*\ ***...*  *.*.\.**.\ *.*.**.*.  .\ . ...* .* . **.* @ \ ......*. . \ .*.*\ .**  *..\.* .  ...\...*  . *..#
#\** \..\ .\*  .*... *  ....***  .   !\..*.\..**.\.\*. .*  \*  *  *\ .*. *  ..* \ .**.**...@   *\...*\* * \.*.  .*@ ..*. \.*  \..... .. !*...\..  . .\.  .\*  ..\.#
#*.. .*   \ . . *!*\ @ .  .*... .* . **.....  .\ *  ... .  ..\...\ *.  *@.\ \   .**.W. *  \. \ .!\ ** . . .*.\  **\ * ..*\.**... ...* !* * .\ * ..   * * .**\*.. \#
#*  \.. ..   ..\.\.* ..*.**.    * * *. \... ...  ..*\. . .*  .  \ .****.**.  \*  ..  ..\  ... . ** \.  . * ...*.*..***. *.*.. *\. .*\  *.\.  .  .\   .\** ..\.\ ..#
#..  *\ *  ..   .. *....** .\ . .*.\..*..* .*. .!  . ...* .\*\* .*. *** . \.**** \.* *.*\..** . .\.**\**.. ***. .  **\.....\...*     .\.    \..  **..*...   * *\.*#
#*. .*..\...\..\  *\* .*  * .  *\.  @...\*.*.\.\.\ .\  .\* \*..  * ....\* ...*!\   . \ . *\*\. *\* **... * ..* .  *.*...* *. **. .*. ..*..  .****...*. \  * *. *  #
# \. ....\ * . .\.. . ..  ** *.**\..\**...\.  \ ....  \ *. .. \*.\. .\. . *.\..*.**\ ...*. * *.*....*...\\. .    ****@ .\ \*.*. * .\ * .*\ * *\*. ....\ **.*. *.. #
#..*. .\***.\ .. ...  ** .\.*\.\* .\ .\  \ \\. *.  .. . .  .  \. .*.*. . *.*  .\.*\ \.. .\..** .. .*!*.\*.. .*\. *....  *..! .....**\. \ **\.. .\   .  *.*.*.\ *. #
#*..** .\.. *.* *..\. .  ** * . .* * ***\. .. *.\. ..*  .\.  ..**\.\.*  .. **  * .. . **...... . \..**..\.\      ... *\**..\    ...  .  *  **   .*  .. * 2*. *.*..#
#** . @ *. *\..* . **.. ..\...W .*\  *. ..\*\..\.*\*.*..  *.*.**...  *.@.  *.  .\  .* ..**. .\.\   .*\* *\..  \..\.*! .  .*  \..\***\** .*.\. *.\*.**\ ..\.\** * *#
#**...*..  \ **. \ *..  . .* **. . \*\***\*....  *..\ * \   *...*  \  * \ *.*..\  .*\* .\.*.. . \*.  ***. ...  .* \ ..\.  * \*.. ..*.*.**\*....*. \ . .*.. *!***.*#
#*.    ..\**. *  \ *...* .\* \. .\..\.**....... ** *. . ..*.*\  . . ..*\ *...***. *.**\..** .....*\ ..\*....  . .*\. .\.. \*.. *.  ....*...\ **.     *.*.*.....  *#
#\. \.*.\.*...** . **. @. ..\.W...* .*\.\ . **!.*.*.. ..\.*.** *  \** .* *.* * . ..\.  \\*W..   ..*. *.*. \  *** ...*\ **..  .**\*. .  *.\. *@...\ . .* \*  * * .\#
#.  .****.* \ .  ***\*.*...*. .*\*.\**!\..\.\..    *. \ ..* .**\.\*. \.* . \ ..\**\.    .*** *..*.*..* *......* \*\ *\.\*..\.. . .@ *  .*. .\* ..\...* *\.. . *.*.#
#.. .\. . .**.. ..\. .\**..*\ ..*. ....    ** ..*  *. * .    ..*   \ .. .\ .** .  *\ *\...**    .\ ..\ .\ *\.\..\.. .* ..* *.*\  \**   *.\  .\.....  ..\*\  ..  !.#
#  . .*\. ..  * \  .\* *...** ... *.\..  . ** .\.   * ...***\*..*.* . * .\   *\  *\    . .\.    * **@  *@*.*  ..*   *.***. ..\ ..***\*.   ...\. .\*\***..**.  ....#
# .  .. ...\  .* *..*\ *  ...   ...\.. ......  *  * \ *... .*\.    \* .*.. .  W  !.*  .    ***.. \** . ... ..**.*\.*.\ \ \\.   * *.**.\ .\. .  ..* .*. *.\*.. .\ *#
#*\ *  ..*\@*..  *!..  * ***@ \...  \ *...*. ..\. \.\*.. ..*** **...  *.\ .... .\ **   **@ *....\.* \!\\ .\.*.\ \  ..* .  *\  .*.*. *..** *\*.. ..  .  .* .\..\.\.#
#*. *\. ....\ \  \\  ..*...*...   \.W\* .   * \..  *.*.   *..\ .. .**  ..*.* *  . .\* .*.@ **   *\* \ . *.!\ *...* ..\    *.....*....*..**\ **. *   . \..  *\* *..#
#.**\   . * . .*..  .  .* *.... .*.**\* *   *..* ...\  .  ....*****.**!\ .\..  \..\..  ..*.*\  \......\*. .  .***. .   *  ..*\ *.*.* @.    ..*\.. *  *.* ....\.\  #
#\...  *  \ ....*. \  *.\\ * ..    .*\.*..  ....*  .** *.   .\. \*. .. \.* .\. .**  \..\  ..** ..*.  * .. .  *.*\..\   \ .. . .\.. . .*.*.* \  . *  *. . *  \..  .#
#.\ \ *.\*  *.\..* ..*. ..\.  \.*. *. .\*  **   ..* .\.*. **. . ...  **.\*\  \  .. *....*..  !. .*  ...    **..\. * .*.. . .\*..    .  ..*.\ . .*.\ .. .*....** ..#
#\.  ..* .. .    .**. \  *..\ ..\..*  .  **\*. .  \@\.\.. \ . .\*.* **.**..@ ... *. .. .. \..  ***.\.* .\ ..*. ** * \.. .  * ....*..!\.. *\   ***..* . *..* .*.\. #
#.\.\*.*\*.*. .. .**\**. \***.**   \*.   . . .\.....  .  .   .\. ****.* . .!  ...* \* *...*..\ \. .* **. .\ .*\.\*..*\ **... .\ .\*\  .. \** \*\W\**  * .\.*. . **#
#*. ..**\\**. .   \   *.. ...*. .\... .\ \* .\. .\ *.*\.***.  *  ....*.\* . .****.... .*\.. **\ \****.\ *.**\\  ** *..*\  . *..*.*\* . .\.\.\.*... .* \   *.** .\*#
#*\   ***..*. ...\  . *...*.... . .  *  \.. .\*. . .\ ..\ ..  ..**\ *..*.*.***\.*. .* .*.\@ ... **..*  *..*  *.*.  *!** * \ .  .  *  \  @..* *\.  \.  ..* . ***\. #
#...*\\..*\* .. ... **. ..*...\.. ..*..*.\ ***.*\ .**.*.\.*.   ...... **\ \**..*\. **. *. *\*\ * .*.\* ..\.\ ....\**.** *. .\. ..... . .**\*.*..\.....  \.*.... \*#
#\.**  .\.*.* * *. .\.. * ..!*  *   ..   ..\..\.\**.\.*\* .  .***.\*\ *.. \..**\ .......**. *.\ * . . *\ *...  .*..**.\ * .  !\** .*\. \. ..*\*. .\ \..   .* \  **#
# *\*   **.**\. . .\   ***\.*! .!\*  . ..\* .* *..*\ .*.. .W**..*\.. .*\  *.. . . ** *  .. ..\ .* .. \*\*.  * **.. . **.. .\   ..\*. . ! \.\ *.!  ..  .*..**.*\ *.#
#*\ *   ...\.. *.  . @. ..* ......\\... * ....*.. **  .*.*\.\.****\.  .*. .*.\. .\..  .* . . *\\.   .   .* .*  \ \..* ..* \.\. . .*\  *...*\. .*.\   .. * *.\. .. #
#*....\ *.**. \.. \  *....* .** .\....... \.*\.....   *.*. . \...\..*  **  .\ .  * .*. . . * ..*.* .*.\* .  *...\.*. *. ..    *   ** . * ...\. .  *. \....\ .*..  #
# . .  \..\.   .. ** \* \** .*.* * .*.\.\ ..\.**\*.. .. .\  **. .*.\@ **\\  . .   .... **\ \..*. \ *. .*.\.**   .*.. ..  . . \ .* .*....*\*.   . *. *.*\. . *\...\#
#.!\.  * .*  *  * .**.\\  *.**\.W*. .\*.*.* .*\... . .  ... \**@ ..  ..\ *\. !..*.  . *..*  * W**...\  . *. ***...**. ..  *. *\.\ . *\*....*. *\  .\....***\..** *#
#*\* . . . \*.  \. *. .. .**...**..\* * **....*  .. ..   ** **\..\.  *** \..\  *\*.\@\.*.\.*.\..* *. .  **.. .. \.***.***@***.... .\*....\ *\*.  . . . * .   ... .#
#*..  *\. .!.\*..\ ..\ .\...\** \**.*\*.*..  .  \*. . \***. ..*\ *.*....**\..****\.. .*.\*. \ \ .* .*..* ..*.\ ..  .\**..*\. **. \..\  \ ***...  * *   . .*@ *\.**#
#*....\.**\...* * \ * * . . * ....  *.\.* *      * . ..\ * .*.* .*\.. \\..  ...\\.. . .\ .*   \  ....\!.. *.. .*    .**  \ . \***.    ...\..\ * * **   .\ .*...*\ #
#**.. .  . *....\*...*  \ . ..!*  *..\ .\.*  ..  \ .  .!@.\...\ .\. *\.  **\  .. ...\  *...\  .\ . . . \ .*  ** .!.  .\  . ...  .**..\.\ .. . . .*.*....*\...\ ! *#
#.. .\.\.  . ...\.@...  .*. .\ W***\ .   .*\.\  .. * **.. .  *..   .**.. .. \. **...\**.   *\*\..* *\ .* ... ..  *.... *  \.* .. *...***...\.  * .**.\ ..* *\ . *.#
#.@   . ..  @ . *. .*.. \** *.****....      .\ .*.... . \\ .\..\.\ .*\ \.*.. *.** ..*** .\.. . * ...*. ... .*  . . .. \....*.\*. *\*****  ** . \. .....*..*\***...#
#..\ *  . *.* \..   \! *.\\.*\***.. \* .* .\*.  ..  \ . . \\*.* . *.* .  .\ .* ... \ .  ***.  *. .\ .*.*..\ .. . .* * **  *. ..... .\.*..*.    *.*! .  ..\  *..   #
#*  *.  . .**   .*....\   6 .**.*\...  .  .*...* *\... . ** .\.@   \ .\.**  ...\**\.**\*\@ *.*..\\.\..\.\.* \  *.  . *\.  . \\.\ .**.*  .\* .\ *  *!    \ * *.* * #
#.. ..*\ \*..  .*.* ..**. * .*...   \*.*.. . .   .. .\  ..    **\ *\. .*.! *** .*. ... **.\..... \*... * \.\.**. *.\...  . . ...\ *.*.*\. . *** ..*   .   \...\ . #
#**   .W\ ..\ ..\ \.  .\* . *...*.*  * . * . ** **.\*  .   * *.*  \  ..*   ..*\  .\   *.**    *. .  .*.\ .*  .* !*.* . \ ..\ .*.!..  .**\.\.\ \\.\.. .\*.\. *\.\ *#
#*.  * .  ...* .\.. *!\.*  ..*\.*\\  W.*.* . .\ \***.**. * .**. *\..\\ .*\. *.. . ..\.**** ** .**.*..***.*  *...\.*. .*.    * * .\ *. .\. .. . \*. **  *..\**..\. #
#* *.*\\ . .@.\ .* *\* \*\*\\W  \*  *.\*\. *.\.\ .*.*.** ***\..  *\  ..*\* .. ..  \  ***.\ .*..*... \.* \   **...\*..\.*..\\.\@\ *\\..   .  .\...** .*\.\  \ ... !#
# *. .   .  ..  *.*\. \. . *.***.** .. *.. *.. .\ .*..  *.*..\  *. *. ..*. *  * .*.  ! *.*  ... ...  \ . .   ....  \....\.W**.*. ..*.*.\ .\  * ..*.*!..  \  .*\W\ #
# ***\.*\\.\...@ .***\ *..\...* .. \**..\ .*... ....*\**** .. * . *\. *\*.*.* .*.\ ..*.*\. .*\  \.* .\ *  ..\..* *     ..*\.  .\*..!. .  * .!\.  . \.*.\.    * **\#
#..*.\..  *. . *  .*W .. ..*. *.* @..* *\\\..\.. \. *\. .\..\ \  ..*. **.*.  *.@@ * \... ... . *.*  .* .\** .*  ..*. .  ****\..*.!.   . ... *.  * \... **..  \W..*#
#..*..\ ..* \... . .* \*\ .   \*! @.\*..* \\ ..*. \ .... *\ . @*\ .. *.*.\  *\.**.. .  .. \.****\.*..*.*.\ ***\ \ *  **.....* *. ..\   .. .\.*. \ .. ***.*  .  \ .#
# . * ..\ . . *\ .  . \. \\..*.*.*.\ *  ...**. \ \  ...*.*    ***... ** ** .   **    .....  * ...\**..*.* .**.....* *.\..\\ .*. . . .*.    *..\.   . ..*..* **..*.#
# \.**  ..*.\*.. \...\.\ ... . *   . **.*.*\ * ...\ **.**  .\* .*  .*.. \..\ . .*.\.*  .\..  . . *. .*\.\ ..*.  .\\**..  *\.*..** *. .   . *\ . .  *. \. ..\\.*\.*#
#\ *\.  \..\.*\ ..*\ ...** \**.. \* **\ *..* ..\.*\\** .... . ...  *.. .  *  **\.*. .  \.  ..*\ *\. .** **.\*. ..  ..\**\ .\.  .*. ***... ..@  .*..    *. *** @. .#
#  .* .. ...\.*.  . \ * .! **.. . \.*..*..*.\.*.\ .\.**\  *** \.* .   **\ *\\..* . \  *.. *\..   *  .\*\... .**. . . *\*!\ .*.*\*\.*...  \ *.*..\*.   .** .\. ..\.#
#..\.** \@. .@.\*..*...@ * \!\.\.* .*\... .. *.  \ .\ *****... ..* *.. \.* *.**  .   .. . \.***\*\.. . ** . .*\ *.*\.. **....\* \ .*.@\ \ \*\   .\.\ *\*.\   *  ..#
#\ \ ..  *!**.*.* \ ..\*. ....  .*\..*\.\*.\*.. .. . .  ...\   *.*..*\..*. *@... * *\\ \ . \.. ..* .*. ..   .*.. .. * .*\ \*.*.. ...\.  .*.*.\.    .\.**..  ** \**#
# *..\ . . * *.....*\. *.* .* * \*@ * *  .* .*\.  .*.* .\.*..  @*...*  ***.......*...\.. \.   *\!.\*.*\  .. .  ..\.*.\.\  ..\\. . .\. .*.. . *.*.  *..\.** !\*.! .#
#... . *. \.... \*\*.*\.\\ . ...... .**!. .\**\.  *. .*** *.** ...\  \ . .\ .   *\. \*. *. .. .*\... ..*** ...\*\..**. .  .\*  \ * .*...*\.*..\.\* \* . .\.**** .*#
#\* ..*.. *\*\...*..  *   ..\ .       !.*  .\.*.** \. ..\..\...... * ...  .**\.  .*.  .\.*\ ..\.*.*. *\\.****.***.\.\.. *..*.* .\* .....*. ..\.  .*  .**.*..\..* .#
# *\!*. \.\*** * *. .*. . ..\    .*  *\\ .*   ..*.*.   *. .*. .* .*\.*\  .*.*.*\. . ..\*..\* * *\ .\*****! @* .\.* .  \.** *.\  .  ..*....\  ****\... ..*..\*...  #
#\..\.**..**\..\* **   \ .  *. ..\.*.. ** ..*\\ .. . **.*\..\  .  \...... . . *. **. * ..\!@ .\.. *.*...\..!..*. . *  .\.*  *....**\\ .\* @. .* *.  ... \... \* \ #
# **.   . \ *\*. ***\..  **...* * *.. *.. .\..*\...*.\*..**\.\* .*.*.\ .. \  ....\.! .  \.*\.** \... .*.\** . *\.  . . .. !.\ \*....*... ! *.\*.\   \. ** *\  .*.\#
# .. \ .  . \*. ...\.\.*..  **. *.\.  @* .***\ *.. *.*.\ ... . \...*\! *.* ...\...\..* *  **. ...\.*. .  ..*\ *.. .  *.   . . .. .  .****  * \.* .*..**..\*. ... *#
#\*.  *.\!. !*.. .. \. .\   \.\    *\ *. \.**  ..  * ..*  !\* *!   . ..\.*  * *.\    !* *.\*\.   .*.*.  .**.  .\ .* . *  .... \.*\.  *..* *. .\*  \.\.\.\***.\*\ \#
#.* .*.* .* ..*\  ..*.  ..\ .  ....*\..\*..*\..**  .*.\* \*.  . *.**  .\. \**\.. .**.@..\ \C*\ .* . . \.. .  .*.. .\.\.\\. . . *..*.*\*  !***  \.\.*  *  *..\.* .*#
#.* ...\...  *....****.\\*\*  **** * \* ..*..*.**. .\.*..** *\. * ..**\ **.* \ ..\\...\ ..\....\* . ...*.\* *** .*\*  \. * *.\..\ ... .  *..*.*.. ..\ .\.\.   *. .#
#*  ....\  . .. *..*...\. ..... \. * *\!  **\.\..**..\.\*.. .**. .*!**!..* ....\\.    . *** .   **.\ *. *...\..\*.! .*.. .*.. ..*@*\ . !.\**..** . .*\ . .   .* . #
#. ..** . . ..*.*.*. .....*\ * *@  **!\.* \.*  .. *.\ !..  \...\.\\*.**\*.**   *.\.\*\ \.\.    .**.\  *.* \..  @W\.*\\. *\*\  *\* ...  ..*..  ..** * * \.  * *** *#
#*.*....  .** *\*\.*.  *  ...***.. .**.** .*..* * .* . **. .\!\..**@..***... .\ \.. *  .*.*\  .**\ . *W\...** .*..* ..* ... .   *\.*\ .\...* .. . . .. *.  **..*\.#
#..*\.*.  \..*.... .\... *. ..@ . ** .**\*\*.\.* ***   ..\.\ *.  *\.. ...*\ * . .. *\ *.\.. .. . *\ .. *.  \.*\.\ . *. .. *@.   ** .*\\!.*.*  \\ ** .  \. *\.*.. *#
# ..*\.. .. ...**..* .\  *  . . \@...* . ..\  *..*.. *..*..**.\  .. .*.\ .*.*..   ...\  .*\  \* *@.*. ..*...**.* \* \.. ..*. ... *  .*\.\..\*\.\... \  . .\**\. ..#
#.. ...* .* .  \* ** ..*\***\ * *.   *.*..\ .** *..*@*\*... *\..\ .* .. . .\\....\ .**   . ....***.* *\.. . !\* .....***.*    *  * . \.\ .*.*  .. .\.\.* * .. *.\.#
#. ... .. ***...\.  \ .\*\*.  .....\...*..W .  \.\ .*...*\*. .   .. \. *\ ..\*\. ..*.. .***\* \..  \..**\. \!.*.\.. *.* ..\.* .* *..\ **. *.. *\* . \*\. ...* **.*#
# \ \ **. \..\* ..*R..*.* . \\**\ *   **...... ....*.\  .*\ .*.*.  ..\..    *\.*.\...*\.\*. . .**..  *..***.. .\* @\ .. . *. *!.  \  \.*\ .*...*...\.*..*....\*. .#
#.... \\\* ****\ ..  \ *..\   *...\...* **   .*..\.\  . .*.. . . \\ .*  *.* **.\.... . . .*..* *.*. ...  \*. .. . .**. ....\... \*.@W.\.*\.  *.** \* \ * .*  .*.\.#
#**   .*.. **..  *  *.*..\\ .\*..  ***\*.\ . .. *.*. . . **\ *@.*.*.\*  . . .***  ...\.   .\ *..*. \.*. . . . **.***...*\ .   *..* ..  .***\ .\.*\.**...  \ .. .\*#
# . ....*.* ...**.\ *.* \.*.* ** .*... .. .\@* ***!*  .* \..\ . . .. ..\*.\ \ *.\.. *  .*.  .  .*...  . \.*  .*** \. *.\   @ \* *. . \*\.\.  ..\.* ... . ** *. .. #
#    ...*.. \   \ * . *\.\* ***\  *. * *.\. ......\. *..*  *.\  ... . **..*\* .* \ *.  .*.\..** !..*.* ..*.\. .....**\.*\. * .*... .  .*\. \.\  **.**. \ *\..\ .* #
# . \ \.*.* .. *.*. .*..*...*.. \*.\.* ..   . . .  ..**..  .. .\*.*\ .\* .. . !*.  \ .* ...*... \  *....**\*\ *.\.**..*. ... \ *.  * !  !* *... .*\..*..*@* ..  \*#
#*  * .\...   *\.\*. ***. .**.\*\.\ .*...*\*. \ \. .\...* .. ..*..\ ...\!.\. .     .\ *!.*...@....\.*..\.\......  !\ .!  \.*\ *. \*\ ..*.  .\.\   \. *. *\\*\  \.*#
#......*\.*  *.. ...*\  . *\.\..... *. . .*. * ..**\*.! .*\*..\*. .  ..*.*****.  \* *. ..**.\.\!  ..*\*\ .. .* . \ \ .\... .\ ..*** . *\.*.*  . . . ..* ..*...*...#
#\  *  ....*...\* . ... * .. .*\ .*.*\*\  * .\ * *\.....*\.... .  .  *..  *  .*.\ .*..\ ***\ \ \ . \  *.@   ..*....\\...  .\  .**.*  .  *. . *  **\*..\.\**  *.*  #
#\  \     \..... * @. \\..  \* * *  .*..*..*.*\**  . A. . .... *. * \ ...@.@.  .**...\. *  ***..**..**..*.\. \ .    .\ . \ .\*. ..* *** .* ...  ..*.\  \*..\...   #
#**. . ** .\ \ \  .\... *.*. .*.*  * .\... \.*..* ..***  . *. ..\.\ .\  **\.*\    .\.  *.   .*  *\*\.*\... *\.. .\ **..  ***....  ..*..* *  *  .. . * **.*. .\*\\.#
#..*\   ..*... .\.*    *..*..*\ *. \. .\   .W. \. *\ ..  ..*... . *  .. * *.. * ..* \ \.\*.*\* *.\.\ * .\  .. .*..** .* W**.\ .* . *....\.* .\*.. @.. .! .*  .* **#
#  *.*** .....*.*.\ \*... . *..  .\.**..**..**\. *.*. .*.... \\*\ \.*.**.  .  *   .  ...\..  \ .*   \.** * .  ....* *\.. ***   . ..*    ....\*.*.  .\..*..\    **.#
#  .* . .\\ * ...  *...  \. ....\ . *.* .. ... ..*. *.*..\ .. .*.. .. ..** * *.*. \.*\ .*.  . .* .* .*.\..   . **.**.*** \.. \.*! \* *\*  .\ **.\.\..\.. **.\\ ##*#
#..*..*.  .. .. *\..  \. . *  ** **.  ..*  *\.\*\** ..* *.\ ** .*  ..  ....\.. *\ .\.*.*..*.*.@.. ***.. **!... ..*....**\  .  .*. *. * **\ *\*.*. ..\*.. *.*.\*.  #
#  ..*\. \ *.  .. *@*\ .\\..\..**.\**.. ..** \ ...\\. **   .\*. . .\  *. .\ *..\  *.*. .*\* *.*\...*\..\..****  .*** ..@.*..  \.\... . .*... \*..  * *** .** .\.# #
#   .. \.. * ***.  ..\* .@. . ***\ . **.* .***\. **.* .. \*. .*  *.*. *\\*...\..\***.*. ...*.\** . *.*! . .\.\*  \....*..*..* ...!  .*\.**. *... ..* ... **   ..###
#  \* ..\*\.*W\ \*\. .   ..**\..*. .@ . @\  ..@. .\ . *.  ..  .**.@ \*\*.*.\   ..\ \*. @ * W\*.* . .\.*    . .*. .*\. .\   \!\ ..*. ***\.\.*\W.\ *\..\ . .   . .# #
# ...** .*.* \.  . * \ .*..**  ..*\.*.* ..\*.* . **      * \.  .. . *.  ** .. .  .. ** \.*\. *.* . *! .*. \ \. ..*!  .*  *\   \ \**.  \\. .. *..*.*.. .\  \*.\ *\##
#..   .. .\*\ ..  ..*!\ .  ..  ** *.. \\.*.* .  ...*.*\ \. .\ ...\*\.* ...   ..  * ..! . .  .. .   .\.*\*..*..\... .* \.\ ***   .***\* ** \ .\ ...\.  ..! ..\.*#..#
#.\   *\ \. **\.\*. . !.*** \\..* ... *\*  * \  \\ \*.. !*. . . .\...\.*  \ . .  \ * *. . .  .\ . .   .\. .* ** .\.. .! ...**.*.***...\.*. .\   .\.*.  ***\  *.*\*#
#.   *.  .*....**.   . **.. ** *      *****..  **. .  ** . .*.!  \.\.. .\ ..**  .\.  .*.*  \ \..\*\***..* ... .\*  .   * \..** .*..  *. **. . .*.. *\     *. * * .#
#   .. \**\. ....*.* \*.. . *..* .\. .... ...  .\  \ . .\ .*  .\.   **     ..... !*. ..\  . \.*.. @. **.  *..  ..*. \  . .  ...  .  .* \.*... ...*  ..\. .*  #. ..#
#\.*... *.*  .\.*..  .*..\\**...*   *.\*** W...   ..\\ \** .*...\.* *.* . .*\@* .*. .* .*\**..**.**\ * ..*.\*.*.\. ... \ *  ***.. .*..   . *  \*.**  .. \ * *.. . #
#..***.*. . .\ *.  \  . \. *.\ *\*. \\**.  *.**\*\.*. ... .... .*..**\.*. *.*.. *.  \..!.   . . ..\  . *....\.\... *.   .. \ .  * *. \.**.\.\  *.\*.*\...*\ ..\.  #
#\\* ..*.*** . *..  . \.\ \ @\.**\ \..**   !. ..* *.\ . * .  ***..*.  ..  \... *. .\ .\ \ .* .**. *\  *  ....** .\*\**  *\*.* . *  ...\.@*.\*....*\.\.\  ..*\.  \.#
#**    .*.*** \. .\ .\. *  .*. **...* \. * .\*\ .!.*. ..*\ **\.\.*..\   ... !\..*..*.\.\.\...**\ .  . . .*** .. ...**. \. *.* \ . . *\.*\. \*  *  **.*..*\ *.\ .**#
# \.\*.\..**.\.   .*\ *. . .\\.**.\..*\  . \ ..\ .\.\..\. * \.. *.\.*.. . . *.*. .. ***.\..\*..*... .. .  .*. *.\\!... . .. . .\ .* .. .!  .\. *  ...\*... *\.\#**#
# .*..*.* \. * \*  ...\\ .\.   ... \ .\ *\*.*.*.\ ..*. . .!       . .*..*\. . \.*  **\  . . \.*.\  * .\*  ..\   .*.***  \         *\* *\!\. . ** ..*.. .**\ ....###
#  .*.\ . . .*  .*\ .. \*. * ..*. .. **.. *.. *. .... \..*...*..* \. **.. . \..\!.\*. \* *@....*. ...\ *. . ..**.. \*.  W.\*.\.  ..*. *..   * .\ *\.*..*. \.\..*# #
# * .*  .. ** \. .. . . .*.\ .\.  **. .@ *.* .. .\.  *.* *\   . .. ...   \ \ ..*   ..*.*\*. ***. .*\.*  . ...8...  *.\  .*..\....  .* .. . \. *..*.*.* .   \. \#  #
#\.*.*\..\  ..   .\\ . .   ..   .*. .\\. **. .**   * . .*. . .  .\. *.*. *  ..*. *.*.. ...@.\* ..   *\\ .* **  .  .\* *..\ \.  ......\ \\**.*..  .**!* \ *.... *# #
#  .. .  .@ . @. *. \. *** \*.@.*.** \\  **. .*.. ..*. \. *@. ! \.  .\.*..\. .\..* . .*..*\ **.  *  ...*.**.. .* .*.\***  .**. ..*\. .. *\*.** . .** .. ....  .\.##
#.* \ ....*. .* *.\ ... \ \..\ *!.*.**\..*\ . .\. \.\  . .\***. ...  . !.   .*...@. \*..... **.*.***.**. \  \. .  *.* .*  \.** \ .. ** ...*.  ***\ .\*.* . .\ \**##
#. **\*\  . . . .*\*. *   *. ..*. \... ... *.. **.. .. \  * .\.* \..\*.* * **..* \.  .*. .* ...*\.*\*..*.*.**!\ **\.*  . .**.!  \*.... .. . \*.. *..*   . *#*.\## #
#\....* @.\   *.*. \**\. *** *.*. .\**.\*  .*..*!.*\*!.. \..\* \*. \.\ \....\.\ ... * @\***..* .. ...* . \ .. . *....   *........**.  *.***\...\**\..\.*.#.*  #   #
# \   . ..! \.... ..** * *.......\ . ***.\.... . .****   .* *. .* @.   ..\. ..*  ** ....\\.\.**\ .....\* .  \.\.W*.* .*...\\*\*.*. \*!\ * .**  .**. * .*\#..\#    #
#. *\*\.*\. .   \..* \ * \ !*. *  ** ... .     .\ ... \  *...* W*.**\.\ . .\ .*.***. .  ....*.\ ****.  ...\  *. .\ .  . .* *.**.    .\ *\.*.. . .*...*. ##**#     #
# ..*\...  *D....*.. . \.. ...* \.*.*.*...\ \.. .* \* \.   .*.*.... .*.\*\.  .. *.*\ \*..**... *.  .*.. *.. ..     *.. . ..*.\* .* **.*...**. ..  .\ #*..#\#      #
#\\.\.\*\**...*.*** \  . . \.\..*..*\ ... *\.@  *.\ ! ...\*....*\\ \ . *\..\  ..\   *  *.*\.*  ...*\*..*.**  **  .  \\\ *\ ..\. * *.*.  .\.. ...\ \.....\##       #
#* .**...  **W.\..* . **  . ***W*\ ** .\\ . *\*.* .\ .  \.*.\....*   *.* .\ *\ * ***..  *.@..  **.* *\ * *.....\.*\ .* *.. . .*\.\   .**..**** .  ..\ .*#         #
#. *.    .** .\*\* \*\.* .* ... .. \.** .. *..*.  ..***\.\*.\ @* *\  .*  ! *  ..\* *\ . * .*\ ..\*..*.\.....  .  ...\**.\...... . **  *.*. . \.. \*..#*.#         #
#..\   ....\ **\..* **\.. * .   **.***.*... \*.**  \**. . *.*.. . . * .  * ..\ *  **. *..  .\.*\ *.* ..  ...*.. \.. ...* .\..\  ***** ..****. *  *##@\#*#         #
# \ **\    *.*.*\***...\. *  *\ ..\..\\ . . .*\.*  ...*. *. ** *....... \!..*.**.*.\ .\.* ..  .\ .*.*. * .*\*.\.\**\\  ..\..  .**..* .. \ *.*.\... .#.#*#         #
#*...\*..  \.\.*...\\.*  .. \*... *    *.\.. . .. *..\.  .**.\..***\*\\.. .*...\.W.\\\.\..*.\ ... .\.. ..***.\...*  *.*   *. *...*.. *. . .*. .*\ * ## #          #
#.\\ ..* ....  \. \.\..\.*  ...\*\*.\. ..* *\* .. ..\   *.\. \.. .\* *. *  *.\* **!* ..    . *. .  *  **.\*. . *.  ....  *.!\*.*.*.*\ .*\.. .*\.##.#              #
#*.*******\.  *.\..*  .*... *  .. ...    * .*. . .\   . \  *   .\**.*.\ .**** . *..*  @ *\.. *. *...\....\*.\... \. ...*\.*..**...**..\*.\... .\ . #              #
#.**..\.. . . \  . .*\*...*..\**.**  \* .. \...*  *\  ... ..@\*.\*. .*. \....   .\*\ . \4 \  . !.***!.!\\.. .!* *\ .** \*..**. \*\*.*  *\ * .* * **##             #
# *.\ ..\.\*\ *. \\ *.*\ .. \ *. ** .. \*\   *.. .  *\*. *.\\.. .. ...* . \.  .*  ..*.. *  \* ****.\* ...  * \. \*@ ...*.\*.. *  *.. \ . ... **. ..*.#            #
#*.\ . . .**..*\* * **\.. . . .*.\**. .***.  .   *.   ..*.*\..... \..*.@.\.    ** .  ....**.* * \. **..\*\ \ . \ .*.*\ !\..*  *. \.*.!**\. ...*\ .  #             #
#.* **** .*\.... ** **...\!.  .*\..\..*\. * \. ...  **\ \ ..\ * .. **\ . ...\.*..   .\* .**.*\.*..\...\.. \.\\..\...!  ... .\*.\\\ **..* *\ \..*\. @#             #
#\\ *. \*.***\ ***  ****.**  ..** ..\**.* ...*. !   .. *..\\** . \ *.  *.*.*. * *. *\ *  \ . ... ..\.*  \..\.** *   \..@**.\.*\.*.\***\...*..**\*\..#             #
# ..  ....\ \ .*.\. \....******.\.*.*..*.\ **.*W. *..*\*..**.*. * .*.**.....*.\*  ..*  . ..  *.*.\\*\.    * **.\..     *.... .@..  . \  ..\.*#.*.  #              #
#..\..* .    . * .....*....***.\.*\ .. *\  \..  . .\ *.***.*.\ .. W..**\ . .*..* ** . . \ .\*..*.. . .*.@W.*. *  ..\.* .  .\**. . \ ...* \ \.#.# .*#              #
#* ...*.\  . . .. * .*.\   ... \..*.*\ \*.... *.. .  .. ** ..      . !. * ...\....\.\  . . *  ..   *\.\.   * \.*\  .*..  . . . ... **...# ..##!.###               #
#* ** * .    \ \.  \ .....  .\. \  *.. .* \**\..*      **. @ ......**\. \..   *\\.. *  *.. .\! \\*...*   *@. .**.*   *.\**\ ..\.* .\.\.\. ##  ##                  #
#. *... **  . . . @..*...*.. ...*..\ .\.\  .\..\...... *.. *\* \   .*.... ....**** .. *\*.   *\. *.* *.... \.** *.*  ...**@ ...  \ ..!\   . #                     #
#.*\. \**\ **. *..\*\*\ *.*\.\***..  ..\\* .*...\ * .\.\.... ** \*...*\. * .* . ... * \ !***.* ..* .*.\ .  .W **.**\......*. **..\* *.# \ *@*#                    #
#.* * *!.  ***\.   .** *\.*.*..*  *\\ *. . .. !.. * .... * *..*. *  \. *..*..  \! \ *..**.   ..  .\..\.** *\ *\*.... . ..  . ** ..  * .*.*#*#                     #
#.... *.  . *.*.  .  . \.** * \. .  *\. @ .... .* .  .*    . .***. .*\...*. .\*. .*** \ .*\**. \*. *\ \*.  *...\   \.  ..  . *..*. .\ .. \.. #                    #
#.*\\ **..  .*...\\ .*. \..\   . .\...\.* \*.*. .* .**\*\\.*  \.\..**    . *  ..* *..\..*\ ...*.* ... *. .**. ..      ..  .. .. .  ...**  ..\#                    #
#\\   ..\**\.\.*\* .  ** .\  *** \ *...*. .. ** \.. .* ..  . ...   \**... .. ..\.  *...\\ \. .. . .   *  ... . .*..*\.*.* .** ..\.\ *.*. . ##                     #
#.* . *...#.\** ..\ ..\.* .*  \.\.**. ****.....*..\**. .*. *\.*\* * *\*\. .*. \.\ *..*\*.. ..  *... .*....**. ..\.*.* \.. \.. .\*.* **\** \ *#                    #
##...*.\*\.\ ... \**..  .\ *. .*. .\... .*\* ** .....*.. *.*.*...***\ . *\ *..*.  *\...\* **. **.\ ..\.\*\. .    . ..*.*. .   \. \. ....\.*##                     #
##.* .* * ..*\* ..*\. \.***.  \*. *. \  *. .... ....  \  .   ..*.\. .** ....  .*.\* . . ...* .*.  *..  ... *  * .. .**** *..\. \  **   ..   #                     #
##\*\* *.*.\.***..@.******** \.**.\.*.\.\.  ***..* ..@@*.  .   .\   **.*\*.\*\ ** .   .* .\.\. \. \.!W*..  .  *..    .**..*\.\\. ... ###\. #                      #
# #**#*.*\..*..* @...*.... * .*.*\.*.. *.  .. .. *.**.\. **\ *.  *\ .\. .** * .\...   **  \*.*. *.....\.* *\\ .*.\** *\.  . *\   \.* ..*.. #                      #
#  # ** ... ***. .\.* *\ *\  @..** . ......*\.**.*.. . .*. *..\ **.\ .*. ..*  \.**  *  .* ..  .\ . \  .***\  . ..*...*  .\  . \ \..*.*.# #*#                      #
# # ..*#. . .*.*.  *....... .\ ..**. ***.\ \ \.\**.* * * ..***.**** *   * ..\*.... .*.\*\.*...   .*..\.*...  .*.\   *. \..*.. .  ..* **..\#                       #
#  ##\  #* ...\    *... \\\ \ \ *.. ....****..  ***\\. \  \.*   **. *.. **. .*   .  *...  .*. .\  ...  . ....*.**.  #\\# ..***.\*  .*.*  .#                       #
#    ###\ .*......** *   . ..\ .. ..* .\...*. ...*  ..\... .*\ * \* .   *\ *\*.\*.  **........* *\  .\ ..\ * ..\\*\.*..\.\*..*. . #\.  . .#                       #
#     # ##* \\#*\**  .\* *..**\ \  .\\*..@.\*\ .\.  \ ...\.  . .  .\* .. .*\.* .. . ..   .\.\   .W.\  * \. \. \.*#.*\# ..*. *#*..\..** \.#                        #
#    #.#\.*\.. . .\  . . *\*.\*\   \  .    . . \ . .  * .*. . ***.*..*.\ \**\* ***.* .* *\ @..* \   .\**..** \.*** .. \ .\ *# #  ### #*##                         #
#   # . **   \ @ * *\*. *..  .   .\... .  .\..*..* .. .. *..* \*     .#.   .** *   * **.**.**....* \\*.*. ..*.*... *. \ .#*#   ##   # #                           #
#    #. #. * *.. ... .* *..**\* * ** *.* *  . \.**. .*\.   *\....   *!... .*.\.\.**.#..\.. \\* * .*.....*. ...*.#  *. *## #                                       #
#     #*#  *..***.   .* \. \*.*\ .*.    . \. \. !.. ... .\.... . ....@*!.. *.\*...*.*..W*   .*.* \..* .\\ \*..*\ \ .  .*#                                         #
#      # ##.\  ..   \ . .*.....*  *\. **.* ***  **.*.*  * . ...*\  **..  **....*\..\..* .... .*.\ ..  #*\ .....   . ..*.#                                         #
#         #..* ..    \.\ ****.#\  *..\\  *\*...  #\*  \*.\.. \\W. .\.. *.*.\*. .**\*..* \*\. * . .*.\ .**.\*\.##\  ###.#                                          #
#        #..\..  #....\*..**. #*. *@ ..\\\ .\    . .\ . . #@  .# . *.**. . ... .*.. * .* .**...*. \* . **  .#\.#*.*#  #                                           #
#         #####.. W  \. .#**.\ #\*.*...\.\ ***\*...\ . ..*#** .** *...* . . *\ *..*.. \. \.  *\.#..\  *#\.. . ##*##                                               #
#             #  *\   . . * *# #**.*..\ \*...**. .\##... ***\.*.#.\. .****  .**. \* \*# * \ *\****.*#\ .#.#...# #                                                 #
#            # ...#.*  . .. *\  #**..* # * *..*...#.##.  ..\...*#*.*. .#** #\.\#...\.** **  \.\*.W .** ***..##                                                    #
#             # * .*.@..\* ###*. *.**.* \.\. .#\****.*...\ .*.## ..# .##\*# !.. .\\ #.!!.\ .* .* . # ####*##                                                      #
#             #.#**##*.*   #  ##*. #\ !*\*#\##*\*.... \#**. \##*.*##.#  ##.\* \...\.*#\**#### ..# \##   #\#                                                       #
#              # ##  #*#* #     ## #* ##**\#  ##*. # . \.#\\#  #\#  #   ####* # *  .# .#..### #**.#     #*#                                                       #
#                   #.*.##     #\.\ #**####     ####.#*## #\#   #      # ..\. #\. **.###*##  !. ##       #                                                        #
#                    #\ #       ##*# #.#         #\...#    #            ##\## #.\##\*#  # # . .*#                                                                 #
#                     ##          #   #           # *#                   #.# # ##  #*#    #\####                                                                  #
#                                                  ##                     #         #     #*L                                                                     #
###################################################################################################################################################################

Water 154
Flooding 6
Waterproof 16
Razors 44
Growth 26
Trampoline A targets 6
Trampoline C targets 2
Trampoline B targets 4
Trampoline D targets 8