###################################
#  ##      #\#                    #
### .#     #*.#                   #
# ...*## #  #.#                   #
#\.\ \\ #.###**##### ##           #
#* .\.. #.#.\.* \ *\#  #     ##   #
#\ ..*** .\ . \.. .#W\###   #**#  #
#..  *  .\#*. # * \ *..\.## #*#   #
#\.... .####... \.. ..*\.. ##\#   #
#  ..\  *#.*.  .*.   .\..* .\*.#  #
#*.  *.8  .**.*...#** * ** ###@#  #
#\    . .   ... .  #\ .....*\##   #
#*.. \. *\!.......**.\***.\.#     #
#****..\\\. * * *  . ..4..** #    #
#..*.**   ...\. *.   ..@  .** # # #
# ... ..  ** .\\*.**\**.\.\*. ##.##
#* .. .**.. ... .  . *. .  . *..\##
#\* *....R.*.. . ..*.\  #\** #.L###
#..**.\*\.**\ ..**.\ .. ...*#  .\C#
#*...**.  H.. * ...*.\ \ ...\*\*W##
#5*2\ . .* .\... \.\.*  .**..\.\*.#
# **.\*. \.  .* *.  .. *  *.*. ####
# .. ..\.. . ..*.  \. **\ . ...*#.#
#     *  \.  !\*..\..**.. ** *.#*\#
#\ **.\ \.* . *  .*.\ ... . **.**.#
# **\@... ... . .*...\ . .*..** . #
#..\..@*. \. . *..**. ..G**\.*.##*#
#\ **\.  *..@*.*. ..* *\*... .*\.##
#.*....A*@. .*.\  .. *\*\**\...*  #
#..*\ .\\....*. *  * .F.. . *\ . \#
#.*\! !\*\  \\  . .\. .\ .\ ** ...#
#*..   .* .\**. *. .\  *** .... ..#
#*.*\*\*B**..\  .*\ *  . ****\.. .#
#*.\....**.*.*\ @*. .   *..*.* ** #
#\\...\..** .*  *.\W\ . .  *W...  #
#.*  * .\..* .*\ ..* . \ . *. *...#
# \ .. . *6.*.*. .  .* .* .. .! *.#
#..*.* **.. . .  ..  .\ *  **\..#.#
#7 *\**\@ . .*.*\* \D*. E...** \\##
#.*  ***.*\*...** *\..  **\*\...  #
###################################

Water 2
Flooding 5
Waterproof 14
Razors 16
Growth 10
Trampoline A targets 5
Trampoline C targets 4
Trampoline B targets 7
Trampoline E targets 2
Trampoline D targets 6
Trampoline G targets 4
Trampoline F targets 8
Trampoline H targets 6