#########################
# L.\ # .#*  .*#* ** \\ #
##.  .**  **.*\..  . .  #
##* #\\*. .****\R.****..#
#\.\..\.*.....\..\\.*.. #
#########################