#########################################
#. *\**\*\ *..\ \.  ... .. *.\* \.*.\ .*#
#. ..\  \ *.  .*.*\ **\ .*   .  .*. ..*.#
#\..\  ...**   * .**.*  \.* .  *.\ . *.\#
#*\ .@\ . \.\*\.\ *.\..*.\.  * .\..* ...#
#*.*\.\. \ ***..*  @*....***. ..*\ \....#
#.* .  . \...\.\ . ***.. ..  .*\   . ...#
#*.   *. .*   .. ....*. .*    .*\* \.  *#
#@*.****. . .. *.* \.*. .*\ . ..*.\**\ *#
#.**....\..* . \ ... *.\*.. **  .. . .. #
# ..*.* !. .. \.\* . .\ . ***\.\.. .. *\#
#**\  !**..  ..\** *. ..***.. ...\ .  . #
#**.. \.*..\ \* .. ..  *. *..  * ..*.*  #
#*.**\.. .*\.  ..\ *. \.....   .. ..*.\*#
#*.... .* ...  ...*  !\... \**. @***.\*.#
#\*\. *.**  *.\  .. *  .\\  . *\@. \ ..*#
# \.. \... .\*. \ **. .*.\ .*\*..*  *. .#
# .*\*.*  ....\.  * *\  .*. .*\...*\\ .*#
#.\..*      *.** ..*\*.* .  \**\* *..  *#
#  ...*  \**\\...\** W .  \..  *\  \ .*.#
#*\*.*.\ ..**\ .\ ..*     . .**.*** \*.*#
#...*. *\.*.\\ \..  \* .!\ . *.* *** . .#
#**\.. ..     ..* . .\***\. .\ .\.*. *..#
#*..**.\\ .*..   . *\*\..  *** \.*.  *  #
#*..*\\  * * . * .*\\..*..*.!*\. ..\.\ *#
#\\**\.  \ *\ *.*\.  ...\.\...* * .****\#
#.**.*. . .\!.\. ...* *. *.. ....!\.\.**#
# ..  . .****..**.  *\..*.. \*   ......*#
# ..** . .*.. **  \..* ..!*  *** . ..\ .#
# \\... * \ * . . . ...  .* ..***. .* .*#
#.  .\*  ...*  *.** *   *.\.\. .\*\ . ..#
#.** .\  W* * *.\ *\... W\ \   ..*. \ *\#
#. .**!**\..*** * .* *. .  .*   \*.\ *\.#
#....*...*. . \.*.*.....***\*..\. *. \*.#
#..  *.  *\.\.  ..*.  .\..  W*... ..  *\#
#.\.* \ .*.\ * .  .@ * R*\* *. ..  ..   #
#**\**   *.. * *.\ \ . *.*.\     .   ...#
#*. .... \.\..\. **** .*..* **   *.  \.\#
#. .** * ..* ..\ \.... . .\ ..**.   . **#
#*...*.   .... .\..*\ * \ *. \..*. * \..#
#.. \.\ .  .. .  .*\. \ .***.  \  .**  .#
#\*\...*  .!* .. .\  ...\ \ * *.@*..*.. #
#. ..\**..\ *\  .  ..\ *. . . . .*.!\ ..#
#.*\. .\. .\**\\.. \ . .\. *  \\. .**. *#
#*.\ *.@*.* . .\ * .*\..*  .  ..* *.  \!#
#**\\ *... \ .*...\  .. ..* * \ ..\.***.#
#*@.  \.*.....#\.   . .\* .**.* *. ** * #
#*.*. .\.  . \* *  .*   *..\  .*! ..  **#
#.\   .. *.**..**\*.** .* ** *..  *\.**.#
#..*     .**\.*\* ..\*.*.**.... * .. .. #
#**....*. .\..*   .  *!.\**   *\* . . \.#
# .\.. .  *..*.  **.  .* .*.*  *........#
# . **\ *\*.W** *\ . *    . ....\   \.* #
#\..*\ *.. ..\.  . .\.*..   *\*\*.\\..*.#
# * \ \\*. \  *... \. .*\.\ .  .*.....\.#
#*.\  * .. . *..\\.. .. *\   .\ **  \*.*#
#\.  . !**   \#**##*\*\.*#  \** ..\ .#. #
#\.\*.*.*.. **##..##\ ## \  .!\\.. *....#
# \. .\.*   **# #\# #.# *.#\.. #\*\. .#\#
# .* *#  .  \#   #   ##\.\* \**.... . # #
# .***!\..## #         #.#.*.*.#*. *\*###
#. *#\@.  *##           ## .##*##\.@##  #
#  . \\\# *#              ##  ##*. ##   #
##. .... #\#                   #*....#  #
# # \.*.* .#                    #\###   #
#  #####. #                     # #     #
#    #..*#L                      #      #
#    #. .**#                            #
#     ##* #                             #
#      #@#                              #
#########################################

Water 0
Flooding 0
Waterproof 5
Razors 43
Growth 37
