###############################################################
#. .  \.\ .* \*....*. . * * \*.**\\*.\.*..\\*.... \. \..\..* *#
#. .. \.  .*. ... .     . .\....\. *.  .  .\..*  .   * .. \.\*#
# \ *   .\.  *\.   *. ** .\ \ \ \ *.... * .  .. .\ ****  .... #
#\ **  \**\ .\..*.*!**@.. *\\. *  . .**@* .\    *  . ..  \ * .#
# ...*  ...* ...*  *.. *.*  \*\..* **..*\  .*  .*.... .*.*.. *#
#.*\.* \.\**    *. *.\.. . @...  .*\. *..*.** .*....* *.@.* ..#
#\  *..\.** \..**  ****\\.*... **.. \..***... .. *\*. \....*\ #
# *... . \. \. .\   .\..* *. ....  ** \ *..  \. ...\.*\\..\* .#
#\..* \...**.\ *.**\  . . *\..*..\.** ...*\ *  . \\. @!.\.*.\ #
#\ ..\. . . * . *.  .*\  *.* .\...* .*\.\.  ..* *.. *\*....\*\#
#.\...* *.\....******   *!.*  . ***.\*.\   *\ * . .**.\\.* .  #
#*.*\ *.*\.  \ ..\..  .\* .***\..\ \.... *.*.\.    *.  ... * *#
#.\ ...*. . . *  * *..\**. *\ \...*..\.*\  .*.*..  *. * .*\. *#
#   *.  \ *  *...\  *. **\ @.... .* ..*.* @...\*..* .  **..  \#
#*@..\.*@ .  .*.*  *\. ..**\*****\.  \** *.*\...\\. \....*\  .#
#\. * ...  .  .*   ***.\.!.. .*\.**..... . ..\\.  *\..\  *  **#
#...\   .\*   *. *\*\.\*.\..*.*....*....* **.**. @..* **\.*.\.#
#* .*.*.*   *\*...*\*\.\.  *. .* \.*.  * ......* \. **\..**.\.#
#. ..*\.*. . *. . *\.  ..*... .. \**..\**.. ..\* .\*.**. \.\*.#
# *\** **\@ *. .\* .\.**.\. *. *\ . \\ \. * *\*.\.*. ..* . ***#
# \ .. *.*.\.....***. .*.*\..\...  *  \ *.. .*\ \ **  * ** *. #
#*.*   . .  *\ .*  .\.@.*\. .  *..*.*\...*.. * .. ..\ *\ .*. *#
#* *.\ **..*...** ..  ..*\ ****W.*!*.  *\*  .. *\ *.***.\ *.**#
#* ..*.\ .*\*.\....*...\. *.*W* *\..**  ....!*\.*.\**..* .*.\*#
#\.\....*@\..***\ \.*...  * *...*  .\.\*\\....  ...  .\..* .*.#
#.   * .*..**.\@\..*...* **..\  ..  * * .* .* .**.\. .****..**#
# . .*  *..  *.*.*.... . .**.. . \  ..*  .**.\.@\ . *\* **.@*.#
#**  ..\. *\ .** .  *  * ..**.  *. . .. . .\. . ...\.*..*. . .#
#\....\..* !. *@.\\\*\.\ ***!... ..\*.... .   *\.***\*. . . . #
#*..* **\*\\. .\.  ...*... .*.  .... .*. \*\ .\.. W..!\  *\*  #
#  .\ .. .....*..*   * . \......*.*  *.  .\*. .... ..  .*..   #
#.\. ..  .   . ... ***.\*.\***.** * *. .  *..  *.* .\ . ......#
# . **\  *.   ..**\.***.\  *.. \. ..*\ ..\*  *\.!  *.*   . .. #
#  .\.*.**\..*\.\.  *..\* \. **** *...\*.*..***\@. ..!.** .  .#
#*@ ...  .*..@. \*. \. *@. .\..*.**  \.   .*.*\* .  . *....**.#
#.  \.* *\   . \.     !\.\.*.*..\* .  ..\... *. **.*.\...\\ *\#
#.*.. * .*. .*..*.\    \*.  *.*...*  \ .**..*. .*. *. .  * *\*#
# \   ..  .. .. **. . . \ . *.\*.*. *.\ ... \*..   .@ *\**.\ *#
#.   .* *  *    .**    .  .\   . *  \*.\. *...* *.*\  W*..*..*#
#\ *. ...*.*\*.\ \\* \..... *\ \ .* *.    .\  . !*..\....\.  .#
#  .* \.***.\*.   . \. * .. *. . * *. . ..* . ..** *. \..\\*  #
#\.\....*** ..*\\.*..\ *.  ...***..*. ... * \   .*R\* .  * \* #
#.\  **.....  ....\..*  ..\*\.\***\**\. ..\..*\   ...  .\ *.\*#
#  . ..\*\  ..*. \...**\  .\* *... .....* .  *. ..**  \*  .\..#
#*..  .*.. *\..  . ..*.. * *.\....*\..\ *..*. * **..\ *.\  ..\#
#.\. .** . .  .*.***.\* .. .. \**\.    \. ..  .*.* \  \....*\.#
#*.   ..\ \  * * *\.*.  **   \.**  \*... . .\ **. .* * ** *.  #
#*. ****    *\..\   .  \ * ..* \.\... .** .* ..*.\ .  .*.*. ..#
#**\@. \*\.\*...  \* .  ..\**\. ****. *\*.**  .*.\.    ... .\ #
#.**..\..***... .\.\  ....* \.. \..* \ .. *. .\\.  . ...\..*! #
#.**\ .**.\ \\. \. ** .  *. *.... @.*.. . \! .*. .  .\. .**** #
# .*.  ..*\ .. . .\....*..   ..   . .* \.!. ..*.  *.  .\. ..**#
# **..*\.*..  .. .  . \*..... . .**. \.\.*.. *.  **  **.  .\**#
#.*.**.  .* .*\   .. **.** \  *  *..\. ..*\ \.. .**\ ***. * . #
#.\.**\ .\.\***.. .\ .\\ @  . ***.*.  .\ **.. ......*... *..  #
# ..**  !.. ..** * . **.** .  .\**.\   ...* .. .*.. *.   .*\. #
# .. .   ..  W.. ...*.\.*.. *. .\..\.\!*** ..* *\ .  *   \.   #
#* *. .*  .....\ . .*..*\ \.* *  **\.* *. . *. .!\. *\.\.  . \#
#.\   *.*\ *..\... *..\.. !..*. \**  .\ \...*\..* .*.. . .  \*#
#\.\..... ..\** **.**.  *. * **...*. \ ..* \..*\. *\* **@ **..#
# .*.* .\*!\  @*\...  . *.\. @\.. .\...* .*.* **..*.*\*.. ..  #
# \. * *\.*. .\.  ..... .*.\.*. \  .*. . .*.**.*.*. ...**!.*\*#
#.**.. .   ... *. *\\.. .\   *.\..  * ..**.*. *.\.\*..**....\*#
#. *** **. * *.. .* **  .* ..*..\.* . *\..\ *  \ *. *****\** .#
#**.\...@. .\..*\ \.*. .\* ...*\  ...\. \   . .. .  \. ..*.\ .#
#*. ...\.\.. . .*. *.   *.*. \.\.  * * .. \ * .* .   **\.*\ .*#
# .* . .  .. *.** .   *..\*.*..** **..\ .\.. . * ..**.\.\.   .#
#\ * .!*.\.. .*.. . *.*...*. *\.*...!..  ...\ *  .\* ** ** . .#
#\ *\\.*. \.**.* . *. . . *  .*.. ..*.\.  .. ..** ..  .*** \ .#
#......*. .*\** .  .\ **. ...\...*. ** *.  \.  ... . ***.**..\#
#. * . *.*.**..  @  *....  \*.*!***.*** *.*.. \ ** ..*.* ... .#
#.... *.*. . .\ .\.*..\@. * *.... . .\*\ **  * .\\  **\.*\\ *.#
#. * .* .* * *.. * *.*.. *  .*\. \  .* *.*\ .\ *  .  .. ..*..\#
#  \  *  !  * .* . *\.\**.\. **    .   ..* .\.  *.. ..** .. \ #
#\ .\...* **..*\.*.\ * .!.* ... **** *... *  *.. * .*\*\ .. **#
#*\ *  \*\*.\ *.....\...  .  .  .\ . \ * ..\\ *.\  \ *\* \*\..#
#....\*\. \..*  \***  .. ..W\\*\ .\*.  .\ \ * .\\.\.\.\.  *.*\#
#\*. *..  *\ * . .\*  ...\.  *...*.**\ **\ .* .*.\ \   .\.  **#
# .* ** **..*\ *\.*...*. \*.*. *   *.*  . \*.*...*.\  *. . .. #
# .  *.*\. *.... .. * \* .. *.\.*.\.*.\. .. .. .*\**.\.. .. ..#
#\  ***. . .\.* .  .*.. .*..* ! *\... *\..* *  .*.*.....* .*  #
#\ ***.   .* .    *.*  .\. *..  \..*  *\. . .  .*\ *.! *.*\ ..#
#  ! .. \.@*\\.\ *.*..*...*.*. *.. ** ..*. \ .. \.. .. ..* . *#
#  *\** ...\.@* .. * \.@@ ..   .* **.\ \ .*..\*\*\  * .*\..\..#
#. .*. .  .. ..* .*\*.*. *. ** \*...*... *.*.** .* ... \*. ..*#
#. ** ..\.\  .*.*..\. .\*** *.!.\*\ *.* @..*. .. .\ * *.*. !\.#
#* .\* ..  ** *. ..* \*  *.*\   *..@\..*.**\!  \* *  ....@.*..#
#...\.*\.\\... .*  .*. *....\..\*.*...**.\\ \ ...   . ..**.. *#
# *.  ..  \**\ *.\. \* . \  .*. *   .\ .* .\ *\... .*.!\...**.#
# * *.* ..**...\ ..* ..\..** \  @.. *.*.\\   \.* \.\.\  \ *!.*#
# ....**..\**.. ** * * * .*..  ...\ .*.. \ *. .. .\*\ \  .*...#
# .  \..*....  .\**.***  .!. * *\. .*..   ** .*\*\*.*\*.. . . #
# . ...\\... .*. .\\... . ...\*. * . ..*@*\* *.*..* **..* ... #
# * .*\ .**....  . **\..\. . ..*...  ** *.*. . . .  *  .. *.**#
# .   .*. .\*  .* .*.. *\. **@  .* * \...*. .*. **. ** ****\*\#
#* .\  . \\*.*.\** ... .\...*. ..  .\   ..  .\.\ . *.*\...*  .#
#. .* .  .\.  \*.**  .\*  ... \ . * ..\. .. . .@\ W\ ..*\ *\ *#
# .\. *..*.*  ..*\ ..**.. ** ...  ...*\. *.. . . . . .*\*.. .\#
# \....* .*.\ .\  \.\ *.  ... \ .\.\.*..... .    \ *\.**  . *.#
#*.\ *..*\**.\.* ..*..*** .\\.. ..  ...  ..* ..  **! .*.* ..*\#
#...\.*..* \ .\..  .*....@**.\.  * * .\  .\...\.*.   .. .\ \.*#
#\* \\. .. .. ***\ ... ..*\*\ \ *..\. . . .* .*.\....\ . *.\ .#
#.*..\*.   * *.  .\. .*..*.. .. .**..* ..**..*!* .* . .. \ ...#
#*.*. *.*.  .....*.*. ..**  .... .  ** . \.* *\.\ .. *\. *.  *#
#\ .. .\* .*.. *.* ..**.*.\..\.\.  **..*\@.. *. . . *..\* *.\.#
#*.    .. .*  ...*... .*. .*\... .*..*... .  *.\\\..\ ..@*..*!#
#*.  * . .*** \ *. . * *.  .  *\@*. ..\**.  \\. .. ..* ...... #
#*...\.*\ ...\\ * \. *. * . .\.. \. *  .. \..* . *  **.  .\.* #
# .*\.**.*. * . . .\..*.  . \ . . * .*       ..\*. \**. .* ..*#
#.... \ *   .  \*\ *\..  *\*..* *\* **.\**** \**.. ..*....\ *.#
#.* \  ..*.**.\ **..** ... ** **.*. *  ..... .  \ * *\ * \ ..*#
# \*. .\*.*...* ...*..* .. \.* .*. *.*. .\  . ...*.. *\..\ . .#
#*  \    .*\  .. \*@. *... ... *.\* *..\ *.**.  ..\. .\\  .*  #
#\.* \**..  . *....**..* *.*.  ** . **\* .\..*.\* \.  .** @* .#
# .@*  \.\ .   .\*\*\ \...\**\  .\ . *.*\  ! ..** \.\   W.. **#
#** .\\...*.*  \ ...  .  .* ..*\ . * ...*   *  * .   . \ ! \..#
#.. ... ..\ .. *...*\.\**.*\. *  ...\\.*.*.*.\ .  \** \   \*W.#
#   \  . **  . .*. **.*.* .. .**\. *.*.\*....  . *.*\@... * **#
#. \...\*** ...\. *\*. . ..  *\. \.. ....\*\.*\ ..\    * ...**#
#\ * ** ***    .. .   \ ... *    ** .*\\ .*.*..*\.****. \..\.*#
#*. ..***.. .*....  .. * ***. ..*\.\#.  .\..*...\  ...\*..* **#
# .\. .... ***.@ \*#. * \**. . .\  .#\. ..* *  \*.***.*.    .*#
#*\*. .  .* ..\   *. .\ .*\\**..\.. * * \*.\.  \. .*.*****. #.#
#*.. **\*** \* *# \ .**#.#. ..   .  \#.  \.  \** \ ..\.\*\..  #
#.*  \.... ..* ##.##. \*#*...*\* * *.#**#  .*#.** . *.. **.\ \#
#  \.# * #* ##\.###. ...\#@\*...*\\.@\#*. .\..  **\..*\ ...  ##
# \#*\ .*#* .\. # *.\*\.*# .***#\.. ###\ *.!*\* \** ..# ..* .##
# ##.*.*\.#\#.#.###*#. !# ###\##\##\# #*## *. *.##.  \ .* ##*##
##  ##*.*##*## #  #*#.*##    # # ##*# #.# #* ##\*#.\.@.* .# # #
#     ##.# #       # #. .#      #  #   #  # # #*# ## ...#\#   #
#       #             #*#                  #   #   #. \*#.*#  #
#                      #                          #..\## ##   #
#                                                 L.##        #
###############################################################

Water 30
Flooding 16
Waterproof 0
Razors 42
Growth 43
