###################
#  ##..*## *... *##
# #  #.*\  ****.#R#
# #  **\*.... \.*.#
##\*#.\ *.***. ..\#
##*# #*.*.\.. * #*#
# ###.\#.* ..    .#
## \..#*..*.*** *.#
####.*.*. ....* ..#
# ...*.* *   *.\W.#
##L###.*.\   \!.#\#
###################

Water 0
Flooding 12
Waterproof 16
Razors 46
Growth 8
