##########################################
#.. \*.**\..*.**\\ .   .  *. *.@...\*\...#
#.  ..*@\*.. .. ...\**.* \..* .. *\ \** .#
#.\\  ..\.* *\.*****.. \*.*.\ **.\. ..\.\#
#.** *.\*.*\. * **\\  ..***\* .*.** ...  #
#*.*\*..*....\***..*  . .*\ *.*..\. ** *.#
#.\. .  **.*\.*.  .*\\! .* *. \ .** \.  \#
#\.   .\ . .  .\... .   ..\*\*. *\ **  ..#
#.\  ..\. \... * ...     . . .. .  *** *.#
#\* .....\.*.. .\.\. .***      *..* .....#
#*. ...\.* \.\ .**.. .**@*.\.  *. ..  * \#
#*.. .! \..... .* \..*  . .... .*.  **.\.#
#*\.*\  .\@\.* \.  \...*\..**\.*..\*.*..*#
#. .. . ..\ .\ .* \....  . . * .\..  *  .#
#.. ..   **.\*. *. * .  .. .*.\.*   .\ . #
#*   * *.!.\ .. \..* .*   ..  .\*   ..\. #
#** . **\.\*.**.. .* *.   *\. **.  . ****#
# .. .*.. *\. .*   ***\..*   ...    . \..#
#. . *. .*.*.\.. \ .*..**...*..\ \*.*..  #
#. *  *  \ *.*. *. *.*.\.*.\.. .@.. *.*.\#
#..*.*.**...\..  ... .*.*\..*\   .. \ *..#
#\\**.!* .\ ..   .*.   .*.* *. .* **...**#
#.\  \ @ \.\ .\.\ *... * .\**.* \ .\.\ .*#
# .**\.\ \...\ ** \*\ ..\\...\..  **\.!*\#
#\.**.\ ..W.. .*\ **   * ..\ \.****..* * #
#...W .**\ \.. * *...*. *. **.\ .*..\.!\.#
#\ \.. ..**..*.\.. ***..... .! * *. . .  #
#* ..* * .*. ...***\. *  . .\! \ \   . \.#
#* \\**. *.\\  *.  ..\. .\ *.. .W*   .*. #
#. .\.**\..\ ....*\ .. ... .     \.*.  *.#
#.* @***..  . . \*!   *.\.* .\ \* ..  .\ #
#.. \... ..  ..\*. .\.. ** .*.* ! @\* \. #
#!*.\.  . *.*  .... *   .** .\..  . . .**#
# **\. \. \    \*.. .**\ .**\*. .\   **\.#
#\*... .  .*.* *\  * .. *.* ..\ *..\ * . #
# . \*  .. .***@*. .* *...*\... * *....* #
#*W .*..\.\**.**. *.  *.* ..\\. . . .*.*.#
#. ..\ * *.\....\ . \ . .* \.\\.     \.* #
#*. .! \.\ . *.\. . .**  ... . * .***.\.*#
#.* \.\. *.  . **@ \  . **!.. *. ..*.. * #
#..\.   *.* .. \\ *.\.\*...\. .\.\*** .**#
#** ** **...    .*\ ***   . .**...*\* ...#
#*.\**... *!.   .**.\ ***.  *...  .. .\  #
#...*.\.  \*   .\\.\ ****..*.. @\ *.\ .\ #
# . .* ...**\.*..\.**.......*\. . \.. \.\#
#...  @.\ ..*.*\*. .   \.\*\ * . *  .  . #
# *!@.. . *!.  ..*.. ...*...\\. *..* . \.#
#\. .  ...*\.**...* .*W**\.*.\* !** ..*  #
#* *\ * ....*..  *.* ..*\...*.* .\    . .#
#.*..!....\ . \\ \*....*..  *.......\* ..#
# ..\  \\ *\ ....\..*\ **\ **\ . \*...\ *#
#* **!...***.**..**.* .*.. .\...***\.*..\#
#*\...*..*\\\*....\. ... .  *..***  ***..#
#*   . *\. \.* .**   \.* * ** !.\.*\.\**.#
#. .*. .   .***\ \. \...** ...  * *.\* *.#
#. ***..\. **....\....*...\* . .\\*..* *.#
# \ .*.  *.   \.\**  ...   . *@*.\**.\\\ #
#    * ..W* ... . @ ** *.**   .. ..  ***\#
#\\***. *    \\. .**.*....\ .. * .*. . . #
#. .* . **  \. .*. .*.. .. .** ..*.*.* \*#
# * \.* *. . .. .* * ... .  *.\ *\.***.\*#
# .\.**    *.*.. ... ..*. .  \  *..* ....#
# **.*\  *.\...\* .\..*. .... *  ..*.\ \*#
# * . .*@..*.** **   ..\ .    ....* ....*#
# . . \. \ .*.* .* \*\..* ....*  \...... #
#   **.**W\ *..   ...*. .\*\ \* *...\.* *#
#\ .\*...* .\.***. \..* ....***.\  @  *..#
#  .....\* .* *.\ .\* *  \*...\.**..*\..\#
# *. ..***. .. ** ****** ..\** .\*  .   *#
#**.* .**. .. .\.* .\ ..*.*.\\*  .  *. ..#
#*.... *... \\*.....\ .*.\.  *. **. \  \ #
#\*   .*.  ** ..* * *****.\    *****.*. .#
# .\ ..* ...*.  ...*. .*.* \*.**.\ \*** \#
#..*.\ . * *  *.\  \..*\ .* ***\. \ ...* #
#*\.* !  .!* .  . *.\ *  *.\*\*.\.  * **\#
#\. .\  .   *.. \ .  \\..\.** ..!   .*.\.#
#...  **\ **\  ..*. *...*..*\...* \ **..*#
#\*. ... .*\  .*** **\. \**....**\.\ ..\ #
# . .* *..*. * W.\ ... . *.*....* .*.. . #
#*...**.  **..    \. \ \ .**  \...\. ..*.#
#*\  ..\ *. . *  . .  .  \.\.@..*\* . ..*#
#*.*  .****   @*.  . \  *...@.  . **\ ..\#
#.\.. .....*.* . .\ *.. @. *@  *  .*.** *#
# .\  . \*..**\.  *. .*.* .\\.*. *.*.**..#
#. . *\ . .\.. \*..** \.\   * . .* \ .. \#
#* .\**    .. . . *.. ..*  ..\** .\ *.\.\#
#**  .*  . .*.\*.\.\*.  @  . ... *   *  .#
#.    * . .*\.*.\*  .  *...*\ \*\ .... . #
#\ ..**.. ** .. .\.\.  \.. .*  ..  \.  * #
#  . *\*\ *\..\. * ***....* .***\. *.\.\.#
#*...\. . .**\ *.. ...**  .  .*... .. \  #
#*.*\\!. \  \* ***.\.\*  *....**.*... ...#
#*..\*... *\ .!.*... ..    ***\* .* ..*. #
#\***.\\  .  ...**. .\ **. \*. ..\* .*.. #
# \..* \    *** . . .*....\ .   ..*. **.\#
#\ ...*   .*....  \ \ .  . .\. . ..\ ..  #
#.\*. *.*\..**.\ \..  ..\  *\    .   . . #
#!**.\* . .\....*.\  **. ..*****  @...*.*#
#.*.. ** . .  ....    ***.....*..... !  *#
#**.*.. \..* .@ .. .\*.. *\\.**.   *\*  *#
#**..... .*.**.*.*.*..\ ..\* .* *  *. . .#
# ** \..* .\*\ * . \.*. ..*.  .*\  .  . .#
#**..***. .*.*.\\*\..*  *\. \ * *  .\.\  #
#..   * * .......... * !**.\.*...   * . .#
#.*.*.*.\ \  *. .*@ \*\* *  *.\  .. \* * #
#.  .*. . .***.. .\ .\*\*.*.*.\  .*\  \**#
#   \*\. * ...*.  .. ..*....\.*** .. . *.#
#\ ..\...* .\.\   .\..\*. . **      **..@#
# * .*.\ . ..* .\.\\  *.*.* .*  .  *..*.*#
# ..\.\..\. \*. **\**.. ***\.* **.*.....*#
#\ ..\.*.\*.. *  **....** ..*.*.*** * . *#
# . \.\.*.\ * ..* .***.. \  @*.*.*.** . *#
#*.\.   . . ..**.  \..\...  .*\... ....*\#
#*..  *.   * *!*..*.*\ ..*  *. .** **.***#
#\*\ .\ ***.\\* \**.. **... .. \.. .* ***#
#****. .*.*.\ . W*..**..*\.*. *.*   . @..#
#*..\* *.\.*. .*.  \* \ .. *\.**. *  ... #
#*.*.. . *\... ..  *.\.. @..***..*.* . *\#
#*\.*\   .. .  *.*... \ .\ ....*\*.**...*#
#*. . * ..\*\.   *. .\ *. ..*\ ...*.*.\..#
#* \. \ \..\*\. . \ \*..   ... .\.....W..#
#...**\..  ..\. *W **   * .* \ .*  \ *.\.#
# .....* ..* .\*.\ \*\.*.. . .    *.*.\ .#
#***  *.   .@\..*.**\ *..\..**.  ..*.** *#
#..  *.*..  !.*** .. **    *...**  **.. .#
#\.   .  ***.\..*. * ..\ *.\ .\.\.*. .. *#
#..   **.**..* .*\      .*\*. .     .....#
#. \ *.*.\*  \* .* . .*@ .*.   . \*.. \**#
#*\ \*...*.\ .*  . ..    .. . ! ..** \..\#
#..*.. ..\.. *\\*.* ...\. .\ . ..  .... *#
#\*..\*  *\. **** *.   .\* .. .   **. ...#
#.*. . . ..**.....  .  \..\.* *\*... . ..#
#..*..* \ ...*  *****.\ **. . **. \\   \ #
#..\  .. \.\** * *.*.. *.**   *. *... .. #
#\   *\*  . \  \.. .....*\..   .\\\  . * #
#***\.. .***. ..@. ** . *.!. *.\*  \. .. #
#\. .   *.. \ \.\..*.** .\. ..*.* *.**. @#
#.\. *.\* * ...*.  * .. * ... ! !*...\...#
#.*\ .*.* \    \  .\. .*\ ** \ . *\  ..  #
#\ *.\\*\  *.*..*.    *  **.  .* . *\..*.#
#****\...* . .* .** \..  \.*.*.\. *.\. ! #
#.**...\.\!\*\.*\ . .     ..  \..*\*\\. .#
# .** ...* *..\.*  \.*. \.* *..**. * *  .#
# .***\. *...!* *\* *. *  .*.*..*.. \... #
# ..\.*. *!   ** .  ..\\\* *\*\** .*. .. #
#* **..**..*  .\ \.\.\*..*\ .. .. ......\#
#..**. .**\.*\*.\. \ *** . *\*. .  *.!. .#
#. .\ * **  \..@\ *. ..    \*\*..* .. *.!#
#..*...  . * \ * ..*. .*. *\.*\  *  .@.**#
#. *.***.*. *\*.  \* *** .\**\...*\ *.\.*#
#\  *. *. *..* ** .* .\..  ... *\.*.* ..*#
# \* *.\  .. .\*\.***.*   \ .. \...\* *\ #
#*   .. ..\W\**. **\...\..*..* *...*...*.#
#*\ * *  . **..* . .   .*... . *\  .*** .#
#. .* * \\.* \  .*\ **. .. \.***....*\.\.#
#\*\.    .**..  \**..*..\* ..\..     *...#
#  ** \  *\*.. *..   .** . .*. \  \\ .*..#
#*@** ***.. .*   .    .....*.. \ \. ... .#
#W.*\..* .  *....\*.* *\ *.*  \.. .* *..*#
#..\ ... *  \* \.*  . . \. ..*.\\...\. \.#
#\ ..  **..*.. \***\.   \ \  ..*..   ... #
# . . *..* *\...**.!\.*\...  \. \. . ****#
# ..\*.... *......* ...!\  *\. *.** *.. .#
#.   .  ..\\.  .*\. .. *  *. . .*..  \.\*#
# . \ * **   . *\.* ..\*. *...\.*@..*.  *#
# \.. \..**   *.*..\ . .\W* ..  ..  ...**#
#* . . *\*.  .*..**..*  .*.***\ *.*** \*.#
#.     ...\***.*.*.*. .\..\ *.... \..  *.#
#* ***  .  *.**. *\\* *.*  ...\ \ . ..\.*#
#.\.\.. *  **.. ..* .\* .* ..\... .\\....#
# *. **.  .R*!*. \. *\. ** ..@. .. *.*\.\#
#*   ..*!\\ . .*..   .*.\* *.. . \*.*. *.#
#.\*\\*** *  . * *.....* . .  .*. * .**. #
#.*..\.*. * * ..\. \ . ....*. .*\.  .\.*.#
#*....*.*.*\*.** *\..* * **.! . .\*.*..! #
#*.**. \...  *.. *** .\.*...\.. @   * ...#
#**.*  *. ..\*.  * * *...\\..!\ \.\\.!  .#
# *..\\. .\\ .*..* ....* * *.  .\. . \*  #
#.*.\ **..*.\..*\*     *******\.. . ... .#
#*. * *\ .. .\*.* .. ...*.*.\!.  \.*...**#
#.. .  .. *.  . **.\..\ .* .. . .\*. *...#
#\  ..\. . *  \ . .*\@*\*. ..* *.*. ... .#
#..* ..***   \....*... !. . **....*\*.\ .#
#  \\ ..*\   .\ \ .  * .\.\ *. .**.. .  \#
#  .\*..\. ..\ . *  .* .   .\* ...*\ *.  #
#*.**.... *!. .* ..* . * .* ...* \...\. .#
#. ..** \ \**.*  .***\.*\.* .**.*.* \\**.#
# .* *.\.* .**..*.*......\.. *.\.\*\\ . *#
#\ .\ ..*.\ ! . ..\.  *\ ..\.\ ..*.** **\#
#*.W   ..\.. \   * \\ .....* *  ** .\..* #
#*@ ** *\...  .. .\ \.     ....\.  **. ! #
#\\ ..*..\*.\*. . \..* !*.*  ...\.*.  \ *#
#.\.\..\..\  * .*\.**.....\\.\* .\. .\ **#
# *  *. .. . * \.\\.\*\*  . *.   .* *.**.#
# * .\*.  *\.* ...\\ !.*.** *  *... . .\.#
#  \\ . \ *.\.. \*.*.. . *. \  \ . * .\ \#
#*  *\*..*** *  .*.** ... \* .* .  * *.. #
#..* \.*.*..\.\\.***.**@. \.*.*. *\*\.* .#
#\ * .\* .. .\*. .*.*....\  .*.*.* \. ** #
#* \   . ...* @\  . .. .\\*\\*\..!\ .\\* #
#* .   .   .\...*\ \.   ...*\*  * * \..\.#
#* \.*\.\*.@* .\..   .*\ @.*\*.*. .*.* *.#
#*...........\. .. *\*.. *\.*. ..  *   *.#
#*    \*.\. *.*. *  **..\ .\..\*\.*.\*.*.#
#  .    ..\.!...**  *  . \.. . .. *  *..\#
#. .\* . ..   * .... \ *. .     .\.  \ \.#
#* .*.  ..* ..*.@\  **.. * *  *...*.\ \  #
#*.*.    ... .\ .    \* \*.*\.* \.. *..\ #
#. ....\*. *\ ..\**.* \. .  ..* .*.\..\. #
#*.*\  .*. \*\  . \ . .\* **.... *\*.\.*\#
# .!**\*.\...*.\.... *\.* .*.. . \ ...*.*#
#\* *...*.*\**! *  *...\.@!.* .\. .*..*..#
#*..\..\.*.. .*..\ .*\*  . *.  ..*** .. *#
#* \.\*  \       .   .* **... . *\ *... \#
# ..  ..***.*.  \.*...  *.*. *. ..* **.\ #
#*\**. .*\.*\ .*.*.* *.****@ *. *..**. *.#
#\**.. .*.\.\ .......*..*!.\ .**.*..\ *. #
# ... .\ \ ... * *.. .. . *   *\..\  *\ \#
#\  .**.... ** .\**  .  \   .***....\**\ #
#.*  \ *W\.**  .... . .*. @. *.\. **\ *..#
#.*.\ .*.  .. ..* *..*\.  **.!\ * ... *\\#
#.*.***.*\.   ..**\ ..** . *....\    \. .#
#!.*** ..\.*..  *.**.*.* .*..*...\.*.. *.#
# ..*.     * .... .*.\.\  . *..\ . .....\#
#*\*.\ .. ....** * *\..  \. **\..   ... .#
#*.\ *...\    ..*....   .. . . *.*....*\*#
#\.. .\* *\** \***  *  *  .. .**.* . .\ *#
#\*   ..\ . .\.*\** ... **.*\  \...  @\ .#
# .. \ *.**  ..*.\..* \...*...*...* .\.. #
#**   . *..\ \ ...\.... ....\**.**. .  ..#
#...  * ......**...***.*\ . *....*. * *..#
# \ \*\ .\ .*..*\. *** . . *.* \ .**.*** #
# .   *\ ....* !. .\..* .*.*..*..**. * * #
#   * **.  . . *.\ . .\    .*\...\\ *  . #
#**.. *.\* **. *   .    . \ . ..\ ...\ *!#
#\. .**@   \*  . .\ \ \ *\. *   .  *..   #
#......*  .*.\***   .@.\....*  \ . ..*.  #
#*  \ \...*....\***.....**.*..\..* ***.*.#
#!* *\ ..\\.\.*.... *\ *\.**... ..\.*.**.#
#*\.\ . **\**.. .*\.\..\ *.** *  * \..\.\#
# *.   *..*.... .     .*... . ...*\. * .*#
#\    .\.\ .*.. * ...\ . .  .  \... *\.\*#
#.. .\ **\  .  .*\ .*. *.\. .\. ..\\*  \ #
#\   . \** *\   .**.*.    * \. .\. *. ..*#
#  \** .*...   *...\.. * ..\   .*! .   .*#
#\\ ...\ *   \.**  .\\..  *\... \. *.. ..#
#..\ * **.*.. *.* ***..\**.. . ..  . *   #
#\  *...\.*.. .!*.\.. .**.*\*..\.*..*  **#
#   .\  .  ....***  ***.\ .*..*\ .* *\*. #
#*\\*   \\  * .W\. *..*..\*.  * ..*.. . .#
#...\.*.  \.\ ...******. . .. .* .\.  . *#
#*... * .\... \***..\\. ..\*.. .\**.. *  #
#. . .. *** ** * *  **. \ ****.  *.*.... #
# ** ...... !\ \* ............! ..\.\*.\\#
#.*...***..W .. . .\\@.*\ \*  *.. * .....#
#*...\.* !\\* **.*\*\..* **.  \** \  . *.#
#.. *....* .!.*. .   . *\* .   * ....\*!*#
#**  \ * .*\* ..\ .* . ... ..*\ .*.  * **#
#*.  . .* \..*.**. ..* . .*  \.... *@*..*#
# ..* *.. ..\.\\*..  .* . *  .\* ....@. .#
#.\.\ . *   * ... .* . ..**.* *. !*.*.#  #
#\*. .#*. *..\.  \*.     *. .*.* .*\**. \#
#.\ # ## *#\    *.. .\. .\**\* .  .*#*##.#
#.###..*\.\ . *\ ..  .   #** \.... *#.# ##
#\ # # #**.**\..\\.\.. .  \.*   .\ @ \*# #
# #   # ##** .  .* .@..\ . *.  *\ *. .#  #
##       #\####  #**#.\#.\.\   ***... .###
#         #    #*.#.. ##..#*\. .\.\  #*\.#
#               #*##*\ .# *# .* *.*****. #
#                # #\*. ### ###\.\..#.####
#                   ###..#   #...#** *#  #
#                      ##     ##*..# *#  #
#                               #.. \#   #
#                              # \###    #
#                               #. *L    #
#                                #*#     #
##########################################

Water 159
Flooding 12
Waterproof 17
Razors 24
Growth 12
