##############################################################################################################
#\**. ** .*. !\. ...* .*. ..  ..\ .*.* . ..\*  *  ..\.. * \.*  *.* ..\.. *  .\\ .. \.*\ *.* ...#  #**#       #
#**** .*\ .*...* \.*.  . \ . ..\*. . . @\*   .\.\. * \*.* .\. \.*..  .   ...  *  **...* * *  **\### #        #
#..\*  . ****W.  .\.**\.* .**  .. . .*!.*.\*  .. * *. .\**..!.*\*.  \ ** . **.\. *........W *..*  # ##       #
# \.*.\  ...  \\**.*   ..*  .  ..*.** .*\*  *. *\.*.    ..   *.... .. .!.\ ..\   *.  .**\*.\.. \  .\. #      #
# . .\ .*.\*  . ..*!.\*  ..  . *..*.@\.. . . . .  ..*.* **.  . .**.  .  .*.  . ..*. \... .\   \....** #      #
#   \.    *! ** *** *\*...*\**..*.... **. *..**  *  **  ..*\.*. ** .. * *..... \.* ..  \. !**.\* \ *#\#      #
#** . *. *  *..*... ..*. **.\.  ..*.*\*...\  * \*1 *......*.\.\. ** **\.\* .*\. .***..... * * ..\.*.\. #     #
#**.*...\.@..\..    *.*.*.\*.  *\.\.\ *. \.. * *.....\. **\.. *. .* .**\.   \ . !... *\ **. .\.. .*.*.#      #
#..\..*  *... *  .*\ ** .**\.. \... .**. \*.\*\. \ .  **.\.  * \.\\ *..* *... * *  . *.*\.\  . *.\* .#   L   #
#.\*. .. **. ..** *..*..  \ . .\..R. *.*. .*.**\\  *.\.\.*..\..  .\!.\*  ** \* \ ..  ... . **. .**. .*# #.#  #
# @* *..*.* \ ..... **\\ @..    .\...*   *\. .. .. @ **..\*....\.  .\ . \ *..* \ \. *.. . ..\*.\.**. .###..###
# \. .\    .!.\.\*\.** * *\..* *\..  . *. *   .****...\ *.*   ....\* ** .\**\.* *. .*..*\...*.. *.**.*.. # **#
# .\.\  *.\  . ..\* .....* ..*.\...*\. \*.\ \   ....  ... .*..\.\. \** ..*.*.    \* *. .  .\ .\ .\**. .    ###
#.*.*  .*..*. . .*.*\ * ... .\..  *.\*.*. *\  .  \.\ *...  *\..*.* .*.\*\.**.*......*..\.*\*..\ .  .*\..*\*# #
#.... .*.*   \..   *. * .. * * .... ** ....*\*\...   ..  * .. ** *.**. ..\. *. .. \ ..*. *.\**.  *\*..*\###  #
#  **  .*. *   * ...* *..*.*\. .\.* **\ \ \.@.**.\  .\\.*\ . ... *!\. @.\. \*\..*.. *.*\.*.. .*. .@.*\*#     #
#*\..*  .. *\ .*\ . *..*. *....*.*.\*. .... **\  *. *. *. ..\\*.\.... \* *..*. *\.  .    *\.* ..***#.**#     #
#..* * *..*. ..*   *** .\..*\* .*. .... .\...*.\. * \.  ..\  \*.\.**\. . .  \* *.*\ * *... *.. \.\* .*\.#    #
#\ .\   *..*  ...\*\.* ..... .* .\ **..* *..*. ...  .  \.\ A\ \ * \.\.*. ..*..\  . .. . ..*\* ..\ * .##*#    #
#.... . * .*** .* \. * * \.!\.*.. ..\..\ ..  ..  .. \\     ...  *....*\. *.. *.*.*** . **.  ...  .\*\**.#    #
# .***...***!. \ !.*..*\*. *...*.\. ..*..  \. . ... .\.    .**\*.\*.**. .*.!..\ \.. *.* **  .\ . \ .. .#     #
#.*\.*.* .*\ ...  .. .. \...*\...\*..  . ....   *   \*. **. *. .  . *. . ..\ **.. .\*\*.*.\\@* **.. \##      #
#.* *...\ ..\ @ .* .\. \.\. ..*  *.*.\.*.. \ \ *.* *.*\ \**.. * \ ..\* ....\ *.*.\\** ***** .*\.** ##        #
##############################################################################################################

Water 0
Flooding 0
Waterproof 6
Razors 29
Growth 41
Trampoline A targets 1