###########################
#..*.* *\ *.    .* *.  .# #
#\.. * \ *.*.*...*..**.#  #
#.  .* .\ ..\. \. .  . ####
#.\*\. **.\*    ..  . \#R.#
#\.. *... .\..* *..*\ .  L#
#. ..\.... . .. .\*\*.\ \##
#.\**\* . ..\*.   **.\ *# #
###########################