##################################################################################################################################
#                                                         ######*. .. *.#*..\*****.*. .*\*\... *\ ..\.. *. . .**. *  .  ..**  \.*#
#                                                        #*..   .*.   .\@.**...**. * . **. \.. . . \***..  .! .*. \...**  .**\..*#
#                                                        #..**. #..***  .. . .  *.\\  *.. * .. ..\ .... **.**. .* * .....\      .#
#                                                     #  # #*#   \ ..* **.. \  .*** . .\ * .**.*  . * *.\. *. . ...   .   . .* .*#
#                                                    #*# #\ *.***#. **.* *. . \ **... ****..*.*... .. \* .*\.**.  *  .. * ***....#
#                                                   #**# #.#@*. ***... *\.... . \  .* .\.**\.** **** .*. *.* .....*.* . .  *! .. #
#                                                 #  #*\#*# **\ . .. \....*. **. \. . **\..   . **\ ..* **. . \*. .... ** ...\\**#
#                                                # ##\..** ..*\.*.**\. \  ... .*..  * \  ..***  .\.\ ...**  .\ *..\ \. . ..\.*\. #
#                                               #.  #.#*\*.*\\.*.*\... .... .. * \!. *...\* ..* . * * .*@. \ ....\*** .***\. \. .#
#                                                #* . \.#*#..  . ....* .. .*\  . . *\.\.*..  **  *.\. **\  . *..**  .  *.. *  *. #
#                                               # #\...*....\ .  .\ ..*. .  *.*\. \. . *..    \\.*\*\. \ .*\. *. .\.  .*. ...\.  #
#                                              ##\...*\ #.   . .!. .\..*\ . .* \  .**\*.*\  *\ .\..*    * .  \.\*. \*.\*.  \.  .*#
#                                             #  .\...\. ....\ *\*. ....  . ..*. \.\* * *.\.\.*....\ . ** ***.... .**. \   .* *\.#
#                                              #.#\.  *. .\..*.**  * \    ..**@.     .* .. ..\@*. ...* *. .*     \.*...... .. *. #
#                                             ##.  . \. . .  . . \ .!. ..@....\ .* \.*!. **\***.. \*.. .\  . .*.  ...\.*.*.... * #
#                                            #\ #*   **  . .  @ .   .\*.\..**. * *.. *    . ..\..\.*.*    .. **\ ** .*\...\  ... #
#                                          ### .... *\. \. * \. *  **\... \..  *.*.... .*   . **\ ..\\ *.\!*.\\  . .\.   .*\*. * #
#                                       # #.\..#\.. .*..\* *. .\. \.\ .**...  .....\.. \. ..\** . \*.. .*....**.\    \**.\ ..\*\.#
#                                      #!##*.# ## .*.**... .* .   ..* **\.* .* * *   \.   .\*.**.*...  *.*. .*.**. *....\..   * .#
#                                      # .#\\. .  .. .* .. *\.  .* **.W. *.\ \*** !* ...\ \.**.. \.* . ..*.*..***..\..\.* ..*! .\#
#                                      # .#.*\.*#. . ... .*. .*... \\...\..*.**..  .*\  \.. .. \.*\ **. .@\ . .\.\.* . \*. *. \.*#
#                                     # #*.*..** ...\. .  .\ .   *\.\@** *...\.  \\ *..*.    . *.  .\...\* . .. \*...! .W...*   .#
#                                     # ** \*.*. ** **  ***\ @..**.\. .  .*.. *  .  * \ \   *..*..* .\.*... . .  . ..\ . \. **.*.#
#                                      #\*.#....*\*..\. \.***. **. *\ *\..* \*.   \.**. .*\. \ . ..\*.*.* .*.**.*.*.   \.  *.**. #
#                                     ####*. .\***\  \..  ***...***.*.. \.....  *..\...   * ...** \ .**   \\\ .*.*.  \.  .\* **. #
#                                    #\*#*.*  ..\.. .. *  ..**.\... .. ...** *  ... **\  ***\. .. . **\.*\   . .*. \.  .\.  .*\.*#
#                                   #.**....  .\*  @ .. .* \.*.. .  .. **\..*.*\**.\.. . ... *  *  .\ *.*. ..   *.\.. . @. . *.\.#
#                           #        #..*. .*  \. .\ *  *. ....**.**.  ...  . **\ \ ...  **. . ....*.\    \ . **.  .*..!* *  .  *#
#                          #.##  ### # *\.  *...**. .\..  *. \. . .  \..\...   . . .*  **** *. .  .* * . ..*  *  . .. ..  \\*\*..#
#                         ##!# ## *.#...*..*.  !**... ..@**. *.*\.*  .*..\...\.*. **\.. *..\ \.\   . .... ... ..  ..\.  *\! .**..#
#                        # .. \*.\**.#*\.\  ...**. \*\.**... . .  \  .**.**.**\.*...*\ . . .*.. .  \.\  . .... *\*.\. *.\**..*.* #
#                       ##\**  *\.\. ..\.*.. .*\.* ..\ . *\. **\ .* . \***. ..\ \ ****. .. ..*\  \ * ..\*. .\. * *....\  !.* . . #
#                      #.#\.* .* \**\*\   *. *\. . \. * .***.** . .**  .\..\.*. .!*...*...\\.\.*. .\. \**... ...\.* \\.*..*.\.* !#
#                      #.*..*\ * .#*  .\* .  * .. \.\.  .\.** . .. .. .   *. .. ...*... .*   * .\* . .\ \.** . *....@  *. .\.**. #
#                       #*... * .\ . .* \ \  .* . !.   .*..\..\..\.  \ \*.  .**    *\ *.*...        ***..\...* .*  \.**.. ..\*\ .#
#                     ####.*.\** ..  *\ ..* . \. *..    .  *   .*. ..**. \.\*\.*.\\ \..*\*\ .\.**\. .. .\  **. .. *. .\. *.\...  #
#                    #* *.... *.\** *... .. *. * . \\..**\. \. \. . .\.\ .*..***.. \ .*.* .. . .  *  *. . \!  .  .*  . \ . .. * *#
#                     ###** # ..!.\.. ...**  **  .* *\.*.. *\**... ...\.\ .  .\.*.*.* .\  *.\ .. **    *...**.. *\... .... *\**.\#
#                      #*##..****\*\ \** .. **...\. ..*.\  \...\*\\.*.  @ .\ *\  *\ * \ !....  \... .***\*...\  * .*..*** **@.  .#
#                      #**. ***\.*** ....**\\... . . * . . **.*\..**.* *.  .\. \*.\...... *!  .\ ..@*. .   *.. *\ \ ....\ .. ** .#
#                      #**.*#.* *. \.. \.*\..*.\. **.\*   . ..\.**\*.. *.\ ..  . \. ***. . .\ \*.*\.** .  ..!..@..*.\   .  .* ..*#
#                       #*.  *. . .. \.*. ..*\ **..* .\   \ ..**..   * . .* *. . .* \...* .\ .\  *! ..  *.*\.  . **..  ..\. ....\#
#                      #! .*. *\ **.  ... *\.  \..*.....   *\.\ ..*.*.  *.\.\\. . . \.\*..  ** ..*.\   .* .*  *. *\.  ... * *\.* #
#                 ## # #* *.\ ..*\.** * .\.... \ ..**.  \**.**..*. *..\..*\\ ..  .. * *\.** **.\* .* . .\ *   .. .... ** .\*. ..*#
#                #.*#.##.**\*.*.* *.* *. . \.. .\ . *.* . .*@.  ...\. ..*\*.**\ * .\*...**. \*..*  ..  .*.  .* .  *.\ \.\.*. .*\*#
#                # .. #*\**\ .....\*  . \.. *.. .*\.*\* *.   .  *  *.**.  . .  \.\ ..*. .*.\.*.*@\* .  ..*.\**..  .*  .!   . ***\#
#               ####\.#. .*. **\ ***..*....*.  . .*  **\*\...*.*  ......* *\ . . **\ .**\. .*. * ..   **  . .. \ * . * . *\* *...#
#              #\!  .##**...\..*\*..* *\\.\.* . *\.  ** \*.***\.*.\.   \.*.. .** .**\.. *.\ ...* .**.....\. \.*...**..\..\.\.*.*\#
#             #**##*. *..    * *...  .... **..  * *\..*\ ***.*. . *.*..\ *..\ . **@*.** \..*\ .*..\* \ \  \.. .\.**.* .\\.  *... #
#              ##  # .#* \*.\. .\ \ . .**....*\.  .*\..*... \* \.   .*. ...@..\\\. .   \* .* * . . ... .\  .\ ** ..\ . *  *\\  .\#
#               #  # ..#.*.  .*  .......***\ **!\.\. \\...\ ..  ...\  \ *. *\  ..\.  *!*...*\**.\\*. .\\.\ *\** . @ \.*. .\*.. . #
#              #*## .\.. ! ......  !**.** . .\**.. \ . *\ . ....*\ . .. ..  .***.*.* .\.*\ ..\\*.     *.*.*...... . ..... *\*. . #
#              #*#.  .*. *. **\* \ **\*\.\  * .. .*...*. .\     ..\  .. *\.  ... \ *. . ....*..\  *.*.\*\*\*....\ * .   . . . *..#
#             #\..* .\.*\\* **.  .*.  .@ *\\..  *. ! ..** ****.**.....* ...  \  \.\...*.  . * .*.*... \.***\. \ ****..* \ .. **\ #
#           ##..\..*.# ! *....  *\.*.\...**.  * ..\..*. *...\* *.\*.. * *.** ..** ..\\  \.. *\.. *\.\..\\  .*.....*\* .\.\ .....\#
#          #*#\\*.*.  .. . \ .\**. .\ * *\.*.\* ...\*.*....*.*. .   ... \...\..*.* . ..*\*  .*  ... .. .\ !*\. .* *.* * *.  .\*.*#
#          #\.#.\..**.*. .*.. *...* .\. \. .* . *@* *@.   .**.\ .  *.   . ..\ \.\*. \ .**\.\*.*  **.\.\ .\ .*. .. \*... .*..... .#
#         #*  .  * .!\**..*.  **.. .* . ..\ *\ \*.*..\ *.*...\ \ ..*.*. ..    .**..  ** * \.*.. *. .* .*\.\*..\  * . ...\ ..* . \#
#          # #.   **** * . . ..\ \. *\  .*.. * *.*.\.   . .* . **\.. ***.. . \ ...*. *\*. .*..* .**..*. .  .\.**\  *\**..*.\.   *#
#           #*.\ ..#...  *.**  .\\ W. .  ** .\ *..!* .*** .. *.....*..*.\ ..*.*      ..*..  * ... ........*\* ..***....*. ....*.\#
#           #.\#*.\.  .*\... *. *    .*\..\.  ** *. *... *\\ *.\. .*  .*\  .*.\  . W*\.\* . *. .*\  .\**.. *. .\..\.*.  *.\\*\. *#
#            ## . *.\   . ..*..\. .!*.* .* . .\. *. .@\*..*.\.  .* . **. \* \ *\    ..* . . *\ ..*... .*   \ . . *. .\.\*. ..**!.#
#         # #*.\.\..*\ *   ..*\*  * ..\ *.....*  .\.*   *.. . *.*. \@.*  \ *..@*.\!\  *   \**.*.*\ *... .**.\.*.*\\  .  .*.**.. .#
#        # # #  \ \ ..... *\ * .  \.*. \**.  .** ..!. . .*. *\ *\.. . *... \.*.*. *.*.....*...... **  *.\ .*.\.** .    * ...*.*\ #
#        # .#\ . \.\*@**. *\\ . \..*\\\... . .*\ .*..\**... \ \.....\W\ ... \*** \.. .. *.\..*.* \\.\ *.*. *\. *.. *   .*  \! **.#
#        # \# *.   \..\\.*.* . .....*. ..*\...  * *..*\..* .  * \.*  *..      .. .  .\ ..\*.**.\...  *. .*..  \.*.*\**.*..  * \.*#
# #       #.\*!* ...*. **. .\ .    **  .\\. .*\.*\* \. ..  \*.*.  * .......* \...  .\ \.@.....\ *  . ***..** *. ***\.\\ \  \.  \*#
##.#       #.#.   .!   ..  *. *.. *.. .. .  *.* .\** .***\ .@\.\.\*. .\*\. \   *. * ... . *.*\\ .\*. \...W.**  @.**.\*... *\...*.#
## #  # ###\* .  .. \.\*\...  ..*.* . \..  .\...**.* *.@.@..*.**.....\  .\ .. .\.\.... *. \**..  *.  * \..*. . \... *.* *.*. .\. #
##.\##*#..#   . .\ .\.\....\.\\ .\* ...\.* \  . ..*.   * .* .*.*..* .*..\. .!\..*.  ** .....\ * *. *... \* *\  .*. *.\. ..*\. **.#
#\*    .\  \\.  *.     \!\..*\  *..*** *   *\.\*.*. \..*  \  . .. *...\. .... \*. *\.* *.\..*\.*.  \**\....\*** .  *.. . \. * .*.#
###\. . .\\** .**.\ **    .\. . *  ...** ... **. \*\*  *. . .\ **. .. .*. *.* . *...\.*. ...**  ***!* .*\ \ \ * ..\ *** . *.\  *\#
#  ##\* . \.!\ *..* .* * .*.**...*\. \**\.\*.* \  . .\ *...... *..\  *..  .**  ... .* *. * *.. *. *... .*\ @..\.  ...   * \  * . #
#   #.. * * \....  . ..\ . .*..\.***  *.*\*.**\.*. *\.\.**  *. . .. ...* . .*\. **\.. . .\*  \ *.**. ....*\...* .*  \. .*.. .\ ..#
#  #\ *\\*  ...*.. * *..\.* *\    .* ..*  .* ..\.\*..*.\*  ....* ..**..   \**.\ *..*\*.\..  *. .*..*. .\.\.\.*..*.  .***\... * .\#
#   ##\.\#*.\*..\*.* .\   . .* \.\ * . \**..\..* .\.**.*.  .*  .! \\. . .. *. * **\...*.\.\..*.   *.....* \. * ** *\... .\*.*.   #
#     #\. *..\ \.\ . .*..\.* \*.  .\  *\*.\..**.* !. *  **.   *  ***..   ... .  ...\.\*\*\.*..\ *.*.  * *.*\.  \. * \* \ . ...\.\#
#    ##\ *\.\  *.* . *..\ .*  .. ****\*.. . *.**... *. *.\.  **  ***.. \  . \.*  .  *.  \  * .* *.. .** *.\.*  .* .**..\\ . .  \.#
#   #. . *  *  * .\..@*\ * \ **. *.  ***\\* ..*\  .\. \. .\. * . **\ \  .\*..\. * .\*\ .\ *.  *.\.*\  * \..*... ** .** \*.  .. ..#
#   #*. ..*..\*\.*..\.\.....*..**.*\ * .* *.  .. ...*.\   .\*.  *..* .... \*.\*\\\.** . .*.*. \.  ..*** * *  .*...   .*.**..*.. \#
#    #.* ..**........*. .*@ \\  *** **. *. .*.* . *\..* **\..W.* . ..**\ ...*\. . *. ... . .\  .\*.*..****. \ **.  . .  ...\.\...#
#   #* .*\*.. .\ * \ *\. . \.*. *** * .. *...**\\ *  *   .*\.**.**... * . * .\ * .* ...\*. . .....**.\*.*\ .*.*** . ..   *\..* *\#
#   #\ ..*..*.**..\. ....  ..** . .\.  .**@ *.*.\.**.***  .* *...\.   ... \   *. .*.**. . **..\.\ *\. * .*  ....\.\.\*\\  ** . *.#
#  #*. #**  ....* .* * \..**  . .\.. .*\  * . \*. *\ ..* .*.\..*\  *\*.**  \\*. .* *\ *\\** *  \* ..\ . \..    \..**...!..\. . ..#
# #..# **.**. *.. *..\.\ ..\.\.   .*\ . *.. .  . **@ ..*\..\. .*\.*.*. .*... .. ..\..*\.* .\  * *.\ ..  . \  ...* \. *  *..**    #
#  ##.*.. *\*.\  .\.\@\... .  \ *\.* .....  *..* .*   **.. . **.. . .\ . .\. .\   *\!  . . .**\..*.  \. \  .. \.. ..*.* *\* . ...#
#    #*\ ** . \. **  \. ..* .  *..\.\*   *  *...  *.\ ..**. .**.\** ..*.\.@\...    *. .*\ .*.\  *..\..\ . .\*\.\ .\*.** .. * .* *#
#    #\.**.. *..... \ * *..**..*... ** ***.*\.*  \@  . .*... !\  *..\**  @*\ *\. ..*\. .      . .  . *** .*..* *...*...\*.\.\ * .#
#    #.\##**#\.* W     *  *...@*** **\   .*. **.\...\ . .* \ . .*\.\ ...* *.*.\*\. .  . *\*.\. . \. . ..**...@ ...*.\.\ .\ *...  #
#   # . . .\. *.*     *...*. *.\.*  * ..\    .*..*.*\.......   ...*.**. . . .\..* .   ***\*\. .*... .  .\**.!**.\...*. ..@..*..  #
#  #.\# ..\. ... \*. ...* .... . ...* *.. \*\.*...*! .*..\*\**.. .* .*  . *  .\. ...\.\.. ...**..   ..  * *.\.   *. ...*.*.. \ *\#
#  #  *\.\. @ ....** .\ .  .*\\ *..\.\.@ ..  **\. . \..*.****\  \ .. \* . *  \.*\. ..* *\.   *  * .**.* *  ..   \\.** ***. *...\.#
# #.\!.*..\ ..  \\.**  .W\  .*..*..*\. .\ * @*\.* . * .*..\...*. .**@*..*.* * **.  *!. .** *\..*..@. \. .   .**\*  . **.*..*  \..#
#  ###\** #\. .*.* ..   .@ . W.*.*.* .\   .*....  .\..\.   *.\.  ... *..\  .. .*\  . .... @.   *\** \.**\\. \ .*.*.*.!.*\ ..\ .*.#
#    # ## ...\ ..*\ *. \* *.\.*\ ...\ *.\. * *\   \.**.\   \.**.. .\ ..  .*\ ...* . . .\ *.\ \ \    * .!..*!  .* ****  . . * *.. #
#     # # . ** *.. ... ...****..*.  \.*.  .... \*\.  ...!\   *\.\  ..***.  . .. .**.*  \\*. .. ... ** ...**.* ...\..  * @ *. . . #
#       # .*\...   *.*. \  *.. *.\.***.\ . .. .  . ...   .. . ... ..*. .\ ...  .. .\ .. .! *\ .  * *\  \..*\.. . @.\ *..\.\.* ***#
#       ##\. .\ *.* \.W .. \\*.. ....**.* .   * \. .*. \. \*  ** ..\.*...\.\* ** **.   . *\. * @.*\.. . *.*.... ...*\*..\...\@*\.#
#     ##*#  ....@*....\    .\*.  *\ *. *. ...*.\. .*.\\**... ... @ .*\.* *. \ *. ..*  ..*..  . ..\. .  .*.... *. . \ **.   * ... #
#    # #.\#*   **\.. ..... . .  ..*\..**\.\.  *.*  ** ...\!.\.\*  * \.*.**.*.  *\ \. . *\.. *..\..\.*.**..... .\ *.   .. . **.\  #
#   #.*.#*..\*  ****\**... \.\\.  \. *. .  .. ...*\ *. *.   .*** ** * .\.. .. ..  . ..\.*. *.*\ **. .\*\**  *.\.\@..***.** .\. **#
#  #\ \\..#....\**.. *\.!*...*. *   . . ..* @ *.*.*\* .    \ .**  \.*.\**.\ \ .\ .*. . \*.*....  *....**....  .\..  \* !.. *.* *.#
#   ###.#\. . *...  .* .*..  .. . *  *.** .*.\. .*.*.* . .W .\ *\ . *\ .\.**...*.  \*. .. .  \.* .  ..*******.  *..  *\ *  . \...#
#     #\## .. *.  *. \ **\.*\*\**...*...**\.. . ..*. .      ..*.. **.**\.\ \*..*.... . *.  \* *.\*..*\..**. ***\*\..*.. .  \ ..  #
#      # #... *.\ *. \ ..*\.....** \.\  .. .. ... *\ \ * *\*. *\*.\*....\.*\.\** *.  .*... .*  .@***\.**..*.\\**..*.... *. .**\ .#
#       #*#\..*\  *.! ....\\.*\.**  .!.  .\* \ *. ..\.\. .  \ ...**.**.*. .. .*\*.*\****    .   ..*..  . ****... *. *.  *  .* **.#
#      #*.  *.* .*#.\ .. *..\ * *.\.  .\     .*.\ . .\..... *\...*..*\**..\*\*. *.*.*.\.\\.*. ...*. . .\ ..\.*  \.\...\.* .**....#
#       #   *\.***  * *\ *..* ..\  .\ .*\.\ \.. .\\** \.\\\ .*  ..*.* .* \ \ *.\...*.**\ ******\*...\ . . \* .*..\   .. .*  *..**#
#       #.*..##.   . \ . **... **  ** .\*    *.*  * .. \ .\ .  . \\\..*....* \ .*  * . . **.**\. \.\.\.\.*.  \.\ . *\.* ..*..*...#
#        #.\# *.\  .* \ .. .\.**\**.. .*. \.  ** ....*..  *  *.\ . . .*\.  *\. .. \. .* .  \.* .* \..\  \.. .   \ ....\ . .\\..\.#
#        #*.#*.*****\ *  *\.* *...* * .\.  .\ .. \ \****. .*.*.\. *\ *. .***.....*.*\.. @* . . *. .\\*.. \ \..\........*.* !  *.\#
#         #**.  W...  * . .**.  @\.\...\. *.*.*...   .. * *. .. \  \*. \ @ \ .* \.*  *  ..  **..\* *.*.. .*  .  .\  .\***.*.**...#
#          #*...\..* .*\...\.\. *..*\  ..\.\\..** .*.\**\..* ..\*!. .\*W.**   . ..*  ** **  .. *\ ..*.\..!.. *.**.\.**. R.. ..  \#
#           ##  \.*.  *  . ..*\ .\....*.*.*  *..\ W . ... \.**.*. . *** \* \*\ .\ ..*.\ .\..* . .\ * *.  . . **! .* ..**\ \ ...  #
#          #.   ..*...**\ * *.... \. \.*.*. *.\*..**\.*..** *.\*.*. * . .. . ..  \\ .** .. * * * .... . ..\*... .*.\. .  * .   .\#
#         #*.. *** .**.  ... \ .**  . .. *** * .\.**..** \  . ..  *.*.**\..   .  .  .....*** .\*  . *. . \....!...    ..  .* * . #
#          #.\ .\. **.. *.**     .\*.  *....\ .\.. ..*..*\..*.*\* *@.*\  . .. !** .  *.. \.*\. .\.. ..  . *. **\.  .. ** .** *.* #
#        ##\ .\.. \\..* ***.*. *   ..  .  ..*. .  *. ...*\...\* .  .\...\ \  \.*!....*\ ...*\..***\.**.. *..*\\.    **\. *..\*.. #
#       #**# .... ...*......\.   .*\.. *  .*... *.. .*\  @... *  \. \* .*. ..* *.\***\ .  .. . **..*..* **..\ .*.\*..\**.*.\ *.\ #
#        #\.\     * *.\*..\.*\*.* ....  \* * .**..   *.. **. *..\.\.*\ .*.*  .*...\.*!*\* . .*. ! . **. .  \  .*  \. * . *..\\ .\#
#        #  \*... .* ...\..*. *\..  .* .***\  !.  \*@. * * ..****. *..**\*.*.***.  *.*.* *\**\*.**.. .*.\ * .*..*\ \.!\.*. * .\ .#
#       ##@**. ** .. ...* ..\...*.*.\. \**. .*\*  *..*..*.**. *.. \ .. .. *.*\.....*\. .  * ...**.  .\* .*.\ . ..*..\..* * .. *.*#
#    # #. ..\  ..  .\.*..**\*  ..  \  \. ........ \..*. *.*!.**\ *.. * ** .  .* .*\..* *...  *@\.\. *\ *.*..\. *    . ...** *  * #
#   #\## . L*\*\*.. *   .*.*.\..\.*.  .. .  ** . .***.*  *.  .* .\.. *\*.\  \ .... . ..**....\****\ \.      *. *.* .\ * .*.*\. . #
#  #\.\\.  .**.\.\ .  .*\. ...*.*\*. \. \ . *.  . .*\*\ .... *\*   . ..*** *.   * . \.....*.  ..\.  . *..\**\! ..* .* *  ..*. ..@#
#   ####*..##.\ !  .\*.** . .*.***..*....  \.   *  .**.\.  *.\*. . .***\.*..... ..*..*  *.  . .*.*. \..* *.* .\\*. .* . \*   \. .#
#       ##\\... \. .\.. \  **  ... *\ \.**\ .** .\.\.* ....\ ..... .\. .*\**  ..\*\  .\\*.  ... . .*.*.\ ..   **..  .\.\.. ...* .#
#      #\*. .. *.* . ..* . .* ..*.\.. \.*.. .\ *\. .   .*.\*..\ .. @..* *..\.. *. .\*.**.**\ .\.\ \*\. .  *. .   * *\ \   .   .\ #
#       #*####.. ..\. .*.. ..  * ***    .** \ .*   *\.  .. * **. @*.. . \ . .\*..  **.*\.  \ \  .  .\*\!\....  \*.  **** .*... .*#
#        # #*##\.... ...*\* * \.\. . ... *... .. **...*\ . . .**.**.**   ....*\*  *.. **. ***. ...* ..*\*..  *@.*.  ...\. .\.  **#
#          #.*\!\ .\..\ .* \  *.*\ .    \.  \ .\....*.\.\ . \.. \..\.. *     \*. .\.  .*.\.. ..\*.  **.**\.* *.\*. .*.*..*  *  *@#
#         #\*##...***   \.\.. .. \.\. *\.\*..\\**.  *    \.* ....* . \\..\ *  .    ..\.. *  .*. . *\..\ .. *\.@..*  ..\..*. .\ .\#
#          ##.*\\#.\.\. . #. .*  .\** * \.....\ . .!.*..*...*. . . . . *****  \. .  .*.\ . . ..****. . *..**.** . W.*.***!\  *.\.#
#            ##* #.  .... \  * .*.\..\*... \ ..*. *.*. ..   ... * *. ***\. * ....   *..  . *  \.*...* ..  \. .* .*.\*\*\.\*...\  #
#              ###**\*  *\. *.  . . ....  .** ....\***  \*  @\...** .*\.. \.\   \.\ .    *\. \*\.    \. \.. . \ *\..\   . *.*.. *#
#                #* ..  ..\..  .  .\ ... .\**\ .  **...*.\.\*.   ..  * ..*. *.\. .*\\...  ..*.*   ***.*  ..*.\*.**\.@ .\\ ...\ ..#
#                #**.. .*.\ *  \*.*..\!*\  *... . \** *\**\  ..\..* ...*... . .\  **.* . \. .\!\. .\ \. * *......*\.. .... **  * #
#                 ##\.\ .. \.   .*  * *\*.\..* \....****.*!.**  .\****\.. .\..  .*\  .*. .*\* . .. ... ..*..  \ ...*.*.\  ...* . #
#                   #\ .. *.\**...\.* ....* *.  . . .*..****  *. .\\.\* *.*..... . \* ..* *..  ..\*\.. .\** . . ..*..!.  W \.\.  #
#                  #\.* . ..  .\. .\.\ ..   *  * .*  .  ..\*  * .!\ . ***.*.  .*.**.. ....*.* *..*. \ .***..*  .*.* *. .. .. . \*#
#                  #*###. \ .# .*.* .*..\. *.*..... .. . * ..\.* .\ ..* .*\..  * .* \ *.  ....   *.. *\.**....*.*\! \.* *\  . *..#
#                   # #**...*   . .. \@**... *   ....\**.. *.*. . .\*.** \.    \.\ .\*   *  .*.* *.. ...... . ..*\\  *   ...  **.#
#                     #.\#  \..\ * **. *.  . .\.     *..   . **......*.**  \*.. * .*.* \*.* \.**   .*\..\ . .\** . .*.  . ..* * *#
#                    #. .* . .   *** .... . .\* *.* .. . .\ .* ...\......*.....\.\ \ .. *\* **..*. \!**\*. . \*..\ .@ *.*.*.. \ .#
#                    #\ \ \ .\. *\.....*..  *...\ . *.* . .*  \\.*.*\ .\.   * .*  * . *..*\.. .*\. . \.   .. ..W.*  ...  ...\.\.*#
#                   #.... .# * .*\*\.* ***.\.* ..\  \...\ \*     ..*.....   **.. \.**..\.*.***\..\ **..  .. .\*.....   \*\**... @#
#                    ##\.  . .. .**  * \...\.*  *.\ .... *..*.*.\ \.  . ...   \ ..*..   *.\*. . \*. @\..*  ..* .*.*** .. . ..**.*#
#                      # ...* ! *.\     .**... *\  .   * \* . .\* . \.*   \  *\**.\  . .\*...*..*...* \. .  ..  *...   .. \*..\..#
#                      #\  #*\..\*.*\.*\*\..*. * \  . \* .*.*\. *.  .**\*.. *.* .\ ..** **..**\\*.* \*.\. \. .  \ \.**  * **\  ..#
##################################################################################################################################

Water 0
Flooding 0
Waterproof 6
Razors 42
Growth 5
