##########################################################################
#@**...\.\*.. @.* \ \.\*  \**.. * **\*\.... .*.......!\*.   \ ..## ..\*# #
#*.\.*.  .. . .\.\! ** ..\..\ . \..* *.** . .**\.*\ * # . . . * .#.. *## #
#... * .\.\**\* \  .*\***.    .\.\..*\ *\!\. *..* *\.  \* \.* . ...*  # ##
#..*\.\ * ** *.  .**.   *.*. .  \ *... .. *\*..\. . .\..\..! . #*##\.*\ *#
#.    ..* .\*\ . .  .*....\.. \  \*.\ ..* *..*..  * *..* . .....!*##*#####
#\\...*.\ \.*** *.. *.\ .\ \.*.. ..*.*!\ .*..\. @ .*.\ .. \* . * . . .#  #
# .*..*\ . ... . .*....\.  *\*.\ .\*\..*.  *\. .. *. ** *..* . . *.*\..# #
#. \**. . .\\  * *\\*.*.*.*.\... ***.* \ ...\.*\..*  . \*\ .*  \ .#*.##  #
# **...\*\*.*............*.*. . * .*@*  . \*. *..* \.\..** ... ..**.#    #
#.\.*.\.\ *\*  \. * ... .. ..\*.*  *...\ * .**..\ \. . ...*.. * *..\#    #
# *.**. *\*   *  \.\..* .\.  * .*\** ..*\.  .*. . .   *  .*..*.#** #     #
# \ .. \....!.*\..* .. \ ..\ *\ \ .@*  .*...***.** \**.\  .! .##\## #    #
#\  W\..   .*\.. **.\\*.   ! . *  ...  ...\*......* *.  . *   ..#\##.##  #
#* . * .**** *.. ** !\ *     * ...\** **  .\.\** *. *. *.*..  \## ## #.# #
#*. *\ ..!. ..\ \** \.*.\***...*  **..*\@... .*. \*\\.*.\.*....##  . .\# #
#.*\!.. . ..*....*.. ..\ .    ... *\  . *. \. ...**.....  .\*\ *# .\ ..# #
#*..   *\ .*.* *.* . \.*.*.*. .\  * .. .*. .   * *.\. .*.*..** @* ***\.# #
#**  **.. \*.. \@.\.\...\. .. ....***\  *.** \.*.\ ..*..*.  *#*.*.*\#\#  #
#.\*\*\*\... \ ..*..\. ...!*\ *\ *.** . \... . \* ...*..* .*..**# .*\.#  #
#*.. **.   . *. \..\.    \ \ *.*.\*.*  \ .* *.   \.. **..****  *.\  \#   #
#... . **.\..*.*.  . .\  ..\.**!.. .\ ..\.  *.\* \ **\..\..**. .. #\#    #
# @.*\**. ...\@.*  .   * \ .**.. . .. *    .  R.. *. .     #\ \.  ##     #
#..*...* *  . *.. @.  ..  . ***\*. .... .*.. .. .\   ..\ **..*.*...#     #
# \..** \..\*.*    ..  .*....*.....\  \.  \   * * * . ...*\ *...\ *.#    #
#  \.   . \*\*.\* ..**.    \ .. .**  *.*. . *.*.. ***.\.*** .. .*\##     #
#*.!...@.**  .* .\   .\.\ . **..*.*.\. . . *\ ..\ \**.@\**.* * .##       #
#..\* \\ .   *. .\.**... * ..\*....\**\ *\ .* *  .  .   ..\.\  .#        #
#.\. **.   *.\\.  .*. *. .\ .*.... .****. .  .. **\* \*\ *.. \. *#       #
# ..**. .* \  *.*\ .**.. \.**\. .. \.\*\..*@ ** .   \.\*. .# ## .L##     #
#*  .\. \..   \*\*! ..!...\\.  .\. ...*. .*. ***.  **  .*...\. @  \ #    #
#  ....  .*\.*.**\  .***.\*.*\ **  \ ..\. ....\.!*..*   .  \. *  .###    #
#*.  .*.. *. .. ..*  .*.\..\. *.*.*. . *.*.* .*.  * . ** \.*.. .  .#\#   #
#..   * . **\.\*..** *\. .. . \....** .*. .\........ * . . .\. .** .  #  #
#*\ *...*.* .. *@*...**   .\@\.  .\**. *.* . \ *.. \ \* .\. *.. \*\ ##   #
#*       *.. \ \...\*...   ...* .  .*..\\*  \.\.*.\.*. *\.. *  ... #     #
#\   .\*.* * * . * * *\*\. ..*..\   ..  ..*\ \....**..*..*  \.* .\##     #
#*. *.... *. .   *.* . ..*.\ .**..   ..* \....*   *.* ** .#.    . *\#    #
#...\. .\...   .*..*W.*. . **.\\*. * .* *. *.  .\\  *.#\\.* .\.**\##     #
# .. * *..\. .***..**\*\***.\....\...*. ** *.. .*  .* **.* .  ..*#       #
#\   * .\* ..**..\ \***...*  .*. *\  .*\.  .\  \  . .\.**  @ **##        #
#*.. .  .. ..  \.  .. \ .    . .\ \ .*.. * * \ ..* *.. . ..\ ..#         #
#.  .\  ...*  \.  .\. .   \.**\ *. . * \...  .*... ..\ .  * ##*#         #
#** . . ..*...  ...  .. ...* . .\.*\ \*.\ ..*.  *  *  \ * *. .##         #
#..  .* *.......@. .* .*\...*.... . ..*\*... *.*. .\ ...* *** .\#        #
# *.\**... .\ **.* ...\. \.  *. .. @ *.*W...*.!...*.*\. . ..\.*#         #
#\**...  .    .. \ .* .*\.\*.. *.**.\.. . .*.* *....  \ .# ##..#         #
#*\..!\.** *   ..** .\  .**..*....\  .**** \ \.. \ .. . # #  ##          #
#.*    *.\  \.*.\*\ *. . .. *\*.\.*.*..\.* *... \.@ *. #                 #
#* ... .. *. *.\ . *.. .* .**.. ..*. **\.\. * *\. ..\#.#                 #
#* \ \ .*\...*\*.\* \  \.\ ..***. *\*.\.\.  ..\.*.\   ..#                #
##########################################################################

Water 23
Flooding 17
Waterproof 5
Razors 46
Growth 35
