##############################################
#          #.#                               #
#          #*#        #                      #
#         #  #    #### #                     #
#        # #.##  #..\..#                     #
#       #*#.\\ # ##\*\*##   #                #
#       #*@....##.*.... .###\#               #
#       #*.    ####\**\*.#\#*.#              #
#    #   #\*.*\.  .. *.*...#..#              #
#   # ### #.\ *.#\#@ ...**.#..#              #
#   #.L .##\... . ..*.**.*.  ..#             #
#   #....##.\\ ..  @\**\. .# *\.#            #
#   #*\####..*.***..  \\.#.# \.#             #
#    #.  \ * * .\.*..\* ..\*.\#  # #         #
#   ##\.\.\!.*\...** ..* ....\# # #\# # #    #
# ## #*\.**. ...\ *.  ..*#. . .#. **## #.#   #
##..*#.**.\.\ .*   .. *.\ *. .\*\*.**#\  #   #
## *##...\ ... . .** *.*. * .\@..\# ....*#   #
# *... *.   \...*. * .*.  ...**....\ *\ ..####
#. .*\..... .  .  .**.*.\ * . \ *. ..#*\.*\..#
# . *.**.      **  .. *. *. \ **\... .*.* # .#
#.*. .*\. .\  \.. . . *\..*.. \*.. .*\....!..#
#*...*.*.\* . . . .\*@W\.***  ...  ... \ *\..#
#..\\.*\* .\.* \* . *..  .*\....* .\. \.\\ *\#
#    *\ . . ....*\..*W *\..***\.* *.    .* . #
#*. .*.\ @\. *  .* *.\.\  *\*\. . @ ...* *\.*#
#..\*....**. .   ..\\  **** * .\ ..   ** \ \.#
#...*..*..** **.  **  \*... *\*..*\   * *  .*#
#***\*. .\.. !..\***\ .**.*.. \.. .. *\ .*..*#
#.@. .  ..  . .\ .\..\@*\... . *@\  @***... .#
#...     .\ *\ ..**.  ... *\ * *\.\ ..**. ..*#
#  *.  *    \.\ .*.*..\. \.  \ ... **.*.*\*\*#
#@..\...****.*. ***.  ... *\ .\. \ .\ *@ *...#
# .**.*.*..\**  .\ *\.*.. .. \ . . \.. .* .*\#
#  *\.. * @...\. .*.  @ \.. .  *\ *.*..*! \ .#
#**\.  .. . \.... !.*.*...*. . **\* ..\..... #
# .*.\   .. .\.. *..\\*.  **.. ** .\ . .. . .#
#\ \ .* . .\*.*.*..*. .\ .... ... .. .\ .... #
#.*.** .  . * *.@ ..  **  .\*.  .\ .\*..*. . #
#..***  .\.\*.*\*\*\. **.**. *.*\* . .\*\.\. #
#** *..\..*..*. ..W.. *\.*.*..***    *.\*...\#
#*\...\*.*\\\\*. .    \.\ .. .. * .\*.. *   .#
#**W W***..\**.. \*** \. .**\ .*.\W *.\.\ ** #
#.\  *.*\   * ***... .  ...... * B\.\\  !*.*\#
# . .\ . .... \..\   . **\*\* *\ \  **. \.\.*#
#**\ !*.*\* .*.*\.* **\*. * ..\**. .* *. @. \#
#.* ..  . ..*.\* \  *\*\*..\*\ *.\    !\ .  .#
#*..\ \*.*\ \ ..\  ...*.. *!*\****. ..  .\...#
#\*. *.*\\  \ *    .. .\* . .....\. * . *.*..#
# *.  .. * .W\ .\ *..\. .. .  . **\     !*\.*#
# * .\ *****. *\.\*. ..\...  *. .. .\* .*\.\ #
#*.\*.* *.*.\**.*.... .*.*..\.... .\*\  . .* #
#.*@. \* *.*.*\*.**....*\*..      *.\.*. .*.\#
#**** ..\.  **.*\ ...**.* \.*   ..\*.\*.\ * *#
#\ ..\  **. **\.   * \.**\  . .\. ...\..\ ...#
#.*.\..  ......\ .*\\\ .\...*   \  ...*. . ..#
#*. ...\ . ..\ ... ..*.... *.\.\**\.\ \* .\*.#
#** .\. * .\ *. .\     \\*. **..  . \*..* .. #
# **.  .** .*.. .*.  .   *.*.*... .\..\ ..\.\#
#@ .\ .**. * .*. * .* .  !. . .   .*   \ ..\*#
#.*\*. \. .*   *\*\**\.*.**  .\. \  .\ .*.  *#
#.. .* **. . \...*...* .... \*.\.*E\*  \* .\.#
#\.*\. ..*.\ .\  .*. *. \  \..\    ..\.. .\*\#
#  . \.  \ ..  .  .*...!\ ...\   \....*. . . #
#\.  ...*..  *. ..*\*   .. . *..\..      .*..#
#.**.\. * . *.\*  .*. *\..  \.* .  .\**** W. #
#\.**.**....  *......*.\..* .  \... \.\..  * #
#. \. ..  .\. \*\\@. *. .** ** ..!...*. *\ \ #
#. *.* \ . .  .. ... .\  . .*!*. . .\.@...* *#
#\.\.*..*\..* .\*..   .  ...*\..\ *. \.*\****#
#*.*.*..*..  .*. *\.*\*.*\ \**\....\.. ! .*..#
#*.. .  ...\. *\.....**@\. * .. . . *....*\**#
#\**\.* . .*\ ...\. .* ..**.*  \*!*..**  * *\#
#...*     ...   .. .**\...**.*\..*.*\.*  . ..#
#* * .\.**\@.\  . .\..* .**.. *. \.W.. **    #
#*\ * .**  *.*  *. .\*.* *\*. ..\ *  *.... *.#
#*..*. .. ....*\*\\ .**. \   \ . \.  **\ .\!\#
#. *..*\..\\ **..*\..*. ... ...  . . ..**\.R*#
# **.\*.*W* .*..\.  .. . *\ .*.. . *..\.* @\.#
#\..  .* *. *\*\  \.*\...*.. *\.  *** .*.*.@\#
#...\ .*  \*.*...*. .   . ...**\.\ ..\*..\  .#
#.\*.@@. *   ** . ..* . *** *.\*@*\**..* . . #
#** *\.  @.*\ .*  .\.\  .\. . *...  .**. .@ .#
#.. .. .** .*. .  . .. \*.*.**.  . . .*.*    #
#**..\ ... .*.   *\ . * .*.*\.\   \\**.  .. .#
#\* * .. *\ ..\*\.\  \..\. . .*..\  **\* . ..#
#..  \  ....\. .. . .. \.* . .*.**..**. .**. #
#*......\.... *    \ *  . ...\.\*.* .\.*... .#
#. .\ * **\  *\.\..**\ \*.. \.  \* .....   *.#
#. .  *\.. .  .*.. \*  ...*. * ...   **    .*#
#.   . *..\\  ***  ...  .\ *  \*..!.\.*.\ \.\#
# *\ * \.*.*...* .. .\ .. \. *.*...** .\ *.\.#
# .\... .\*..\. .   *. *\.   \..\**....*.\.  #
#*   .\   .*.\**\@*..*..   .. . \. .. \.***. #
#... \.\....\ .\ \..\.\. ...* . .\* ** \. .*.#
#  *. *. @*\.*\. \ \* *  *. .. \*.* ..*.\  . #
#*\**\*.*@. *..*....* . .    .*.* **  .\ ..\*#
#. ..*\  ..*  **.... .\ \ *.\.**...*...   * .#
#. .*...* *.. .**. ..**... \**.. *...\. **.. #
#   .\* 1.. \. .* **.\..*.\.*.\ \*  ..*  \\..#
#.*  .4*.*\ .\. .**.. . ..  .**...\**.*...**.#
#......* \.\ .\.\. *\*..***\..\  ...  . \.*\!#
#  *...   *.*\. ..*...\... *.\* .*. \.\ .* . #
#\*\ .**. . .*\.  *...*   \*\*.*.\ *.@.  . . #
#*.***. . .   *..*\*\**..\. *...**.\.\* .*. .#
#*  \**... * ... ! *.....**..\\..\**. *\ *. \#
#.*  *\**.\. *..W\.\*.*.**.*\*. . ..*.*.**\  #
#\ *\ *!.\!.\**  **  ..  ..****    * @*\** ..#
#...* *@\  *.....*. ..*\ *\.... . .  **.. \**#
#. \.**. .\..  * *\*.\*  .* \!\ * .*. . .. .\#
#* . *.*.\ *.\.*. ..\....* .  . \.**.\. * ..*#
#. *. ..       .  . *.*. \... .. .*.*. \.\*..#
#\ ..\.* \.\*.*.. .\*...*. **\  ..\ .\*..*.*\#
# \  .\\ *..*.*\*.. * . .  ...*.. ......*.\..#
#\. .*\. ...**..*.* . . *\.. .* \..*.\***\*.\#
#.* .*!.*   \......\ *... *   ..*.*.\..@\..* #
#**\ ...\\ \.\  *\* .\.. *...*.\*.*......  . #
#***.\ *... * @.**.** . .\*\.  *. ..\*..\ .**#
#\.    .*. * *.**@\.* .   .* . ..\**..**.* ..#
#. ..* *  .. . .** ..\ .*\\. . \.***  \ @. ..#
#\ *..*...  \ \ ** *. \ .@.\ .\*.\** *. **.\ #
#. \....\. .. .  * \.. .@\. \ .. .\...  .!\ *#
#.   *. *     *.@..  .. ** ..*D\.* *..*\*.*.*#
#. .*\.\..*. .. **\  \* .**  .. .... *\.. *\.#
#  *..\..\*\   \*  .*.* ..\ * @.*\ ..*  . ** #
#  .. ..\.*.\. \*. \* *.. . \\. . \ .* ...*.\#
#\...*...*!*.*..* .!... .*.. \. *.*. *  **\.*#
#.  ****\* *@\. ..***. . * . . . ..\.. .. . .#
#*\ **\ .*.**   .*.\. .**.\*.\  *  .. \* ..\*#
#.**..*. * .\ .*....\* *. *.**.*..  .\ *..*..#
# .\.\ ..\..*.*.*. **. ....\*. .*.* .**..*  *#
#...\. \*.. * . *.*.\   @.\   **....*  . .* \#
#\  * . .  \.  *..\.\\*\...** ..\*\\.  *. ...#
#. ..\..  ..\  *\*!.W.*.*. *..*  .*\*.*.*. *.#
# .\   . \ .*\ .\. * ! *.  .  **. .!*.* .* ..#
#   *.\*\. ...\  *.\  *.*.\.\*\ .**.* ..\.*.\#
#.  .\ . . *  *. *.  ..\ \\\...*...\  .*\ . *#
# .*.*  ***..***\..... .*.*. \ .* **.. .* * *#
#\ . .  .....\.. .* ..* **.    *...W\.\ .\**W#
#. *.  *.**\...* .\  \..*..* *  \.*\ \ \**.A #
#* .\\..... \.*..\.* @. .  .*.@ ..\. ..\*.**.#
#* *..  .*.*. .*\..**\..*  .. ...*.*. *\.  *.#
#..*\. ..**\.* . \\.. .\** .   . .\. .*.\**.\#
#..\.\ . . *** .\ ***\**\*   * .@*.. \.**.  !#
#\ *.*. . .\.\ ..*...*..*. .**\ *.*\..\...**\#
#.**!*...\. . ..\.*. \...\.  \.. ..* \.\.\.. #
# ...**.. .*\* ***.* \ *\ .  . **\ .. ..* ***#
# . *.***. ...  .\...\** .\* .\ .. \   ..**\.#
#* ** .\..   * *. .  ....\** *.** \.*.*..*..*#
#*  . \.*. *.. .* . . *\\ \  * @*..\.\.. . . #
#***.  **  .. \*  \..\. .  .\**.. *  \.\ **. #
#*\* ..\.*..  *..\!.*. ..*.**.* .**W  **!\.\*#
#\ . \ .\..  .**\.*\*\.\ ...* *\\*. * ..W.@..#
# \  .\.    **\**\.*\..*\*. **..*.  .\*   . \#
#  .. *. .*\\ *\..\.....*. ..*...* \. .** *. #
#\  *\**.**...**\ *\. *.... \.....\.. *.\.*.*#
# .\ @....\.\ .*.  .\\.*.\ *  *.... \..@* ...#
#\*\ *.*  . *@ *  . .\* *.*\  \*** *.. . * \.#
#.* *.\. **..*..*\ ..... \*... .** * . ...*. #
#.*\*.W *.... .. .* .*\....*\*\ ..@  .@.\ ** #
#*. . *  *   ..**.. \ *   .....* **\**\ *.**\#
#*** .. ... . *\!\  ..* \ ... ..*. *\... *.. #
# ..@  .*\     \**.. \*...  \*  **... \  .\. #
#.\ ...\  .  . ****\*!.  ..*... *...\\..\*  .#
#**. *..\. @.* ...***\.* .!.   **.\*. \*.....#
#.\*.*\ . ... ** \**\!\.  .   ***. . ...*. . #
#\ ....*\*  .*. * ...*.\.\ .* . . ..\ *..*. .#
#** *. . **.*\.** .. .* . \ .@..* \ *.... *\\#
#.*..\** .. .. @@. \. *  *.\ ..\*  ..   \.. .#
#.*. ....\* *.. *\ .* *..* . .  ...\\ *\  C. #
# . *\ .\. *....*!**. .* .*.** \. **.*. .\\ *#
#. @.*W   . . \...*..*.  \..*. .*\..\....* .*#
# .\\W..*..**\..*.\ .@** .* *  .* .*  *\...\.#
#  7..*.*.\.\ ...  *..*.\..**\  .... \..   ..#
# \***..... .  *.*.**\.. * .*   . .\*..   .. #
#\.**\*\ *..\\ * .*.. \.\.*..\...\. . *.*\.**#
##############################################

Water 70
Flooding 0
Waterproof 18
Razors 15
Growth 10
Trampoline A targets 4
Trampoline C targets 1
Trampoline B targets 7
Trampoline E targets 4
Trampoline D targets 1