#################################################
#.*C!. .. \3\\. .*..\F*A...\   .****  . R. # #  #
#..***\.  G....*.*.I. ..*  .*   .. \.\@*#.#\#*# #
#*  ..  ...*\\..*.\. ***.\*.***  *\. .*..##.. # #
#H    .\.\ ... ..  \  *.*..\**  \.*  .* . .**#  #
#**\* .\*.. *\. **..D.* ..2..B .. .   .*@ #  L###
#*E...  ..*.7 .\*.\. .*. **. .\ ! *\ *. \.\..*\ #
#*\ .\  *4. .*... * .*.  ..  . ..\** ..    ######
#. .*. *   . .\ \.\ .* *...!.*..\ *\ ..*\  #    #
#################################################

Water 7
Flooding 12
Waterproof 14
Razors 24
Growth 32
Trampoline A targets 7
Trampoline C targets 3
Trampoline B targets 2
Trampoline E targets 4
Trampoline D targets 7
Trampoline G targets 2
Trampoline F targets 2
Trampoline I targets 4
Trampoline H targets 7