###################################################################################################################################################################################################################
#..*.\. *\* *****\*\ .  .\.*  **. \* .  .*\*   ......\.**..*!*   . * .\...  *\* *.\\.*\..*.\.  \*.*.*\.\* **....*...  . ...\... .\ ..@..\.*.*\*.\\.**** .\ \  \**.... *@\.  ....* . .* *! !*  ... .*\ .\  #. ##   #
#**.** ...*...*...   * *  @.. . .  * .  *.*. **  .. ****  *\**...   .@*.\  *..***. .*\.. ...\ *. ... .\..*\..\  ..* *.\  .****\  .*\ .*  ..*.\*..  .\**.*..\*  ... *.\.*..  ***.\..*. . \*.\\*@  ...  \  .#\##.## #
#*...*\* !. \   .. ... .  * \.* *.*\  * ..\* .*. **** .. .  ..*. .**\ *.*..* .... *.\ . **\*  ....\.... \\* \..  \..*   .\ *.* *.\. \ .*  **...\\..\....*....*\.*.\.....\** .* *..!.\ \ *.* .*  ..*\ .. .*\.\ . \##
#\.*\.*  .  . \***   *. ** .*..* ***.*.  .*\ \** \..*.\.  .!. **..\.. *   \..\. \ . *.  .. . *!\.. *. **\ .*. *\\. .   *.  .   *@. ..\.*  \  * . . *.*.\  **  * ..  *\.* ....\ * ... *..\.. ...* **  * *  .\.*.*# #
#* **.\**\ \ \ \ ..**** . \\*.\.  .!\*...** ..*.   \.\.   \ . ..... \...\. \ ..  .*.**. *.*\ .\ .**........*... .*..*\ . .  . * \     *. \* ..\*. \.* \. *\.   *...@\*...* .. .* .**.\. .**\. \...\* .\* .*.## *.##
# ...\. **....  * .. .\.\  .\ *.. ** \. .\. \....\ ...*..  *   *   * \..\.*\ \.. * \***.. .*. **\.*\ *  *.\.**.**..*\* .\  . .....\\. *\\ .. ... . * ...* .* **\  *..*\*.. \....  *.. . ..*.*. *\* .\ . \*. #.\.###
# .* **... .*.*\\.\..* .**.  .*   *.*.*** . .  .\..\* .!* \..**.*...   *. \. *.    ...... .!. .*. *  *. .\. ...**\ *.\*. . **..* !***@.\. @.* .**  .W.*...*..* . ..*\.*. .*  *    \\*... *\.***......* .  **.*  ..#
#*.* *.\ \ \. . ... .   .*\ .** .\*...** . *\. *\. *.*.*.\**...*. . .\ . \*..\@.  *** ..   *. \W.\.* **. **\. ***  . \  *. *\ .. *..*.*..\.*..*.\..**\ *\.\ *. \.*\*...**\ .\* ....\.*.** . \*..\   \*. ***. *#\\##
#*\***. *\** \.**..\..   .*.\*\ **. \ \..* **. ..@.\\... ..* .\*\* ..  *.. \*\*\..\.*.*  \.*. .  . .\. .**..  ... .* .**\....*\ * ...    .... .*.!.**.* .*..\.*.\... .* !*\.**\.\\ ..  ..  \ ..* . .*. ** .*#.#.# #
#*.*.. .* ...  ** \* *\*\ .....*.\. . .\  . \ .\!...* .*\ \.\.* ..* \.\**.. . ** . **.\\... ...   * *\ \* **.* **. .....**\..**\ \ \  ..  .** ..\..!\**\.*\* *  \ ....* \ . *.  ****\ ! * \ . ..  **.* .. *\. #*# #
#.*. *W\.  @\.\. ..  ...*.*.** \ ..\*.*.   ***  \.*\.\.. ...*..* .. . ...\\!....\....** .    \**. .*.  ..  *.** *. \ .* .\.*\.*   *.* .**..*... .*..@*.. . . . * \.  *  .*. *  \\ *.*.\.**.*..  .. . ... .* *\ .# #
#.*.\ ..*.\.*.* .  .**\..*..*  *.  ..**\  \\.. * *..\..  . ..  .*. . .*   ** .*. \.... . .  .... .\.*... **.  .... .. .\ * ..*\ ..  ** .* ..*.  .\ \**\  .\ * ..  ...*.*** *.. ...* .*. ...\*.*  \\     \ ....##  #
#\..   \.. *. \.. *...   ..\.* !*.**\*\ .*.   .\*.. * .    .*.  . .\.* . ..*@.....*  ....... *.  .. .  . ..\* ...*\ **\* * \\.... ...*.\.  \. .  * \* .\* .. *  .*  . ....**... ... \..  .  *\. ... *.* .***.*#   #
# .\*. .. \.\\.\*  .\ \\ @.. *.\\... . ...**** ....*\*\. *.\**.\***... * .\..*.*  ..\* *. *\. * @ ...\..* *** .*....*. * **  * .*. .*.\ *....  * .\.*   ..*. .\ ... \ *.\*.*\ *\ *  ..* ..  *... .*  . \  .**.#   #
#\ *!    \.  \**.* *. \..**... ...**\. .  .*. ....*.*    .*... *..   *..\@.  .** \.\*.*.* *...! .  *** *.\..  \*.* *.* .\ .\..*\  * ... @. \**. \..*.* . .*.\.. .....*.*.@\ .. .*.*.\ .. .. .\ *.*.. *. .* .  #   #
#* . .\.* *\.... ...*\..\.!.*  . \*.  .  ...*    .  ..\.....*\ *\  *.*.\*. .*\.\..\.. . . *.  . .. .*.* *. .\  .* \*.. @.. *\.*\..  *\  ***.*.*\. **.. ** ...!  * * .\..\.. *.   ..  *\  *\ .*\ ..@*\.\\**\ !. #  #
#  * ..  .**.  .   *.**  * \\. \. *..@*\ .  .\ . \   .*..\@.\.\. *... *.*... ... **...\**   ..\*.* *\ .*. .*.. *\..\ .*. .\  .**. .* * **.... .*  **\.\ .\. *. .\ ....\* \.\ .* .*   .*.*.*  . *. *!**  \.\ .  #  #
#  .\..  \ ...  *.. \...\ . *\   ** .*\ ..* ..\.**.  .. *.*. \ * * *...*.*.*.\    .*.\ . \.** **@\ .!......*** . *...*** *... *.\. *.*.. \*...\ \.\. *\.*   . **.\*\.  . .W.. . *.\ \*. \ * .* !  . .* ..\ *\  #  #
#  ... \**\*\   ..\  . \**\*. . ..\  ..* . \   ....**.  *\..*.\.\\*. \*..\.*    *.\.. \  ..\.*..\   .\* .. .***. .\**\..*\*   .. * . .   .*  \.\. .**..  .. ...*.**. *.\\..**. *....\  .*.\. .\ . \. . .  .\   #  #
# \ ..\....***\.   .....**\..   .*. **...\ . .\  \ *\\  *.\ ****. \ .*.\  *. .    \*\..*  ** .  ..*\  .. \. ... .\*....\. *..\\  \*.\**.* . **  .\. \.\.  \*.*...**  .. . ...\ *..\. . \***\*. \.\.   .....  .*#  #
#*.\.\ *\*..\** . * . *\*..**.*. ...\..*...*\.*.* ***   **** @ *  .* . .. *\.  * .. *\....*. @.  *\ .*      *\\ *..   . \.*. .. *. *..*****...\\ *\***....@. \.\*. .*  .** .\..\  .. *  . ..*.. ...*\*. @.. ..#   #
#. **.\*.** .R *\ ****.@*\.*. ...\ .  **. **@!.*W\**.**.* ..\....  .\ . **. .\.*.  \.*  \*.\. \ *..\*. ! .. \  **\*.\ .*.\.*  **. .\ .**  *\* **\..**. **  **..  \* .***\..** * ** *  \**.**.. ..   .#\.#\*.L.#   #
###################################################################################################################################################################################################################

Water 4
Flooding 2
Waterproof 1
Razors 3
Growth 48
