#####################################################
# #***.* *  . \* .  \.  .F\   * \ * **... \ ..   .. #
##* .\..\.   . \.  \ ** \*.\.\. ... ..*  * ..@.. .*.#
##.  .*..\..\* .   * .\ .@ .\ \...\..**.*.   *.   *\#
# #.# \. . . *.***  . @...  . \  *.* .\\* **.*.  **.#
#  #.\*# ..\ .**\. \\*****\*...  .\.\* \. *...*.*.W\#
#  #\..  ..@. **  \ .*...* *@ . .*  .. @ * ..*.*. * #
# #\* . *\*. * .\.  \*\..!\ \. ..   .\.\*.* \..*4*\ #
# #L##* *.\ **.. \   !  ***\ *  .....*. *..\. \ * ..#
## # *. .*  . *... .*!.. .... *. .  .\.**.* **.*.\  #
#* ..\\. .   *.  ***.*\ .\..\*.* .\   .\. \.\  . . .#
##.....\... *.\*\.\\.*.D   * .*!* . * \.* .. ..  .. #
# ##*  .G#*W.. *..*. *.  @*.C\. **\ \ .*.   @...**  #
#  #*\#\\\# **..*.\..*\\ *\!... *\  .  . . * * .\. .#
#   ###.. .\\**. . .** *.*.*.\\ ..E\.. .\. \.* ..\. #
#  #####. *..\** 91\ .\*.*\\*......   ....\.**..\ ..#
# # *. ..*#*.!*.\.*. . ..*  *\** .*.*...   *.. ...\.#
#  ##* \ . .  .\\.*. .*. . ..\.. . @*. ..  .  \*R . #
#  #  ..     .\* \8*.\  ..\....\.! . \..*.*  *\.  \ #
#  # #\ . .*..#..**.*  .\ .*.\\.\ \*... . . .... *.!#
#   ##\#.# .*..* .. *.\. ..\.\ ..\.**   .\...*.\...*#
#    #\ ...\*A.\ **..**. \ **..* ...\*\ ***\.. .   .#
#     ###* .##**\*\..\.**  \ *... .\ *.*  . .\  .\**#
#       #*#**#.* \.* .... \.\...   ..\.\ ...* *.B\.@#
#       #.**## #.\ .*\\. *.\ \ *..* .**.  \....\..\.#
#####################################################

Water 21
Flooding 2
Waterproof 0
Razors 17
Growth 8
Trampoline A targets 8
Trampoline C targets 1
Trampoline B targets 8
Trampoline E targets 8
Trampoline D targets 9
Trampoline G targets 4
Trampoline F targets 8