############
#### # **\##
#* .## .. *#
###*#C. * .#
##9! B.\*\ #
##* \.\...3#
# #\.. \R\.#
#  # *# . .#
#  #*. * .*#
#  L*\.#  \#
#   #*##\..#
#    ###.\ #
#    #*.** #
#     #7\.\#
#     ## *.#
#    #\*A.*#
############

Water 9
Flooding 4
Waterproof 3
Razors 23
Growth 29
Trampoline A targets 9
Trampoline C targets 7
Trampoline B targets 3