####################
#                #\#
#             ####.#
#            #**.. #
#             #.\. #
#           ##\.#* #
#          # *.\#. #
#  #     # #\.**. *#
# #*##  #\#.#*.# .*#
#L#...# # ...*..   #
#*.#..##\*. .\.  .R#
##\***.. . .*  . \*#
## . .*\ ..!* *.*.##
# #*.*.#**.@****.. #
##\*! ..  W*\ ...*.#
#  ..*. . .  ..* \ #
# **...\ @..***\  .#
#.\.*  *.\. *\  \..#
#. *.\*. .\ . ..** #
# *\* .\.* ..\ .\..#
#..*  .  * .  * . \#
#*    .  .* .\. .\.#
#.\ .\*.* ..\* *\..#
#\*...**\*.\ *  . .#
#*.**\.!.\ * * \** #
# ...**. ....*..*. #
#... **   ** .*\ * #
#* .*.*.**.. * * * #
#** .*.. *\.\..*.. #
#!\ *. . \.  .*\ *.#
#.**.. **..  *\* .*#
# .\* * \ .. ..*...#
# .***. .\ **.*..\*#
#  * *..  \.*    .*#
#\...* \ .**.*..\ .#
#*.*..*\\***\.\..*.#
#..@*.*.!A  **.. .\#
#  *. *  . .2.... .#
#*. ...\.  \  .\  .#
#\*.\* **.*.***\.. #
#.!. . .. !\..\.\**#
#\  ..*..*  .* .*. #
#..\ ..\\* .\. *. *#
#.*\ .\*\..*. ..**.#
#.  *. \ . . \*\***#
# \ .*..\   *.....\#
#  \ ..\ \. .\.\ ..#
#\. . *.. ..\* .. *#
#  . ...**.. .*\ \.#
#*\.. .\. \**.** .\#
####################

Water 27
Flooding 19
Waterproof 11
Razors 14
Growth 42
Trampoline A targets 2