###################################################
# ..   . \!*!\ \ \ ..**. * .*\..*.. **     \*.* **#
#*.\.*. *...*  @*..*\.* * .  ...*. ..   *!*..\   \#
#.*...\ ..\ ..*** .*   \* * .\.. ....* *.@  @. \ .#
#*.. \    . . .** ..\ * .  .\ . *.*\.. .*\.***...\#
#\ .*. *\.\  .... . .*.\.\*  .* *  *     \*.\.* *.#
#..* . . *\* \.   .. . .**.*. *.*....\ .*....\*..*#
#\ ..  **** .**\* .\. ..\.. *\.**   \ .      *.. .#
#..*\ .*\\*  ..\..  .. . **  ... !. .!.*\.\\ . .**#
#.\... **..\ \ .*  . \.\  ... *\. .\ .\.  * ** *.*#
# \. F \*\..  . *..\ .*..\ !*..\* .   ..\ .... .**#
#**\......*  *..*...\ . *  *.  .  ...*** !*..***\.#
#... ....\.\ .\..\    \*  ...   **\  .\.  .*..*. .#
#  **  .. ** *.*\*\ . ..\. .  *.*.*... .**..*..***#
#\..\ .*. \...*\    .\*@\ .  \ .. . .*  .*. .\..*.#
#..  * . * ..\. *..  .\.\ \\\* \ . ..* \.\*  *\\.\#
# A ...** *  *9 ..... .. !\ ...  .D. . .. *. .**.*#
#* ..\. *\  **\    \**\..*\.   .\*... .*\..\ .....#
#\*   * *.\ .\**.**.*. .  .. . . .* ..\.*\ ..\.\.*#
# *@* ...@..* .  .*... * \. ..  .\.\*....****...\.#
#\.**\ .\.**** ....  . ..W.!.\   ..!\*.....\ !\.* #
#  *.* \*....*.*\*..*..* .*\ ..* **  ..*\ *    \.\#
#* .**...*\* ... ...\..*\ **\*\@ ..   \.*..*. * * #
#*. .*.... *   ..* *. ..! .*   \.  *.\** *..*\ *.*#
#. \ .!*.. *\*\.**..*. *.* **. . .*\ .\. *\ .... .#
#\....!*.\***...@!. ..\..!.*.\   ...**** @.  *  * #
#**. *..\.*.. *.. \. ...   . ...*\ ***....*.*.  ..#
#..* . ..*.* **     . \ .   * * . ...*  ***.*.   \#
#  . \*...\ *\!* ..\  ..* .*... !*\ \*\**..*.*.  .#
#*.* ...* . @  \... .   .. .. *\***..*.. ...*..** #
#* * .\... \....*\   ** \**\.*.**.. *.**\*.*.* .\*#
#...\   \*..\\ *  **  \ ..**.. .*..\. ..*.. ***\*.#
#**. .*\..\*. *\. \  ... *\..\  ..\ *.. .! ..*\ **#
#\ *\ . .*....\*  .   *\.. .*... *\ \..!\. * .*.\*#
# ..@ .\.\ * * ..  .*.* ..@*    ..*...  ..**..   \#
#*. \.\.. .\ . .**  **.\ .*. .*  ..\..   \*.\.**..#
#.** **\\  *@\ . .  **  ..* *\.**. *.*  \.**.*.8..#
#..\.  . ....*  *.**. .*  *...\.** . \\*...  \. **#
#.!... .*. . .\@*\.*\ \ . \*. . .*.. . .*\ .*..*.*#
#* ..***. . *..\.*\. *...*!....\.* **.** .@ .**. .#
#..  ..**..\. \* *. *.  ** **\..\.\.. ..  ..\***..#
#.. *.**\ .*\*.\ ***.\..**\C.* *.. *   ..\* .\*.  #
#.. ..\* **. .  ..**..   *  *.E.*.*.. .**..BH .** #
#* * \*.**..*.\ *.. *    ..!** *. .. **.... *\*.**#
#..\*.. . ...\!.. . @. *. *...\*.   \.\***\ **3.**#
#.. ..\.  **\..**  .\.\*  .**. .. *\  ....  .**. .#
#*..!......\ \ *.\..** .  .\.\ *..*.....@2 **W.*. #
#.*.\ ...   . .\ *. .\.\.. \.. ...... ..  .***  . #
#\ .*\**..\. *.\..*\**.W. *.. ...  *  ..**..*.   *#
#.. .* *. .\** !\.* \. \.... . ..\..\ .* . .**..\.#
#  * * *  \..... .* .  ..*.  .\ * .  \\ .*...  ** #
#\ *\*\.\.. \ .*. .***\\ \*\\.*.* * ...*.. *.  .  #
#..\...\. *. .. *.*...*  ... ...\ ..* \* *\.\.\.. #
#\.*..\ .\.*.\.. .\  .*.  .  .*.*..*.\ *.***. *.**#
#...*\* *.*\. .*\ **. *... .\ . .  .  ... **. \ . #
#*\ .*.\. . ....  .*  **. \..** \ * .** \ *.  .*.\#
#..\\* .*  .  ..  .. *.. . .  . \ ..*\.\.**.\.\.  #
#\** .*\..\.\*   .***..\  **.  ..*\ ..\..**\ \*.\ #
# *.*. . *   *   \ .*  .\ ..*.R  . .\*.*.*\*. ...*#
#\*..\ . \.!*.I*   **..**.\.. *. ** .* ..\ ** \...#
#.. .*. ..* .* .   .\\ .**.. .. *\.*.\ *.*..\...*.#
#*\ ... *\*  \ *** ...   ...\  .\...\* .  . . ..*\#
#\.... *\.!*   *.!\  *..\  * * \ .. ..  .. \.. .* #
# *.\ ..*\...\ ..  .*.....*..... . * .*.  . *..\.\#
# .*  .**.\...*.\..*.*  .*.@   . *.*....* .\.*..*.#
#*\ **. .\.  *.. ..**. \ * .*. .\*** *   .***.@.\ #
#. ..**. **  \ .\  .\ .\..  .  .*6\.\*.\  ... * . #
#. .\*.. \. *.*  *\  .\.**  ...\..\. .\ . *\.  ***#
#* \.. * .* .\**@. * *..*.\* . .....\ * *.*5    . #
#* .  *\. * . . *.\. \.\\ .  .. *\ G  *\.\*\ .*...#
#.\ .... * \.. *.! *\. . \  *.  .*\*\  .\ * .***  #
#*.*. . \**.  *\\\ ..*.*.    ..\.\***...*.. ..*..*#
#. ***.. .\.\. ..\ * . .* .   .** \.*.\.... *  #**#
#* \.*.. *.*...*\.@\ . * . ..*\..\.**..\\ .. \ **##
# **\. . .**.  ....\ .\!\. . . \.. .\.* *\   ..*# #
# *\ ..*. . . \ \.#  ..   * . \.. .*W.  *.. . #.# #
#**!.**** . @*.*.*.  .*** *. ..*\.**.\*.* \*  ##  #
#*.\.*..*.* .*.*\*..** .*.\ @* ....\.** . #\##    #
#\ **. ** .\ ..... .\ . . * ** \..\. *. #*.#      #
# \. \.\...*  *  .\*..  \.. *..*\\ .*.\#.#\L #    #
#\#.\.\.*#\.* . .\ ..\... @.\. ** * !\. . .## #   #
# \..*. . @#*. .\. *\... ..  ..*..*  * *.. * *#   #
#*.\ * .#**###.  .## *. .. \ .*\#.**.  .\.#*##    #
##\..   #*# #.\*..#*. *..\*.#**..#..*.\*###\#     #
# #* *\ ##  # #.  #.#..*\ ....\. ##. \* #  #      #
# #.\.*...##* #\ . ..\.*  .*  .. *#\*## .#        #
## ***.##*# ## # ##* #..  *..*...#*#.\* #         #
# *..\.# #      # #@\#\.*.*.. *\ \.# ###          #
# #  ##           #.*##.#*.*\*...\.#.#            #
## ##             #.##. ###.*. . # ##             #
#                  #  #..#.*.* *.. #              #
#                      ## ##*\#####               #
#                          #.#                    #
###################################################

Water 0
Flooding 0
Waterproof 6
Razors 11
Growth 33
Trampoline A targets 5
Trampoline C targets 2
Trampoline B targets 8
Trampoline E targets 2
Trampoline D targets 6
Trampoline G targets 8
Trampoline F targets 8
Trampoline I targets 3
Trampoline H targets 9