####################################################
#       # ..W*! ..  *.*..!.. ..* .  . *.\ .!* .. *.#
#      #*   .*  * *\* . * @...* .* *.*..*.* * . .**#
#      #*..*\\ \. *..  **\*...*\ .\ ..\.**.**\***..#
#      #.. . *\. ..*.\.*.*....\   ..... ..*...***.*#
#       #  **.* *\ .@ \.*.*.*   . *.\. .** *. .* .\#
#      #.\*.**  .** *  .  ... .\** *. .\@ *    .* *#
#     #**..*.* .*.  .***    \  ..  *.\ ..**\..\\. .#
#     #..\ *.*.\\* * ......\..\. ..!  .* \.*@ *\ * #
#     #\. ..\.  .* . .  *.\ * \*...\***. . *\......#
#     #* .\*.*.  .*  * .\  .*...* . *..*.* .. * .\*#
#    #**#\*  .   \*.**...*....*  * \*  .\...... *.\#
#  ##.*... *...*.*.\.\*\\.@ ...**.  .\*   *.*.*\.*.#
# #*.\*.*  \. .\.\. \..  *. *.  .\..\..  ..  .....\#
###.#  #\ \.\. *. \ .. \*\@**\ \   * .***\  . ... .#
#\ * \# .. . *.**\...* ..*.*..\   .*\*...... \ *..*#
####..  **.*\**** . .   ...* \.* ..*..*.  *.   ..  #
#  # #.*.*.*#..\ ** . .\ .\*\ *.\   .*.**\* * ..* *#
#   ##\##.*. .  * . .. *.  *.\ * *.. .  ..  **\\* .#
#     # . # \..*.\*. *\.**\. \.. ..\  . .***.... \.#
#    #\  . *.#\*.\.* .\ *.* * .\.\*.!* . **.*\ .\. #
#   #   #  *\.*#* ..!*. ...\. **. **\* .****\ .  .*#
#   #*. # #.#.#!*\ ... * .... ..*.\.*. ..*\.\.. *. #
#    ##*  #\ #* ..**\.*. ..* *  . ... *. .. .\   . #
#      # ##..\*\.\.*\**.\ *\...* .* *. . \. @\  .  #
#       # # ##*.  ..\*.\..*..\.*. * .. !..** *.****#
#         #.*.. \*\ \.    \*. *\..\  .\. **.   . . #
#          #.#\  .* .  .* .. .\*  .\ **.\.. ..  .*\#
#           ##  #... . **..*   *\.* *.  * .R  ..* .#
#           #.   ! ... .  **.\...**. .*  *.  *  . .#
#            #L..#\.!   . *..*\**..*.*\ .\. .. *\..#
#            #* *#* #.\* \ *!.W*#\..   *  *..\..  *#
#             #.#*\ \ *\  \.\ *\  *.** ....  !\ . .#
#              # #*\..\...  .*..*....*   .\* .*\  *#
#                # #.*.**\.*\.\.* \.. . \. *.*\..* #
#                 ## .##\.#.* .# . * ....*.@*.*\ .\#
#                 #*\#  #. *\*#.\  ..   **#\..* *\ #
#                  ##  #.\ #..  . \* .**.....\\.**.#
#                      #.\..#\.  *.\.\....*\!** **\#
#                      #*..*#   * .  .  \.*..* \####
#                       ##\# **.\ \#\ .  \...#**.# #
####################################################

Water 22
Flooding 10
Waterproof 17
Razors 28
Growth 48
