##################
#.#.*@**  L  #\###
#***..  *# \\. * #
##\.\\***. B* ####
##*. ..\... .**# #
# ****.*.!.\ ##  #
#\..*.**.\. *\.# #
#  \.\..\ \.# #  #
#**..    7.*A##  #
# ...*.. !..\ R# #
# .  . . \### #  #
#*  . .*** # #   #
#. **\.**.\ #    #
#  ..*\!.*  #    #
#\.*..# #9\#     #
#*.*\*#. ##      #
##################

Water 5
Flooding 16
Waterproof 4
Razors 38
Growth 47
Trampoline A targets 7
Trampoline B targets 9