###############################################################################
# ..\..*.    .*\.*.\....*.*.\.. *.\.  \@.*..*.  *.. *\. \  *  .* ... .*.* ..* #
#.* * .*** .\ .*** . .*..**.  *..\* \.....*! .  ..\...*\ .*.*.\...\.  ..  \.\ #
#  ...* .\. ...**.  * .  .*.* **\**.*..*. ..*\ .*\.....**\**\.* .  *\   * .. *#
# **. ..*...!* *.. * \ .\..  *.. .\*. **  *\.\.  * *   ...@\ . \... .!  ..   *#
#*.**\.  * \ * .\!*.\ *\** *...*. *.**.. * ..*. ..*. . * .@* * *. *\. ..\ ** .#
#..*\*. \\...\***.*.\..** **\. *. \ ..*....\ .\ .\  * ****\.\..*.*.  . ..\.   #
#*..*.*.  \ ****.  R.* * *\..\*.. .   *.. . ..  *.\..**. .. .*\....* . *.. *\ #
#.@....\.*.*. ..*.**\.\.\..\\.*** *..*.\.\  *.. *\. **.*. .  . . .\.  .  .*\ .#
# *.#. . *\.*..*  .** .**....**.. \. .  .\.* . \\.*.**.*.*.  *..*@ .\. .  . . #
#\@* .  ... !.*...\\* \. * *\ .   \\. \*.  .\ . .\.***. .**..\. *.* ..@. *\*. #
# . \ . **\..\..*\*\..   . .*  !.\..**.\  *.. .. **...* .*.*  \*.*    .  ..* \#
##* ** . * *.*\*!*\*.. .\  .*    .*    ***.*.. . * @. *@.. . . .\.*..\  ....  #
#...\.*.\.\*.. . ..** * *. ****  \.\ . .*.\  .\*   . ..** *\ *. *.... . . .*\.#
#.* *! #  *.* **. . .\..*.* \.*.\...* .\. .*.... ...* \.... ....* *\ ** .. .\ #
#.\ .*...*. * .*.   ** *.**\.*..*.*.**.*  \..\*...* *.  \*.**. * ..\. ..  .**\#
#..  **** **. ..*** . ..\ ..   .*  .\.\...  \.*..**\..*..* *. ...*\.  .    ...#
#.\.***.* .  . *. * . **\...* . . ... *\ *.\.***  * *\.* .\... .. . \\.\ * . *#
#.\ \.. .\..* !. .. *\.\!.*... .\**. ..  *...**.*** ** *\. @\ * *  * * ..\.. .#
#\.   *..\ \ **.\...*..****  *..... ..\ .*  .*.*** \*\\\.\** *.*... .. \\.  ..#
#\*!... ..\ . \  *..*.\.\.\ .*\*. *\. .*  .* ...**  .  *...\\...*.*\.. ... ...#
# .*.* **\..\.. *..**. \.*\..* ... . *\*   ..   * *  ..... *. *.**.* . \ .. .\#
##\  *..\*.\  *   ..\  ...     * \ \.. .*. \ !* *\.\*.. ... .\*.\. *    ...*.##
# #. ..*\.*.*\. * *  . ..* *** .*.\.\.*. **   . *...*... \. ..   *\ \ **.*\.*.#
####* !.# ..* \.. *\  \*.* .*. \.* ..*.*.*. . . .* .. .*\. .\.\ ...* .\!\... .#
#** !\.@.\*... *..* .*. \.***.. . .. .*... .*.\ *\  * . *.. .  *.*\*.**..  ..*#
#..\..... *... *. \  **** . .* * . \** *. .**.. ..\.** ..*\ .\  ..\.. .. **@  #
##* *.... #**.\..*.\. *....\ ... *. \.*.. \*..*   .*\* *.* *..*.* .!\  .*\.*. #
# ##.#. ..* .#. .....   . \   \*  \*.**.*  *\ *\\ . *.\ . \.\ *.. .....*....*##
#   #\*..*.*#\**  . . *... .     ..  ..**\...\*.**  *\ ..\  .*.. . .\*.. *.#.##
#    #*##** .*..   ** \. \*    ..  .*\ *.  *  *\..**.  .   \*\.\ \# ..\ ...#*\#
#     #  ##\ #.@\*. .\..*\.  .\ *.\*\...*\.\.\*.  ..*   ..  *. \ .**. .#\. \# #
#        #**# .\..*\ *... . ..* .*.... *.   .  \.*..\..  **.*..  \#.\ .!.\ # ##
#         ###.#..\**.....   **. *\.*.. *..\..\. ...*. . .* \  .#  \   * ** #  #
#            ## #\***.*.* \..* *..* . ...*. \ *\......**..\   .##.**.....##   #
#             # **..*....#.  .\ .@.\..   .\   *.\.* *... \#*\... \#.\#\ .#    #
#              #*.\.\ .\.*.\**..\!   . **\* *\.\ *.\.***\..#...*\##.# ## #    #
#               #.#. #*. **.\.* **\*. * .*\ .** ..*.\..* .\** .. * #    #     #
#                # . *....\\ .* *. \*.. ..*.* .*. .W*\   *##. .\.##           #
#                 #*# *#* . ..#*.*\ . .\.\**!*.\*.  ..* L.#*.# . #            #
#                  # ## .. *. *.#..!\. ** ..*. #.**\\ *. **###  *#            #
#                   #*#. .#** ###. *. .#.*  .W\ .\*#* .# ##  # ##             #
#                  #\ . . ..**\ #####\#\ . *# .   ...\# #     #               #
#                   #.*.\#  #\. .#  # #\ ... \  * .   .#                      #
#                    ##.#.*.** ##    # ##  . .\*# *\ **#                      #
#                      # # ##..*#        #.*. ..# ##*.#                       #
#                         #  # #          ##.\#.! # ##                        #
#                             #            #. ###.#                           #
#                                          # \#  #                            #
#                                          #\#                                #
###############################################################################

Water 0
Flooding 0
Waterproof 16
Razors 33
Growth 22
