######################################################################################################################################################################################################
#          #*. *. .\* \*\.. \\* R *.* . ..**.*..  ** *\ *..*.\*  .\..\*.*.\*.*.*  *\..*\ *.\ \ . .\ .\.  .\\ .....\ *\**  .\\ .\.*  *..\.... ...*.\.  ... \.*..\.  \**\*\. .\  ..\  .*@ * *.\* .\.*.!#
#          ##*#...  .  \  * .*\.....*@*. *.*  *  *.. . ..\..   *\**.\.  ..***\.***\ ..\ .@  \*\ .\...**.. ..   ...@ *..\.  *  .. . *. \ .*.*.*..\**  * * *.**.... * .\*. .*   ..  .. .. * .* ..*.**. #
#      #  #\.**. \ . \..  \.*. . \*.*\..* @\.*.*  *.  \*.. . ..\. .  ... ..* .\*.... \  .*\..     ..*....\...* *\.  .*\\*.  .*..* .W*......\ .*  .* \* \ ..... *. . \ *.. . * ..*.\ . *\*..* *\..\.* #
#     # # #.*..* \..\ .***!  ..  ...*.. .**\.* * .\.      .   .*\ ... ...\ .  *. \ *.*\. .*.\..\*  . ..**.*.*\*. .* ** .* \*.. \*. .. *  ..*  ** \. .. . *.*\\ .. .* .\.!\  ..* .. .  **.\.\.\! .. ..#
#   ## \ #*.  ..*.*\.!.*\*\    . ..\*... **  .. . * .  * \* .*.\      .!\.  . ..**..     ..*   *.*. .*.\.*... .* !....... .@ \...... .  ..\..*.  *.*  .*\ .*\ .*.\.  . *  .\...\\*.*.... .   ....  .\#
#  #*. ...  . # *** .  . ..* .* ..\.\*.. ..\**...*.  .\. .. . ..  . .* .** .  \.****  .\ \ .** .*\*  . **. *\ *. .\.\.**\ *..  . . .\.* **.\ . **. .*..\.\ *.\.* *. . .\.\   ** *.**.*..*\.. * . .\\.#
#   #\# \ \*!\.\#.\.. \ *\*    ..\ *.*  ..\.\  *\*\\.\  .\. ..*\*  .\. *.*.......\....  *.\... .. !... .\.   .. *. \* *\*.@\.\*.. .*.@*.   .\.\*.*. .*.*. .* *.. \ .*   .. \.*.\\.  ..... *\*\ **..**#
#    # ..\..*.\*\\ \*.* . .    @*.  \*.   . W*.\..*.\*.\. . .*\  ***   \*. \.*\.**..  ....! * *\ .\.@. ..\\**\. .  . *. *\\.   *. .*...  **@ .*\*.*. * ...**   ..\*..**.\**.\\. . *\  *   .*. * * .\.#
#   #* . .. .* . .\!*\.\*.\\ . .  ..**  * .\.. ....**.*..\.**.. **  *..W. . .   \..\.. .\   ....*\.  .  **\!...*  .   * ..*  * *. \**  \**  ...**..*.*\. *.* .*\. *..* \*.* .   ...   *.. ****..*\. *#
#  #*\  . ...* .  ..* ! .  * ...\***.. **\. .*.    .. .. .\...* ..  *  !  . *..*\..*\  .***..\...*..\.\.*\   \*. . \.   .\.* *.. . *    ... . ..* .  \  .* **\.  ... . .*..\**.      \. *\...*.**. * #
#   ###\ *  *\*.  .\...\...** *....*. .\.* . \ * *.**  \ ... .* *.  .\.**.. \. .\. .. \ *\  .*E... .  .*. *    .  *. \.\ . ..*. * .. **. .\ *  ..*.*\... .**   *..\ .. .\ *.*. .*...\  \ .  .. *..*\ #
#    # @  *\*..\* .** ...\... *\ . .*\* ..\...\*\.......\ *...  . *\  \.\....* @. . .\* *..\\ * **.\\***..  \.. ...\...\*   ...*\.\*... . ...\* \. .. . * .@ .  \..\*. ..   \ \*..  *  .\.*.\**C ..  #
# # ##.# \*  .. .\.. \. \. .\ .*   *      *.. .*.*.   *  .* .  *...*..! * .  .! \*    .. ** \!.\  *...*\.. \... ..*** \..*.\  \. ...\ .**\*\. *.. * *\.. *... ...\ .!.*. .. . ..   ..\. .. .*.* \ *..#
##.#*.\. .\*.*  ......\ . .* . * .\*....\*.* .\...\ ..*\.*..  *.\. ** ..* ..*  ...\.. . ..*..  * ..*\... \.  .** ..*  .*.\.*.*...*. .* @*.!  .\.. . .*!\.\  ** \*.   .*\.*   .\. * ... .\.\ ...*\ . *#
##.*. #\. .\*\.\*\.  *.\ \*. . . .!*..\. *..\ * ..!**.*\*. .*..**\ \ *  \*.**  ... ..\.\ .*.\. \ ...\.  \    ...   ..\ . .\**.. \*** .\.* * .*. \*.  ... ...*. ...*. *.. . \..** . **.\  ..\      \ *#
## #\... .\ \... . **..*. .**\.\...\***.    *\\  * **..  .   .*. .  . .... .\*\* . \* .. * *\.*.. .\. ... \ *.**\.   *.*   ...*. .\ *\ *\ ..** *\.  . *   \.. * .@\ ..\ .* .\...   ..*. ** . . *.    #
# \# *  \  ..*  .\ .*\ **.\@\  .* *. *..*\*.. . *.  .. .   . .! .\ .*. *.* \*\. \ .*.\**.* \ ....*.. *\ \ . *... * .\* W. *\!\*  \. *\  ..\.*\  .. \.\*. \ *@ .\.. *.** \.  ..* .** \*.*.* .  *.* **\#
####\.*...  \. . .*\**\..\..\. .....\ \.\..\.*\  *.\\   .\* . . **  .\*\** *.   .. ..*..  *.*.\. ** \.. .. .*\ \.\ *.. . .. **  \.. \.*\ ......\ .... .\   .*     ..* .   .  .  .*. \. .\.*\*.\\\ .. #
#   #\.*\*. . .\.  .\     * ..    ...*.\  ..*....* .. *** . ...  \ *..**.. .\*  ..* ..**.*\*.    . .   ..\.*  *.*. ...*. *. ..*. *. . **.   \.\.  .*   *. \**    \**.. .\  *.\ .\.**..    W*\ .\* .\.#
#    ##* .... .*   *.  . *. *.  \  ..*...*. . * *.\* .**\* \.!\ *\ .@\.*    * .  \**  .!.\ .*.  .*.\*.***. .*.\*. *.**.. ..\...\*. .\\*  *\ W\*\*\ *** .@*..   .. .*\. . ..\.! *. .. . ** *  W ..\ . #
#      #.*# * *. *\*   \* \.*\.* .*  .. ..* *.\ *  \ ..\.\.*..  ..  .*.. .\....  \ ..* * .\ .*.. \\ *\**. .. ...*.. .\. * .  *.\. . .* *\.  .  .. **\\**...\ *\ .\..! \ .  \****..\..*..\ ...*.    *.#
#      #\. .\ .*  .* .... \*\..**  . . .. .\*...\* \.*\. *..**... *. ... **. .\ * .\.* \.\ FW*   .* .*\.. ..**\..* .\  ...** .\ . ** \\* @ \ *. \ .\  .*..\...**\ *   .   \ *...*.  .  ...\ . . \\  *#
#      #\#\ # *..\#\. .\**...\..\\**. \*\ ...  @ *   . **....* ..  . .*\..*.    . .**..* ***. .***.\*. .  ... W.*\**  * .** *.. .*\ *\!*\. . .. \ \\...*!.  . ..*..\*  .*** **. . *.. ..\ ** ...  @  #
#      L ##.*...\.#.#**.*\.   \.**.*.*.. *  ...* *  .. *\.*.*.* *.**\ .  ....*\ ** *.*.. ..\ * .*\**.\ \@** * ..\..\ ...\.  ..*@.  \.@.*..**..**...\.*\     * * *\**\.\ .* .. .**.* * *.  .\* *.\ ..\#
#       # #*# * .. \..* .....*..*\*..*.!*.\ \ **..  \**   .*.** .\@..*.*.*. .. ***\.***.   ..\* \...   ..*\*.*.** *. .  . .\ \.*..  **@ .\.*... ...*.\*\.** . * ...\ .* .  \!* ....\.  *.!\ ..  \..* #
#         #*... . .# *.\@* \.* *. *  .\ ** ...*\..\.\.*  .  .\.\. ..*...* 8.\* **\*\.\.\ ...**\*. *\*\. **  *.*@.* . *     *.\ \*   \..\   ..\  ***.*.. **   \.  .\..*. .\.\.*.* . *. .. *.\ *.\*. ..#
#          ##...#*#.  **.  .\.\.\  **  .\. \* .  ..\. .* *.. ***. .*...*.. *. * *.\.. * \.\. ..*.\*. .  \.. .*..*.. . . .. ..... *@.* *  *  ..  ....! .* .. \.. * ..\.. .   ..\.  ..\.*. *.\ **  **\.#
#            # #### .*\.* .    \. . .\ *. \.\\* ..* *\*. *\*\...*. ...* !\ ..\.* *. .\*\.\ . . *\.. .* *\. .  *  *.    \. ..     .  * *\*..    *\\*.**\ * .\. ....@ ..\ *\. \...     .*.*\*. .. ** .\#
#            #\. *# .. \   .*.*.** *.\!\ .* . . .*.\. *. \.** ..* .*. ..**.\  . \.**. .. .\.*. .** ...\*.... \*.  .\*. .\ *..*** \  ..@.* . . .** *.***.. \.*\ . *\ \.!... ..* *.*\\  \\**.\...  .\..#
#           #*.\*...*  .**\.*  **..**.\ ..*** *\**.  *..   *.*\ . \. \* *.  * .   ..\  ** .\.. ..*\  ... \  ..  *\ .! .   ......  *.\.*\.  *\ *.\*. \..*..\ .... **. . ......*.*..\. \....\.* *  ....#
#            # ...* *\.\.*..\ *@. \**.\. *\*\ *..*.  .\  . ... .*\. \..... *.\  *7 . **\  .\.\. @.* .*\.      .\** .  * ..*@* .*.*.. \.!*\*\ !.\\. .***\**.\ .***.*. ....   *.\..\.**. *. . ..* \.*.\#
#            # #**.#\.\.*. *.\!.. .\...  *.\. \..*\*.*.**   . *.\....** **. **\*...   .\.* .   .\.*.*. *  **. \* * *  ...*...\\.\ *****.**..*..*     .. *. . ...**  * ..* .*.. \\* .**. \ \ . .@  .. #
#             #..*.\***  \ \*.\* * .***@ . * *** .*\.**.. * *\.*.*. .....*.*\**\... **\* .\* * **** 3. . . .  .. \.. ..\ ..\*..* .*\.\..* **.*\*\....  ..*.*D  *\.. ..  \*  .*..\.\ ..\. *\. \...\\ .#
#             #.\*  ..*\*\*.  *..  .\\ .*. **.*.  ..**.* ... ..***\  .!.**. . * * .\    ......\.. . \ \*\ ...... .. .. . . .@*.*.\* ... .\.. .**  .\ *  .****. *.* .  \.  ..****..*\*.*. .*.. \    . #
#             #*.  ..#  *.**** .  ..*.  .*. .\..\* . . .* . ...*\*.. *. \..  .* .\ ..* * **  .*....  ...\..  \* .@.  .. *\ .\..\..\.\*\.\ ..  .**.  .* .**. * *..* **  *...\ ..\* *..\.*.*.  .....\..#
#             #\  #*.#. . *\.   . **.   *. \* *.....  ..*... ..  .   .. \*.*......  .**. !. \*.....*..\ .***\...*.\.**\!*.\ . .* \. .**. . \..\ *\ * .**.\.** .* *.\.\*..*. ..*..\ *\.* \\. \  **\.. #
#              # .#\    **. *..*.   .* ..\* **.  .*..*    .***.   \   *\  .**\*. . ..\.**. \.\* *. .*   *..\.\... \ ..* *.   * \ **..*\.. \..*..*\.  .*.. .! .**... \ **...\ ..  .**...* ***\***.   *#
#               #.##* *\.*  .\ ..*\...\ \* .**.\.\..\ \\\**..**   *.**.   ..   ..\.\**..***.\ .\.   .*..*.\.**@. \   \....*\ *.....  .. .  ... ..  .*\.*  ...*\.*. .! A. .\ . *.*..\   \***. . . \ \.#
#                #  ##*..*..*.. .*..* . ..\. \.. .. *...\..  \    ....\ *\ \ **\  ..\.  .**.* **.  *..**\.. ..W. * .. .. .. .****\ ... .*.*\.*....* ** \ *.  \*\...*\*  .**. *...\. *...  ..  \  .* *#
#                 ### .#*. \ .\. * . *.. ..\.. .. *.*. .\. . . \.  \.  **  .\\*.  ...*  !\*.*\...*..\!.*.. .*. . **..  ... . *.\....  *.* *. ! .\*. \.....* \ .  \ ..* . ..*\\ .*. \*.*..\  \..* *.\.#
#                #\*..*  \@ \ *.\* .* ...  .** @* . . .*.*.  *\ *...\.\*.\ . \*.*..\ \\**. .*.\.\.\*\. **.  *\.\.*.*  .\*  **.. \ ..* *\. ..  .  ..\.* ... .*.*  . **.\.   .... **. *..\..\ ..\. \* \#
#                #*  ## .B**.* .*  **...** .*. *.*.\.\ ***.* . .*.. . .\.    !.  . .. . *   *\   **\.*\ .* *..\.\\.\..  *\ .. * ..  . *\...\...  .*  ..\.  * ** .  *.     \.  * *   .*\ !.\.**  .*.\.#
#                 ##*#. # .* *.*. .*.*\ .* *.*.** *  .\... . . .*. *  ..**.* .\*@  .. \...  .. ..*\.  *.\\ .. .  * ** .**.   .*   ..* *.**\. *   .\** . * \. . .**..*. * \ *... *. *\..*. . .\ .. .  #
#                   #*.\* *\ *.. *\.*\.\** . ...*.  . **.***!**  . **....\!.*.\**.*. *.. *.**.. \..*  \ . **** . *.*\ \.*\. * *\\*.*.**.......* .  . \  . .*** ... .*..\..\... \ *... * \* . * .\   *#
#                   #*...  . .. *\. .*..**.    ..*\\ \. .\..\\...*..\*** . *.. *..\.*. \.***\  *.. * ..   \.*. *.. ...  **.\\. .* ...*\*\ * ...\*** ... *. ... .  ....* \. .\  . \ . .** .*...  .. .*#
#                    #\. *@  .. * . *..*.*..*\. *.....*\   ...  .  .. **.* *. *..*   . .* \.  \**\...\\.   \..\..  ..\ ... .. * \  .\. \.   .  \..*\..*.*W *  .*.*  ... .. . .*. \!\W\..\.\* . \. ..\#
#                   #\#* *. ..\ .*.*\!..*.\ *** . *..*.* .* *.\..* . .\..\ .  ** .  . * ...\\\.\. *. *  .. .  .* . .** * \.*. *. *. *  .*. .  *.\** .. ..*   ..\ . *  \* * * .. \..  . **\@. @   \ . #
#                  #\*.* #* \  ..* * ***.*  .*\* ** ....\ . .\.... *. \.. .  *...*.* .\.*  . .. .* ..*\  ..* .** *.   .\\.   .   .. .. *.. *\\..*.*.@*.  ...*.**\..* ..\... ...  ..\..... .** \.@ \* #
#                  # *!* .*\ ..  **...W. .* .....*...\* ..\.**  .... *. *..\ \ *\*...* .  .. ...**  \*  \* \*.*. * .*. . \.   .* *..  *\. \.*.*..***\** .. ....\.* .  * . .   . . ** *. ...\.\..* .. #
#                   ##*.. . . ..\ .. \ ..**   *@.**\. . ..\... .\ . * .**  *. ....  \*.. \*..** * .  \.. .. . .... \..* .\ .\***\. . . .  .  .\*!.\.... *.  ...\ *.  ...  * **\   .. * \*  *\* \.. \.#
#                    ##   ... . *.\.* . * ..\.*.*.. @\* **.*...\..*..\...  *.\.\. **. *\. *.*.\*.  ..**. \.\.. * *.\ .**\..* \. *...\ *** * **. .. .@ .  \..*\.\*.  .* \. . .**  *   ** * .*.... * \ #
#                   #.**#. \**\***. .. @..\ * *...  **\.\\*.\ ..\** .*\ \.*.*.    ... .* .* .\..* **. .  .* ..* .\ . *.* .*.*  ...\   ..\..*\***. **.* \ ... **. .  \. .*..\  .  * \  . *.\  \ .* \ *#
#                   #\5.** . .* \@*.*.\.\  *. *.. \ \ *** ..   *.. ...**    9* **. **.\.*  . . ** ...   *. .\.*\.. .... \..\.\*\  * **\**.*\.*.\* *\* *   \..\.   *  \   \*..\ ..*.. .   \ .* *.*   .#
#                  #****..\..*...* ..  *.*.. .\ .\... .\ \ *  *.. .. .....   * ..  .**.*. . .. \. *\ .\ .  . .\.\  \.*.  \. .  .. *\...\*.  **..* .. . ..* . .*. .. *.* *.. \ \... .   \ .  *.. \.* *#
#                   #***\. * *\ *@* \  ..  . *...*\ ...  W\.*\..*\..   *.*..\. *  *\. \*  ..\ .!.... !*\*. . .. .. .\ ..@. . .... *.\..\. * !*  .. * \.*\. ...\...*..\.\.\ ....**. ..*..**  .......  #
#                   #\...***. .\*. . *.* \.\*.*. W  .  .**.... ......\.....* *.*.*. \..\ . W*\..*   .\ ...\***.\  \ .*. . .* ..*W\*.*  ** . \ .   *\\  .* ..* \..*!.**\  * .. . \.   .* .*.\   . *  .#
#                  # **\. \. ...*  \*...** *.\.   *. .*..* . \.. *.\ .  .    \ \**.\ *\.   \ \*.. .\ *\**.**..\..*\*..  ...*  .\  . ** .. *... *.*. .. **\  . ..*   ..***\ ***  *  **** *.** *. \.  .#
#                   #.#**  \..*..\....*\ .\..*..*.\.@\ *..*.** . *. . .. \ ..\.  . . .*  ** ..\*\   .**....\.\   .* .**.  *  .   .* .\  * \ .*....\   \* *.  . * @.. @.....\.**.**.\**.**..** \ .. ..#
#                    #.. \.#. . **. W   *..\*.. . . .\*.. .*.\ .\   \*.\  . . .*   \.*. **. *..\.*  \. \    ...**...\..\\.\*.. .*  *.. .*. ..\  \ .*.\..   . .*\*... ..  \.*.......* **\*..\\*\**  ..#
#                     #\\*\.  .\# \.* ...\..  . \  \* \ * ..*. . \. .....*  .\*\. * ... \** . .\ **..\ .. ..\ * *.\ * . *  .*\  .\ *** *. .\*.* .. *\.*..\*   ....  *\ \ !\..*..*\*.  \..   ...\. * *#
#                      #*#..* .. \  .*\....* *! !*.*\ .*.* ..\*. !  *\ ***.*. ..\.  * \ ...!.* .*\*......*. ***...**.\ .**\*.   * ..\. .*.*.@ .\** . ...*.\* \. .. \.**.\**.\.. . ..*.\**.. \ \.* \*.#
#                       ##* \.  \.. ***. .*.*.. .* ..*.*..*.. ..\ * .. .\** .*!.... *.*.\.  ..*..\\ .*  ..  *\.* *... .\ \. \   .* * *.\**.\.* *\.\.**.\*  \*\   .\...!*.... .*\ .\ ..*.. * .** \.. .#
#                         #*G. * **  *  .\..\*. ..\\ .*.. \*. * .**\ .*\*.****   .*.*.\.\!.  .*..*  ... ..  *\*. .*..*. *\. . .\\  **. *\.  **..  * \*.** **. .* . ... .*\.\* ...... **.*..**.. .\**.#
#                          #\.*\....*. \ .*.*.*.\**.\*\.* .  * * .. \ * ..@. \..  *.. .*. @\**.\.!.. .  *. ..*.\ .**  ...*. *\ ...*.*\.... *.*\  ... ** .*.* *  \*.\*....*\.*\ \*\.**..\*.*.\ ..****.#
#                          # \. .#*! .\.  \ \.**.. *\.* *.\. \ . \*. *.. *.*.\.*. .. . *...*@.\  ..   *\*\. *\ .!.. \. *.*\ .\... ! . .*!* .  .* ...\... .\..\*....*.. * ... .*.*..* .\.* .. ..\.*.\\#
#                           ##### ##   *. .\*\.*\**. *\....\*@.  ...  *  *. . \*....*\ \.*...\. ***\ *.@. ..\  \ *. .*.\ ..\\**.. *..  ...\..  @.* *** ..*..  ...**\ *.  *. **. ..\\ ..*.**.  *. . * #
#                                  #* #*   *..**\*\.\ ..***.*...\  *.\...\ . . *\ . \.. *\ *\.\.  .. . *  .\.*.*..\....*.**....  *. * . \  .*  . .*..** ..\  .. *\...\*..  **. . **.\* \ ...* ***@.. #
#                                   ## #*. . . .*\  .***..*\..    .*  .*..\    . .. . \.*... **.  *  .\\ \@**\ ..\.*.*\ *\.*.  ***  \ .\*.\**@. . .\*   . .*...**  \ *..*.*\\..  .*.*....*. . \..*   #
#                                   # #**  \.\ **.. *..*.* .\ ..\... *....  . \  \.***.*.*..*\.  .*.\ *..\...*..\*  **..\ .*  \* *\*..  * ***.\ **  .\\** **.\\.\ ..** ..*.. @.. \..\..*  \.\  .\.\ .#
#                                   #.**. \ . .**.  ..*.. *!\.* *\.  *\.   ..... .  ..*\ \ \*. *\  ***.\\. .. \.*.  \.* *\ . *\.***.*.  ......*...    * . ..*.*.*. *.. .\*. ....\.*** .. ....\   \*. #
#                                  ## ..\\.** *.*..   .\. ...**.\ *.  ..\   *\ .**\**.\. .* .  *. \... . .*! .* *\ ***...*. .* \... .   *.\.  ..... * * .  ....*.*.   .\..  .  .  *\..*\.. *. .* .  .#
#                                 #. \ .* * \.**.* \  *\  .**.\*.... *\\ . *  .*.\*** .*\***\*.** \  ..@  .\  *\.. .*\*\.*.\ ..*.*.*.\\.\  *.* ..   ....*.*  \ ....\.* . *. *! *\ **\ *  * .*. *\...\#
######################################################################################################################################################################################################

Water 54
Flooding 4
Waterproof 16
Razors 15
Growth 26
Trampoline A targets 5
Trampoline C targets 8
Trampoline B targets 8
Trampoline E targets 5
Trampoline D targets 7
Trampoline G targets 3
Trampoline F targets 9