###################
#*.  *\... .. . .\#
#\@ **  .\.*\   * #
#...* \..*....* *W#
#\ \**** *.\ .*...#
#.. ..**\.  . . **#
#\  .\. *..\!\ *.\#
#*\..*... \.. ...*#
#. *..*. *\.. . .*#
#..*\ \.*...   ...#
# ...*\ .\ *\   .\#
# .* *..**  . *   #
#*..  \. .\ *\. .\#
#.\ *\.*\   . .\*\#
#* *..*.* *\   ...#
#.\.. *** *. ..** #
#     *\. *.  ***.#
#**\....*.*  *.. *#
# *.\  \..* \ .\ \#
#\.*.  ***. ..\.\.#
#\\.\. **.*.\..\ *#
#. *..*.**.** *. .#
# \..*.*...*.* .. #
#\  *...*..     ..#
#\ ..  .*.* **R.**#
#.    .**.*...\..\#
#  ...**.... . \  #
# . . .**.\\\. ...#
#\.\*\*.. .* .\.  #
#* \. @  . . *.. *#
#....*...\. \* *..#
#... *..*. *.*\* .#
#.\.... \.*.*!*. .#
#.. \*... ..\* .\ #
# *\.   .*     ...#
# .\.* .\*..*. * .#
#*. \.*...*.*\** \#
#** .\  *.. .**.* #
#..*  **..  .... *#
#*\**\*.**\ ..  **#
#*. ... *. \.. *\*#
#  .*.     .\ * **#
#*.*\ **.* ..*\ .*#
#. . .. .\..*  ...#
# .  . . . *. \  \#
#..     ** * . .. #
#.. \. *. ...   *.#
#..  ....*.**  **\#
#..  .. ..\\*. .\*#
#. ..  \ \.*..*  .#
# . .\\.*......\..#
#.*.\ \ * *   \  .#
#*\**!* \***    \\#
#*... .*...* *.\.\#
#\.*.*..\* **\*.*.#
#  . .*\ .*.*.....#
#\.  .\.\..*.\. * #
#.*.*.. .. *.* .. #
#*.*    \.\!\. * .#
#.*.\\\.. ...  .\.#
#\*.  \ \** .\ .. #
#**\  \. .... * .*#
#\*\. .*\  \. .\ .#
# \ \* .\.\. ..** #
#..\ ...*\.* *...*#
# \ .*...  \ .  \.#
#\. *\.*. \..*.  .#
#*\.*...  \ *.  *\#
#.*\. *   @ .\ .* #
# \ *\. * \*.****\#
#\.*... ...!  \...#
#. .*.\..*\*\  .* #
# \ \ \. ... .\*. #
#\.\. . \.. .. . *#
#..*. .*. *.. . . #
#*\.\  !\ . *  * .#
#.  ... ..\*\  .  #
#  .\..\.. .* *\ .#
#\* *\.\*\  .*.* \#
#.*\** ..*.. * .\ #
# \***   . \ .\\..#
#*  ... .   ..*   #
#. \** *\  .**..* #
# ...*.**\.. \ ...#
# * *.***.   .   *#
# ..*...W. *.* \**#
#....\   ...*** * #
#. *\ \.*.. * * \ #
# \.. .\.** . . .\#
# ...  \.\  .\ .  #
#\ .  ..**.  . ...#
#***. \ . *.\** \*#
#*. .*.\ .\ **.* !#
#... . *.   **.*.\#
#* *. \*..\*** .  #
#!.*\*.!.  ***** *#
#. .*** .*\*.* . .#
# ...\*. .**..\.* #
#*  \..\. .... ** #
#*\ . .**  .  \.\ #
#***  ..\***. .   #
#*  .* ...*. ..*. #
#. .\**.\..   *   #
# .  .*..*\ .***. #
#**.* ** .**\.. *.#
#.*..\** *** .. ..#
#\*   .. . .*.\. .#
#..  . .\***. ..\ #
#  .\. \.\.\.\*...#
# \ ... *.\ .*.  *#
#*...  .. .. .\  *#
#. ...  ....  .\* #
#\.***\*\ . . .*..#
#* ... ..    *..*.#
#.  *.*.\. \.\ ...#
#    .\\*.  . ..**#
#     ...\..!   .\#
#\.\. \*  *. **.\.#
#.*  .*..    ** * #
#  *..  \*\\ ..\\.#
# .  . \.*..*...**#
#\ ..! ....  * *\.#
#..  .\.***.*.**..#
#..\  * *..*.\*\..#
#.!*  .* . \ ...**#
# \*.*..  \.  .. *#
#*   . .... .\. *\#
#* .\**. .***..\.*#
#.*\.*\  \. ***. .#
#*\..\*.*.*.*..  .#
#\ .  \ \.. *.  \*#
# .\.\ ..*   *. ..#
#. .*.\. .**...   #
# **\*..*\.*. .  *#
#**  \...**.\*\  *#
#\*... .\...*.\** #
#  **..*  *....*. #
#\*.\...* *\. .\.\#
# ..  \ *..* **  .#
#\*@\.  *\ ..**  .#
#**..*   ..\.  \*\#
#*.\*\.\  *... .**#
#* *. @ * ***. ...#
#*.*..  ....\.. . #
#. *...*  \*... .\#
# *  ..*\... *\ *.#
# .*.*..*.   * .\ #
#. .\.* ..*. . . *#
#   ...  *. *.!\..#
# *    . ....* .\\#
#.\.... .  . *\ .*#
#..\ *. .*. .  . *#
#\. ***.\* * ... .#
#.*.* ..  .   \ ..#
#@\..*\.*. ..*..\.#
#.* *\..    *.*\. #
# . .\.*  . ... ..#
#\. *.*   ***. * \#
#*\.* *...!.\. . .#
#\.@. ..*..\. *\. #
#**. **. \ .. \   #
#*.   *\ @*.*\.  *#
#**\* *  .*\.@. .\#
#.......*..***  * #
# .. \  .\.\\. \.\#
#.*..\.. .@.\**...#
#.*.***\ .**..*...#
#\*....  *..*. \. #
#**.\ *  .. . ..**#
#\..*\*.. . .  **.#
#.... **... .  \. #
# .   \. .**.\....#
#\.*\.#*\***  * \*#
#*\### !*#. *.. ..#
#.#   ##. \*\.\  \#
##     #\...*. *\.#
#       #\ ..* *\*#
#        #  *..*.*#
#        #**\ *\.*#
#     ####*. . *.##
#    #* ..\.* ##. #
#     ##\ * * \ #L#
#       ###\.\##  #
#         #@. *#  #
#          ## #   #
###################

Water 0
Flooding 0
Waterproof 18
Razors 31
Growth 28
