#####################################################################################################################
#. .. *#  ...#  . .\ .\  . ***.W * * .\... *.  *...\\.*. ..*\.\.. *.\ !** . *.*.  . **. \.\*.  . *.\ .. *.. . \.**\.#
###W*....\  .. .\\ *\*. **.\*. .*. ...**.*\. ..\*.    ..  *.  ..  *... ***\ * \@    .*.\. **.\ *\. .\ .*.\. .\   .  #
# #\ ##.\# .\ *. * . *.\.  ..\ *.... *! .\.\*  .\ *\.*.*.*. *\.*.\***. *.**\.\.** ....**.**.. *.* *W  \\ ..  * *.*.*#
#  #\ ..*#  .*.\.* **.. . *.\*..*..\ .*.. \ *\\.* . ..\... \.. . .\*\. . . \..\.\\..\ ..*\..*\.*. .*\.....\ .\.\....#
#  # #\.*.\  .*  . .. **..*... *. *.  . . .*\.... .*.** .\W****. *\. \*.. ..*\ .. *\*\. ..*\  \\.  *.*..\\ .\*... \.#
#   ## #* *\ .*.\.\  *.. ..\.\\.*.*@*..... ...... \\ *... . .**\**  . . .. *.... .* **\..  .!\  .  ..     *.*.. \* *#
#    #* .\..\.\\* .\ . \.\*\..*.**.\. ..\  . ..*.   .  \ .. .. ..\ *!*.\ * ... *.\\.*\  \     \...\ .* * \. . \..* .#
#    #. .##..*...***.... .**@ . ..*\\. \*..\   *\ *.*!\.\.**.   .*\.*.. .@\* . *..  .** . *..\.*.\  .  .  .*** * \ *#
#    #..## *\.. *.*   . . .\.**.  *.* *.*\ .  .**.\* * *  ...**  \.*.*@. ...\*    .*....  . \.*\.* *. .*@*** ..  . .#
#     # #**##.*..**!\. \. *!.\.*. \..*.*\  .*.\.. .\ **\ ..*.\.  . *\.. * \\..*\.**\ ..\W* \..**  ....*  *.. ***  .*#
#      L ## . ..*.*.\\ ..*!*.\\\* *.*.*.... . *....  *...\*.\.* *\.**\.!.*.\**\. \* . ..\.  .*.\.\ .\. .....*... . .#
#      ## \#\.\. .\  .!\ *.*    . .\ *@  \.  .* * .. .*W.. ..*...  \..**..\*.\.\* .  *\ \\..@... .*.. * .. ..*\** . #
#     # #*.@ .**..*  *\  *.  .\ *.. *.* ..\.\..\ \ \....**.**.. .* .  .. \    *\. *. . . \\..\**. *\  ..  *....!. *@#
#     #\\#.#* ...*.\..** ..  *\!.\*  * * .    *..** .** ..\..*. \\ **@.*. . * *....*.*..\.@\  *.\*.*... **.***..\\..#
#   ### ..*#. #\ ....  . *\ .. *  \ ..*\ . .\ *\. .*\.\ . .\ ...  .\. *.! ...  **..*.**.  *.*\.*.\ * ..*..*.@.   * .#
#  #* #.\..\**.\     ... .  .*\.*. .*....**.*  *  \.. . \. **..*. *\  .  . .   . *\**...\** .*.*\.**\  . * ***. .* .#
# # . # . *.*...  \. * * @ *\   ..\*.. ...\..  .*. \.\ \.\\.. \..*\*\.\ .   \. * . *\.*  ...\... *.*. .\*.!\.\.\*..*#
#  #**..* *.* ..\*.**. . .\.. .*\  ....**.  .. .     !*.. .  ..* ... *\ ***..\ ..* **. \.*\  !\ \..*\***. **.  ...*.#
#   ###*....\ \ .* .* * *    \.* .. ..\.*... *.\*.. \. .\\ . * ...*  ...*.\.\.  **..*.*.* .** .  . .*... . \..\.*.  #
#    #\# .\..**.\*  .\*.* * .. \.\*  \  *\.\*.*. . .!* *. . \. *..***. .* ..* * ...***. * *..\ .. \*.\**  \. ..  ...#
#    # ** .... \ .*..\*.*\.\\*    \ ..    \**.*\*   .*.*W   .*....\**\*\*\ ...*...! . *\.**\  @  \\ .*..*..\*.\   **#
#    #*##  \ \. .\.\ .. * \*.  . . . . **\.  \   * .*.*.* .\ .\.* **.. . \ *.  .. \ .*..\.* \.\**.\..*.*\ \*.  \. *.#
#     ## * #.*.. .. .. .*\.*  *  ..**\ .\***  . .*\ . * *.\\.  .\ .\..\@\   ..\. \.\..  **. .*..*. .\.*.  .*@...\ .*#
#     #\ ... ..* **. .\ ....*.\.*\*.***. .*.\. . *. . .!...\\.. ** **\ ..\** \\ . \*\ *..\..*.  *\. * *\ \*\. ..**..#
#      #. *. * . \.*W  .*. .**@. .\ .** \**.* ..\**\*.**.@. ..\...*.**.   *.*. .\..*. .**..*\.** **\..*@ ... \.**\ \#
#      ##..\*.. #.*.. .. .. *.*... **.*.\\ \ *.* \\.\*.\.*. *.   \. ... \ .\* . *@ \ .  \\\*.*.. *.**. .. ...... *.\#
#     # .   *\* ... ** * * .*\.\ . ..!...   .. .  .**.  ** .\\.*\  *.*  .*.!*.\. . \* *.. .. .\.\ .*\***\.  .* \ .. #
#     #  * .*.. * *. . ..@\***\.*  **. W*. *.**.   . . *\..*.. .\\\. . *..*\.* ***.*.*. . *.* @*..*.\.\..**\* \    .#
#     #* #... * *** *\*.** ..   .* ....\**.\ *. .  .   *  * * ..! .   ... .. * **.***.. * ** *.*.**\ *  .  \.* ***  #
#     #..\  . *..*. ..\  ....   \****.*. . ...\!  .... *  . .. ...\.*. * .\**\.!...****  .*.*.\. ..  \..*\..\* ..*.\#
#     #\# **\ .**\***..*  ..**. *\..\!*...  ... *\*.*. *..*\.. .***.*...   ...  .* .*.* . .*.   **.\.  * **  ..*.\ .#
#     #*. *..*.***.*..\.....**. \.!\ .\ .*\*    . \.  \*...**\ .*.*\ .**..*.\... .*.\**.* .*...***  * . .!.*  * *.. #
#     #.**. .\... *. ..  @.*@.* ..**. .@ .. *. * *.  *\.\ . \**  . .. ** *.\.*.\.. ...\....\*\ *.*\ .\. .  ..\ *.\.*#
#      #*.#... *.\.\** .\. .*\. \\* .**.\. \. .\*.\ ** .. *  .\ ** ..\.* .*. .\  \..*.*   *... .*.... ..\ \   .\.. \#
#     # #* .**. * ..* .\  *\ *.*... .\. *. ***.. ...W. \  *\*\*.*.\* ..*\ .  . !.   ***\.*.\ .  .\. **...\ *.....* *#
#    # #.*   *\.***.W \***\..*     .... .. *..* \..  * . \@.. . ***. *\ *  .....*..*...*.. .* *. *\ *. *.  @\**.\* *#
#    #\.\. *.#. #.*\\. .\*** .\.  . \ \ *.\.\*.\....... *. .\ . ..\.\ *.. ..* **.* ...\.  ...\.* ..\...*** .*..*.\W.#
#     #  * \.\. .\.  .! *\.\ *. .*.. .. ..*.**\.\.*.*.\   \. .  * \   . .. **  . *.*. .\  \   *. \*.* **.\.  . . **\#
#    #. *. .*    .\ .\*\ *. ***...*   . * * \.*.. .\    *\**..*.* .* .\ .* .**.* \ . *. *  .*. **.\..*.\ .*\* \ .*..#
#     #*#*.**.\\@.*. ..\ .  \....*\ . *.\ \ . .. .   .*..\.*.** .* * *.\.*.*!\\*  * ..  * .\\..\.   .*...*.*  . *.. #
#     #*\. .\  \...*.     !@. . ***. *...\ .*.  .\ * ..\*.  *..*   ...  ****\  . *** .* . * .\*** ...\\*\...\* *..\\#
#      ##*. . ... *. . \*. .\   .*.  .  \*. ..*   *  **.*.\ *.  .... .  .\*. .*.\*..****  *. * ... \. .. *** **  .* #
#     #  ** .\* .\.* *..*... *  *\   *\.**  . .   *\*.* \ .*  \ *.  *. .* .* \\.\ ...*   \** .\.   .*\ **.* *.* ***\#
#     # *..  .*.* . *.\ \ * ** **   ** . . .  ..  \*. \  ..  .\\......\ .\..**.\.*.\..*.* *.. .  *\********   . **. #
#      #** #..*.*..*\   ..*......   ***.  .\  ..   . .\ .**..  * . *!\.  *. .\.*..*   ..! *..*.. ..*..**...* * . *.*#
#     #\ . ..*\*.  ** .. \.*. . *\.\..*\ *   .*  .*.\   **... .. ..**.*  *. *. .\.*    .\*\.***\   *.  \     \  ..*.#
#     #. *.\ . .*  \.*  *.*.* \.\ ...\.* .  ..*\! .. . ***.**.*\.* *. ** *. *. \*.    \\*\ .** *. *\*... .*. .....R.#
#     ## #.*\.      .*.*..\....*.\* .*\! *  *...   ..\\...*.**\.*..*  *.*.\ *.*..*. .  ..  **.\.\  *...\..\. *.*.*.*#
#    #. *. .*.*.*  *\. .*. ..\. *. \ .*\ ...*.\  ...@*  *\. ..*.*.\.* .*.*.*\ ....\ \ .\...*.**...*...*  **. ... .\.#
#   # *.\ .*\\  *\...   ..  *. *.\  ! *   .*  ..*. *.*....\..  * \.*. *\.  .. * .\ \\.*.   *\..  . . ..* ...*  *\  \#
#   ###\*\.*..*\.\\  ..\* * W   *.! *..\.**.*  . .*\..  .*. \ ..\. !\ ..*.\ *** !* .**.*.. \    *.   **.***  \ *.. .#
#  #.#**.**.\**! *    \.* .\*@. \. . ... ..\ . .\ ..***. \   *. * *   .  .. @*  ** ..\  . \ ... . *\ \. *..\ .** \  #
#  #  *  *.\*..*.. ..\  *\.*... **\ \. .....* *!.  *...  . \ \ ...\    *\  *\* ...  * ...  \. .\.\\.*..*\.. * **  . #
#  # .****\.***\. ..  .*!. ...*.\* .** \   .\. ..*\.**....@.* ..  **.\ ... \ **.*  .\ . ** .* \**.... \ *...*  . *.\#
#  #.\...... .**. *\..\! *. . ***.. **  *.\* *.*@...* \.\.. .\ \.\.*..\.\ ...\ *...*....**.\**.\.\ ...\*.**\..\ \.* #
#   ## \#*.* *. **. \ *\*.. ......* !.\.*\.*..*.\* \**    *. @\. ... **\.\ !..\**\ \.\.*... ..  .W\  . *....\\* .*..#
#  #* \. . * *...*\*. ... . ..\* **.\.  \ .****.*   .... \  *.*..\. ... ..*\ . .\..* .   ** ..***. .*  . *   . .\..\#
#   ##.*\  * *\.*\.\*\.*   .  .. . .. .  **...\.. . \.**. *..   * * *!    .*\   !. . . *..***\....* *\. *.\....** ..#
#     #### .  *\\   .*\ *** .  \ .**  .. *.* ..\*\*.*.*.* . .\.**. *\   .\ \ .\*. .*. .*  *\....\ .\*\* \.  \ ..    #
#         #...! *.*. . .\*.\.  .. .*.** \*... . **.*\ .*.. \ .\ ** ...** ***!*.. *\\ * .  ..\*  ...  .\..   .    . .#
#        #. .*  .  *.  * * . *   . *\ .\*.  .*  ***\..\  * .\.**  @*. ..\...*.\ !..**\.\ ..*. \. *..  . . ...\\.\.\.#
#        #\  .\..\.*.....\. ..\ .. ...  * \ **\\.\*.* \* ..  .*.@.\...*\ \.. .\*..*.\.*.*. .*\..  \..\   *. \.\*. * #
#        #*\. *.* *\*  .*.\.. ..* *\ *\.  .\*.*.\ ...*!\*  .* .\*\*  \\ \..*\..*. ..\ * .. ..*  \ ....\.* \ .  . *\ #
#         ##.*. \.* .*. *\  *.  *\.\**\...* . . . **\. **  *   ..\.*.. ..  **@..  .*.*.\.\\* .  * ..\ * *.  .*. ..**#
#           #*\##\.\*..\**\ *.**. . . .\**.**\ * .\. ..** .* . ..\\\\ * *  .*.  .\  . \.* . *  .*\*\.!... **.. ** *.#
#          #.\*# ..*\  ..*\.\* *.. ...* .\ *...* \.** .\\\ \ * \..@ .  \.. *. .*. *\.  *\.*..  ...\. .** .*\  .\.*\\#
#           ###\ .#.*.. *..\.  .\  **.\  .\... * ..***.... ...  .  *\. ..*...\.  ...*  .  \  .\*. . .* *  *. **.\* .#
#              # .#* \.**.*...#\.*\*.. * **** \.\ \ *..* \. ..  .. \..\   @. ..\.\.**... \ .. ..\*..\*   **..\....\ #
#             # *  ..@ .*  *. .**** .*\\ . ..\. ..! * ...\   \..* \.\  ..*..*.****\..\.*... .. \*.* *..* . ... \  ..#
#             # # \*\* *. *.  \*.\.*..*\. *....  .**\....... *. *\.\.**.\.  .\*.. *\ .*. * . *  ..*. .\..*... . ... #
#              # # *..*.\*#.*\..* ..\ .\.***! .*\ ... \..**..\ *\  * ..!* .  ...* .     ..  ..*\.*  .\! ...\.\.\.\.\#
#                 ##...\*.# .#.\.   .*.\*.... *. \\.. .. .**. .\..** *  .. .\*\*..* ...\.\. .\.. ..\\* ...\.\.*... .#
#                #.** *##.#\#  *  *..*.*\. . *    \  .\* \ .!*..**. . * \   .. \ *..\ * **    \.*... * .\..**....  *#
#                 ##\\.# # # ...\ *  \.\  *..*.\.. \  ....\**.. .. \.    . *. ..\*  ....*.\..*! . .\ . .\...* .*.\\.#
#                   #*#     #\*##*..*...  ****.**...*\ . *... . . *.\ \\\ \. .  * ..\. ..*.\...* \W.. ...\*.\ ..\.. #
#                    #      #.\ ..#.* .@**.  \..... .***...* .*..\*. ..* ..   . . \..\*. *.. * *  . *...   \ .  .*..#
#                            ##*.!**\* *.  ....* \.*\...**..\..*...*.. *. .  . .\   *..*...*.*\. . .    \*.**.*..*. #
#                              #.* *. *\#.*.**## !@.* \***\.** . . .*\..  \.. *.   .**\*. *. .* *..*.* ..... .. *.*.#
#                              # # . . ***W.*..*. * .  * *. \* *.\. .   \*.\!*...*.\ ..\ *..... **\.*\.*\.* *.  * *\#
#                              #\#..   .*.*## ..\..*\ .**.. \. . \..*\... *. . .  ...  *... **\@.\. .. **\\   **. \ #
#                               # #..*** ** .#*#.  .\ *W . *. . \.*....\. .\ .  . .\.*** *  *\..* . * ..\ . **... .*#
#                                #*\.\.*\\# # #..\\.**. .* .\ . .\.*.*.\.* *.   * .* *.**** .....*. **  @! ..*.. \ .#
#                                #*.\ #\.# #  #*\..*.**. .*\.     .\..*. .*** ... \\*\.*  .   .. .\.. . .\ *\..*\...#
#                                 ##.# ##    #\*# .# .#*  . ..*  .@.\. . \. .\... *.*  *.. * . .   .. ** . .*\ .\.\*#
#                                   #        # # ## ###\ \.*. * .@* \ . .. \*..* .\...*\*  *. \.  \.\**\* *. *. ...!#
#                                            #\#       # . . ......  \.. ..  .*** **..\..* .*...\...*....* !*** * ..#
#                                            #\#       #..\** *** \. ....*\ \\*.. .*@***\ .*.*.\...\.*..*\..**\*  **#
#                                             #         #\***\..*....\ . ....  *...@\.\.# .*\.. .* * .\.@*..W* .*.. #
#                                                       #.*...*\.\*. . *.*.\ * *  *\...*\  .   @*. ..* *..\* *. * \.#
#                                                       # ..#...  \.\*..*..*.\.*\.W .. . * . * . . . \ . ...*\.**  *#
#                                                        #  ..#\\.#...\*. **#*. *.*** .. * ..*  * .*. ... . .\ .*  *#
#                                                       #**.*.##W * ** .\. ..\# \*.\*\ *....**# . .**\..\.\...*.\ .W#
#                                                       #..\* .  \ \. \  **\. \ .*.*.!   .**...*\\ ..* ##   ..#. .* #
#                                                        ##### #*.\....\ .\. #.*#.*.  \ . . .\*.  . ***.*#*.#\\*\ .*#
#                                                            # *# #*.\  .#*  *##...#   .  ..** ..*. **\  *.*.*\..\**#
#                                                             #.\* * .\.. .#*# ..*## .**. .\*W *\ .*... ..#*.#*#.*.##
#                                                            # . *..*\@# ## # # \##\ ...  ...**.*....... **.# ## ## #
#                                                           #\\#*#* .# ##      ## # .**.* \#*#.**#.*** *..#.#  #.#  #
#                                                            ## # ### #           #.#.#.#. ###\#* *\.\.\.@*#   #.#  #
#                                                                                 #*###\ ##  #.##\.   **.##     #   #
#                                                                                  #   ##     # #*.. *#.#           #
#                                                                                              #*.\ \# #            #
#                                                                                               ###\#               #
#####################################################################################################################

Water 65
Flooding 18
Waterproof 18
Razors 16
Growth 26
