##########
#  *  . .#
#. .   **#
#\   \...#
# .  \* *#
#\\** * .#
# \....  #
#\* *  ..#
#  ** .\.#
#*\.  ...#
#.* \.\..#
#*\ .**. #
#R .\.\  #
#* .\.*.*#
#\*#\.. .#
#...*..#*#
#  \.. \.#
#..##*.###
### #.L  #
#  #.*#  #
#   #\#  #
##########