###########################################################################
#                                         #*#                             #
#                                        #*.#                             #
#                        #              #.\  #                            #
#                   #####*#   #       ##\*.\#                             #
#                  #*.  \.#  #.#  #### ##..# #      #                     #
#                   #  \# .##\..##  *...**  # ##   # ##                   #
#                   #....\.** * . #****\#*..\*#*####**\##                 #
#             ##     ##.....* \  \#*\..*  .* ##\.* ##..# #                #
#            #* # ## #* .*\*  .  *\ .\*. \.***#.*#.   ..\#                #
#             # *#..##.\!  ..*...\*  . ..**..*.*##\#**\.**#               #
#          #  #.*. *##. . **...\*** . .\.\*. .*.*..# ***.#    ##          #
#         #*# ##.*.#\\    *\... ..** . . .  .  .\* . .*.#    #..#         #
#        # !.#*.*. . *#.. ***  ...*\.\\.*.\\...  .. .... ####\ ##         #
#       #\#.. .*...  *.\ *.*.  *\.  \# * ... .\..\# *** *#\.#    #        #
#      #  #.*   \ .\.**.** # \.. **..\ \* . .   * *..\**#*.\.##..#        #
#       # ...\... *.*.*..*   .. ... **.... *....*\*..*.. ..*   **.#       #
#     ##*   .   . .\.*.\ ..\.. . **.**\.*  **\ ..*****   * .\#\.. *#      #
#    L*##*\   *\*. .*. *   .**\ .***..* .*\*.@  .\* . * .  *.\  *.*.####  #
#    #*....*\***.   .*.@\. .\**... . *.*.. @ \ *.  .* . . ** *\ . ....**# #
#     #.*@\**.* .\*   ....\* \..* * **....\.*...\***.*.*  ..*.\  . \ *.#\##
##   #\.#*..*..*. ..  .** .. *..\....*.*..* ..*..\.\***\*.. ! . * ..*#. .##
#*# #  ..*\**\**  *\***.. \ \.**..\. .....*.*\.\.* *.\*. *. .#\.  *.. . *##
#.###*#*.. *\ \*. ** \..*.. . ... . .   *.. ***.\*.*.*\**! * \ .. **...#\.#
#*...*#*.*..*. .*..*\ ......\**\. .  . \. *\..\..\...!* .. * .*\*.\.#*  . #
# . .#.**  .*  ....*.. *. . .\* .@ *.*@.  *\ .   ..*.*\ \* .   * *. \**.. #
#..\.. .  *..\. .\.\!.. . .\*  .  .*\\***.* *  *\    *.\..*\*\ \#*@\...*..#
#.. **.* !*.*..  ! . .. .\* * ... .. *...*.*** .. .. *.*..*** ..\*\* ..*  #
#\*..* **\. **.*.**..  * ..*. .* \*.....W*  .*  .* \ ! .\  **\ *.!.*   .  #
#  *..\....*\\ * *\* .*\.*\ \... ..*\* . . **. .   *.\.*..**.... . \.*.**.#
#\* . .\. . .***\!..**.*\*.\..* \ *.*.\* *      ***..  * *..\.**.  . \*.*.#
#*.\.*\. *. ....** **...*.....\ .\.. . \**  *\ . \.\..\\*.. *..\.\ .  \ *.#
#. *.** @\.*.. .\*\.. ***.  .. ** . ...!*.. ....*. **\..*.*..!  \ . . ...\#
#...*** *  *  !* .  *..*..  ....*\.  \ \.*...*\*  ....\.. .\. . ..\ \.*.  #
# **...\.* *  \. .. \. *.\ \*.\ \ **.\ . ***.. .\  **\  .* . *  * ..@ #. .#
#.**\ *....\* .   * .       \.  .*.*.W.. \..  * * \.*. .\.. .R\.\ . ..* .\#
#.**\ * .*.\*. * *.\*.*.***..... **..** . \... ......\*\ . * . \* *. ...\.#
#.. * \\ . *.... **.*.* *.. \.  .*.. .*..**\  ...\**\ *.\ .**. ..@**.  **\#
#\ .. .\..\.. . \ .\\.*.  !    . .**. . .*. *   *** * *.\.. \.   \.*.   *.#
# *...   \..**   .\..\.\ \.   * *..  \..*.\..*... .*\*.   \...***. *. .*\ #
# ..  * .  \..* **.\ .*.* .*\**.**  \.. . ..\...   .*.. . . *\...* \*\ .*.#
#..\ .\*..\  \..*..*\ *** *.!.. \.  ..    .  * .\*  ..*...* \*.*....\.....#
# *.    *    .**\ .! *..\ .   \ . .**.\..\   .. *.*   \.* ... \....\  .   #
#    .   .   ..\. *..\ . * . .\ *...*!\*.. ***..*..*..*  .\. ..*   ..  *\*#
#\...**\ .*\ ...  . ..\!.**.\ .*.. .* . *. .....*   *..\.** .  ....*\*..*\#
#*..... . . \ .\ .** \ \ * \. !. .\*.  \** .  *... .*.. *\.\**.* .*\*. .*\#
#..   \  . .*.*..* . . .\****\*  *****..\.. @ .*.\.** *...  \ \* . .\\   .#
#.**..*\**  \*.   \.**\**..*..* .....\*..** . *\*.. ..\ **.*\*.. *    **!.#
# .*..**..  .\\ .\. ...*   *.*. . * ... ..   \. *  .*. ... * .*  **.* .*  #
# .*....\* ** .    *. ..   *\\*.*\... .**** *. \.. \*.\ .\ .  . .*!**.\*  #
# ..**. ..\.. *..*\ .\ \*\ ** * ..**.* .*  *..\.*\. *. *\.\*. *\ .\.**... #
#  ..*\  .*\...**\**\ . . .*..*...*.*.. . ..  *.\\* .. *\ ..**@ .\.*..\..*#
# * *. .... \ .....*.* \*  \.*.\ .. \.. . \  .\ . *.*  *..*\. .  *. \.* .*#
#\.  ** * \\. .   \.*.. \\*.\.*  * \** .* *\**  .*.\ \ .\*.**. *\. \*\..*.#
# \ ..* * .. \.\... .. .... ..*. ***... .*..*\ \.*.*\.**.   *\* ..  * \\. #
#\.. \.*..  ..*..\**..\ .\* *... .\.* .*..* \. . ...  \..  .*** @\*.*...  #
#...\......  ..\*.*\\.\...\ . *  \. *.* \ .   .  . *  *..*. .\. . ... \.\*#
#*\. . *\ ... \ .*.\. .. ..\* @...***.* ...     . \...** *\    \. \.**.*!.#
#@  \. .\* .\  \   * ..\\** .!.*\\*  ..\ .  *. *.*.@.**. ...*....  *\* ..*#
#*  .*..*\.\ . .****.... ..* *.\. .   \. * .  ..*\ *\.\ !\* .!** @...** *.#
#\ \.. \..  .. .  *..*@   .*\.\* . **..\..*\. .\\**. \.\. . .\.\.*. .\. ..#
#  .. .. .* @  \ \.* .*\..**. \  . **.\ ..*.* ..*.\*. . .. .*\...\!\*..\ *#
#*  ** * ..*..*. . \  .***.\...*****..*.*.*   *\**\**.  \...\*.* .  ** *  #
#\*..\ .\.\..*  .. ....\.\...**.. *\ .*.*.*.\ * .\.*\.\*... *@\* .  .* . .#
#.\*...  \* \ ..* \.. \ * .. **. \\. ..*. .\. .*\. ..* ..\. ..  .. . *..  #
#***  *\ .**.   .\.  *  .  *...\ .. @.*.\. . .* .* ..\\**. *!   \.*....*  #
# *. *\*.... .* !. .\**.\  \* * .\ \ .\ .  .\.** .\ .. . \ . ..*..\  ...\\#
#\. .. .\*\ *.* * \  **\.**.\. \ * . *\.*\.*.**... ..* * *.\.\ .  .\*.. .\#
# ..  \ .** \.. .*\ .\*.*!.\  *.\. \.* *  \*. \.\ .** .W**.\  * .**  * * *#
# @...   .**.... * ..... * \.\** . .** \...*  ....**..   \.!. \* .    .*.*#
# *** . *\  ..*...\. \  .. . .\. . ..  * \.*\*.* ...* *.*.**  *. .!**. ..@#
#\  .. ..**** .*.\.  . *... \ .. *.***** . ..\ \ *.....\...* *.\.. *\.   .#
#. .** .\.. !   *   *. ..*  .*!\..*..*\..*  **.* * ..\...*\..\ * .*\ .  \*#
#\.* ..\ ***    .\ ..\*.... \*...\  \.* *. *..\.\.* *....** ..   *****.**.#
#.....*..**.....*!\.\ ..*@. ..*\.*. *.*..... ..\*. ..*  .*.. . *  .\.. .\ #
#  *.**  \.* ! * *  . .  . .*\.**.\.\.*\.  \.*\  \ .. .\.**..*.  * **\* ..#
#\*. ...*  .. ..   *  \.  . ** ..** **..   .\** *.  *.*!.*.*\* ... ..\\**.#
#....*.\.\**\!*** @... * .\.* \*  * \ \* ..*..*..*..*.* *.** . .\. * ..*.*#
###########################################################################

Water 67
Flooding 9
Waterproof 9
Razors 33
Growth 4
