##############################################################################################
#.. ...  .* .\ .***\. *..*   *.. .\*  ..*.*..****.\..\. ....  ... *    * * \*\#              #
#\.  .   * .   \*.*  .** *...\.    * \. .**.\\*.. .*\. \ *.  *  .*.*** .\#\.. #              #
#...   . .. \ \.\*.   *\!*.. *..   * .  **.\...  \ *.....*.\*\   *.... .. . *.#              #
#  ..*.* *  .\  *. .. .*.*\.\.* .* ..  *\.. \. *  \. ... *.\..   ..\ *.\ *  ...#             #
# .. * \ \  . .  .\ *....* *..*  .*   \*.\\.   *\   * *\ *  .* \.... *** *\ ..! #            #
# .* .   .   \  *   .* @ . **  !\ .\.\. ...\*\ . .\.. *...\ \.* *.   *...\..**# #            #
#  * .* ....*.* . \...  .  .. .... ..*. *.*.*.* .. *. \.\.. !....*. \... \ * \##             #
# *. .*\ .\.* *  \. .*.\\..*\.***....*.  *..\ .. .***..  .  *.*..**. \**\..* *.#             #
#\...**\*\.*...\*. \ ...\   ..*\W.\ .@* .\.@ *.. ..*\ *...* . ..*.*... ..\ .  *\#            #
#*@.\\.  . . ..   !*.\..* ..\.* *.\.*.\... . \ .*.\*.**..\*.*. .. \   .*.. .\..W.#           #
#..* .. .\\. ** .*\* ..W. \ . * ...\..   *.  . .**\ *\..\*. **\ .\*\ \*.... !\.###           #
#\*..*.  .  ...   *.\*\ . *\.    \..\**\\. *. *...*.*..**.*.*... .... \. *.  *  .*#          #
#..\ .. .* *. .\ ...!\  \.\..   * .\*. W   ..*@\ ..*...*.**\.  *\\\ * .*.*  ..\. . #         #
#* ..\.***.\.  .*    ... *\.. .*. \\*..**. . ...  *. \ *\* *.*\.....*... \\\\ .**##          #
#. \ . .*..*.\. \  *.\ . * .\   ...\....*...*..\ .\.   *\ . **.  \ *.  \.  .  ####           #
#*..\* ..  .\  \ .*. .\\.*.*.   *\  **\ **.\..*. .  ..*.*.. *\* ....\**  \.\  ...\#          #
#*.* . .*\. *** ! . \.* *\..\.*\\ ... . \. *  . .\.  .. .\.  .    *..*\ \.* . .... #         #
#\ @ *   .* ..*  .*\ . . . ******.***. *..\..*   .\.* .**.*\...\\ * * ..  .  . \ L#####      #
#..**.*\. .  \ \.*!\ . ** ..\.\...\*..*..\@* *\ \* .. ....*...\*. ..* \ **..* .@\  ..\ #     #
#. \....\ \.. * *... \. .  *.   *  .. \.\... .. .. .\ *...\. .!.. .\*\ ... .*\.*..# \#\#     #
#* .*\... . \ * .*. \. . ..\.\ \. *...   *.**....*   \.\...    .* *.*.. \ .  ..*  * #\*####  #
#. * * *  .. !\ .. .\ *.   . * \  . . * .. ..\  ..  *... \. *. .* \*.W .. **.  *.\. #\ * \.# #
#.*\*@ . * \.. * . *. .  .  .\..*\  * .  \.* *** \ ...\ *\* ... . ..* .\\*\.* *.\.  ..*..##  #
#\.* . \ *.*\ .!  .\   .\   *\*\*  .*   .. **\**..\**.  ..\ ..\ \. \.*\*.  . *.. *\** .*#    #
# *.    ...\ * ..\.*\**\.***. .*.. .* \ \.*..*@.. ......*@R*  . ..\. ... @  ...*\.  \#\..#   #
# .\. \\ \*..** *.    .\**\. *.*.  ..* \. .* . * .\.* * ... .  .. * ....\* *. \...\...  ##   #
#. .. ..... *** .*.. .*. ..  * .* \* * ..  ..  **. .\. *.**.*\*\ ..  .*!** **\  *\ *  *.#.####
#. . .\.\ . ** ..   .*\   *! .\\. .  .**..\ * .***** \.*\ . *.\.*  .*\  ..**!* .*.**.*\. \#**#
# ..\ .  . \..*** ..@.\.\ . \ W.*.*  .*.*..     *** *.*\.\.**  .. * ..\*  \.   .\ \.*.... **##
#.. *.*\*.\.\ *.. \* .!. ..\...\ *.  **\. @.* * .  .\ . .. *.** . .\   .\*.   *#** *. **\*## #
#\*.*. \*. .* \ *\.*.. *..** .   ..  .. . **.**   . .***..*** *\\. .  .\....\ **.. *..#.*.\# #
#.**\  ...  * ..\..*  .*.***\.\**. ...\ **..*.\..     .**.. ..\..   ..*\ ..  \.\ .\.*.. . *# #
# ..*.*\. .\.*..  \.\@ . .. ..\...\ \*.\*.\*.*.** .   *.*.**.*.W*  .\\ .*...   ...# .. . @#  #
# . ...**....*  . .. *   * \  . .. ....* . ...\*..\* *.\.*.  .*..  *  .\....\.* * .# \####   #
#.\. *.*. .. ..*\ *\\.*.. . \..*.   . * .  ***.\ . .......\  . .\**.\.   .** .\ *###**\#     #
#\..\.**   ***\**.* **.@.*.\. **..  \  .*\\ *\.. **.*.* .  \* *\...\ .*\ .*\..* ..# #\#      #
#..  .* \ .\***.*.**.\.* *  \ .\..\*.* @*.. .. .. . @ *  **\* .**** **. @.*  \*.*\*# #       #
#*.  *\  .\ . .\.*...*   * *\..! \...\.\**.*.\* .**.. .\.....\..@*..*..**..*\ \ . ##         #
#*  *** .. ** .. *. \..*..\*!..*  ..  *.*. . .*\ \*\.**. . \**.* **.\ . ..*5.\. ** *#        #
#. ..\*\  \*\*. ...*.W*.\..*\.\... .**.*.A. .*.  **... . \*. .*. \\\*..* .... ....#@#        #
#*.\.*.   .*  .   \* ..\\*..*. *\.  .* \. \  . *\....*\ * ....*.... .\. \. *..\#\# #         #
#\*\**  .\*..\. . .*  *** \ .. *.*  *....*\**\ @*. ***! * *..*\. .   . .* \  #.#\#           #
#**.\..\ ...   \@.\.*.*..\.\  .\ \ ..*..*\.*!**..*..@\..**.* .   \ \.\ ..\..\*##.#           #
##############################################################################################

Water 0
Flooding 0
Waterproof 2
Razors 49
Growth 14
Trampoline A targets 5