################################################################################################################################################################
#\.*\ ..\.*.*.. ... *. . \ \ . *\ **. *.  .* .\.\.. .\... * \**    \ .*\ . \***.*.**..*.* .! *.\ **\\.\ ..\*.* * ..*.. *\ *..\. ..*.*... .* \ **. **. .*..** \*#
#*  *. \\*. **.*... . .. .*.* *@. *** .\ *.  ** .. . .\\*.. ..\  .\.* **W. .... * . ..* *\.* ..  *. .*. *.  \.*.!* .* ...\.  *\. \..** * .. .\.\. ..  ** . ...*#
#.* * . *.  *\..  ... *...**\*..\.* ..  *.*.**.\ \ * \* ..*...* *\*.\. ....\  .    .  *.. ..*  \*.   .*.*..\  ..\*. . *.. .*.* *\ .  *\.   *.*  *\..  \. *   .\#
#**. .* .@* .. .*.***..*..*  . .\*.\. ... .*....\ .*\ ..*..*.*.  ...*\  ..* .**  \ *..*. .. *.  *\. .\..*...***. *.   .*. *..*...*   .*.  .. * ..*\  **\ .*.**.#
#*  .*!\.@*   \.*..\ . . *\.*  **.* \.\.  *.*  \.   * \..\ * .   .\*. *.*.. . . *. \  .*.\..\ *... . . .*. \.*. !..\ \\ .***..*..  *.* . .  *.** .... .*.*...**#
#**.*. .@*. *..   . .. *..  . * . *.. *. . . *. .*.    \. *.*. \* .! **\.  !** *..  .  . .*. *.* *..\\.\.**.***\!... .* ..*.*  \*\ . .* .\  .*.\ ...\\.*  .\ **#
#!* !*  *. *.. *.  W\ \...  .*.   \.\.\   *\ .. ..*. .W\**.**.* *  \ .    ..*.\.   . *..\ .*\. * * *. *\**..  ..\\.\  \**.**... * .*. * *..*.*.\.*...\..* *  ..#
#.* *.@.***. . .  *.....  *....***..\*\. \**.* *.. .\ \ .* !* . . ..  **.\.\.  *\.. .\... *.\. .*. .\*.\\ \.*. ..\* .\ .  *\..\.\..*\ \  ..\ ****\. * .*.\*\*\ #
#\.\*\.... ...\ ..*.*    ...*\..!* ..*@* . ...*\    .*.*\. *. *.*  \*.\!\...\.\\*\**\*.\W***.  .\  . ...... \ \*\***.*  . * *.  .\ .\. \ ..*.\ *\ * *. \....\..#
#\.**@* *\.\*..  . *.  \.*..\*.*.. **..\* ....\.\   *.@*..\ ** * .*!\. .*  ..*. . .. .\\ .\ .*. ...*..  **\*..\.*\..\ \  *\ ..*.. *..*\.. \. . **.** *  . ..** #
#* .*.\*.* .* *!\*. .* *\ \.*. **! *\ . ...* \  ..\.* .*..\*.\.** !     .\..... **. . *..\  *.\ .  *****..** .* .\  .\. @..*\*. \.*.*.\  \..*   . .. . .     ..#
#*.*. *.*   .*** .  ....\.\.* ..* *\*.  * .\ * *. \.\\..   \.   *\. ..*... ..  ...\ *\*.*..\.\.\**\..*..* *.\..**\* ..\..\*  \ .  . . ....... *.  **\  *..* .. #
#\.*\\. *   . *..*. . . . . \ .* *  !. .  *..\*.. \.*..\  * ..**\*\ *. .. ....*.  * \.*.*  * . .    .. *.*.\* .\..*** . .W*.\.\.. *. ...*      *.*. *....*..\* #
# \..  \***.* \  .  \ **.  \   .   \ *  \\ \.*\!*\.*..*  *.. .*\***. *\  . \*\.**\ *  .....    *... .****.\ .*...* .! . *.*.* .\.\ *  .  *\ .*.*.* **.\*  *\ . #
#*..   .\\..\ *  ** .*.*.\... *.  .. .\. *..*.  . **..  *\.*\@..W... *.. ..\!  .  .@.\*. .  \..** ..*\.\..*  ..\*.\..  *. **. .* .\..  **...\.*.   \\. *\.\   \#
#\..@\. .\.*. *  \****\..* \! *\ *  \***.  **..*** .\ .*.@.*! *.*...\.*\*\ \..***.\ ..  *  .**.*.\ **  . *. **\.* .**. .... ** .  *\ .  . . . .**..* .\   .  .*#
#.  *\... ..  \...... ..*.*.* **..\  ..*.\**....*. ***.*.. \ *.\.*.\\ .. * .\.*\.@ .*  *\*** .**  ..\. *.\ ..\.\*\ *.\.**.\*.. .* \* \*..* ..  .  .*\ . ...*!.*#
# !. . .\  \\...\*.*...  ...* ... *** ...* .*   .**..* .***W\.** \**... .*\ ..\**\  *.*\. .. \.* .**....    \*.* .\.**  @ .**  ***.*\ *.\**  * W..**\  .  *.  .#
#\...\**.  . * . .!\ *..\.\.* \. .*.*.*\*.*... .*..   .*.*. ..  \ .**.\   \.@. ...\  \*\  .. ... .\..*.*.*.*... \ .*.. \.*\*.*....**  ***\ .** .\...\.. ...**  #
#.*\ ...*..* .   \\* .*  .... .   *\. \*... ....\.*\ **. ..* .    .**.  .  *..\ . . *.*.**.. .* .\*.* * ..\.*   .  *   . * .\..***.\  \*** ..\*\...  ! ** *\.. #
#**..  \..\.\**  **\.*.\.... *  ....  * *\ *.... \ *  .*.\.*..**.* . . *. \.** *. .. ..\*. \ *.\ \.*.  *\.     ..  \.. @.. ... **\..@ .... **.  \. ..!..* .*\\.#
#*. . *. .. *.  ......  .****.**.\**.\. ...*\\*\  *  \** ..*. . \. .. \.\. *..*...\ . .*.  ....  *  ..*.*..*** .**..\ \.   ** *.*.!\..*\ \...*\..  * **\... *..#
#*   ..*.** .\ .W.  * . \**..  \ ..\..\.\.*.. *..*.. ....*\.*  * .\ \ . @..\  .\. .\.....*..\* * . .* *.  **... ...*. * .*\..*... *. * \*...\*.\.  . ..* \*...*#
#... *. ..\ ..\  *. .\ .\.**\.@\** *. .  .. *\\.\. .. *  .. . **\@ . .!\.\*.*\\*.  . .. * \* .\ .   . *.. .. ***.*\.  .. \***.*\! .  \. ..\..*..*.! * W....*  @#
#.\. ..\*\.. \ ...  *     .. .\.\..\ . \*..**.** \*\  . * .  *..***..\* . . .  \.  **.\..\ . .*    . \* .* \ **.\.*\*.@.. .\ .\**@\ .. \.\ ....*\!. **.*\. .* .#
#**. *.....*...* .***\..\. *..*  ..  *\  *\ . ..... . \.\.*   . .. *\*..* **\ \.   ..**   * ... !.. \..* .  *. .. ..*\. * \*..  ..*..\..\  \ ..\ . \..*.. *..\ #
# \. \ **  ...**   *** ....\ \.\.. .*\*...*.* * * .. * .* . .*.. *.\.* .. .*. .**    **.**\ \@ *\ .\. *.   ..... *..*   .**.. . .\.*\. @* ..\   .   . .@\ ..\\ #
#  ...\... ..\..\.\@ .*.*.. ..*.  .\. \*  ..**. *. *\.  *\   *. *. ...\**  .\* \..**.*.*\ **.*. * * .\*!  ****.  . \. ..\..**!****..\.\*. .\.\** \.\.*\\...\  *#
#\ .. **.  * . \.\. \.. . \ * .* .\  *....  .*..*.\. * .. .  \* \  \   ..   *  .*\. *. **\.* * ..\.**.\. .. ...\. *. .*\ *.\....\.   *.*  *...*.. * .***....\ \#
#. \ .\*. *... ......  *\ . .   *.   .*\.\.  .*\ .  ..  .   ..\* ... .. \ \ .\\\. ......*..*\..\.  ..   \** \*. ***\ .* .*  \** .* .\. .*\. .* .\****.*\**\ . .#
#  .* .*  ..* .*\  .*.\ * \... .... ..\. ..\* . .*  ..\   *..\... \*\.\.* .\ .*\ .* \. .\ \. **\**\... !..*  . \* ..  ** .*.\.* *....* *.*  .*\ \\. ...... @\W #
#..\ *. ..... *.* \@.* \*..\. .*\. ..    *.*. . \...**.\.*.   ..*\... *. !    *.\ .\.*.\......\*. .  .**.\*.\.. .* .  .*. .* ...*\.  *.*\....\.. . . .**.*.***.#
#**  . *. ..... .\.*\*. .    .*. . **.. *.**  *...  .*.*.\  *.\*.\*** . .\. \ *.  .  .*** .**..**.  ..*. *.*  .*\.  .....  .\ * *...** ... . .*.  .**.\  \..*.*#
#\.\....  *.. .*. . *...*\ .* ...*\ .\\.**... .. ..* ..*.....\    ..**. .. ...\..\.* \!\. *... .\*.*. *..*.* .... ...   * **. .*..@*..\.*. *. . ** ...*. **..**#
#.\ .. * .....*.**  * ....\ . .\   .*.\.*\.** *   \.* *.  ..  *\*. **.*...* .*.... .*..* ..*  .  **\ *** * .. .\\ \*  . .*..*\.**\.\!.. .. *.*  \..\. . **  *#\#
#...* \..  .*.!\**\..  \.....\..*** .*. *\... .. .. \..  ** ..\.*.*..\.. .* .*....  .*.*  ..  \.* ..* .. ..\..*.* ** *..\.  \...\\\.....\ .*...\.. .*.##\.*!  *#
#*.\. ..... ... *. * . ** *..**..**....\.. ** *.\**.  \  *..**.\*\.. ..  \. *\*\\* *  ** *.*.** . * \* *.* \  .\ \.**.\  ****.\.  .....  . .. . ..* **#..\#\*..#
#**.*  *\* *\ *...\  .* * . .** \\. *\...\ ... * .. \ .\ ...**. .. ..\.*. .\ .**.*\.  .! .\* *.\* * .. ..** . * .!*.*\..... ..  * *.*\ \ ..*\.* \\\  *.*.#.*..##
#..**. ... *.*..*.   *.*.\ .* .\.*. .. ..**.\.**.*.\. .\* .*.. *!.    ... .. *.**.....  ** . \  *.  *** *\.**. .  ...  ...* *.** \ .*  . \ .. .* \  . *#*.###.##
#.. \..* .\*. . ..\......   . .*...**\   * \* .**. * . .*\ \*..**\....\*** .*.* .\.\  **..**... *\  .\.*! ...***...***.**.* \...\. .* * \.\.   *\* *.\*#** *## #
#*...*.. . .**  . *.*.****  .*..*\ ... *\.* ..\. . *.   ***..*.*\.*  \**.*..*.*.. . ****@*.  \..\. .** * *.\ \.****\\. *.\ \ \\ ** .... \*. \  .\. #*.##\#.#   #
#*\ \*** .  .*. ... ..*\ .\* . *.**.*\W* \  ** .. .\   **.***. ..\.*\**.*!*.\ \.*\ .*  !***.*. * . ... . . \.*\.\..***.\. *.\.*..**.   \ .**   .*.\ \#  # L    #
#..  ..\.*   *. . !* *\*** .\ \.  . .\ . .. .  .*.*  \. *  .  *...**\* .*\. *\.\.* *. .\.\\*.!..\.** .*.*.*.\.*....**..*\... ..*\.. .. .@ \\..\**. *.#         #
#.**. * **. \.. .\***\* .\.\**. !\***...\ ***   *\..*\  \ \**\..  *.*.. ..! ..*  .*.*  *** .*\. @\ \\..*\ \ .  ..* *\...  *. \..  * ..*\*\ .#\*\ # .#          #
#... . \\W. ..  *\\*  ..   * .   ...*. ..\...\. *...**. .. .. ..\ \ .*. .\..  * . * *\..  \ . \*\*\..\.. . ..*\.\. ..\... .. .*. *.@**.!* \...\..@ ###         #
#\.\  . \* .  *.\. .. !     .....**\...*\*   * ..*\... .  *. ..**\.!\.. .**...*..  *.. .. *. *.  *.  ..* *.* ..*  \W***... ..  !. . *..\ .  *\*. ..\**#        #
#. ..\.*.. \ ..   . *.    \ .***... . \!.\ . .. *. .*. ...*. .....* .*\***\. ..*.**  .\ . .. **  .*.. . * *.\..\* .*.*\..\.*  *\...**\ . \. *.@. # #*#         #
#\.   .\ *.*\    . \.*.\***.*. . * .**.*...*\.* * \ . . **.\* \..  .*.**....  .*. .*  *. \*  *\*.\.  \  .\  !\..  . .    * * \.  ..**. *. . .\*\##.##          #
#. \. *. * **..*  *.**....* *.  .. \\.***....  \*..*...*..* \.\.  ...**\ \.  .*... .\.*  .. .. **.*. \..**..  .* *.!  * ...   *\*.**.\ .  * \....*#            #
#\. ..\ .* ..\** \*  . .* .\.\.*\  !* *.*.    *.*\..  *\  .. *.\ .    .*. *** .*    ....* .  !\..   *.* ...\.. ***.\  *.. \ .\\ .   *\.** .  .*. .*#           #
#*..\***\*@.\.\.*.\ *  !... *.\* .  .*..\.. .*\. .*\ ..\ * . .* *.* *  .  .**.*..***. .\ . . ! .* **  *.\*** . ..\ ...\ ..*  .\ *.. ....\  .***\  .#           #
#* .*.**** \.\.  .\ *  **.  .* . . . .\*...*   .*\ * .  \..*... *\* ..*..\*.\ .  *. *..* **  \ **...  \!**.. *\. * ***   *   .  ***** .*\@. ....*@#            #
#* **  ...\.  ..*\  ..  . *\*.\. * . \ \.* ** *..  ..\  .\**.  . .. **  \ .*.*\  . .*.\.*...\..\.\..*\ *..*\*\ **.\**.\ .  \.\* ..  .* ** *\  . .\##           #
#*... .\  *.*.\ ****.\ \*\... .. *. *.\. * * .*   \. .*.......*\  \ *\ .. .* \.*\ .*.\*..\ **...*  .*.\ * .. *...\..*\  ...\. .*\. **..*..*  *** .* #          #
#\**W*..\.  **.*.\.  ** *. .\  .*.\ .\.**  . \*\ ..*.\*....! .*. .  .*\ *\** . ..\ *\..\.  .**\.. *\*\ \.  * ...\.  .W*.  .  . ! **.. ..* .. ....*..#          #
#*..\. \  . .*.**.  ....*  **  .\*.\.*..@. *\... * \\ !. \ * *\....*\. *.. * *\ ** *.. . . .    ....****.\ *.\*..**. \. .\ . *\.\*. ***...\\.. .  .. #         #
#\.**. ..*.  *@.  * .\.*. ... .*  ..  . \ *.*.** *\ .**.. .\ . *. ..  * .* ..\   . .*** . \  *.    .\*\*.......*...\ * * .  .\.*  **... *....* \.# .#*#        #
#. . ... *   .\.*. \ . . \.\  *. * .*..***  * .  \ . ..\ *\\* .*.    \.  .\ .  *.\. .*.. \.*     **\ *..\   .****  W\. ..\  *.. .  ..  *\*\  .  ..#**\#        #
#.@   .*  .... *.... * .\..@ *.*.*  *. **.   .*\*.\ ..** ... .*.\    .*  ....*.@.    .. \.***.*.. . \*\. .\  .... \ ..\.....**.\ . * ...**..#**\* **##         #
#*\.\**.*\  ..*. \*\.. *** *..\*\.**.   @\  * . ..*.  *.!*.** .  . \* .  .\ *. *. \ .**\ *.*\.*.... ...\. . *.. \..\W **.\  .....\..*  .**.*  .##.##           #
#.\ ..\.\ . **..\.*. . ..\ .... .\*.  ** *.\.  .*...*\.\ *. . * \. ...... ..*. \. W  ..*.. **..*@.*\... ..  * .*. .   *.*.*.. *.. *.*\..* . #.* ##             #
#\.*.**\.\\*\.    .\ ****..**. \  **...* ..* ....**... .**\   * .. ** \  \ .... * .\* *.*. .*\.*....*.\.*. **.*\.\\\.\. W\..... ..\...#\... **##               #
#*\. .***.\*..*\\  .  \ ....  .. \.*  \.***.\... @.\  ..* .   . *.*.\  \..\..***.* ....*. .  \ *** ..***.  *.\..\.*.**  * ..\ .  .. \   \ ** #                 #
#**  \*..\..* \**  \   \*   ..*\*  *\\  *.**\*\\ .. .**\  **  @ .*.\   .!..    * .\*.* .  !**  *....\ .\.\***. . ...   .. .\ \ .\ . .\... # @.#                #
#*. .*.*\*... .  \.\.*...\\  *\**.\  . *. ..... *   *.*.. \.  . ... .\*.\ !* ..* *.. ..**..\.. \. *.*\**\ **.. \ **\ .. *..* .  ....\**. * .  #                #
#.   . *\. * ..@  ....*. *   .\..  \.\ . ****..\.*. \ \.*\.  . . . . ..\*  ** .*.\ .\  ...\..\*\.*\..**\..\..  . ...  * \..*. *..*.\  . ..** #                 #
# ..\ ..* **...*.*.. .*\ ..**.**\ . \   **. .!..\\*      ..\*. *.   .** .*.* . . \. * * **\ .... ....\ .\. .* .** *.... \   \.* .. *  .*.*..#                  #
#\  *. \. .* *.* \    .*\. . \.\ ....   *.\.. \  .* * * ..\*.  .\.. *.*\ \ .\*. *.... \*..*   *.*  ...\  **\ \**\..*..*\*. .**.  #*  \**\\ *#                  #
#*. .*....**  !\...*.*... *  .*. ...\***.**\. ..\.* .** .* .\  *.\  . \.... * *\.*... **\ *.*.\*\.   . \ ....\..\ .! ..*. ! .*.   \.... .*.. #                 #
#\**.\*.*!..\   .*.*.*\.**..**. . *.. *. .*..\*.  .\ ...\*\... . .. \  **. .* *.*.*.* \....**. \.*\@* \.. *.* ...\  .* .. .\*.**.*..***\  .##                  #
#\..*. *..* * ....\* ***** .\**\\....\.W.. . *.\*\\*.. .. .*... .  ..*.\.\ .*..*  .*. .*\. **. *.**..    **.**\ * .. .\ \. \.*.. \.\.**##* #                   #
#\.\.. *\...*.  !*.! .*. . .*..\   *. *  !*\*. .\.*!. \.*.\...  \*.  .\** .\* . .\.*.  *.. *.. .**.*..\... *.\. * .***.*......\.*. *###  # #                   #
# \.*.*. .**.  **\.\* .\    .*. ** .\ .*. .*.* \ *.  \ .    ..**...  *.\. \..  *.*\.*.\*\.\.*\  *. \...\*. *...*. *... *.\ ..\  !.*#      #                    #
#  .*  * W. * . .* ..\ .    .*...\ .*  . .\..*  \*..**.**\.@**...\R    *  *\ * . .. * \ *.\\*.\**\ ..*.....   .* .*. . *  *.  *\# #                            #
#*...*\.\***.  * .* . ** * ..** .*.\*. ..\.* \. **..*..\.. W.*.\ . . \ .\*\.* . * * . .*\  .\. .*..*.\\.**.\.. . .* \ #\\..   **##                             #
#*\ .\ ..\.*.\ ..*. ...*.  .\..\\** *\ *\..*\..* . .\ !. *.... *  .*  **.*. *..*  . .  .. *\ ****.\.*.  *.* ...* ** .*. *.*..#..\#                             #
# .. * .\*.   *.*\\   ... * **\ *.* **\.  \..\.!*\...*  ..*.\ \.\ .\*.*. .*@..*.*..* .* *\.  .\\. * ..\*.*  ..** \.  .\.**\#\##**#                             #
##\* *...*\ .\*.... \  .\ \ *.. . .* .*. . .  . \.  *.* \ *.  .** .****..\.*  .@...* **.**** * .*.**\. \.   \ \* **.*\ \**#.*.###                              #
# ..#. * *  . ...   . *.\** .**\. \. \.  \ ..*. .. *.. \ ..\* \\.*.*.* .* .. .*.*\. *.. *\. .. .* .\  .***\\ * .*.***##.\.#.##                                 #
#  \*.  .! .  .*.** \ \**.   *\.** * .W.* W* .\ * *. ..*   *.\ ... .*@ .. *. **.**.  . *..*..**.**\.*  * . *@.......*# #. ##                                   #
## \*\. * * ..*@. .*.***    *  *....@\*\.* ..*W.*...**...... . * ..... \. *.*.\*.*. **...*\ *  \.*  !\ . . ...**\ #. \#** #                                    #
#\  \ *## .  *\ ....*.\. *..* ..*.    .  .  .**.*.*.   *   *   * .. *.!...\*.\ \\**...\.**. * . \.  ..  *\.*\**\ * .*#####                                     #
#. * ##....\... ***...  \*..*   *.. .** ....\......*  .* * *\**.*..*\  @*  * * .  *  **\..  \ * ..**.\\ .*....*.**.\...#                                       #
## ##\ \ .\.\ * .  *\.**..  . **..   .. *\... ..\ \\.***...*... ..\... .\\.\ * ** \*..* **\*...  .... *\.. .\ .\...*#.\#                                       #
# \#*\..#  *.*\ **.\.\\.*. *...***  * .\***\ *\\  .\ *.\ \.. .   *. . .\  ..\...* .. \.\... \.... \\*.*..\ *..    .* .#                                        #
#\# ##### *#### .. *  \#\  .   * . .\    **..   .** .  *\. .\.@*** *. **.  . . ..* .\  ** *\.@* *. \* .\.. *.\.\*  * #                                         #
##       #**...    .\ . #..   *.* *.\.  .*\\ *..\ . .....      *.*.  **\  .  * \ ..\**...\. *.  .   .. * ...*.*.\ *.*#                                         #
#         #*\ \*   .*  *\ \....\.\   *** \**.. *!*.. .*..\.* \*.*. \**\.*\** .\   \*\*    . *..\ .\   \**\**..**.\ .*###                                       #
#          #  .*.\..  * * .. * * .*.*...\ .. \ ...  #\ *.*....\\*.*  \* **.\ .   ..\.* .\.. \ .*\  **\.. ..*  *. .**## *#                                      #
#           ###\ .. ..# . *..* *\...\*  *.*    .* .\. .  .*..#. ... *\.  .*\  .  * .\..    .\.*.  \.*  \  *.*.**.\W\.. #                                       #
#              #.* .##* .*** .  #. # ..**\...#\*.. * * * .#\ **\....  ..**....\\ .  * \  .*...*.  .*@.\  .\**......* \#                                        #
#              # *\ ..\# .#\.. *.*.. *.\...*##*.#*#\*#  .\#.@.\.\*\ ...!.***.* ..\. \.. * **. \.\*  . * *  *..\.*. #\#                                         #
#             #*. #*#*##.# *#.*#*.** ## # *#  #\*.#*.#..\##\*   #* .. *\@\. *.\*.@. .*\ .\.....\ .\.**. *...*  #\.# #                                          #
#             #**\.*\.#*.####*\...*\ #\\#*#    ## #*# ##.# #...**.. . \ *#..*\*. *  .* .*.  * \  *  * *....\* \ ##                                             #
#              ## #### ##    #*#@*#.\### #       ##\.#  #  #\ #*.\..*. *..... .# #.* # ..\    .* !  \ *\*\.*\\.\ .#                                            #
#                #            # ## #.#             # #      # ##* * .  ....#\  #.#*\.#.* * ..\.*. . .*..*  ..  *##                                             #
#                                   #               #       #.# #\.# \###\.\##*## ##*\.*\.* . ....  .*..*. \. #\#                                              #
#                                                           #\##* *#*.#  # *# #     #*\...#.\ ..\. *\  ..*...*.#                                               #
#                                                            #  # *\#*#   ##         ##. ..\*#*#* .  . * ****...#                                              #
#                                                                ### #                #\ .#*@... .. * \ \*.##. *#                                              #
#                                                                                    #*.*\##*##**\... \ *.\.** #                                               #
#                                                                                    #.\## #\*  \#* *. *.. *.##                                                #
#                                                                                     ##    ##*#.#*  . .\. ##                                                  #
#                                                                                            #.###. *. .  #                                                    #
#                                                                                             #   # \.*.*\#                                                    #
#                                                                                                #*.#\####                                                     #
#                                                                                                 #.##                                                         #
################################################################################################################################################################

Water 0
Flooding 0
Waterproof 11
Razors 24
Growth 25
