##########################################################################################################################################
#        #. **.. \.\.* .\.. * \*  ...\.*..*\  . *\ ***  **  *\  \.* * \.*  \*\..\.*.*  *.. . *.\.\..  .\ .. *.\*\*\*. \*  \8\ \*.  ... * #
#      #  #.\*. *... .   * .\... .\* *\..\*.***.**. ..**** *. \.***.. ... . ..\ *. *. *. ....... . .\  ...*.@  . ...* .. . * . ..*...  . #
###  ## ##**.\ *.. ..*\\ ..\** *.* . .  ...*...**  *. . *.\**\.\... * \..\.  ...\ ** . .*\.\.  \  ..\ ..\.. .  .* \ \  ..*   * \.!* ..\. #
#..## .*.... * ** \   ..  .. . .. \. *  ***\*.. *. .W!.\. **.    .**\. *   .... *\. .  ..   . . ...*. .*. .*.  *.  .. *.*. .*.\   * *.*..#
# * .#*#!#\  ...\* .*..  ..\  ..\*. \ . *...\.*.\    ** ** . \** ....*..\ * \ * .   ..** .*\*..\. .\\ .. *.*. .  \.....* *** . *..... *. #
#\ .\*..  ..\\\  .  **  **** * *.**. \*... .  . * \!*.** * .       ..@..  .*.** \... .*. ..**\.*\ .. * .*.*.  ..... * *\ . *..... \ . .\.#
#* .\*.\.*.  \ .* . .*\@.. . *.. \ *  \.  *  * *...** ..*. **.. . *\**. .*.*.*. .\ .* . .  .\ \..  .*  \\ .  .  *. ** . . ...\.. .\.   ..#
##.  .. @*. ...  ** *.*\.. .*..* ..* *..\..@*\.* .\...  .***..\ .*...\ ...\   . \@ * \.. ..\*...* . . *... ... .***.  \    .\.\\ *..  . .#
##.** *..\*  .. \**\. *.\*. *. * *\* ... . *. *..* ...\  *.. *.*\.\  .  \ \.  *.... . . ... *  ..*  .. .... \. ..* *.   ..***.  *\.**\*\.#
#.  *@*.\..\..\...*.\ . .\.  . . *..* *. *.\ *.* \.*.*.* \.* *. .\.  ...*. ..\**.... .\\ \\.* ..*\ .\ \  .* .* *\*\* . @* ..*\.  .*!..\**#
#   *..\.\..      .* .*.** . .**\\ \ !...\*. .\ * \. .*... . . . . \.* *..* ...* ** .\  \ .*.    .   *.  ***.**..*\.@\.*...!* *.  .. *.*\#
#..*. .*.. .*    *** **.    ..\. ....*.  ..   *.\ .*. .. *. .**  .. \ .**\.... * ...*.***. .. *    ..\* ..*.*..**. *.* **..\* . .  * .   #
#\*..* *\*.\. . .*... .* \..\.*.* \  *    *\*..* .\*** ... . .\* @\*   ..     ...\**. .\.. .   .\ . . @\* *\.* @* *... * . ..* *\  .*\ * #
##.*.. .*..*\. . .  \. \...\.**..*... .W\ *.. .*   . @*  .\ ....   ! .\*.*...*..\**.. .*  .\     . ....\*\ *\**...\.*\.\.  \.\.* .**\.\. #
##\.**.. *\. **.    . .*\    ..\ .\ . . ....  *. ** \..\*  *.* .*\ ** .*.\  ..\.\ .. *\...  .\*  .*.*.  .  *.*.  ..       **\*..*.\. ....#
#*..#\..\.*.* \.\.* . \... .\.*.*..*. ..*. .\..\..*\ \*... *.\..\. \. ...   . \. . \ ** . **  *  *.** ...... ..\  **\      *\..*. @... . #
####.* .*** .\  *@ \ .. @.  . \. \W\ \ *...\*..***.  ...\ \.\ **.*..\ .*.\.\  . .* .\ . ... \.. \* *.\ !**.   **..*..*\ ...*.... ..*.  *.#
#   ##. *\.\   ..6\.\.\.* \  \.  ** ...\ .\ *.\..**.\**\ .... **   *. \* ..\*.....*. .. .\.\. .\.... ** *.\* *....***.*   ..*  * \\\\.\* #
#    #L.#.  .*\* . **  *.  \..***\.   @..\...*.\  \  \ *.* . \..\..*\  . ..*. \   .\*\*.\ **\ ..* *A *.\.* * \\   ! * .!*. ..\ .*. .  ***#
#   #   .*..\.*. ..\..\ .. .\ ....  .\**  *\ . .*\.\*..**.* * *** .\. ** ** ...\*** . .@.... \.**.... .*..*. .***..\\ *.****... .  * \..*#
#  #.\ * \ .* *\.. .  .   \*..  .\* .*\ .\. . . .  .@W ***..\ ..     .*.*.*.. * ..* .\.\**!\* \. \ \ ...\ . *\ .. ..*  *\...\\\*.**. ..* #
#   ###. . \**** ...*. .  . .   ..*\ ..\ *.** *\. .* .W. **\...\ *\* .....*.. * ..*. . * .\.. ..*.*.* . .\. *W\ .*\.. \*.\ \*.\. ... .* \#
#     #.**\.\*....  .. * \ * * ..\...! ..  . ..*! ....\. .. * **.. \  ..  ..\.\.\\.** *.. \ ***\*.. *  *.*  .  \@...* ..*  ...**\.    *  #
#      #.. \**.*.   \  . . . . .  .  *\*..\ . * .. *.  \.* .. ..*..  .*.. .*.*...  .*...\ . *.**.  .. ..    .\ .. \**. \ *. .*..*.** **\.#
#     #\**.**...*.*\..*  *\..  .\ ....*.*\*. \.*  ..\.*. *\*\ .*.*.. *  . *.*..  .  . *.... ..*..**. *...*!\ ** . ..\  .... .. .!\ \@.\.\#
#    # .*.. *\ .*. ..**... . *..*. .* \*.*  .. . . \*..  * .*... . \*.*.* . ..****  **. \**.**\.*..\.*.. .\ ..***   .\.  *. *\ . ! . ..\*#
#     ## .. .**. .**..\* ** \. *.\  *..\.*\*7* \  ...**.*\ .... ..*.\.* .\.**.\..** .\\**.  ..*.. !**\*.\ * ***.  . * ..*.** *. ..\. **.\#
#    #....\.. \* ...\. \  . .  .\ *\.\..\**\ *\.\ .. * *.... \  \.\\ ***.. ** *.***.\.* ** ***.. .......   ..\.\.\*\.   .*\*.* *\   ..\ .#
#     #  \. \... *...**. . *.*.  \.* *   *\*.\ . .\\ .\. *\*\ .*. . ...**. .\ . .\*..\.\..\.\*  . * \   *.   **.  ..*\ \..*...\*..\*@\ @\#
#      # \ \.*.   . ..**. \*.\ *\.@.\.. .... ***\..* .. ..*. . \**. ***.. .*\..*.\  ..*. ..* * * ..\.  *\ \ .\ *.** ..    .*.* *\...\ * *#
#       ##\.*... * *.*.* .!. *\..  * .\..  . . .***..*\ \ \* ....*..*\..\. . .\....* *.*.  .\*\.\*\ .*..**.. . ..** *\.  ...***.  ...\ \*#
#         ##.  .  \. ...\...**.*  .\ \..\*\ *\..*..   . .*.\* ..\**  .  * . *   *. ..* *..*.*..  .* *. . .\** ** ...***.*\..\.\* * . *\ .#
#         #\.***.**..*. . .\.. *.\ .*... .... ! . . ... .* ..\*\  \   . .. * \. * \.***.\.!\ *    * . . \  *\ ..\*..*.  .*** * *..***\.\.#
#        # .#\*.\.** ... !\.\ ..*. *.* .**  * .\* ......  . *  . .*. *  .*.* ...*.** .\   .*\ \  *C  \..**.*..* *.*\.*.***...\ *..*..\.*\#
#        #   ..   \*. .\. * *  ..*......\..   @.*\.\.*.\*.  \*  ....*... . .**...*..\ **....*..\..**...*..**..*\*.***.  **\ .. *.\.* ** .#
#         #..* \**.**\.\  ...  *\*.*    . ..  *.*.** !.*.*. .\.\    .**  ***.!* \.   *..*\. .  . .* .* .\ \. .*\...\..* . .*\ *.** * *..\#
#        # .*#\*..\..*..* .! . ** \. . \.**  .\.*.. \.\\..  .. * .  ..\.*. *\ . ..*.  ... .. *  \*.. ** .    ...\ ......\ *\ \..\.\ *\.**#
#        # *..*.*. *  **** .\***\*..  ... .**. ..\.*.  \.  ..\.*.   \ \ . !.*\*@ .*.*.  ..\ ... .* . ..*.@. \.*..*  *.*\..* .  . *@\ * ..#
#      ###*. .\ *\.. ......\** ..* .* .\ ..*. ....*. .\  .* \ ..\.  .*. ..\*\@   ..... .\.*  *..*. ..* . *...*.. .\**.****.  ...  **.@\..#
#     #......\ ..... *\. * **\ * . *. \ \*..  *.  *\    . ....\.**.. \* *..D .  * *. *.*\**\... .*  *.\..\.. \  . .**  *. .*.  \.***...  #
#     ##\..#*  .!  * *.*. \@***... . ..... . ...**..*. .. .. .. ..\.  . ... ..* *\. .....\. ..   .  *. ..**  .\ ...!*. . ... ..**..\\**  #
#    #*##\.##. \ \*\.\ W  .....**\**. ..*.*. !  *\ . .  \.*.   ** .. .. *. .\*@.** .  *    .\..** ...*. @.@..\. * ....\*. .... \.**. W. .#
#    #.*. ##  .* .\.*...*.***. *. .....\.*.\ . . *  .*...\**...*.   .*... **. ..*\. . ..* .* *... \\..  ** **...* .. *..  \*\.*   .* **\.#
#    #....*  #**\ ... *\* \ ***.  .. ***.*.*  **..!\ *.*@* ****.  \  .\ * .. \ *..W.\. * * . * *. .  * *...*\. \..*..W* . !.. *  **. . . #
#    #.** .  ** .*\   !.*. ****\*. ***\..*  *.\.*.*  *\**\ \*...*\..* ...*.*  * . ..*. *\* *\..\  *.*. *\*. * ..\.*..*.\ * .  .*.. .\ *. #
#    # \\ . \..*.\ !  W*.  .\   ** .* .\... .@**.@*.**.*.. ...*\..\...**..*. *  ... .*\. \....** .\ ..**... ** ..*\\ .. .. .\ .  .. ..*.*#
#     ## . \ \.***** .*** * .   *. *\..  * *.. .\....**.\..*  * *.  . ..\** ** * ..*  . ..**.. *\\.*B . .\ *..  . .\. * .\* ..** *..\.. .#
#    #\.*.\   .W..*. **\.\\*\ \.\!***** ***.**.  ...\*..* .. ** ..*.   \ .*..*   .\.  . ...\. *.***. *  **.*.*.*   \.\\ ...\  *  \*\.*\ *#
#     ## *# **  . *\\*...  .*\.\ ..*...\\. .*. .\ *. \..\*.  .*.**..\..\  W....*   ..* \. *. .* @\.  ...\  ...*.     **.*\*..*  \  ... ..#
#      #. *\..    ..*   *.* .* .\.*. . \.***.*   .\.* \.*. **** *.  * ..*W\! \*.*..@*...\.  . .\ *\  .\*.. *..*.\..*  \ \*\..** .***  *\ #
#      #    .. \** .*  .\*\..*.  ...**..\*\. .*..*  .** . *. *. ...*\...*.. *...\. .*\.   \ *. .\.*..*.\ * .. ...*.*. .\.* *\*** *.  ....#
#       #  *#  .\.\.. @*.*..**.  ..\.*\  . *  @* **. ..\  .  .  ...\.\ *\  \*.*..\.*.*\. *..\ \.*..  .\.**.*.*.   \.*.....***.*\.  .\  *.#
#       # .# .  . * \.*. W*..\.\.\  *.\!   *.\** .* ...* *\\. \*.\..... *.\.....*. **.*..\.*  . ..* * * *..*\\* . **.\  *..*.\ * .    .. #
#        # #*..\..\..*. \.* *  ..*\..  \. \..*.** . \  ..   .. .**  \*. .* . *     *  \..*.\     .\*.*....\* **.* .\ *.  \\*. .. * ..*\* #
#         #..*. .*.* . \ ** . . *\1\ \ !.\. *\ .*\\ . *...*\. ..** .\. .     ..*  .. ...*\. . *..\...... ....**.*.. .. *...*  .\..  \  . #
#         #.* #. #...\*... \* \ ... .*  ** .*..*..\.\*.. ..* * ..****..*\.****.. . \ .**...\ .*\*.\..**...   ..*.\..*** ..*...* .......\ #
#          ## ##\*..* ..\. .*... *\\ \*...! .\.\. ** ..\.!...\\*.*.\.  .  *\**\ ** .* **  ..\..\.*\. .. \  .  ..\\  \**  \ *  .\*.*   .  #
#           #\#* \....*.*\ ... .. .  ***  .* . \....*    * ***.. *\..*. \..**.*.\*\..*.. *.*. .*\*..*\******\   .* * ... .\@\.\ *.**...  #
#            ###\..*..##\. .\. ...  .  .   *   .*..** *.*. . . .*\..\**\. \.*.. *.. \*.*\..\* ....**\* .   *..* *. . ... **\. ..  .\ .*..#
#            #. *.**#*#* **.  \**\*..  **.\. * *.... .* ..* . \....***. \.*\.\ ..    . . \*.\*. \.\. ..*. .*. *\     .  .*\. * . * *!..  #
#            #*#*### #.**..\.....*.\* \..! ...  *.*.*\.   \. . . *.!..*. .*  .*.*.\*\ *. .... . \ .   .\*. .. .\.*   ** *.. **.   *! .\ .#
#             # #*.!#*... *. *** .. \...\  \.\.*.\*.*...* . ...  ..*@.* .* \.\. .*... .\ *.**  *\* ..   ... .  *\*.\.@.*.* ...\ . .  \* .#
#               # ..*.*.*\.  .*.* * .**   \.*..\...**\ \.. ..\ *.*.*\.   .** **   *.  .. ..\*.*  *** .  **.\ .\**\ *..\.*.*.  .* .*  .*  #
#               #\#*.* ..#  *\*.. ....*... .. *....!*. W . .**\..\.. ..\* .\. **.*  *..\ .  .*.* .*.*. .*.\. . ...*..\  ***  .\...*  **\.#
#               #*## *. * \ . .. * ****\\**\...*\.. \.. ...***.* *  ..*.*. . \.* .  .*\.**.* \..* . *\  !*.\. ... .. . *.  .   . ....\ . #
#               #\..** ** *\  .\ \*..\.  \..*. *.*\ . .* .*..*.* .   ..... *3*..* .. . . .\.....*.. .*.  *  *** *...   .. ..*.      *  .\#
#               #.##...*\* .. ** .*.** .* *..\**   * .\..!.*.*.*\...\**..  *..*\*** .  **\**..*. .. **\.*. ..*\ *   .* !** *\ **\..\  . \#
#                ##\ . . ...*\ .. **....*. .  .*.. \*..  \ .\@.. \**...* *.*.\.*\ . ...*\.*.. *.... ...**\     . \. ..*\*.*...\. *@.* .\.#
#                ### ..   . .** *.*.. *\..\ .* .. ...*.*. \ *\  .. .  *. *..   *..  .  .....*   * ..\\**...*..*. .  ...  ..   **..\*.\..*#
#               # ...**R .\! . ...* .*...\W@..* .** \ .*  *. *.. .  \* \ \.* .\*. ....* \  ..  **  .. \.*.*.\*.\\. \\* \\.\.**\.*\*.. ***#
#                #*#\\..**.  \.***.  *.* .*.....*.*\.*.\  ***\ \**\  . .*.**\  *\ .. .* . \. .\**.*....*. .  * . **  . . **\  ....!.  ..*#
#               #* .#\. *  \  .!\. \  *.  *. ...* . \.   .\..  .\ *\..  .\\ . .\*  .\ .. .\.\ \ ..@.*.\..\.*.*\.. . .. * *. .   *\\ \. ..#
#                #\*.*#.\ . .*.. ....\.. \*\**.\.* \...*. * \\.\  . .*  \* . . .* * .@ .**. .. * .*  *\  .... .\..\. ....\.   **\  .   .*#
#              ##..*#..**\  ..**\*\ \*   . **.\.*.\*\....***. ..\* ..* ***. \ ..*. *..* ** *. *  .*  \   * .. . *\. ..*. .\* ..\*\*.*\*\.#
#             #**. *#.\ . .. \*.** *\.* ....* . ..*\  ......\ *..  .*..*..  .. \.*..   \. *\*.\. ...*.   *W\.. .! **  .\. *.\*.*! .  *.!.#
#              #.  ..**\  .* .. ..   \.* .\...* .\.   .\.\\*..\.*\ ...... \.**.\*W*.** .\ .*...  \...*@*\. \***\.\*\ ** ..\   **.** ....\#
#             # ..*\ .*..* .*.  **..*. ..\...*.\** .....\. !..***...\ .. .***.*.* . \*\*.*.. .\. ...\ \ .*\*.....*. ...\.  . .\.! .!**  *#
#             #. *#.*. \ .\..  .*\*.. .*.  .*..**.*. . .*@.\**.**\\ ..  ..*.* \.*. ..**...**..\..*\. \!. . ..   *..  ***.\  .  .*\. .\ .*#
#              #\#  . *.*\ .\   . .* . .* .*.*... . .* *..*..\..* \** \ . .\ .\\  *...\ .\.****\. .\.** .\. * \! .. \.**..**..*\.. ..  ..#
#              #.\  ..**!*.*  .** * .****.*. .. * . .\..\ *\\.*\.\.!\\. .**** . \.... \ *.... ..\  . ...*.  . .\* . .. * .\.**.*  \*\..*\#
#               #.***.#. ... ***. .*  @***...\ ..\\.  .\*.****..\  \.  .......\ .\*.. .!. .\...*...\.* *\ . \* *. * **\. *...\*.*....  .*#
#               #*#\.\  *.*.  **.\.\. .....*.*. *. \... .***...* .\ \ .*. .\ **..*.\ ** \\.... .*  .** . .*.\*.. ..* !*.\ *.* . *.  \*. .#
#               ##*.!*. . *.. ...** *.    **.\.....F ***  .. \..*..*.\ .\ **.. *\.* .....   \  *    \. .  .  \*. **. .... \ .** . *..*@\*#
#              #... .. .. ** *.\ .. \ ** ...  \   \*...* .\. .\..*\*. .   ..\@...** *.. .*\..  ..* .@.... \* .  .*.*E .* *..\.*.... ... *#
#               #*#\###. **  . .*.. ..*. *.\.!. ...* **.\\. .*...\..   . .* *..\.\*  . ..* \  ..\.. .* ** . *\..*. **     .\* .  *\  ..* #
#                ## ##\. \.\ *#\.\**..** ** \*\ .\.* \... *... ..*  ** .  . ..   .@.   *\* .. . W*. \. ..\  .**.\ ! * *.!\. . ... .\.. ..#
#                  #  ##### .....*.*. .  .* \ .  * .   *...\... .*\ . .. .\ *  . .. * .\. *   . *.*..\\ ...  .*. \*\. . .*.*\ .**...**** #
#                      #.  ...** *. *  \. *..**\ *.  . .* . \!!\.*\. *  \***\ \ .\*\.\  . .. . ....* ..  .... .. .*..\\   ..\ \.** \** . #
#                      #..*\ \  ... .* .\  .**.*W\*\*\  \.\  . * ....*  * .. .\*..* \ . *. \  .\.  * ..*.*. * *.\. ..**.. .*. . **\.!\ * #
#                       #*.. ..**..* *. .*  . \. .* .. . * .** ...*. *.**.*.  !. .. .**\ .*. *...\  \*..**.*...*.\  ...    *.\.*......*\ #
#                        ##..* ... *..\.\.\**#.*.*.   ...*   .\*.... ...*..\*.. *\ *\*\ \ ....  \.!* . *.***. *. . . .. \* .*..\  \*..*. #
#                          #\*\*  .\.\.\..**\.*. *. .*\**..*. *  .*..  \.*.*.. **.   .**.. .* * \ .* \\..... ..\ *.\.    .!\* **\.*.\.*..#
#                          #* .* *. @.*. \.    ...  \....\..\.*  .\..\*..*\ *. **. * *  .\  ..\*  .\ .    ..W@** **  **\** *. \ . . ..*  #
#                          #** .*.  \#..**\* .\. ** ....* .   \ ..* . . .** * . .* .**. *  *  \..**. **. \. *..\..\..* ... .*\ .@.    \. #
#                           #*.....\ \.. ...  ..\...*. .*  *. *.!* \..*\ .. ..   \.  \* ....*.. **....\. .\ .\**. ...*   \.\..* * *. \. \#
#                           #.* *###...*\\** *.*.*.*.\.\.  *.\ **.\. \.*.....\.\*.\  .\*.\ \\* ...*...  \....*.*....*. \ .*. ** *\.  * . #
#                           #.#\.  *. .# *.\ **.*.\\ *\ *. .\*..\.* ..***.\.\** *.\.**  .   *.**@\.*    ..**.\...   .\.*\..*  .** . ** \.#
#                          # . . ##*# .##.*. # ..\.\*\\*. . * . ..    \*..  \.\ *.***...\. . **.\.  *.  . .. . . . .\*\ *.\*   **   ..*..#
#                           ###  # ##* .**. \ *\* *.\ **\ *. .\. \.  *.. .*  *.!..*\\*.**.*.\*.*. ** ..**@**  *.. *. !.*.. \   . ..  **. #
#                            #\ .# #*.* #..*  **. . \.****!*. .W.. **..*  . **..  ***\*\ ...*...*\*.......*.     .   *  . ..\.\ \*.  *\.\#
#                             ###  #.###***##*\.\..\.*..\. *. .......\ . .\....\ **\**  .**\..*.**.\ . .. .*  .   . *. .  . ..  **.\.. *.#
#                                  #*# ##.*\.## . .. !\.* .*. \ * *. \.*. .. \.\* **.*\\*... ... .*. .  \.*... .***\ * .*.\\..**.\  *\ . #
#                                   # #**\ ##  \**\. \. .\.*  . ***\\ ** *.\..*. .....*..\.. *# ***..\*.* .*#\*#\..**. **..*\.\\* . *..\ #
#                                      ##..\* .*..**..*   .*    .*.*.*.\.\.   .*\*\*... . .  .... *.*\ *.* * # .. ... \*\.**.\ .. . *#.*.#
#                                        #\##....*\.....#.\.  *   .. .   .\. * \ \..... * . #...*\.*... .. \.   \ \* .#*#..*. ..*  .....*#
#                                         ##*..*#*  .*.**.  \*. ...\ \ .*  *\.\. .*.#.*\ * ...!** .\*. * . .  .\#*\. *#*#   ..  * \  . **#
#                                           #\**.*\*\. \*\.\  * .. **.. .\*\.  .  .\*\ ..#**. ***\ .\*...# \.\.\ \#*@# ##.\ #  *# # *.*. #
#                                            #.## .#..*.**.*  .* \..#..\#... \@**\ .* \   * #\#.. .* **.\..* *#\ ..## ##* ..@##*  .*.* #.#
#                                             # #\.W*# ..... .*.*..  ..*. * *!..\. #**\. *# ##.\\*   ##*.\\**# # ##  #*\  * # ** .* *\  .#
#                                                ###* *  @ .  .*\ @*  .   ..\*. * *#* .  ! *# # ...\## .#\*##  #*#    ###*#.####* # ######
#                                                  # .*#..#* .  .*.##*.  .\  .  \ * ##*##.*#   # *. ## # #\ #  #*#       # #   #\.#*\#   #
#                                                  #*##** .### *\  !#..* \.#* ..#\#\# # #*#     ### # #   # #   #              #* #\#    #
#                                                   # #*..#..\*..*....##. . .# **# #     #         #       #                    #..#     #
#                                                      #. #*\#.*.*.** .#***.\*.@#                                               #*#      #
#                                                       ## ##**.*** *\**#..*.# . #                                               #       #
#                                                           ##* \*\.*..# ##.#. *#                                                        #
#                                                          # .\*..#* .#    # ###                                                         #
#                                                         #*. ... \.##                                                                   #
#                                                        #*.*.\.\ .#                                                                     #
#                                                         #.#\*. ##                                                                      #
#                                                          # #.*#                                                                        #
#                                                            #*#                                                                         #
#                                                            #**#                                                                        #
#                                                             #.#                                                                        #
##########################################################################################################################################

Water 8
Flooding 11
Waterproof 15
Razors 27
Growth 10
Trampoline A targets 3
Trampoline C targets 7
Trampoline B targets 1
Trampoline E targets 1
Trampoline D targets 8
Trampoline F targets 6