##################
#..*..* *.\71. # #
####\...*. .*\*.##
##*.!\** .... .C #
# #.# ..   R4..###
##.* ..   .#.*#  #
# ##A\#.** B *#  #
# # * #\.#* ##   #
#  L##*. .\ #    #
#     # *  #     #
#     #.#.#      #
##################

Water 8
Flooding 6
Waterproof 15
Razors 39
Growth 26
Trampoline A targets 7
Trampoline C targets 1
Trampoline B targets 4