###############################
#    #@ .*#*.*  .*@ **B*\.*. ##
#   #*..\. . . *\A. . .* *...*#
#    #*\ * \.* \*\.... ..**\*##
#   L#* \. ..#. 9\@..*    # #.#
#  # ..\..  . .* ..!  .***\ *.#
# #*\* *## ! \ *  .* .  . **..#
###**.*\ *#    \ *\*\. .. .** #
#.\..**.  .  \.. .   .\  *.*. #
###\*.   .\ \.  \* *\  *   .\.#
#  ##*.   *8.\.* . *.* ..*  *.#
#   #.** \.*\* *\* **.\..*....#
#    #**#..**2.. \.\..*\ .  .\#
#    ##\*..\*.@ ..   *.*.\ **.#
#   #\ *\*C * .. R. *. *.\....#
#    # .\.* .**\\.  .**  *. . #
#   #### .*.* .**  *\*. \ ....#
#  #*.* *.\*\.......*# .W * ..#
#   ##.** *.   *    ..* *.\ . #
#    #...#* \  .\  ...*.. . \ #
#     ## ### * .*#*\ \ \*\*..*#
#       # # \*.* .\*\. !**#\.*#
###############################

Water 20
Flooding 12
Waterproof 14
Razors 15
Growth 17
Trampoline A targets 9
Trampoline C targets 2
Trampoline B targets 8