########################################################################################
##  #.#                                                                                #
#.##\*#                                                                                #
#\*#..#                                                                                #
##.  \.#                                                                               #
##. *.# #                                                                              #
#\ \.# # #       ##                                                                    #
# .* # #\#      #\*#                                                                   #
#..\ *#\.###   #* # ##                                                                 #
# @.*..#***\# #.* *#*.#                                                                #
#* *\.\ #. \*#* .\.*  # #       # ##   ###        #                    ##              #
#* .*# . .. .@ *#**  # #*#     #.#.*# #...#  #####\#  ##              #. #             #
#.   ..*.. # * ..*\.*.##.\#   #..!...# #**.## \ * .# #.F#  ###       #.* .#            #
#    \. *. .\* * .*@*# ##.#   #** #\.## \..*\#*\..\*##\ # # ..#      # \*#             #
# .   ..*.\*  .* ..\\  *.**# #. ..### #  ** *..* *##\*#.#  #.#     ## .#..#   #        #
#. .* **\. ..\*...*...*. *#*# .#*. *## #*#* .\......#*  ###* *#  ## #L.#..#  #\##      #
# \ ***.** \*  *. #\*.#* \#*.\ .\.*D..#\*.!...*#\. #.\. .H..\.###**  ..\  .###. .#     #
#.@ ..**.. .\.....\**...  .\. *#*\... .....*\.*..\## *****#*.*  ###** # .. #.#. #      #
# \ .****. .\  \ *.*    .\ ...#*.   * .*.#\.  *.\#..*.\.!# . # .##   *\***#....#       #
#*.  ..*W .   ..*.*.*.\. *.*\\ .*..*.\ ... *....#..##\*.#\* *.   *#  ...##.#*.*.#      #
#.  \.\. \   . .!.. .\*. . .*.*.....**  *. *.*.. .*. **..*..\.\*#\ ..* \*\*\.*.#       #
#!  .\*.*.*\. \*... . .**\**. .  **.... ..!\ *. ...  *.* .. 6 *..*. *.\.. ..  . #      #
#\.*..  .*..\. *.\**\. \\** .\*.  .\*.....\* . .... .  .   *\* #\ * * *..\   . .#      #
#* *\*\**\.@.\\...*\**\.* .. \.\ .*..*\.@.*\* \\....*..*W\* ... .\. *  \*. .*\.##      #
#.\..\.*** .*.\ . ....* .\   .  .\..*..**   . \ **..*  *\ ..   **  .. .\*.\ * . .####  #
#.  **.*.*..**..*. **!*.* *.* .   !\ 1\.. *\...\.\  . *..*... .. ..***.\* ...\..*\.* # #
#\. *.*.\........... \ *. ...  \... ....  *   ..***@**.  .*\ ***. *\*\ .  * **#\**.* ###
#*.**** .* \ .   8\  .* * \\.* .*.\ B*  *\ .*** . .*#*. . .*\ ....\.....***... ..*.###.#
# *.\.\  . . . \ \..* . *\*  ..  9. *.**. ...*\ *\ *.* .\....*. *\ * *\..!.*.\ **\..*  #
#*  ....*. *.  .\. ..   ... \.\ \.*\ .*. ..* . \**. **\ *..*\...!.* .\ *.\ . !\..  .####
#.. ***.*....\****......* \*. ....\.\. .**.*  ...*. \..\..\..\*\...*.\. * .\. * .!#*...#
#* ..*.\.****\**.*  *\.\  .. .* **.*    ..*. . **..... *  ... .\. *..*. .\  . ...\ . \ #
#\*.  .*.***.. .\.... *...    ..*\...\.**\..   ***\* .*.\.*.....\.*.\\..   * . *. ..\.\#
#.* *.*. ...\..*  *** .* *  *. *.@ .*.. ..**.\ .** .\ *. . .*. *. ...*.** *..*  **..*#*#
# .*.* .....  .* ..\.. * * *... .*. * \ \\..\ . .** * *  ..\ **.  . .  **\\. * .\.  *\ #
#. . \.*\. \.  * *\. .*...   .   .*..**   *\*  .\*\*..  .\ * .* .   \*...* ! *\.. .*...#
#\ . .\..**.**.\ .   *  **.W.*\ \\.\. .\ *.*.   \.....\... . ..*.*.  .** *****  \ * *. #
#*. \!*.\.\**..*\****.\ *.\   .  . .*..*\....*  .  * \..   .** ..*.\.*. \*... .  *..\. #
#*.\ * .. ..*. *.\.\.  ..\..\ *.*. ..\ *. .. .*  ..* . . ...\ **...  .*. .  .\ .*. ..*.#
# .... *\@ . *.*.*\ .     *\*\\*.  *.. .*. .*\. *. .*.   \*. *\ .  ..* * .. ..*..*\\. .#
# **@\....\  *..  ...* .. \ .**..  *  W ...*.*  \ . ** ...*\ .  *...*\ . *** *\\*.#... #
#\.**** .* !*\ *\ * .****.. ..\ ..\*\  *   ... * ..\*. \...@*\\*. . ...*\*.\ \.\*.*\ . #
#.... *.\... **\*.   \*\ \.*\ *.*\ ..*.. .*. *. *\\.@.\..  .*\*. ...** * *..*.   . . . #
#   \...*..**.\*W \ .*. *....\.*.*** *.\.*\. .!.*  ** .* .* **..*  ..* **.  **. .. .\.*#
#*.*..  ** *.  .\...\*. ..\\  .... . .\*..*....@.\.....**....\*.* **\. .\*.......* .**.#
#. *.\  ....*. ..   *. *** .\. \*  \ *..\. \*  ... .   \* . . .**\.  *.  .  .. \\..... #
#\..*.\. .\ .*\.  **..*\*\\..\*.*  . * .    *  . .\@\ * \\ !\  *\*..*.*..**. \ ..\ .   #
#.* ....*.... .** .** .....*\*.... *..\  .** *\  .*..\. .\ \..** *..  *\  .* . ..*. \. #
# .\.\*\*.  \* .  **   ..   ......\! *  .\*.. ..\\*\. *\*. \.*..*. . .**  .. *.* .\ . \#
#.*.\.. ..  ..  .*.  ..*....* .. .*.\. ...*.\ **   .*  *\   ...* *  .*\.. .  . ...* *\.#
#.* *...@.  *... ..*.\\. .\ .\ . *** .. . ...\.. ..** *.\*  .  * . \ . .\ \* *   \. \. #
#\.*.\\.\ *\.***.\   !\.**. **.  *.*\.. .***\. *. .\. . *.  *.\.\ *.** **\  **\!. *..*.#
#*.....\ \*\ . . .\  *!  .  *.\*\*. **.*.** . ..*. *    .\.\. * .**.*  ..   .*.\*..*.*\#
#**\\** ...*\.\* **... . *...  \ ** . .\ .*.  .*\. .\\ . ..*@..\ \*.*  \. . .*..*.....*#
#.* * *   \**\*..... .\\ * *  \.. ..\* ...*.\. .. .** *. ...**!  .\ .  *....* @ . ..\*.#
# **..*  .. *.**\.**. . \.*.\. *.\ **.\.*.**.\ .\ *.***.\  .. .\.\.. ..   ....\*.*.\*..#
#.\*.\.\\  *...*@.\. \..*.*..* .* ..*...  **. .... .*.\     ..*\. .\.*.*.  *  *. .* ...#
# .** .*.*..**.\. .* .  .\ \*.    .\* *.* *..\ .*.*.\.....*  \.*\. . . *   .  .*  .. *.#
#*..\.** \.. *.  ...** . ..**.\  * ...\. *C. .. . *.* \ W ! ...  ** \.. ..    \   **\.\#
#. . ..\. *.*\  **.*..\ .  *..  .\ *\** * \.  *\. *.\ .. .\  *\* .. .... . !*   *.** .*#
#****. **\* \* *..\*\....\..\ . *. \*.*... . !*.W*\\    .\. @**.    \  \  .*** .**.\*..#
#.  .  *. .*...*\.    \.*.\. *\...\.*\.\   \.** ... *\ *\*.  ... *\..W* .. . .*...\.*..#
#.*.\ *.. ...\ \..*. **. ****. *..** *...*..\.*  ..\.... \ *.. \ *. \.*\.   . *  *.\   #
# .\*\.*..*   . . **.**.\.\\*\.**@..\*.....\  \.*    *.    .   .\***. . \**@. \* \\   .#
# \ *.*\..*.* *\. .  . \ .\\.  . .* \* . * .**.*.\* . .\ **  . * ... \.. ..* .\..  . .\#
# ..... .* *   * \.\.. . .*\ . .  ..... *   .  .......\ \.*.\* .  *.\..*.\ . .*\..G . .#
#.*.\  .** .  \. .  *\**. .   \*.\ .**\.* .**. .\ *.  .\.  **. ***. ***.* *. .. *\.*. .#
#.*.**.**.* .* *....* .\..*.*. **.***\*\.. \* . .\**..* **\ ..*.**. ..... *\ \ . *   .*#
#   *W. ..  *.*. *\..  * *\ .\*....**.*\*....\..\  * . *...*.**...*.\ ! ..  . *\\. * .\#
#  ... .* \  *.\...*  \.\\.\*@ .*.\**...\** **.\* .** .* . .\.\.  ..*...  ...\*.   .** #
#\.!*\*.. .**.** . *.\.**. ***. *. ..    ....\ \. ***\ .\*  .\.\ .E.*   ..   ***.. ....#
#   . *.\*....**\@ .*.  ...*..   *.\.\ . *..* ..**.*.. . .W*\*\.  *.  !.. . .\. *\.*   #
#.*\  * *. .\.*\!\\**.**.  *.  .  \. . * .  .*.W.\ .. \ **\**. \*.  .  .*.. *  .**\.\*.#
#.\\.***.. .@ *\ W.\.... *\.\ *@*..*.. .\ ..  .. . .....*..*\*.... *  .. . ...*@@\ **\*#
#\.**.*..**....*...   \..**** ....\  *. . ...  **. ...\.\  **.* W*.. \ *   \. .\. .*. *#
# *.. . ..\. .  \  .*.*\ .*\.\*  \ ...*W  .. .. *\ **   .\ ....\**..*...*.\.. .* .* .\.#
#\.*\ .* *   .  !.\*** .\ ... \ .\*.\.  3.\ ... .* .*\.... . .*.\.*\..\..*..*\ .. ...*.#
# \..**\ \..*\.@..*...  ..  \ ..\ ...* ..\ *.  .*.*. . * **   .\.\  \ *\...*.    . *\. #
# ..*.* ..**.* .\\..* **\ ** \*   .. .\ \ .\ *... .**\.. *.   ..  .*....   * *..*  ....#
#*. * . **.. .\*.*\ * .*.\@*  ..*.* .... . .  *   \.\.*  ! **. * . \ *. . *.\. .. *I **#
#*****\. .. .*.\.\.. .*.*.\. \.\... .    ..\.\.\*... \ .*....  .*  ..\*.... *\ ...\ *..#
#\**.* *\ * \.*.*\. *. **   .. .\   **   .\ *.\ *.*..  *.*\.**. .**..\.  *. ......**.W\#
#  ... .**.*  *!..   *\*. *W  .*. .* *  **. * !.**. ..*. . *.. \...*  .  \.    *\**..\.#
#. *.*.  *.\.... * ....*\*  .  .\. .\.\ **@ ..\ .\*.**\.***\.  ..  ..\* . \    *.*.*\  #
#\*...*.*. *.\...*. .\ \ .***. \*.  .*.\.*.*.*.  *! ..\.... .\.** *\ *\.*.* ***.*.\....#
#*. .*\*.\ .. .*..  **.. \..* *\. *..**...*.  .. \....*. .\*  .\..*.\***... *... * . R*#
#*\  . ***@\ . .\.\.\.*\ . ..*.!  .\..\ \.**\* * \...*     \ \..  *. . * \..*..\..  ***#
#\ * *.\@...\..\... * .*  \***\..*.... \ **. . .   *.\.     . .  \. . .\...*..\   . .W.#
#....\ *.... * .  . . ** .**...\ ..   *..  *... \\ .  \.*\*.**....   .**.* .  .*  .. *.#
#*.\..*\\***.*   *    ..**.*\* . .* ...\*..... *  .\*.. .***!. .\. \.  ..\   ..@ .\.\..#
#..*..*.. ** . * .\ *. **\....   \. **.**\ .\.*\* .. \. \. .. . . .  .!.!*.**.**.\ \  .#
#* \ **.\ \.\**\..* \.\.*. . *..\.......*....*..*\   .*... *\. .*.....   *\*.\.. ... .\#
#*\*.*.\.*.**..   .\.  \.W .**... !*. \.\*\.\*. . .\!\.. \*  *. .  *\. *\.@   ..* !\ * #
#* .*. .   .* ...*\.\**.....\.*  \*\*\.**\.*\*.  \*.\*..  .\. *. \.**  *   . . .\.**..\#
#.\..\  ..**** \ . ..**  **  *.*. ***. *  * ...\ ..* ..*..\**.. .   ..*.* *  .* ..* \ .#
#   .\**.**\.**..*..\.*\*** *.@\. * A*\@** \. .*  ** \..\*.\.  ...*   .\  ..**...\\**  #
########################################################################################

Water 46
Flooding 5
Waterproof 9
Razors 14
Growth 29
Trampoline A targets 8
Trampoline C targets 3
Trampoline B targets 6
Trampoline E targets 8
Trampoline D targets 1
Trampoline G targets 3
Trampoline F targets 1
Trampoline I targets 3
Trampoline H targets 9