###########
#      #.##
#     #\*##
#    #\*..#
#    ##  \#
## ##\.*..#
#\#*L  .* #
#*..#* *\ #
#. *\. ..\#
# *..   \ #
# .. \. *.#
# \.... . #
#.@. \  . #
# .\ .*   #
#\*.*\R\**#
# . *.  \\#
#.\ * * **#
#.**.\.*\##
###########

Water 11
Flooding 17
Waterproof 13
Razors 30
Growth 38
