###############################################################
#.. ..*..* \.  *\  @. .   ** .\**....\*\ ... \ \**.#          #
#\*.\*  *.\. *.\ .\..   \*\. *.*..\  ..* \\*\..#*#*# #        #
#**  .  .*  ..   .  \ * \.. .\\.* ...\* . \  . ..## #\#       #
#*@. @*.   *   !  ....!\.\\* *\\.  .\*.*  . \# *.\.#\. #      #
#.\*\..*** . *. \.  **\ . \. \ .** *.* ..   ....*.. .\ ##     #
#*\!*.....  ..*.\*\*\* *!5.  .**....\* **  \*.. \**\.#*.\##   #
#*  * **     *. *. .... .* \*.\.\   \.\..\..  *   .* .#.*..####
#.\**..****..\*.*    .*.*.@....*..\ .. *.* *  *\. ..R\  .** **#
#\ ..\ ..*.. *\ **.\.* \.*  .* .\*.  .*. .\. *  !.* *.#.#######
# ** *.*.* .*\*..  . .   . *...\ *\.\. .  .*.* *  .##..\#     #
# !* . . *. .*.  *. ..**   .* .. . \. A*\ ..*.**....####      #
#\ .\.*\.*\.*.\**..** \. .*\*\... ***..*   ..\#    ###*#      #
#. . **. . ***\.*. .*..* .**.*.   ...\6..**   .... \ *.\#     #
#* * .  .*  .  \ \  *. . ...**. *\* \\ *. *\. .\. ..\\\*#     #
#.\.  .. **.*.\*. *\*..*\!  .* .* ..*.* * * .D*.* .  \##*#    #
#* .* *.*..\.*!.. . .   *. *** *. * *..** \  **.*.    #.*\L   #
#*\ *.  *.  ...*   .\*.** .... * .\*@ .** .**.\ \ \..  * #    #
#.. 4   *   .* ...* .\*.. .*.*!\. ..*   \ *.*. .\..*#*...#    #
#\  . ..* .. *  *.. ***...\**.@.\  .*\ \. .\.#\.*.*..\* .\##  #
#   @.  *@ ...\...**\.C.. *.\*.\* *\7   * *.*.*.#.*.. .\ \**# #
#\ ..  ..*  *  @* *.     . ..*. . . @.\ * *\.. *.*. \  #####  #
#**@*..\ .*\.\*\..*\. F***\.. . *  *.... ...\. *\*\ ##\*.#    #
#*.*!@\ ..**. .*\*..E **.. * \ ..* . .\    *   ...**.#**.#    #
#. * * \... ***.  @***.*...*\*\*@.!   .\.\ . \..*\.* ####     #
#\..\ .@.\ \ \.. \\... *.  \.*\.* \.\.\.*@. ..*.*.\ #         #
#\  * *\ ..** .*\*.  . .\@.! @.**...\.  .\ **\.*.*.\.#        #
#.\ *.... \ . .\.* *.\.*B* ..* .**\    \ . *.*.  .#*#         #
#*  .\. *... **.3****. *.*. *..*.* .*\..** . . .**..*#        #
#\*  .**..\* *.*\@.*. ..\**\.*..\*  \ \ ...\\ .... *!*#       #
###############################################################

Water 17
Flooding 5
Waterproof 3
Razors 42
Growth 45
Trampoline A targets 4
Trampoline C targets 6
Trampoline B targets 6
Trampoline E targets 7
Trampoline D targets 3
Trampoline F targets 5