#####################################################################################################################
#                                      # #                                                                          #
#                                     #W #          ##     #                                                        #
#                                     # *####    # # *# # #.##                                                      #
#                                      #.# . ## #.##\.##.#\ .*##                                                    #
#                                     #\*  * . ##\.# .#\.#.. * *#                                                   #
#                         #   ###     #* *\.\   .*. ...#..\*#\# ####                                                #
#                        #.# # .*#   #.#\.**  .*..*# . ..  . ..\  \.#      ##  #                                    #
#      #     ###         # .###\..# ##.\.\.\ **.\..\ \**. **\ * .\.*.#    #.\##!##                                  #
#     # #   # *\#        #  **\. # #*.**\   .\.\** ..... .*.*#. . .*##    #\. ..#*#                                 #
#     #.####\**#         #  .** L # ##.... * .\. .    ...**  #     ## ####. \#\.#\.# #   ##                         #
# # # #*.*..*.#         #....\*#\#.##* !\.*. ..*.\...\ .\....#  .\*#*.\**. .# #*..*##.# #\ #                        #
##\#.#. *\* .*# ### #  #..*.\*..**.  \  **.  * .*  **    *. *   ... . * *.*#.# *  #\#* ###.#                        #
## #.#\..*\* ###***#\# #**..\. .\.#.*.##  . .*.\!. \.**... *.@*  \ \ .* .*... \* .* .  #.#**#                       #
##\.. #*\....*  ##. .###.#.*.\**\.\..\*#**..*\  .\.....\..\  .*.\. \.. . . .*... \. *.* . .#                        #
## .... .\.*##\#*\\..*\# ..*     ** *..* .. .. . * .. ***  .. . \ .  . .*.*\. .  .  .\.\ .*.##  ###                 #
#.\.* .\ . .# *##*.*.*.\ ..***\  *. *\ *.\*\*. . .\ \. \* ****. .* ... .*\*...\  . ...*\.*  ..##\..#                #
#.#...** \*\*..#\*.*....***.*.* .*.! .*.  . .*..\***.\... \**.   ..  .*.*.\  \ \.. .\... ..*. \\. # #               #
#.#** ** .*.. *..\  *. .. \...*\*  ..\.   @. .\\@*\.. .\\.. ..*.    \..*. .    .. .  #.\ . #*.#.*\ # #              #
#\.***.   ..**\*..#.\   .\ #...\*  **. . .\.\  \.\   .**..\...**.*.* .*\*. \*.. *\  * \.   .* . #\*..*#             #
#*.*.*.\ .*.*... *.   **..  *.  .\..*.  * .*..*  .*.\.*. .\  ***  \..\...!\ .   \   ** @\  .*  * #.* .#             #
#*..\* ...\ .*\. * \* *\\* .. \*\ *..* *.. ...*.  *..\  \   . \   **..  \**\ \ .8 *....* .\\. . .*..\.*#            #
#.*. . \*\*\ \   . .*.*.\* **\ **.  ....*  .*.\.  * ..\. .* \ . ..*. *   W \  .  \..\.*. \ \.*.  *#.  .#            #
#.*  *..\.*\ . ... \. . .* * . ......  .. .   .*.@.*.*. ..\ \ .  ..\.. **\.. \  *  \  .. .  \...  .\..#             #
# .***\.. ..   .* ..\ ** \ .    . \ .*** *.\ \  \.*.  *\.*\*\.. ** .*.* . .*  *\..\*\.   *  .  .. .**# #  ##        #
# ..\...  * . \*. \. .*.*..\.*\  ..\. *\** *\.*  .\ .. . .....\.*.. .\  .. .   . ..\  . *  .*. \*   *##\##. #       #
#.* W..* .. *\.**.*.* . .. * *.. * .* .  . *.*\.* *.* .\ \ . .....F\ *****  * * . .*.\ *\   .**.\. *\.#.# .\#       #
# .   \*. \ *. \. .** \  .\  .. **. . .. ..*.\ .. .\.. *\\**\.  . .*..**..*...* * ..*....****..\ @ ***...***#     # #
# !\  ..* .. *.\*...\ * . .  .. ** \.\.   *\. \!\.**.... **..   . \ . ...   **.\ * ..* \\*.. *\*..*. ...* .*.## ##.##
#\* . !*.  * ..*\ .   .    . **. *.*.*.*.*\.*.W\**..* ..* ..\.\.*..* \\ .\\.*.\***  *....\ \.* ..  \.  .  ##.*\#\*.##
#\.  * . !..* *.. ** .\. \\.!..  .\... . *.\.W*\.\.*..*\*.*\ \.*.*  .  . . ... \.***.*   \. *.\**.* @* .    \.\...# #
# .\\.@.** *. .\.*. *...*.  ..* ...**\  *.\\... * \.* ..   .*...\* \  **** **\*  .. **.  W **..*...@.**.**.*\ *#.\ ##
# \ *.....  **...*\\.  *.**.*\ .. *.*....\   *. \\.\   .. .*6.*.**!  .*.* *..*.\* \**.* . ....*.\\.\@....\..\ *..\*##
# . * .\.....!\*.. . \. \.**\.**. ...\\\\ . .. \. .*.\\ . *\ \.\ **\..\\*.\ *\. ***..\.  \\.*..*** ..\*... .. *\ #\*#
#\.*.@.  *.\.....*. ..\ ..** \.*\*.*.*\. \.\...  ..*.* *\ . **.* .  .   . ..*...* . **.  ..\.  *\.\  \ **\. ***  . ##
#\.***\.*..*\ \*..*  *  * \* .\\ *.  *.* ...  .**  .\* *.. **..  *.. *\*\ .*.. *    ..\.\.@  *\  .*\..  .   .\  *.. #
#. .****** . . .\ \ \....\ ** ...  .***\. .\   **... **.\ !*\.* .\..  . G... . .    \ ..@\. *.. ..* **.\ \*  . *\. .#
#.\.\.W.\ * \*... ... ..\* *\\. ...  *.**.*. .*.*   \.W *.**....  \*.*. \..  W**\.*\. .   . \*..\\* .** \.*   *\ .\.#
# ... *..\.\.\ ..\ ....  . .\ * .   ..\ . ......\!\..\* A ..*  .. .\.*\ .*   \..\*..  .  ..\...* .. ..\ .\*. .  * *\#
#..*\ .. ...* .....\@ ..\...*..\...***  .*  ..\ * **.*.. ***. .\..  .*.W \*.*.*\*.*.  *.\ .  . .  ..***.**.*\\. ....#
#....*\  *   * .*  *.  *.*\.*. . ...*\...\ \ **.. .\.**\* *. .*..\ ..*.@\   *.\*....  * .*\\ ..*. .\*.**.. \.. *. .\#
#. ****. . ... ** *\ . \**W *..*. * ...*.**.*..*.*\ .*..! *...\*.  **..\. \ **.** \.\* * *  ..*.   . . .**\. .\**. .#
#*\.!\\*.\*\.. **.\!.  .. *..!\*.*\   . @** ......  \* \ * * .*..  **\   \** ..\. *  *....  *.\   ..\.!.. .   *\.* *#
#*!\\.\.*..*.. .. . *.. *\ *\..\ **..\ * .. .  ..   ..*  \ .\.*\* ..*  ... ......*.\ \  .\  **..  .*** *.*.. *.* .*.#
#*\.. .** ...\.  .... .*....\ . *.... **  * *. *\..*\...*....* *.\ **..\* .. !*.\.\.\.\ \..  ..\* \*\.*. . *  **.*.*#
#*..* ...\ .*.* . \.*.\   .\*.**\ \**\ @\*\*.. .. **. .* .W .... * .. ...***\ \.* \  .. . \ .  **\*.. . \*\.. .\..*.#
#\ \.. \. .\*. *  ...* ..\ .!***. *\  .*.*.*.\* .***. ..\   .  . ..!.. !.*.. *..\  .  *\ \  \.. *..\\* .** \ \*. **.#
# ..\*..*.*..*\. *\.*. *.*.* .**. .*\\  \.**. ** **\*\ \..  .*   *\  *** \.\..\*..*\ .* \.\ *  ..  .*..*.*\.!..\.*.!#
#.*.*  ..\.* .  ... ..\*   *\.@.\ .*  . .\..\..**\.    .**\*..\* \. **.*.\    ..*.**\*\   @ *\ \. **  \.\* .    . .*#
#..\.  *\ **.   ......!*\... *.\ .   *.*.. *. .*..** **.\.*....*... \.\ ..* **    .... .*.*.* ..* *. . *.. ..* .\.\*#
# .*\. .  *\ ***\ .\ *** .. \.*!\** *.\. .  *  .\* *.*\* .*  *.\.  .....**\ \.\.*. \*..**.. .*\.\ .*  .. *..\. .*\ .#
#\  .\.*   *\*\*.. .*.\**\... .\. . ...\*  \. * *... .*.  * \*. !*.*   \..*. .*.\...\* \  2.\.** . .\   ..*...  *.. #
#...\  *  \\..*..*. .!*.*. *  *.*  .**\*. \ ..* ...   *.  . ..** .*.\**..*.*. .\. . *    *.*.* \** . \ * .\ \ *.\...#
#.   \..*.  .\.*\.. \.*\.. .*..*\.  **.\* ..\.* @.*.  *.  . .**. .*\ *. ....*\. \\  .*.*\*** **. \*\***\  . ..*\!! .#
#... ..*. *..... * .....\   .* .*. *..... *.* ...\.\. .\ .\\   * @\...**..*\. **...* * .\...  *\*\  .... ..\ \. .   #
#* \..*..\.* *\*.*  . !\ ** \\* **\...!\* ... ***.*.*\*\!....  . ...***. ..**. !\ \.*\  **...*.. \*..* **   *  *.. *#
#...  ..  **\***\. *\. \.** ..*.***    ...* *.*..*  . *.\.\.*. *\...  **.*.\*   .  ...\ . *....\..*\*.*.* *  * * .*.#
#.   *  ..\.!..  * .    \**... **** ** ..   .....*\.*.*@.. .   .\*  . *..*..\.*.  \\*. ..* *\.... ..\  @*\...\ * ...#
#*   \.\*..   *.  \.      .\.* *.. .   *.\ .*..\ .****\**. ... *.!  * * *. \. \..  . ..  . .  ..* . .*...    *\.*..*#
#!..\*...\**.*\    *\. .**\.\\ ..  ..*\.\ *..    .* . .....*. ..****. ..*.\.*.. \.. .**. *\. ..\. * \.*\\.\.\.  ..*.#
# \  .\* *  .*\........*.. \*...\.  .*...**\...*. ...\. \ .@. . . **\* \..* .   .. * \ .*\.. *....\ . . \*..\..*....#
# ..*..\ * .. .*** .*\. *.\.\  \**\**W\  *\. . \...*@. .*  .*** \*..!. .\.*\...\ .\*  . \****\ . \*..  . \ .. .* \\.#
#  \\ .. .\*. \ . *....\.* * \.  ***\ . ....  ..\   \ ** .. ..  .\.**\ * .*.\. * *.... . .\.**  . .*. ..   *. ***.* #
#\. **..\*.. *.@\  .*  .\.  \**.. .* \.  . . \ . .\  *\.. \* . .*...\.***\.\@*\.   .*. .\*. . \* .  .. !.  .*. !**. #
#.* \..\ . * *\. . .. \ ..****.\  ..*.\ ..*... *.. ... *. *. \**..* .**.. \*.... ..*  \ W..\*....  * * *  \ * * .**.#
#\* \. .@*.\ . *\*.\  *. *.*.*\*.  *. . *\**  \..   .\.\ \......**\\ *. ...*.. \. \*\. \.\ .*   .  .****   .. * ....#
#.**  . ......* \.  . . .**. ..  .*.*  .*.. * .\. \.*. . .  . . .*  \ . . \. . .  \...\.  *\.**..  . .*\*..\ .. *.*.#
# ...*.....*\..* \...* .....*  \  **.  .  * \ ** ..\.*.  .  *\ *\**@  *.\... ..\ .. \ .*.\. . \*\..   .\.*.. .   . .#
#\*.\.*.\*.*.  ..  ...**.. .*\  ...\ \ ** ..**.\**\* * \.*  . .. *.*\.*....\ **. **\.\@...* .*!..*\*.*.\ ** \*. .@* #
#.*.... .. .* \ \  .. **.\*@*..*\.*.. .*.\ \. \*.*.* . .*\  *  ..\ .*...\*   \.*.*\.* .\.\* .* *\. ...\* ... \.*. !*#
#*. \.** .* \\.\.  .  *.**..*.\. \.\ * .  .*.\*.  .   .*.* \.\.*..... .***.    .*.* .\****\ .** .*\*\  .\  . ....  *#
#.*. ...*.. ..\*  .\ ** .*... .    . .  *. . .\*..\\.**.  *.*  ....* . *.. *.** ... .*  **. ...**. .. \ ...  . .*.*.#
#\. . *..*  *. *\.*...\. ..\*  *.*\  *  .*  .. \ .*.**\*  * @.* *..\   * \.\.** * ** ..*... .***.W ....**  \ .\  @**#
#  .  .. * \..*..*.*.* *   ...*.**.**\* ..\..  \*.*\7  .  \. *. *  * * * ..**.. .\ .\. .\ * ... .. !\. *.  ..\.*. **#
#.!.... *. \ \.  . *.*.... *  ! \* .*.. \.    *.....\**.. .*.*\.* **\...* *. *.\.  .. . \.  *\* .**   .. *  \.. * * #
#*.  \*.*\.* .. .. ... .*.\.\.* ...  .*  .........*.*\ .    .\.*.  .. **  .  .* .*.    **\.* .. ..  \ ** *..... .\..#
#\ *..  .. *\ . * *** ......* . .\..**.W  . . .\ .@*. .*...* .*.   ** ** .*..*\  .\.\ ...* * *\***.*....\ *@.*     .#
# *. ..*.*.* \....\..\.*.   .. .  ......*...\ ** \**\*..\ .*   \.*  .   . \  * .*.. .  . ...\..*\*\. ..\.  * * @..*\#
#. .*. ***..*.*.\.  \ ..  \.  .*  .\*!. **...\*.\ .\ \*.   .\.. **..  . . \  .\ .. \ !\\\*  *\**.. .*..B . .....  . #
#\.....*@. ...\   ..* W@\ *..@*.*\ **.. . *...*...  *..* *\** .* *.. *.     \ .    *  .* *. \ ** .*.* .*. \***   * *#
#...  \@..!\*  .*\  .. ....* ..* *. ** .. ...*\ .***\**...*.\**\ .* *\.\ .\*.*\  . \. \.\ ..\\..\.* \*.* ..**..\ * \#
#** .*\.**. ..* ..*  ..\. ..*. ..   *. .  .. \   . **.*\*.***...  \..   **.. ..*. . ***. .\\ .*\ *\\....!\*\.* .....#
#..  !.\*.*.\ \..*. . \ .*\..!   .* *\***. \ .   *\. *.*.*..**  *\.\**.. .  \. ... .\.*. ......* . * \\* .* .. .*\. #
# *.. . .....*.* *. \.. ... * \ . *. ..... ....* ...\***.. ....\. .*..*.\ * .\** *\** \ ***. . ..* . * .* * .\.  .* #
#    .\.....@\ ..*...*.. .. . \. ...\*..\*.* ***...\ *.** *  . *. *. ..@\ **. .*\. ... *\.****.**.. W. .*.. . ...\. #
# . .\*\*\.\. \*\.....  \\.. *.\  .. ...*.\. .**. *.  ... *..  .. **.  * \ .. .*....*... .*... . ....   .\.. .. .  *#
#\ **\. . * *..*..  . .*...\** .* * .\. ..  . ..  ..\  ..*..*.. .\.*  .  .. .* *.\**.*.  ***. .*.* !. **  .**.. *...#
#*\*.**\... ..*\..\ *\.\  ...  *.\.\ .... .*. \ .  ..\  .\ ... *..\**. ...\* .\ *\  .  **.\.\.*.*..   ..* .. *\  .@*#
#.  ** .*.*.. ..   ...\..**   .*  *..\. * .*  .. **. *. * . *  *\..*.. *.     \  . * ..** ..*....*\ \.!*. .. \*\...*#
# * *\.\. .* .. .*\  .   . \ ...\ \* * .*..    . .*..\*.* * \.\.*.*. .\.\ .. \  .* .*.\... *.   \. *\...\*.. .  *\*.#
#.\ .  * \..\*.\ ..*. **.  ...\** .* ***. * * *  *.* ***.\.\   *.. .\ ..   *. \*...\**\   **\. ...@.*\ \!*  .**..*. #
#. ..  *..\ ....\\ *\...\  *** ....*. .. ...  \ **\ \  \ * \.. \*. *. \ ...*...\..\..\*. ..*.  **.\ \.  *.\ ....\ * #
#  .....\   ..\ . * .  . .....\\\*\.. *\*.  \. ......* .***  *...* .* .    .*\  * .\.*** *...\ *.*   . ..*!.\*.* ..\#
# *. *\.*** .   . *.\* ... \  *..\* *.*. * . .   .   . *.*  *.\ \.  . \.  **.* ...\..* .*.* ** ..** \.*. * .  ...*\*#
#\.*\. \... .*   .**.. .. ...\***.\ * . ..\*\\ .* *\*  * ......  .  * .\..**\..  \.**.*.* .. \\  ..\.\. \. .. .\*. *#
#. ..* \.\  *\.* .* . .    \\.*.** \* \.  ..**\ **. . ..... .. .* \\*.**  .*.* .*\ .\** .  .  .\ .. .**\.*\**   .. \#
#\   .      .*. . *.   ..*   .. ** ... \ *..**  ***.\.     . ..**..** *.. ..\*.*. . . * *.\ \.\ \ ***.\ .\ .   \    #
#.*.\.  *.*   . ..!*\*** . .**.\.. \ *\ ..**..*.. .    ..* ..  ..   *.*. . *\.\ .*\.\..*...* .\.. *\*.. *..  *.* \..#
# . *\  .\. \ .. ..*.H ** . \.*.\** \. . ..\* ..\. *  *..*\.. * . .*. \   \.*...\\ *. \.....*...\.\ ..*.. \.... *.  #
#* *..     ..\ ..\.. ..*.* * ..\ .. .* . * ... .\ ... *\ ..\\*.\**.  .\ *. ..*.** \ . ...  \.*. ..  *.\.*. .\.*\...*#
#\..  ****. *.*.*.**.*.\.  .. \   .\.*.  .\.. .. **.  . *. * *. *.**** ..  .\... * **  ..  ..  *** ...** .* .\*. *\.#
# *\ *.. ..\.\* \*.*** .\.\..*...*\.\..**..* \ .\*.*. \..   .@*.*.\*\* .    .. . .*. . * .. *\ ..\..*..*\*\.. ** .*\#
#*. \...!.\ *..**.  .\ ** . ***\... .   .. *\ \  ....*   .** *..\** .\ .*.   \*   ..*\.*  . . .**.   *\..\. *\. \...#
#*\ . .*.   * ..\.*.*!*\**\.. . .\ . **..   ... .. * ..  .**\**.*.* .\ *.* .. \ ..  \*\ ....*.\... . .\.\. *.*..*  *#
#** *.\. *\..  . \*@*\\* .*.\.* .*   \.*. ..   *\  .*.*......!\   . .  *\ ..\ ..*..\ .*! * *.  *\ .\ \ .* ..** .*. .#
#..\*. !\  *.\*...\.**.* ..  *.\*\. ..\ *\*  *\ ....\*.*\*\  \!*\* .\. .   * ..  .* . . .**.*. *      . .\\ .*\*...*#
#. . ...  .*.@.\. \.!. .** . ..*.*\ \.  ..\. \@ \ . . *\..!  \..*\  . \ *\..\  . *.\...*. *.\. ..\ \ .**  .  . .....#
#\. *\*  . . *..*.  \\..*\. .\*..*.. .* .\.\ *  . *@ ....*\. *\*..*.  * . * *\.....   ...*\..  ** .. *.*\ ...\ ..* *#
#W.\...   \ \* .* . .  ...* @.* .\ . ** ....\. * ..     *..*  ** *\..*  ** \\ *** . .  * *  * *\.\*...*.. *\ *. ...*#
#\...\ .*  ..   . *.   * \ .*.. ..**...\ **. *... ..**\.*.\\ .\. .*\*  **\*. *.. . .***.*..\*\.. \\  \ ** .. .*\.\ .#
# \\*.\... *  .*.\\. . .*.  ..\**.\.\ \  .\ . \*.\..* ..**.*\.*.. *..\*.** \\. .\*. * .    ..*\.*.  3 .** . .*.....*#
#.. ..\. \ .. .* .  *...***.\ ....\ .**. **  ...  *....\ **.. . *..* *.*.*\W@.*\..\**.. *.** *  **. . ..\.*  .. ** .#
# *.!****. *....*.  . ..**** \...\.  *.... .. .* *..@.. *\*. * * .. \* *.*  ****\ ...*\**.\.*@\*.@\   . *.@    *....#
#.\ \*.*.\.*\  .\  **.\...\*..\*....*.* *   \.    * ..  .\**.\ *@\*..\ .... .*  *\  .*..*.* ****\. . . *.\.*  ...*..#
# . ..  .**\.\.\**.\. .\*\..   .   *.*..\*\*. .. *W\.\.*. *.*.* \ . . . .  *... ! \.*..** *.. . ..***\.\..*  * .  . #
#..\*..\ *..\.*.*..   . ..\ .\ .\ **. \ .\. *\*  . .\ .\ .\..*@..  . \. \..\.*. . * *...\ \*. ...*.***..* .W..\. *\ #
#. .\   *\**.\*...  W*.. \.*..\ *  .\\..***\... .*. ..*  \*. .  ...*\.* . . \.*  .... .*\ .*   *   \ .*  *.  . * .\ #
#\.  . . *\  ....* \* *.\. *\ . \. .W**\. .*\  .*.*\*\. *.*\.* \ *.*. .. .. .*** \ .   . **.\*\*  . .*. .\ .*\.. .\.#
#. ..*   . *..*. .\ ...\  *..\ \.* *..... !. ..   ..\ *.*... ..* * . *.* .\....*\.\ \. *\.. *.....*...   *\*.** ... #
#\ \..*..* \......*\.\. .\*.** \......  ..@* \. .  .*.  ..* . ...*.*****\........***  *.!* .\.* @..*  *\\ *.*.. *.\.#
# .. ..@*.* ..\* .\*  . ..*. \ .      \.* . . .*\* **.\*. *\**.\*. *..... ...\* .\...*..\ .*.\*\*W \ .\ ..\.**.\ .*\#
# .***.*  .* ..\  .* . *\ * .\*\**.. *. .  \ . ...\ *  .\ .*.*\*.*\* *. *. *...\..*.\..*.\.* .*   .!.* !..*\.* * ..\#
# \\***.. .*\........ ....*  . . .\.\..\*   \ .\  . *. .  *..\ ***.... .\.\*\..* ..\*! ..* .*\. \  * **. . * .***.*.#
#. *\\   **. * . \*\.**\.\  .***\ *.* \..*  .*\  *  .*.   *.  \**..*       .\.*\* ***\.* .\.*..*   * *\.  ..** ....\#
#\*.** ..\\ *.\\*\**\***.**\ *\\.*\****\ .\* *.. * . **\.*..*.... .* *  . ***.\  *.*.. ..\.... **. ..* *.*\\.*  \.\ #
#.\. . ....**..... ...*.\.* *\.\**..*\*  *.\   *.*  **.**. *!.\*\. ...  .*!*...\ .*.  * .* ..\....* .* . **.*. .**..#
# ..*. *. . *. .\* .* ...\.@*** .\...*. .  ...*.\*.\.*\! * \ ...\.* ..\ *... *.*  .   \***.*. **. *  .*  .*.*\ ..** #
#*\* ...*..@.  .*  .. *.. . ..*\  *  .   .\. *.**.   \. ..*.*..  *\*.*.\.*. ..\. \ *\* *. *\**\ * *. *. **..*   *.. #
#*. *. ..***.\*\.\ * .*\ * .*****.. ..*...*  \...  \ \*  *.   *   * .**. . ...*\  .   .*. \.\..  .\  .\.\. \. *\   *#
#.  \.\** \ *...*.\.  *. .  .* *....  **\. **.. .   ... *\   ***. *  * .. . ..*.\*.\*. ...  * *.*. \  *\ \   * ..* .#
#*\..\..  *.\ * . *.!   * .\*      *\.\.\  ..\ .\**  *.... . **\..*.*.....  \ *. **** .*\\ *.\.\*.\. .@ . .. .\.*\. #
#\.\ *. *\.\  .      .\ .*\\.\.... .. . **. .\  *.!  .\ . .\*\.   \*..  * *..*.*\  \..@ ..  .* ...    .. *\*.\..\**.#
# \\.. * . ..\.  **.  .\.****!  *. .   **.. *. \. \ *..  *. .  ** ..*. @..\! \.*\*\ *\* \**.** .*.\.*.  .*.\*.@.*..*#
#.* .\** *\. * .. .. \ ...*.*.*.. .\ .**.*..\\.  ..*..  *.\ *\.\. *\...\ .\.*. .\\ .* .*...* \. . ***  . .*..*\ . **#
# . \* *\\.*..  **..   .* * \*.  . .. .. ..*..\.\.\..  .*.* \  . ..* **..\.*..  **.****.*. . ... \*..**\.\. *.  . *.#
#\\  ..* *\.\*......****.\*. \. *..*.*D. .  **..* . **\ .\.... \.\\ ..* **..  .\ \ **.*\*   ... . .*.**.\.\.***\..@.#
# \.* *.!.. ..  *.\.. \.**\ .* \.  *.*.\ .\**\* *\*.  .   ..*!....  . .. . ..   . . .\***  .. ..\*\  .\ ..  .*. . ..#
#\ **..*  *\  .\*.  * .\!.* !\ .*..***  ** .* *.  * **.\    *\*.*.  \ *.  . .... .**.\*..  ** \ *. .* . *\\.*.   ** #
#.*. \\*\...   .\\. . \...* .*.*.*** * \.. *.*.\. ..*@.*..  *  *.. ..* * \. *\. * *. *\.  . . . .. ..     *. ..****.#
#\. *. .!*.*.* .   .  !.*  . * .*. \.  .\\ ..*\.....\*.\ * !*. .   \ *\* .*\. ..* . . .... W\\ .*..*... \...**\ *..*#
#*...\. ** ... .\\.. . *@..  .\** *.  \  ..**     *.*.\.. . .\.*. ...*\@\.\ . *. * ** .*.*  *.. .. *** ..   ... *.**#
#. * ....*..* *.**.* . .***. \.*. .* *. \..\.*. *..** ...\.**.....\ .*.. . . *. .. .. *\**..\  **** .* ..  * \  \ ..#
#\*..* .\....*. .*\..  *  .   .  .   .*...\    .**\*!  .    .*\.\*.*\..*..  ***.\ .   * .**\..  ... .\ *.*..\.. ... #
#... .. * .*\.*\ *. !*\. .\ *\\..**\ ..* **  \ *.....*.. R   .*  .**  .*.*\*..\. ... \*  \ . ..... \   .** .*\*  * *#
#\. \*. .. ..***. * .** \\*.!*.\.\*.*.* \ .  .**\.\* *\.\   .\.\...  ....*.@. *.*..  .\   *. .*. *\.....*\*\*.*.**.\#
#.W\ . . \ ***\* .*..*.   . *.*.   .. .\.*  . \..\.\ .*   **.*\*****.  *.* *\*. *... ...\.* .** *..\ .*...  * **..\.#
# .. . \..*\. .*.\*\. \** **.\. ..@ .  .\. * \...\ .*\. .*.**\**.*..  .\*. *..\  *\.\. \ *. *. ...\. ....  *.... ..*#
#  .* \.* .*\.*...*\.@....*. .\ . **  .\** .\... .* ***.*. ..*\.*..  \ *.**   ...\* . *.*  *\...... ....\*\. .*.\*.*#
# \ .\ .* .*!*\  *.\\. .  . ..  *\   \*. * *.  \ .  . .!...\\*..... ..*...\.   .\..  \..*  * *. ..*.* . .*..\ \\ . .#
# .. *.*. .*\.\  .\**. *\..\. .\. \. .*. **. .\ . \ *   . .. *.\* \\...  *.\\*  .*. .\..\\.**. ...\..!*.  .\.  *. .*#
#  ! .**\..\\. *.. ..* *. * ..\.... * . *.** * @ \. \.*\** .*\* . ..\.\.\ *  *\*\  .\*\*\. .**. .*.  * .*..*  .  . .#
#\  .\*. \*  \.\.\.  ... .*\  **   ..\... **\. . .\..*.*.. .***.@.*\. . \*.\ .**.. \.\ .*.*. \  \* **.*  *  .**\. *.#
# ...@ *  **..\...\** @.\ \ \.*\\ .* *.** . *.    *.\..*....*C . ...\.*..**   *. \.*  **.** .\*...\ ..   *.**.* *.*.#
#. .\  . * * * .**...  ......\\*\ .*   ...   \.. .  .  .   *. \*.* .....*.. * \\ ... ..\...\..\*...  *.* *...*\ . . #
#\\*  .\ .  \. ..\.*. *.....*. \! .*.    *  ..  *..\  .* ..** .. \  \.*.*.  *  . .* \.....* .\..*\*\*...\.\  .*  .  #
#*.. ..   ... \\..\    \*\..... . .*@*.*@.\..   *. *   .*. ..**\.* \.*! *** . *   .  *\.* .. .  ..*..**.. ...**.  \*#
#. \  *   *..*..*..     .\ * .\. ****\..*.* .*\* *.\\.  . *.\.*.. *. \ *\..\.*\  .  *\  \  .* .   * ..\ .. \**.*\\\*#
#* . *. .* *\.*\*.**.* ..**\    *\  .*!. \ .\* *\. .\ **\...   *.\..** *.. ... ..  *..*\.*\ !*.* . *.\.\..*..*\...\.#
#.\* *.. ....\...\...* *. .**\*..... . \. * \. W *..  .. *  .*  \*.. .*...* . .*\ *.*.*\..**  .\    \. ..\.\  .    \#
#.*. .*\*.*. . \*.* .. ..  .*....*. .  . .*\. *\ . .. .*@..*.. ..*. ..   ** ..\**.**\ ..* ...\. .*\*.*..*.*\.** \*  #
#\*.*\.. \.***....*\ .\ . \ .**.. .  \...* ...\ ...\\...\  ..**\..\*. . *.\ W ....*\  . .*\...     .\.*..***.. ..\  #
#** *.. \. ..*\..*..*  . . . \. * *.\  ...  *.\. *  .   **..***.   **.  \..\.\*\*....*.**\  .  *.. \. *.*..*..  \. *#
#.. * *.**.  ....\..** ** . *.*.\*. . * . *\***. . . .\ ..* *... . *.    .\*...\.*****.\.*\   .*..\ * .*.\  * .   \.#
#\*  **..  ***\.\*.\ .\.    ..\ .....\......     *. * * .\.    . *. *. .* .*. *!.\ *..*.*.*.\ .* *.. \.\.  *.\*  ..*#
# ***.....** ..* *..  . *.. .\.\ *.*.*\ *.*\*\ .....*..*. .  .\  .\ **\**. .!\*..**...* ..\ .**. .. . . .  **.. **\.#
#*  ..\.  .. .    \  .**@ *****. \*. .. * .*. \ \* .  \ . \ \.*.   ... .... *. \*\**\.. ... *. *.*...\.. \ .*.*..** #
#* *\*\* *\. \. .\. ...\....\* * . *. ....\. *..... .\ . .. .. .    *.* .. \...*.*.....\ \..*.......*. *. ...** *.**#
#*\.*..*.*. *..* *.* *. *.** *\*..*\... *\  *\   .. ..\*.  .....  ....  ..* * * \...\.\.*\.\.. \  *\\ .\*  . .*..*..#
#**... . .. **.  . ...  * ..\. .\ ** *  !\..   *\   ........\   ** *\.*.**..  . . *  * ..* * .\.  .\**\..** *.   * \#
#...   *@ . .\  . *.*.. ..\.*\  .  **  **.*.. \.*  ..*...\  *\ . \*..*...*.. ..\ .*  .*.* \.* . ..  !**..   .*\\ . .#
#.\.  **.\*. .. * .\**   .** ..*   *. \ .*.*\*...*  * .*..**...\  .  * \ ..  . . ..  .. * ...\.*\  .*..*\..* . \@\..#
#.\..\.**.*..\... ...*   *\. \\. ...*\. ... *.* *.  .*\. .\.*\  \.. \.....\ .* \. *\.\!**\\* . *. ..\....\\. E ... \#
#\.**.*..*.*\ .W .* W\  \.\ *\ \*\... . . \.. .*.\  *..** . .**.!.. .  **..       \. ..*\!*.*..**\.\  !*     ...*..*#
# *!... ****\ \   .\. ... **.....*. \ \ ..*.. *\** *.\ *. *..****.\. ***. .\..***  .** \*.*. .\..\ .**.*  *..@ *\.\.#
#..\..  . ..**.    **.\.\*.*.\*.\***... *\***.*.. ..  *** \.  *.*..**..*.* * *..* **\ .....  .\*\  * *.*. .* ...\..*#
# . * \ *  .*\** .\*. * *.*.* *...!..    *...\  *.* * .*. * . . * \*.. .*.*\*\.*\!..  .* **\ *....\.\  . *\ . *.. \.#
#  .... . **\.*\ .  * . * .*.* \.\*.\.\*.*\ .. ...\* *.*... .*.. .... \ .\*.*  ....\ .  . ...\ \ \.*. . **.*.\.*  .*#
# ***!\.*... *....**..  @ \..\ .   \* ..*...\. .*@** *..*..*..   .  ..* .!... @.* *\*  .**\  *     \.*. \. ... ..\.*#
#..\. .  .@  ..\\..\..  ...*.... *. *. .*..!  **.\*. \.*.**\.  . *.. .*\ .    ..  . .*.* . .*.  * * *.. ...   *.**..#
#\ *  .  ..\  *.  *@ *\  ...\!..*.\ \  . ..*.**\. 4.*.\*\ *  .\* .  \*..\ *. .*\\**.\\. *\ \*\ *  *** \ \.**\*\ .** #
#####################################################################################################################

Water 0
Flooding 0
Waterproof 3
Razors 37
Growth 34
Trampoline A targets 3
Trampoline C targets 2
Trampoline B targets 6
Trampoline E targets 3
Trampoline D targets 7
Trampoline G targets 7
Trampoline F targets 8
Trampoline H targets 4