####################################################################################################################################################
#               # .\. . . ..\ \\*  .. **..** .**  \..\. .**.\. ...\. ..** **. .**\  * .* . * \ .*. .\.*** *.   \. \  *\ \*.. ..*..... ..  **  .* *.#
#              #..\.*....  . .  .\  .*. ...\*\ *!\.**.*\*.*...*\ ..*\..* .!*. ..  .... *... @.. ..\ **....  . .  *...\.    . \ \ *\.\\..  ..  *...*#
#             ##.*..\.*   * * \\ * * . **. .* . \*\***.**.**..*. . . \..\ *\*\ W * . .\*.\....\*    .... . .*     *.   \. .  . * . .*\.\.  \ ** \  #
#        #####.  .*\... **\ *\ .\...\*\*\.... . *..** .*. .* ..\.  * ..\*.* **...**. \.\.*.. .*.\ ...\**   \. . ...*..\.** ... .\ ****.*\ .\.\*..\ #
#      ##\.. ..\.* * .. .\ . * \*...**...\.  .  *...\*\*    .\**. \.@ \ **  ..* *...**. \*\** ..*\**...\ .\\..*\  .  \.*..\ .\**...\..\**.  ...\\* #
#     # .. * \. .\ *  *.\** ... ** * \...  \     ..**. .    .  ** ..*.. .. .*\.*..  . \  . . ...**\.** *.\*. **   \ ..*  * . *.* *.*.*.*.* .* .. *.#
#    # *.\*# .\..* *   .*..*. \  *\. .  *.\ .**\. *..*. .*  * \....*!\ . \  *. **!   ..  \. ....... .**..*.**.* *\.  *.* ***  **.\*.*. .  . * . \* #
#   #**#.##\R.*......*..** *\ . ... .*\.*..*\*..*. .\.\@ *.  *. ***. . * .* . *..    \ *..\    .\   *.. .* ...* ..   ..*.. . .... * .*. * **..\ .  #
#    ## #.\ #*..  .**.\.\.*\ .\.. *   . *. .*. .... **..\** ..  * .* * ... * *.!.. *** ! \...**\  ..\*.\ \... *.*.   .*\*   *.  . * *\ **.*.*.*. .*#
#      ##**...*\****. *\.**..** \ * *..*.. .\\....*.*..* *** .\*. *  \ *.\.\ **.\ .\..  **\**..***. ..*@.. ...**.*****. ..\ ** **\.   \ *.\ . . .*.#
#     #.....\.  .\.  .  .*. \ * . * ..   .**..* \ ***..\ \ * . * .* *....*   *.!  *.* ..*. *. ..* !. \.\...  \. *.....**.  .....\.\. *...*..\.\ ..*#
#     #\\ .** \  @\*\*   .   ..\. *..  . ...\* . \.** \*** * . ** ...**. !.  .\ ... *\ .* *\      .\*.. \..*..*.....\. *.  . ..  \.  * \..\.*. **  #
#    #  .\ \..... !**\ *.. \ *.. *.*.**  .\.\.. .\.... @*... .!\.... .*! *.. \*\*  . . *..* * \..\.**..  *\  \.\.\* .* .  .*...\.... *\W  .* **\  .#
#   #\ \..\.\ *W* \ .  . ....* *\. .*..***.  * ..     !..\*  **    .*  .*.  ...\*.  \  **** .... ...\ . \*   .\. *.*. \ *.*.\   .\*\\. .\*..\**. \ #
#    #.# ..\ ....\ .\.* . . .**\.\..\  \*\  . *.*\ *.  .\.*\ ** . .**..*\* .. \  ..*\.*..** *..  \ **.  * .* .  ..\** ..*\. * .   .** .  . \ *. **\#
#   #* # **...*.*.. .  .. .\. .*.  \ *..*.\ \...* *\*\.  *.* *. .\*..\*.*. *.\.*. \.*\.....\**  .*...\.*.\.\ ..  . .\. \*.\ \   *  **.\.\*.! *!...*#
# ####..... ..\**.. .*.\..   **..*.**.. .   \.. ..\.    *  .\.\  *.  . ..* .*  @.....*. . *. \. \.  *. .  ..**.\ . .*....*. .\* @* ***..\\.\..* ..\#
##\ *.#.#\**..*@\ .\*..  .**. * \.\*. \... . *\*\  .*\.* . *. @. .*. *\  \**.*. **** .. W.. *.\ . .*.\  ...*.*\*. .*.\.\.*. *..  \ \  *. ..*\ *\  *#
###..!** ...  . . ..\  .\.* * * ..*\\* ...* .. .*..****.**\*.* . \.* . .*..*...\*\@* * .*.** .*.*  \ \ .  \.  ..*. . ..\...* *.. *\. .. ..\* \.. *\#
# * ...     \*  \.**\**.\ .****  *. \*   *.*..*.. ****\\.. .\*.   .*....** .*\*.*W ***.*...* \*..\ *  ***....\***.. .. *  .. .\\ *.\\ * *  *.!**..*#
###L##\**. ..**\..!\*** ..*.\**  .. *\ .\ .\. ..  .*.  *..*   .*.  \\*. .* \.*. . . ** .*\ . *.\\*.* ...* \\ .\ **.\* **.\**..*.\**    *\* .\.*. \.#
#    ##.#\ ***.** \!**..*.** .* .\.*.*.     \*  *  . ..*  ..**.*.  .*.   *! .. .  * ..      **  .* *. !..*.*@@. @...  ...*.\.\**... ....*. **..*...#
#   #*.\*  .*....*. \.. **.\.*.\.*.. .**\ .*..\.* **.*..\ . *.* .  \**.*.*..*.\. * ...**\  .\...* . ***...\*.*\.\.  * . *.\*.*\*\ . \. .*.  *..*\..#
####################################################################################################################################################

Water 21
Flooding 17
Waterproof 7
Razors 40
Growth 22
