#######
#  #*##
####  #
#*.*\L#
#*.*. #
#**..##
#..*\ #
#  \. #
# *. *#
# *  ##
#*. .*#
#...  #
#..  .#
#  . *#
#   .\#
#\ \..#
#*\ ..#
#\.R. #
# . .*#
#. .  #
#\*.*.#
# ....#
# ..**#
#.\...#
#. * *#
#######