####################################
#                         # # #    #
#                 ##  #   # ##.#  ##
#          ##    #. ## #  # ## # #*#
#         # .#  # L. .\*## *\#\###.#
#  #   #  #..# #\#\  . *.*\*..*#.# #
# #.###.# ##.##  !## .*.\*#. ..\*..#
# #. *#  #\. # #*#*# *#* . ..*\*\*.#
##.#\.**#*\...# . *  *....\ \. .*.*#
## .**..**\  *#  .. ..@ \ ... . ***#
# #.   \ #.\...*. \.*..*\  .***\*..#
### *\.\. .*\..*..   ....*. ..*..\!#
#*... *. .\.*.*.*.** .   .*  ...*. #
#!.. ## ..* .\\*.... ..\*.. @ . .\.#
# .\ ...**.\* .*** **\ *\.. @.* * *#
#\ .*.# .#**. ** ...* *!. .** .. B*#
#.\.*.**.......  \  .\.  *...*.  *.#
# * .. \.. . *.*..\   .  .\.* \. * #
#** \...@.\* **. ***.\  ... . .  ..#
#\. \... *\. ... .**\ \   \.\ .\ * #
# * *\ \.**\ .. * . ...\ *.@. .... #
#.. .. * .\. ....***.\..\ .....\. .#
#  . ...  .   .\ .*\*.. * \..  \.  #
# *.* *  **.\*... **. .*.. .\. . *.#
#\... * \..**R .  ...\..  **.. .\ .#
#\ *.!* .  .*\.*\*** *. .*@\ .\*..\#
#. * ...\. *. ..*\*.\*.\  ...  . . #
#  **\.  .\.....\\*\ ..*  ! *.\ .*.#
#*..** ..*.**   ** .**.\.* .*     *#
# *\.*\  ***...**.*... .*@  .**...\#
# \ *\.**.*\. * .\.. .***\   ....\ #
#\. \. \.  ..\\\.. .   *   ..*****\#
#. .*!* . ....  .  .*.** ..\ .\.\..#
#\*.* .. *.\. .* .\ .*. * \ .*..*.\#
# .*....   .* ...\  *.* ...   **..*#
#\.. ..\*. .. *\\ *\....*..*  ..*\*#
#.\. ..*. .*     .\..** .**..  ..\ #
#.**\. *\\. **..\*. * .\.* \. \. \.#
#\.. *.***.*..* \*\.*.* ....\..**.\#
#. \ .  .\*. .. ..*\.*\ *.. *    * #
# *.*\ ** \ \\   ...  ...   *  ****#
# *\. **\..*..\.\. *   .   *.. \\..#
#*.. .**..   ..***\. *\ *  ..\ .*.*#
#* *..*.** * .\ .. *5..**\\** ....*#
#. .. *.*. .*....* .* **\*\.\*\.  .#
#\ \..*...\*.. *\..*.*  *\* ...\.  #
# ..* *....*. ... ** ..* *.\\**.\  #
#  \*. *..  *    *..*\ .*....**.\@\#
#.. .**.\*. \  **.. . . ..*. \..***#
# **..\.......\*\*. .. *.*. .\*...*#
#.*.  !..\.@.  \..\**...*\ @\  * *.#
# .\.  \  *. .\. **.*\* *\... .**\*#
#. .  \.* .*. .*..\..\.**\.. .....*#
#. ..\ *.*.. \*..**  *.\.  .\.*  *\#
#\ .\  . \  ...... **. *. ** .. . *#
#... *  ..\..* *.*.\*  .. *. .... *#
#*\ **. \*..\*...\*.**   *.* .  .. #
#... .\...\  *  . . . .\***.   ..\.#
#. * .**.**  *.***.*\ * \...*.\ *.*#
# ...\.\ *\.   \\* ..*. ... .*. .\ #
#  .**.  *  ..** \  @.. ..*\ . *.. #
#...*.* .*  .... .*\*    .*. . *. *#
#.*\...* ...   .\ .\. * ** .\...* .#
#*.\*  *\.. ***.*.\ . .  .**. . . .#
#.*.....\    ..\.\*\. *.*..* .  @  #
#*   *. .  .    * ..*.\ .*..\* *.. #
# . ..****..**\ .  W\..\...*.  ***\#
# * * *\..*\...   . *. **. .\.** \*#
#\*   .*  ...\   * **..... * .@.. .#
# \  ..*\* *...!*\  ...*.\.** ....*#
# ...\.!...*\\ \* .  ...  ..\ *\.\.#
# *.\...*....\  . * .\ .\   *.*. *\#
#\.   *\..*  ... *..\ . .*  .\*. **#
#.. .*...  \..   ..*   * *. *.  .*.#
#\\.  \* ..  *\. \*!.. .* . *.\* ..#
#@\  \\.**.\ .* \. @.. ..  \..*. . #
#*  \...... . \.  .A. ..\. \\.* *. #
#*..\*.**\*    ..!*.**.\*\..\ ....\#
#*. .  ..*....    .!....\....W . .*#
#*\. *\*.*\ *.**.  *.. .\..   *..C #
#..* ... .* .........\ \*..\ **\.\ #
# *. .. **.   * *  .\ . \\8. ...\*.#
#\\...* *.  *\\.\ *\\\. .... *....\#
#..\ .. . **..    \..\.. \***...  .#
# .*.. .. .** *  *.*\* \.\..\*\  . #
#**.  .*.!  * . \.*..**. *. .\..4\.#
#....**.* . .. .  *.*\.\ ...  ..* .#
#\.**\* \*  .\**. .* * *...*\***. .#
# \\....*.. \.@.*. **  ..*\...*\.\\#
#. .**.*\*.* ...\ . ...*. *.@\.\. \#
#.. *\*... ..*  * *  .*.* . . .**  #
#\* .*.* . \*\. ..**  ... .. * *.. #
#..*.  ..** . *  \. \*.\.\**.. .\ \#
####################################

Water 0
Flooding 0
Waterproof 16
Razors 42
Growth 8
Trampoline A targets 4
Trampoline C targets 5
Trampoline B targets 8