###############
####. .\...*. #
#\.## ..   .*.#
##  \**\.. \. #
# # .\** * .. #
#  ##.*.*. . *#
#  #.  .W. *R\#
#  L*. .\*@.  #
#   # .*#...\.#
#    #.# ###.##
###############

Water 9
Flooding 12
Waterproof 3
Razors 40
Growth 23
