###################################
#* .*..* ...  \.. *.\.**\   ##    #
#**.\.*..****.. ..**!*... *\*.#   #
#\.  *. .*. .*.*@*\*\.\* *. *R##  #
#. **.*. .\    .....*\.* . *... ###
#\***.*.. ..\** \.  . *.  *###  *.#
# *.\.*\. \. ...\.. .*\.  .###\####
# \ *.*.\*.\..  \*. \ ** *  *##   #
#\...@   .* \ \ ..#  * * *\ .###  #
#* .*\  ...   . *. .** \..  \.**# #
# * . .* \*  ..**..*\. #\*.*  ##  #
#.\ * .\*.*... *. *.#*  ..  \W.#  #
# ..\*.**   .  *\* .##   .# #\#   #
#.@#. .**\*.  ** ...* *.\.#\##    #
# * .** * .\. * *#\ ##.### #      #
###  ..*..** *\.# ## #\ *#        #
#  #   .#*\. # .#     #.#         #
#  # \ #**\ **L#       #          #
#  #\#. *.#..#                    #
#  ##*. .. ##                     #
# # ##. . #                       #
# #* *.\..#                       #
#  # #*#.\*#                      #
###################################

Water 17
Flooding 0
Waterproof 9
Razors 2
Growth 31
