#######################################################################################
#\..\*...*.*\.\.\**.!*.  . . *.*\  *. .  *\*. . ...  ... .\..... *\**. *.* *#         #
#.  . .  ... .@... \..**   *....\*.*..*\ **. * .*. ..  \... . W\ . *.* . *\* ##       #
# \.... *\**. \ *  .* ** . .*.***\.**.W  *\ \.\**.* .  . ... !\*. \* *.*.#*\#**# ##   #
# ..... *\ ....*.. \\ \*. . ..... .   .* * * *.*.**.   ...*  \.\   ..***..* ..###\.#  #
# *. \**...*...\.\....*\. ...*.*  .\***  ..W \.. ...   ..**.\ *..* * *.#.*.#.. *\ #   #
# .\...*\...\  ..   .*..** *...\ \  ..*. *.    . \ *W\.**.*.* *.\...*....* . * #.#    #
#\..\*.*\  \.\.   .  * .*.... \ .\* * . *.. \. ...  !.*.... .\. \**\. \*.*.\   *#     #
#...*.***\*.*.** * \ \  .\    . . . .    \.*.** .* *.\.***.. * ..!.. *.\** * **.##    #
#.*.*   *...\.*..* *\. * *  ..**\. **  .\ *. .. .**\* ..*.. .\ \*. .\.\... . .*\*.#   #
#.\\.\...\\ . ..\**..*.  ..  \**.\\..\. * *...**.\* .. \*** .*\.. *..  * ... \  #\#   #
#... . \ ..\.  *  *.....  *.\...  .  .* *.\*.***.\...* .\..*\.***..  **... .\.*.\#    #
#.**.. . .  . ..*..  * . *\.*.. ***  \.*. *. ... ..**\.. ****\. *\*...*.\.\@.*  #     #
#\ \ *.**. \***\.*.  . .\\     \...  ... *\. .* \   .    .  \.*. ..*\*\ * **..\.\##   #
# *. .***   **...\.. *. *.*.. *.. *..\.*..\*\\*\.*.*\\ . *. \..  .*** . . **\.\* # #  #
# .  .*** ..*..**  * .  * **..*\.**..\\.\  . .. *\*.   .\*W\. \\ .\.*.\* ....#*.. \ # #
#\ \* . .*\*.  \*.\ \*\*\*.*.\... * \ **\ *.\*\..... .* ... . . .  *\....**  .\. ###  #
#* . \ *.*.*\**..* ... .!..\ ...\.\*..... . ...*\  ..*\  .*  .* .*.*  .*..\ W.*\* #####
#. .. .\..*. .  ...*.. ***...*  . .**\ *...**.\\. * .. .  \ *\*\ *....  .* .*\.\.. . *#
#..  .\*  .*\..*\* .  \* . .   ..  .* !.* . \.*.. .   *.*...*.\ . .. *\* .**...    . ##
# *\..**.* ..  *. \. . .** ****\**\ \*. *.\ .. *.  .  ..*  *... * .  \*. .\. . .   .# #
#..* ..  * ***..  . . .\.* \**..*. .\*. ... ..\.*..\. *.\ *...\ *. . ..\.  .\\.L .**# #
#..\.*\ .\ .*.\ \*. .\ ...  *.  *   .*\.  ...\ \** ... . *. !  . .\*\ ... . .  * *.#  #
#\  .*.\ W  ..* ...**   * *\*\\  .*  *.\ .  .*.!.*  ..  *.\. ... .!.. . \   .\.#.*\*# #
#*.\***\.*.\..*\.*..   .!\\*.* \*..  . *   .\..** ..*..*.@**  ... *  **..  ..### ###  #
#. .\  *  *.. .* .  .** *  .   .\*.*\ ..\*. .! **.\*. .\. . .......\.* ....* #.##     #
#.*. **..\.  *.*\   *.*\. \. .\ .*\.*.\ .*.*. ... .  ***.   *   .. .    .**### #      #
# .  **. . ..   ... **  *. . *.\ ...*.W..* W!*.\ ..\*\*. .\*.*.\.R**.. .\#\..\ ##     #
#\.*   *.*.*. .**  **\*** \. . *. ...\  .    * .\\.*  *.** * ... .*.. ***. .*.##.#    #
#  . .**.**. .****.*  * \ .*  .. .. \ *..    *..*.....\ *.  .. .. \.** .*\\..\. .#    #
#. .\W**.\*.. ..\  \.*.   \. \...*..* * .*.* !\*.\  \* ..   .  **\ *..\*.  \. ###     #
#\.* *.  ****  \*\..\*\... .*  *\*.*\ *\*  * ***..   . .*..**.* .*..* *\  ..*\.#      #
#* .. \. \.\..  .  *.\..\* *....* . ... \*\. \.* .\ ** \.* * .*\.. .*\* *  ..#\#      #
#\  .\ ..**.\.. *\*. ** ** .. . . .\.  *.... . *.  *.   ...\ **\*..*  .*  ...###      #
# \ \ .*...\..*.  .\\**  *... *..****\.\.  .. *\ ...  \.*\ . *\ *. . **...\*.  *#     #
#*\*.W *  **. .* *.*...*.*. * *   *... *. ..*\..* .**\*.\ \  . . .\  .. \  *\*\#      #
#.*  **. ..... . .  ..**..*.*..\\... *\ * @  .. . . * **.****\\..**. ** #\  .##       #
#.   \. . !.\ \*. * .* ..** **\.\*. *...*\* **\ *.*.\ .*... ..* **  ...   *. .##      #
#.\. ..  .\!  ..*..\.*\*.*\..  *.. .... ..* ** *.  \.. .*.. *..**\*** ..** .#.@.#     #
#* \ \!....  .\\.**\.. . .\**... \*. \** .*\\*\.* \.*. *..  \ * \ .\**\*..\**.##      #
#**. .**  .** ......*\   **.* .  ..** @ . *.*.*\   \.**\  .\..\*.   .\. * .# #        #
#\. * ... ***.  .*..*.*. .\*.\   *.*  .   .**.*  \....\.*\ *.   . * .** #\.# #        #
#. *\ *.  .\.\ .**  .@..\.*..*\ .. ...  * ....*\*. * * *  .*\.*...\.  #\\## #         #
# .* .\. * . .. .\. **...* * * \.*. \.. . \* ...*.\. ..\* *.  *.\ .  *.##             #
#\.\.\ ... .** *.* \ \.*.*\. .*.\** .@   .... *  .\ ..  *\.\\ *\. *####               #
#  .*  .  .**.   ...\.\ *..*!\..*. . .\..  \ * .  *.\.\.\ *\.***.\. **#               #
#\.*!* *.  .. **.*  ..  .*.\*.*\   ..*. \. .** \* .*.*. \ .* . \\.#...\#              #
#. *.. *\  ** **\   **. \..*\*.\.\\* .* . . .\. . .  *   .**\ ###\\ .\#               #
# \..*.  . *.@** *\**.** *.\*.   .\.  . \..*..\.  *. . ..  .*..## #\##                #
#... *.** .* \. .\ ..@.  *.. .    ..*\@\...*    .*.*\.*  ..**.. ###.*#                #
#\ ... ...\... . *  *\. .\.* **. .*\*  *.*\*. !*\ . **.*.\.*\**#.####                 #
#.\ .!* *.W .\ *.. *. . *  . .*.  .*\*  .\*.\.\**\**.**.! . *.*..\.#                  #
#*** ..* .\     .  ..***.@\\ .*\ *\..    ..**\ .. .*. *.  **@###*##                   #
#.* *....\...  . *\..**.  .  ...*.. \*..*  .*.*.   ..  *\.*..\..#                     #
#*... *  .*.* *  .  *.*  *  *\.\  @  .. . . **.*\*.  . ..\ *.*##                      #
#.*..... *.*. .*\.\....* .**. . *\..\...    .\*\  .#\**\**  \#                        #
# .  *\.*\.* .\  .   W*\**.  . ..\.\ ..* .* * \#.\  . \ .# *#                         #
#..*...***.*...  .*\* ..\* .\ * . \ .* \... .*\ .#* *\! ...*.#                        #
#*. .*. *. *..*.  * ..*\.. . W.  . * **  **...* . **###\\##. *#                       #
#.*.* .\...\... .  .  * . .   ..  .. ..  \ .!.  . *#   # ## ##                        #
#\. * ..   .. .  * *. .*\ *  ** * .  . *.* . .. #*#   #*\..#                          #
# ..**.  \ . .  .\ ..\ .  . \ * ..** * **. .  .  .*#   ####                           #
#\\ \..\...**. ...  .* \.\..*...\ \.... \ . .\  **.#                                  #
#*.. *. *\ . ** * .**.\ . . . \ *..*\.\.\. \.  \.\.#                                  #
#*** .. **. *\*\**\.* ..*  * \.\** ** *. .\ *.\. .#                                   #
#######################################################################################

Water 58
Flooding 14
Waterproof 3
Razors 3
Growth 7
