##################
#   #\..\.R *. . #
#  #*. *.  *\*  *#
#   #    ..**.*  #
#  #\ **\ .\**. *#
##L*....*..@ .. .#
# \*\ **.  *. . .#
#### .*.\.* \ *  #
##.*.  .. !\.. . #
# ###... . *\.*\ #
##################

Water 2
Flooding 5
Waterproof 12
Razors 12
Growth 24
