#####################
# .\ .*.. *. ... \..#
#**.. *. * ...\    \#
#*.. \.* .\ *\... *.#
#*.*  .\ \@ .  **\*.#
#. ....*  *  \.\.**.#
# .*. \. ...\..  .\*#
#.* .\ ** ..  * *..\#
#\.*.\*..\.\..*... *#
#* ..!*..\.*.@. ****#
#\.\* \* .\.*. \....#
#  @.***.. ..  \  * #
#. . \..\ * * \.* **#
#\.  .  ..*\. .*.\ .#
#      ..**..   \ \*#
# ..\.  ...\.*. . ..#
#. ..   * ..\.. *. \#
#\ *.  *.@\.  . \  .#
#* .. *\  .\*\. .\ \#
#. . .. .\*. * ..*..#
#. .. *\   ! ...***.#
#.**\ . ... .*\\...\#
#\**   .\ * .\.\  .*#
#*..\.\\ ..* .\ \\..#
#.... .. *\ . ...\\.#
#\  *.*\  . .**\ ***#
#.  .* .*\ .*.*..*..#
#* .\  *.  \.\* *.\*#
#.. ..*.*\ \*.. .\. #
#    \. ....\ . ** \#
#*   . *. * .. *.. *#
#.*  .*.* **.....  .#
#. \..*  \*.\.* \ ..#
# *.  .* .\  * \.\. #
# .. *  .\!  .\  .* #
#....   \\..* . \ .\#
#\ *..\\.*. ... *.**#
#*.W..*. ..*.\.\*.**#
#.\. **. *..* ....*.#
# .   . . \ \.  .\*.#
#*.  *  *..  .. ...*#
#.\ .  .**.*..  \*  #
#..* .* . ..\..* **.#
#. \* * . . . .\  ..#
#* ..*. ....!*.*.. \#
#!\ ...** \\*.** ..\#
#\..\  *.....**\    #
#*W\* ..*.*....**. .#
#. ..* *\.  * ***\..#
#\\ .  . . *..*. *@ #
#*\ *.\  *\  ** ..  #
#\..*\.\*. ..*. \  .#
#** . \ \ *. \**. * #
#.. * . . ..\.. \ .*#
#***  .\. **  **!! *#
# **  .  .. *.*. * *#
#\.!  *   * \..*\.**#
# . . ....*\.*\..\ .#
#.  ... * *. *    .*#
# .\ .*.*  *.\  ....#
#...  ...\ ...!*.  .#
#. *.. **** . ... .*#
#*..*. .*.   . *\.  #
#..* .. * \* .*...**#
# \* *\.  . ... ..\.#
# *\ . * * .\*.. *!*#
#...\  .\. **.***..*#
# \..* \.*.*..\*. *.#
#\* **\.\.* *.*.\.*.#
#.\\*\!..   *..** .\#
#\ .. **.*. .\. . *\#
#.\***\. ..  .**  *.#
#.. .  * \**.\.\.   #
# *..* . ...*.*\ **.#
#*....**     .* *  .#
#.**.*\**  *. ***.. #
#*.\ . .** .. *.*.* #
#.*@ ..... *. *..*..#
# .......  .. \ *.**#
#.* .*.\.. *.*. .. .#
#\* ** * **..  ..\.*#
#   .. \ *\ \. \ * \#
#.......\. * *..*.  #
#  .* . *.\!.  *.*\\#
# \*\ .\ .. *.*.*..*#
#\...\* .  \**..\ \.#
#  *\.**  \.\\\.   *#
# .* .... .   \ .  *#
#... *  *\.. . \ ...#
#.\.\...\*  * *. \*\#
# .. .\*.* **.  ...*#
#\*.*. .**.*.*\\*  \#
# ..  *.**...**.\  .#
#  .   ...*.\ . . **#
#**\*   \!.\*** \..*#
#\ *..\ .  .**. .. *#
# .W\*.\*.\..**  .*.#
#\   .  ..   ...  \.#
#   ***..* *\ *.. *.#
# . .\.*.* .. \....*#
# .*  *R*. * . * \ *#
#**.\. \*..\.\ .....#
#**.**..@* ...**.\  #
#*\... .*.....*.* . #
##.*.* .. ..*.*..\ .#
##..*. ** ...\  .*  #
##.\. ... .* .*\.  \#
## \   * .*. *.#*@..#
#* **  ..*..! @... *#
#*#.**#.#\. \.*\*.\\#
###\###\  !\*! *\#**#
#  # #\...#..### \.##
#   #...*# #L   ### #
#   #.**#           #
#   # ##            #
#####################

Water 97
Flooding 16
Waterproof 8
Razors 8
Growth 12
