###############
# .\*  .. *R  #
##\*\.**  ..  #
# #*. ..      #
#  ##...\..*\ #
#  #...**... L#
#  #*.\.**\.*##
###############