###########################
#          #.###          #
#          #*.**#         #
#           #..#          #
#     #  #### . ####      #
#   ##.## .*#.\ ...*#     #
# ##.**#*.#*\.  *..##     #
##*\  ...*. . **.##. #    #
# .#*..  **#\*\.. #\##    #
#.#* .    *#.*.*.\ .# #   #
# .#*.*.****.\*..*#  *##  #
#.**#.# .*..\.  \*  *.#\###
#\..#**\ ..  . * #**...*..#
# \#.#.. .   .*.\ **. ##* #
#*..\*.. . \ . ..\. ...*..#
#.*. \.*7 \!.  \ .\\  ... #
#\* ..  *..... \\\* ..!\. #
#..\*\ \. . .. .\.  . *** #
#\. \....  * * .  .  . !. #
#..  * *\  *. .\\ . **  . #
#.!*.. **!..*. .\ .\*. .. #
# *.  .*  ..  .....*\  .  #
#\..****\  \  R*.*.* *.. *#
# *.*.\*..\\ *. \*\.*.*  \#
#\. .\*.*... \ ..\*..*... #
#  **  *.   \  .. * . ... #
# * *\***.\* . *.*    .* .#
#..   ...  .  ..\..** ..\ #
#... *. *\ . . . . *\. .* #
#..\\   .. ***.   *\ ..*\.#
# *!.\..*\ ....\. \. .. . #
#\* ..\ \ . . .*.\.* \ \.*#
# ..*.  *  .*\..  \.* *. .#
#*... .*.*.\. ! * ..*\\.\ #
#*\.*. * ...*. ..  .* ..* #
#!.    *\  .. .* . **. \* #
#\ ..*..*. . \*.*.  \**.. #
#..\  * . \** ....   *.   #
#* @\**.* ..\.  .    .. * #
#..*@..\*..\ .*.\*  *.\.. #
#*...*\....@  .........\*.#
#.*.*\ ..* .\. A\*  .**...#
#*\.* .\*@\*.* ** .* *.. *#
#..**. \*! \*..*.@**..\.\ #
#**....*..* . .* .*...*  *#
#..* . *\* .\*\. .***\*...#
# \  ..* . ..\*\. *..*. \ #
# ... \\  .  ..  * . .\.*@#
# !.. \   .*  .**..   *\..#
#\ \ .*.   * \*..W .\.**  #
#* .. .**.*.!.  *.\.  ..  #
#.\.*.**...\ !\.*** . . *.#
#\  .*.... .  *. .*\  ...*#
#** *...\  \*..*. . . \ **#
#\. .. *.* .\ \* .\  \. .*#
#  *.\**.  . . *  . *.\. .#
#  .   . . .  *. \  ..... #
#.* ..   \ \ \\ . .\\ \*. #
#\\..  . .*.*. .  \*  ....#
#**. .. \..*...*\. .*.  ..#
#* \.  *...\.*.*. \ * .. \#
#.* *.* . .. .\..\.   . ..#
#*\ *\\..    .\* *.\..  *\#
# . ** *. ***\   .\*.  .\.#
#*!... .*\... .*.\.*\     #
#.  ..\.* .\. .. *.... .*\#
#***...*.\ . *\...**W..  .#
#*\ ..*.*.. *.\  .*. ..\* #
# . ..\****..\* \..*.\*. *#
#\ .W\.. *.\* \..\.* ..*\.#
#*#.*. **** * .\ .\***\ **#
##\.*. .*..\. **.*.*.* .\ #
#L.. **  .**. .* * \.  *.*#
##.#*.\.  !.*  * .*.#*  . #
##.#* ** \. .  .  #.#\. *\#
# ##...* .#\ #. .. \.#. .\#
#  #* ## \ *..\* \*### *#.#
#   ## # !..**#### # #\*.*#
#       ###* *.##* # #**###
#       # *.\.*# ##   ##  #
#      #\.#!#\#           #
###########################

Water 0
Flooding 0
Waterproof 6
Razors 21
Growth 19
Trampoline A targets 7