##############################################################################################################
#   #*.. .# .\.* .*.\ .\ * *. ...*\*.. \  ....   * . \*..*.   ..*\ . .*\..   .@. \*. .. \  .    .\ ..*.\* .  #
#   #\ *\**. .*\ ..\*\ . * ..\..@\ .. * ..**** ..**. ...\\\..\**..**.*. .***.**  .*.*  .. \ ..\.. .*\ *.*.. \#
# ## ...#.... ...   *  .\* .* .** . .*.\.*.\..*   . ...\ *. .* ****.....\*.....*.\ *.. \ *...\...**.* .  . .*#
##*.**.  ..\*\\**..*.\ \.. *... .\ \ ..*@@ !* . * *\ \**..\.\. ..*\.** \ ... !\*  ..*\*.*.*.*\.. ..**\  *.. \#
###.#.**.   *.*. .*.\.  . \*\ *  .\.*\**\\.\*  ..\.. ..\**.\ \.  .. .\...**\  *. .. ***\*.. .* * .* ....\@...#
#* *   \   .* #@*** ...**   .*!.*  ..*.* *  * ..*.*\. *.**. * **.   .*   .. .\.\*  **.*.. \*.... ...\ \. .\ \#
#*##***..\.\ .** \.   *.!.. .. ... .....**..*  *.**.  .@.\ .*   ....**\*. ***. .. *.  .*\\. .   .*.*   \.\. .#
####..**. *\. .*\**. **.\ \ \....  . .* *..*.\ . ...\  * * *.* . \*\ * .*.@ ...** 8 .. *..***. ...*\  ** .*..#
##..  *..\..\. \**... *..*.. .\.\   \*.\ ..*.**..... . *\.\**.*. * *\*  ..*  . ...\.***\*. .. .* *. . . * *.*#
##* ..**\*. . ..\* . .\... *... ..**.! .   !.W\* .*   \.  .\  .. \.***.* \\ .  *\ *\.*..\..\..*\..   * .... .#
####*... \ ...*\.\.. .** \*. . * .** * .  \*.* .  .\.    .*. **\ . \   ** . ***. ...*.@ .  .  **@.   *****\..#
#. ##*.**..* *.* **.  .. ..    *...*.*   *.*\.  .W.*****.\\  .\ *\*..**.\.*...  \.* \ . .* *.. ... ..\*.\. .*#
##..*.# * ***!\....  \*.*.\ .. .*. \ ..****. .*. **... *\ ....... \*.* *.**. .\.! * **. . !.*. \.**. \. .  *.#
#...*\...  *. * **.\*...... ..  .. !*.  *..\***\*.*  \ ..*.\ \ *\\.\ *..\.*. .*..  ..  * *\..\*...\.*.*  .*.*#
#*. *.  * \.* *.*..*.\ *  ..*\.\ *.   .  . ...*** *.@.*\ *.*......*. * . *. ..*\  .*\. .. **.  .... \ *.*\W..#
#..*..  * !.* .**\ .*.*.    .  . .\..  *\.\...\.* ......*\* . \.* *  ....*  \.. .* !...  *.*  *.*. ..*..***.*#
# ..\. \    \..\*.\*.. .. .. \.\ ... .\.\ * *** . * \.\.. .  .. \ *.**\ \..**\ * . \ \.\*..\  **. *@..  *\.. #
#. *.*  #***.  . \.\   \. .\.\*.. . . .*.\. ..\   *.*.. . . \.*..*\... *  .*.*\.\  .\.  .... *..  \.\.. ..\*.#
#\.*.\  ...\  **\. *  .. .\ \. \ \* ..\. . *.\. * *. .\ @.  .*..\..**\..  *.*....  .  ..  . ...  . \. .*.\ *.#
#* ...*.*** *\\. *\.@..\* .*..*. .*.*..*.****. *\*.!    ..\ ... . *\..\ .*.**.*..\ ..  .  .*. . * .    . .*\.#
#*\*  *....!.**\*.. .\...  ***.\* ..  **..\.\.\**\\..\.**...\. \..*\.*W.\..*... *.* *     ..*..*.**..  .*.*  #
##**  .*.\  *\*..\ .*.  * \*.  ..  \ .\..* ..\..  \ .*.*   .*\ ..*.** .*  *. *..*\..* *.*  *.... ..  .\\ \ **#
##...\ . *.\.*\...  . * *  .. \  *  . .   *  . . .. .*. .\. ..\ .\** *..\..**..\. .**.*..** . \ \ .\  . ...* #
#* **. **. .\.\ .  *@*\.. \*. .  . *.  .\ * ..*\ *.\*.*.***  * \ .\..* \**\..\.!.*\. ..*.... *. . @.....* ...#
# ..\ *.\*.  \.* .....  *\ . .   .*  *\..*...\.\.*.*\**\*\. *. .... .. .\*.\*\*....*  ** . .*..*\\*.  \\* .\.#
# *.  .** .   .** .\  **  .* ..*  . .     .\..\**. \   .\ \\. \    ..\.* *****\\ . ..\.\ ***. .\. .    ..*.. #
#\#* .  *  .** *\.  ... *.*..\.\.\   ..\.*\..\*.. *.*..  .. **...\ .** * ..**... *\.*.\ .@.  \ ** ** .**\... #
# .\. \*.* *.\*.* \*\.\ **.. *..*. *..*!**  *.. ..\.* *\ *. *.\ *. *\.*. ..\.\\\** ...*.....*.\..\..  .*..*\ #
#.#* .*\ ... .. **..*......** . ..*..*.*...\\. .\ ...... . .\***. \*  *. *..  **.  ...\  ** . ..*. . ..*. ..*#
# \* *.*.* . .. \..**.\..*. \\  **\***... * *  *** .*  .*..  *..* .. *\\.\.*\* .\... *.** ..  .** .. .*. *\ *#
#* * \*\..* .!  .  ..* *.*  . *\. ***.* ***\. **..\ **\*.** .. *..\. *.\.  * .\.. .\\. *\*  *. ...\ . *\ ...\#
#*.\ .\  .   **..\.  .*.*...... . \\**. ...  .*. **..\*. .*\.. .. .. *.   *.*\   * \*\.*   ..**  \**\*...  . #
#**. . .**.. ...  .  \.   .\   .\ . . ***\..  . * \  ..\ *** .** **   ...*.**..*..\.*  .\ .\ ..\. .*.... ..*.#
#4\* *.\ .  * **.\*.\**\  \*.**   . ..*   *. ..*   ..* ..\ ..**.* .. ** *...*  !  .\. **. \*\*.*.* . .** .\*.#
#.#!* \#.\. ....*.** .\. . ..* \. .  \..\*\*   *. .*..*.  \ \ .\*\.\....\..... *  *.. .*..** .*. *.\  *.*\*.\#
##* .*.* . @...\*\..*.  * *. *..\ *...   **.\.** \ *.\.*\\.. * *  ..**.\ *\\ ..* *.\ *.\.*..\**.\\ ... \  .* #
#.* *\*\**.. \  \  .D.....*\ **\  *\. .....    * \ .* ..* ..*.\ . .\ **. .. **\. .\...**..*  \*..* *\\. . ...#
#. \*. * ***.* *  * .*..  **. .    \. *** . .*... \*..\. \* ***.... ..*.*. . *...* * .*..!..\*** \***\..*@  *#
#\  *.\ .  *\...... *\\  ..*...* ...  .   .*. \. . *. * A..\... \*   ..* \*  \!* *......  .@   \.\*\*.\ *\.*\#
#.!..**\.\ ....     .*@*.\\* * *\*. .*. .* .   .\  **\.. ..\ .   \! *\ \* .\*. .\*.\\.***  .! \  *. *\..\... #
#*\ *  * .\ .  *      *.. ***\. .\*. .  \* . *. *..*  ....\*.*\  ..\\.*...* .   .\.... *....  ..** \..@..\.. #
##*\.**\. *    *.* \.   *. ...***.\*. *\ *  ..  *\ *.* * *... * \  \ ...@ .\ .. .*   *\..\  ***... . !. **  *#
#\.* ..  ..* \.**. ... .* ...* ... .\....... \....** . ..\ .\ *\ \.   *\. * *.. *  \.... \***.****\**.*  *.. #
#*\**** . *. . *. \. *.\.!   ** !** . *.\.*.\. .  . \...  * *.. *\ ..@    ..*..*.\....*.  *...\..\ *@ .... **#
#\  . . .\*.\.\\*..\.*@...\**. .\***.\...\. .  .\** . . ..*\*.\.*...\ *.\.*.*  ..**  .... .*.. *\. .** ***.*.#
#..  **. *.. .  \.**.\*   . . *\..\..W. .*..**\. ..\*.  ...*.\*!.\    *.*. *.. . *.*.\. \... .         \ \\.\#
# *..* \ .  \! ..*W\. .\.  .. *.* * *\   *.. .  ** ..\.*..**.. ** ...*  *\\.*. *. .\. \ .... *.. \..    * . *#
# .\*. .*\.  *. ..!. *\.  *.*\..*.. . .\ \  .* . .\.*  ..\ .**\... *.* ..*.* .*.. ** W...\ ..\  *   . **..\.\#
# ..\*.*.*\* *. .* . *. .**..**\*\      ...* *.. .*.* ..*.\ .\*!\..*\.   * .\.*** \* . . .** . .******. ***  #
#  *#\*... .\  **.  *\ . ..\*@.*.**.*.    *..*\*  .**...**. *.\ . *.**   ! \*\..\ .*.*. . .**\   ..* .. **\. #
#\.*.*  *.* .  ....... **.  .*** .\*. ..   *....  @*.*!\ . ...**  .**. **   . \. . .*.  \. . .... .**.\ .\.  #
#  .**\. ...**. . .*.\! .  ....*  *.    \ .....\\ *\*.*.*  . .* *.**.  ** .*. *  . .*.....\. .. * ***..\ *.*\#
#\*\..** **\* *..\*.. \.* *.\* .. C.*. \ \. **@ *.  * . *   .\.\. \ \*. ....\*.**.  **... .     .*..*\ ****\ #
#@.*..!..\. !.... *** .....*.*  *  ** **..****\ . * *.* ..  * ..*...*\.\* . ..\..*.*.*!* ...  .....*. .\. ** #
#**\  *.   .  *. \.!.*..\*  *. \..***.. *...**.. .* **. *  ..**.*.* . . *.*  .   ... . ...** * ! .*.** ..*.. #
#. .\*#.  #***\.\......  .\  .\  *\ ..* .\ !*\. **..\.* ...*..**\*.\ . \*\.\**\ * \ ..*   *.**..\* ..@\.***  #
# .# *  * *.*\. **.. .\ .\ \***.* .. .*\..* .\. **. . *.  ..\ \***\. ...* . .*.  *\  .*** .*. *\ \*\. ....\.*#
# W # .\.** \ .*....\*  *..\ **.. *** .....\..*..... ..   \* ..**. \* * . ..*..*.\**\\.. ... \** .*.\........#
#. .\*##.**  \ **\\.*.**. \* .  .\**.W\\*    ..*.@ *1.\*   ....\ .**\   *\ *!. *\.*.   \* !* . * *\..\.! \*..#
##*.#.*\.... \...  *. .. .  .\. \.\.. \ .  . *..\*\.. .    * .\.\ . * .*  ... *.* . \.*.*  \  .****\*  * .. .#
# #.#..##\.*.* *  .*.*.  *.*.\  *\*.* ***\ *!\ @*..  ..*.\ . **.*!   .\. * ..*.\*  .* . \\   .*.....\.   .*.\#
# #.##* . \  . .    \*..**.. \. . \@* *. .**   *\.\ . ..**\.. *\. .!\.* @..\.*.*.\ *****@\. . * .\...* . *.\.#
#  #... ..\.*.*... \. .  . \..  * ****.*.*\\ *.\.\ *  \  . ...\....*  !\ * \   .. *.**...\...*.  .\. .\ *.\ \#
#  #\#\ #.#*.\*..**.    ** *  * \ *****..\.*.\  \*.*   *\  *. . \**. \ \*.\   .*... *\.*\. \*.* ***..*.... . #
#   # # \*..R.\...*...  .\*.. 5*.*.  \ \ .\.@... ......*..*** **.**@. . *@\ ..\. ..*\*\.**\.\*.*\.* ..***\.**#
#    ##\.\. .\.  ...  ..*\*\.* *  ***.  ....*..*. ** .\\@**..\..**\  *\.. ... .*. \. .  ..*. *@*... ...*.. .*#
#   #*##.**. ....\.\ . ..\* .. . *.\.    \*.* \.*..@. . .. *   *.. \**.  *   ***  .*..  .\.*... \**\.\..\.\. #
#  #\.* .*..**.\... @ ... * *  .\.\.. .\. \\*..*..\..\*.** . ...\. .. .. *.*.*.. ....*. . .\* \..... *..E *\*#
#   ##.*..*\** .   * * \* . \ .. \.* \!.  . .\.. W .\ ..**  . \*.**.\ *.**\...\\.. *..!  .\ *\.* * .*...*  .*#
#    #\ \..\.***\.*.* *.* .\* \. ...\..\.*\**@ .  \  .  \  .*. . .* *\.\...  \*. \.** . .*... . .*. *\*\.\. *#
#     #\.* *\*  ..!\.\.\.\*  \.  * *.. ** .. * *\ \.* \ . .\..\*.....  .    **..\.*.\. * *.\..** .*\...*\  *.#
#     # #*...*.  !\*..@.   .* ** .\..\.\. \ **\*!.* . ... \  \ .. @.*\..* .*..\   *\** . .\......*\.\* \ ...\#
#     #*### ***\*F*..*.*. *.\...*. .\  *\ .  . .**.. * ***.**.*..*\.*.*\.*..* ..\.*...*.\.W.\. !**.   \..****#
#      #  # ..*\ .*. . * .*.W.  *\.  .*  ... \.\*. \*. .*.\..*!\. *  \**.\.**. .**\.. .*..\  ** .*..*\* **.\.#
#         #. .\ * ....*\ \ .\.******. . **.*\.... .*.. \...  . *  *@.*..  \* *\.\** \ ..\*.\..**.* .* ...**.\#
#        #\. .*.  ...\*.*..  ...****..  .\*..*...  \.* . . . W*.* **.. *  .. *..*.... ...***.*......*\ .. *\*#
#         #*\*...*  .** ...* ..\!..*\.. .*****\\.**  . ...\..\* *.\*. \*\* **. ***\ .*!  *....\   \ .. . .*..#
#          #*..*... .**\.**\\. .**.*  .. .*.*\. \..*.\\  \. **\*W*..\... @****...!**.\@\ . \**.* \ . . *...  #
#          #*.\* ** **. **. .  .. \....*\ ...*  .\ *..   . ....* **.****.\ .***..*\.\*. . ..*....  .\.*.*..\.#
#           #\# #.@.*....#\..  * \.\.*..** . .     ***\** *  ..\ \\*... **  *\   \*. .\*.. ..*.\* .* ..... *\#
#            #..#\. *.* ....\ ** \*.\@*... *.\    .. *..* * *   \.** .. .*. *.\.** *.* *\.\.*.**.\..  .\ . . #
#             ###.*..\.#\  \. .*.**. **.\**.!*. .. *\.*..\* \ \\  ..  *  .  .  ..\ .@\*\*   ....    .. .\.*.!#
#               #\#** \ *.* .  ....* .*. *..\.** .\..*. ** ..**  . ...*. . .  ..   **.\..\ ..*\*.    *\. \.. #
#                ##.. \ .\.***   *... *. .* .**.\* . .**. .\ *\*.  ..*.*.  **  \.**.** .\ \ . * .!.* *\  ...\#
#               #. *  ..*  \   ..\. \ *\  . .. \.. *\*.*** .*\ . **\..  * \* * . *.**.** \. . * *..\ .* .  ..#
#                #..  ..\ ..\.\.**\ . *.. *  \.. . .* * \  .\... ..*.* \. ..  .  .. *.!*..\. .*...\   . ..* \#
#                #. ...*  . *. *. .* .\. ..    . .*!. * .\**.  . * . . .  \ *.  \** .\ *\@ .....\ ...   *\*  #
#                 ####\.#B*\*.* .  *#.\*.!.  ..\.*..* .*..\   ... ** **.*..\*. **.. .. *.***\\ . . *  .** . ##
#                  # .#.\\...*...\*.\ . *.* .* .*. .. *. **.  .  \.  .*\** ...\.  .* *@.*\**..*. \  \* \#*\#*#
#                   # \ .\....*\\ .    .*.* .*\*.@*  .\. ..\ \* \\.*.*.*.\.     .!*..*. *.**\ .   . . .#*. **#
#                    ##\****\ \.\ .**..  ..* .  .*...\*\ * ....\*. **. *\   . **\ *.*  \...\.\..\ **\*   \ *##
#                      # .*. \*\ . *. ...\ .\ .*\.* ** ..... . .*..*.*..*  .\.\**  ..* .* \*.*.\  *\ *\* ..# #
#                     #..\ * ..\****...*.   . *\**!\...****   . .\\\*** .\** ...*  \ .   \  !*  .\*.\.#*.  # #
#                      #..\** *.  *  #\       . .. *.\ **.\*.. ...  @..\* .*.*\*.*!.. *.. *.    .*. *  *  #  #
#                     #*..#.! ... .*. \.  \*.. . * \. **.. **\*. .***. *\. .*... ...* *.*.\**. * \. \.*#.#   #
#                      ### # *   ...* #\.  .   * . ***.*\*..\*.  *.** *.W. *.  @\\\ ..\ .  *\....# \. # #    #
#                         #.\* **.@ \ .  . . *.   .*@.....  .. * ...* ..\ *..\\.  .*..! *. *  *#. .#@#       #
#                          ###**.*.\.*\..@. .#. *. .  \ \. *..*\*..** . * **\* .**..\.*...\..*# ## *#        #
#                           ##.* ..  \   **   .* *.*  . .. .**..*\ .\ \ * .7******.. ...   @\*.##.\#         #
#                          #\ *\ ** .*** \*\ *  ... . \.# * ... *** ..* . \*.\#..**. *#.#\ ..\.##*#          #
#                          #.#***.@\.*##\..*.\  *.  .\.  .**... .*.*.*. * .***   \..\ .##*    #  #           #
#                           #.*!*\\ ##  ##\..#* ...\..  #**..\* *..  . * .***.\....   #  # *.#               #
#                            #..\..#     #.  *. #*\. *\ . . .*. * *\*. .. #.##.# .... *##* *L                #
#                            #. .\#       ####*.*. **\    *W*.*** *.**. .\ .* . \.  * #  ###                 #
#                             # #*#           ##.. .* .*.  .* .* * @..  * #..  #.*  ##                       #
#                             #.*#           # !. * #\**  \..\*...** .. *.#\###.*\ *#                        #
#                              ##             #*.*. .*#..\.#...**.#\ \#*\\.#   ##.##                         #
#                                             #*.#*#* ##** .\\*..*#*.\##.\#      #                           #
#                                              ###.*# .##.*. *.# .**.#  ##                                   #
#                                                 ## ###*.#. *\###\#*#                                       #
#                                                      ##*\ \ .. *# #                                        #
#                                                     #\..##.*#.*#                                           #
#                                                      ###  ## #\#                                           #
##############################################################################################################

Water 0
Flooding 0
Waterproof 2
Razors 47
Growth 42
Trampoline A targets 5
Trampoline C targets 7
Trampoline B targets 1
Trampoline E targets 4
Trampoline D targets 7
Trampoline F targets 8