#####################################
#  #.#    ###                       #
#  #*#  ##. G#                      #
# #.\###*###\#                      #
# # #..\* #\.#                      #
# # ##* *\** *#                     #
###* *. # \. ##                     #
#...\*.\..\* *\#  #     ##          #
#..\..* \ \ *..# #\#   #  #         #
#.*.  . .. .#   #\**#  ##.#    ### ##
#\.. *..\ ..\. ###.\*##\#.# # #   #.#
#*.\* \.*.**@ #..*L . *.  ## ### .! #
#*\.\.. .*..* *\..* . *..*##.#.. \.*#
#*  *.\.** \*\.***#. .\.. ..*.*.*#*.#
#.. . .\*.* \ \.**  *\. \*. **...\D*#
#.** \ !\***. .   . ## \. . C... F\*#
# \. . .*.*. *\ .. * .....  ..\* . *#
#* . ...*.. @.***.... .    .**..* ..#
#. W..\* *....*  **\.\.. ****.*.\   #
# .\ *.* ..*.\.\ A.. ... .*#   .  * #
#* .*. *  ..** **. \.  .*#.*\ *.* *H#
#.  *\ .*\  .... .\\** *.\.*\.. *.. #
#*  *\ .*\@  ....   .......4 . *.\..#
#..*..* ..\ ***.\ ... .... .** .***.#
#**. ** ** .*.*.** .. * .   .\*.\...#
#\.\*9. .* **...*W.\ .*\ ***  .  . .#
#*  .. *.  ..*\ . .*.*. * *.* *. .\.#
#...** . *.\.. *.*\.*.. \ * .\ ..\  #
#..\***\**\.\. *  * *   . .. ..*. *.#
#\.!. * \.*.   . **\.  .@\. .. ..\.*#
#.\. *** *\. *.\**.***.*  .\.\** .\*#
#  .\..* * . .  .*  *. .\.. \ *  \.*#
# .   .. ..    * *\..\. *.. .... .**#
# * \.** .  .*\. !. * \**..*.*. . .*#
#.*....  *..  \  * \. ...*\. *\*.\ \#
#\.. *. .**  *..*. ...**.\. ...@ * .#
#\ \ *  **..\\  **\.\******  . .\. *#
#*  *. *..* . ..... .***\.*..* *.*.\#
#.  *  \**.*  **\*\.**. . *. **.*\*.#
#. **\. * E.* .\..  *  .\..* .*. *.\#
#.*.\ * ... .\. .  ..\ .  .**.*...* #
#\... ... ..  * .\ *\.* \  .. .*.*.*#
#*. ..*  ..* .*.\..\.....  .*..*\.. #
#**.  *..**.\ *.*.* .\..\..\ . .*\ .#
#!*.\.*  . ..*.** \.  .\. ..\..**.*.#
#*\ .*\.. *... .\\. ..\.\ ***\..\.\*#
# .  *.....\*.*\...* \ .. .*** *. *.#
#\  \ * .\  .\.. .*... .  \\*** \* *#
# .*..\ \* ..* !.!!*.. .**  *.*\ .. #
# .*.* . .\*..* .*.\*. **.*\.**...\ #
# .. ..*.\*. ...*. *..*... *..***\.*#
# ..**.  *  *!\.\*.@ ..* ....*. ***\#
#\..... ..... \**...  .. \.6.. . .\.#
# ....  @.\ *\*...\. . *\.\*.\. .. *#
#  ...**. ... .. **.\  .  *.  \   *\#
#.\*\  .\*.\ .*\...\..*  *\ .. .*..\#
# *.*.*.*.   ...** .  \ ...\*.\*.\.*#
#.. .*.. * ....\..    .*..\..**. . .#
#.  ..\. \.*. *....\ . .* .\ *\**..\#
#.....**.   . . .\.. **   .. .*\*R.\#
# .. .*.* * **   .  .!*  ...*\ .*. *#
#\  ....***\  \**** *\ ..  .  .**\* #
#.  . \*\**. * ....  *\.*.\ .* *\.*.#
#.*\* ....*.  *..* * . .**....   .. #
# .    ** ...** ....\\ *.\..\\ . .*\#
# .... . \*. .... \. . *.*. *.\ .  .#
# *\ @\  .**.  \.  ..*.\  \.**.     #
#\@.*\.. .....\. .\* . .. .\\...***.#
#*.\ .  *  .\    ...   .\ *. *.*\   #
#..  . ..*\.*  \***  *\ .*..\*.**...#
#.* ** *   *\*\ .**\*. .*\  \.*.*.\ #
#***..\. **.**.  *..*\ *..\ ..*\.**\#
#.****\.*.\ .. *... . ***\*.  .**\..#
#\*.*\...*..  .*.  ..**..... .\ ..* #
#**\\*. .*. ** .*. \ @..*.... .*. .\#
#..\**.  .......* .. ....  ..\\\. .\#
#**.  ..\ .* \!.*  \. 1*\..  * **   #
#.. \ . \ **...*. ....*\. *.**\\ \@.#
#.**..  ...*. 8. ..\*.\.* .*..*.....#
#B*  \. .\**\. .*. .*.. .. .. .* .* #
#*.\*.  .*... \\.\* .*. ***.\. .  \ #
#* ..... . .**  . ..* \*..\  \   .\.#
#*\. .* \**..\..**\*\.*.\\**\..** *.#
#..   *. *.\W. \ * I.... *..... ...\#
#. .\..  7* \* ..*\.***..**    .. .*#
#####################################

Water 0
Flooding 0
Waterproof 18
Razors 11
Growth 6
Trampoline A targets 9
Trampoline C targets 1
Trampoline B targets 8
Trampoline E targets 6
Trampoline D targets 8
Trampoline G targets 4
Trampoline F targets 7
Trampoline I targets 6
Trampoline H targets 7