#######################
#  #   #\#  #         #
# #.## LA# # #        #
# #.#.#\ ###@#        #
# # #. ** .  #        #
##  *##.*# **# # #    #
#\*..*#.\*..###.# ## ##
# ..**....\.# #*#\ .#.#
#   \.!#  .  . \ * ..\#
#.\...#**\\ *...*#* .##
#.* * *.* .\.*# \.*  ##
#\\ .*.  .\*..\ .*.  \#
#*   *\** ..* .\ . ...#
#*.* .***.. . \*#..#..#
#* . .....*.\  .\.**\ #
#***.  .  *.*...... . #
#. . *..*\.**.\*\*\***#
# . ..\ \. .\.*...**.*#
# ** \.*.\ ** **\.*. .#
#* *   .. \  \.. .** .#
#**..!\. \\.\. ..*... #
#. **  . .. . *.\*..  #
#  .. @ .1.. * \  *.* #
#.   @.. . . .*. .. ..#
# ....!  .* . **.*\.**#
#\***\ \  .\. .  . *\.#
# ....   \. .\     .  #
# . . .** . ....*\**.\#
#\*..  ** .  ..\\*..* #
#. !*\ \  \*.\   .. .\#
#*. .  . ...*. . \R   #
#*..     .\. ... \*\..#
#.\*.  \.\ \*\. .\.*. #
# *.\*\.*...\. *\. *. #
#  . .* . .\* \\  **..#
# .* . \   ..... .*.\.#
# * *    *. . * \ *. .#
# . *\.  . *. * .**\. #
#**.** .  .\ .  ..**\\#
#.\**\ * ..      \.*  #
#. ..*.* .*  \! ...*\.#
#.   ..   .\. * *.*   #
# *.\@*..\ **.*  .*.\.#
#.*  .....** ** .... .#
#.*.    .\ .\*\...\\*.#
#.**  .*   * .. \\   *#
# .. . ..**.....W.* *.#
# .*  .  *..*.... *. \#
#  * *@.*.* .  * .*\ .#
#\** .*....\  \*\  *..#
# .   **  * \  .*\*. .#
# .\*  ..@..\*   * \.*#
#  ..*... * ..  *.\. .#
#.. ... ....   \  ** \#
#\\.\     .*.\..*...  #
#.\.\\. . ** *\.. .** #
#   . .   **.*\   \*\ #
# *.     ** .. .. .. *#
#.   ...*\.. .*.\. *..#
#. . **.@**  ** !\.** #
#\.. .*\**.*\ **..\*..#
#* .\**.**\\*\\..  *\ #
# .. .**.*....* *. .  #
#*. . \*** \  \. ** ..#
#*  . ..**..  .@...\ \#
# *\.*.\...*\ *...    #
#* . . *\.\.....\... .#
#.* .*..  \.\..*. *.  #
#\.  ..  ..  . .\\.*..#
#. ..*\ **\*. \*\.*..*#
#*.  **\*.@\*\ . *. . #
#*.\ .\ *  .*.\ ***.  #
#..  ..*. *.*  *..\.. #
#* . \   *. . ...   * #
#*...**.*.\\*.*.. *\*\#
#.*.@.*. *B ..\*\\\...#
#\ .\.*\ . .\\ .  .* \#
#.   ..* .. \*6  *\.  #
#*\ \*.*\* ..**\.* ..\#
#######################

Water 9
Flooding 18
Waterproof 14
Razors 21
Growth 48
Trampoline A targets 1
Trampoline B targets 6