################################################################################################################################
#                                           #\.##. . . .   .*. *#..\.  !.\ *.\   ..*. ..\* .*\ . *..\*\ *\.\. ..* \.* ** **    #
#                                            #. * ..\#\ * . * .**  *.* ..* *\.\  *@**..***.**..  * . . .!**  ..*@..\**.**.*..*.#
#                                            #.*##*...*.*\.....#!\ ... * . ..*...*.\.\*.\  **...\..\*   . .\  * ..*..*\.*..  ..#
#                                             #.**   *.   . ..  * ... \.\ . \..*.\ .\*.*  ....*  *.*.\  *  ...**. \*!. ** . .**#
#                                              #.. .*.. **\. .\*. \. ..\ .\ .. .* . .. *  .  .. **..*.**!\..\*..\.....\... . *.#
#                                              #  **  \ .\.\..  **. \. ..*@.. ..\. .....* *. .* \.* *..** .\ *. ***. \.*.. *...#
#                                              #\#..* . *  . .. **.*.. *... *  .. . .. **..* *. .\. .\.\.*  ..\\.*\...\**...*\*#
#                                           # ##\*..* @ ** ..* ..* *.\ ..**.\*\*!. . *\*...*... .\*.\. . ... * \.**..\ ...   ..#
#                                        ###*#*. . ##\....**  .... .  .* * . ..**\. \*.** *.!   .. \..* ... .\  .** .. *    ** #
#                                  #    #*..\###*#* ..* .*** . .    .*.... *. ..\... \*.. .. ****\**\  .   .\ .\*\@*\  .\  *.. #
#                                 # # ###.*###*\ \*\* **...\ .*..**** *..*\ ......* *.. .* **......\..   .\**.W \.\. .* .***\  #
#                                 #  #\.\\.*\### *****.\. *    *.*  ...  *.. .*\.@  . ....\.\\ .\.* ** **..*.............*. ..*#
#                             #   #.##.\ ...#\.*\\ ..  .*\ . *...*\*.*....  . *.*\...* .*\* .  ***.\ *..   *       *.\. .   ..*#
#                            # #  # *#.\*#*. .\. .\    . ..\.\. . ..**.*.*...\. ***. \. . .\\ .**. .\...*** *....   .*\.\   . .#
#                            #*####\*.\.\ . ..*  * \    **!   .. .* .* . .\**..*..* . \  ..*   *..  .. .... *....*. *..... ..  #
#                           #...\.*.. .  .*..\* .. ..**\*\ ** @\*. \ \.\...***\**.\\* ..*   . ..*.  .\\ .\*.   \*.**\*\ .. *  .#
#                            ##\#.#\ \ \ ...\ *..\*\  .W  *...* ..*.\....  .***..\* ** *.\ \ \ . .   *.  *.*.  ..  ...*..* \..\#
#                              # # #*..   **  .\*..*.. *.\. *\. * \.  .  .\ \... .. ..... ..  *  . .*\* *\.**.  *.!*. * .*.\ .*#
#                                 ##.. #**.**#*.. \   .******!\ .*..  ..\* !.*    . .. \.*\*.**  .  *\ .\...... \ * .. . ..** .#
#                                #*#*...*.... *\   *\**@\.\****\.\. .*\! *\  .*\ \. *\.*.. .\..\... ..*... @\! \. .**.   .*.*  #
#                               ##*\.** *. *.\!***\..**. *.  \ . .. *.*.    ..\ .  \. *..\ \*\*. .. . ...\ .*.\.*.\\. \ .\.**\\#
#                             ##.#.  ** **..*  *.!..**.* .*..  .*  **..   .. \.**   **..\...*. .\*... ..** \..\\.  .\ **..\..\ #
#                            #. *#... ..*.. *  *.\ ..*.. *..*\ \* .*  . \*\ .  .  \**..\..   ..  *.** *...\\**. *.*\ \..\ **.. #
#                            #  . #*.*.\.*... @!*   \*.\ * .  *..*.*..* .* * . *!* *.*.  .  .**\.* .  .**  .*.. ..  .  **.@ . .#
#                             ##\...**..\.  .**..\. ..\.*!..     *.* @\ .\ . .....*.*.\* *   \   ..\.*\. *.  .....*.* ..  * \ .#
#                             #**\* ..  * \ .\.*.  .*@.*. ..*. . ....  \ .   *\\**  ...* ...*. *.*. .\ ..*..*\*   . . \..*.... #
#                             #.. .  . **. .\.*..  *.*. . .W. \.\  .\ \@**\. \  \*.  . .\*. \* ..  .*..**\* .  * ** ...   .\*. #
#                             #**.*.*.*..\. *\..\\\@*.*. .\ ...*. .*. . .. . ..* .\..@.!...**\*.\\.* . \.*..  .\..**.* ..*...*\#
#                          # ## ..*\..\..*\.\.\.  ......\. ! ..* ..*.  .*\\**. * ** *. .  * \ *.*.  .\..\.\ .**.  ** *   \\\...#
#                      #  #*#*#  .**..  ...\ ..*.....\ .....\ *\ ..\*   . ..** ..* *.\.\*... **.. . .*. .\. *\**..\. .* \. .*.*#
#                     #.###\#.## * \.. *.\. \ \*..  . *@\ ....*@* \.. \** ***. . .**\.\  *  *..*.\\..\ .*.* * .\\.... .\**.\  .#
#                     #  \#.  \ .**....\\*. ....* ......   *. ... . .\... *. .. * ......\. *..*    ** *.. ...***\*\* * .\.\*.\ #
#                    # . .. **..\**\\*. ..*\ *\ ..** \..*...\ . *. ...\* \..  \..\.\ .. * .** . **\\*.\\* ***\.\*.*...*\.* .\.\#
#                     #*.*\.\.....  *\ \**.  ..*.*\.\ \ .*\*\   .\\* *.. . .*..\*@ . .  *.*.. **.\ *....* . * ... .\ .\ *..... #
#                    #..\...#.. ....*.  ..*.*\!\ * . . * .. !. **  *.\..\. ..*. ..... . ..9 * .\*.**\*.**  ..\ \.\  .**.@  . .*#
#                    ##*##\.**\. . .*\ \ **** . \* .\. * ** * .\*  . .*  .\ ..\.** . .*  ..\..  . .****\**. . .......*  *.    .#
#                   # #\..*#*# \.. *. * *\**..   @ *** .*\. .\* .\.R  .*.* \ \.\.  * ..\*.*.**.*.\ ..*\...*@. ..\\** .\ .*.* *.#
#                   # .\.**  . ..\... .. .*.*\.  .@.!*\.*... *. *.. . **\. .. \*..\...   *. .!.. .. \**...\. .  . *. .. ... \..#
#                  # *\.*.     .   ..  *    .. *\\.* . \  * **\  .   \.\  \ .. \ \ *.\.. *.\ ..\.* *.*\*  *** .*.\*.\.*!\  ****#
#                 # \##*@* * \.\ **   \.* **..** .  *.**  *\ .. **** .\!    *. .\.\....\..  ...\..  .\*... ..*. ....* ..*. ..\.#
#                 #*##.##* .*# ..\*. ..*.*\..*\* .*..*.\  .\* . *\ . **\*  *.\...*\ .\.*\.. . * *. ..  . \.* \. .*\ . ...* * *.#
#                #*.*#\.\. \\. * ** .  .\..  .  ...... *...*. *...\..\. .\..*.** * . . .  **..\*\**.  **\. **.. .*\.  .\.\.**..#
#                 ## .   @..*@*. ..\.*..\  * ***  * \. ..*\...*\  ...  .  *  *.. .\ \* .  *.* .\.\.*...\.  ..  * .*\ \*.*.* ..\#
#                # *** #*\*...... *.** **.  \...\.*.\ . .\.\ .*. .**\.**.*..*.* *.**\ .*\*\... ..... \...  *   .\*   .*....*.* #
#                #.... ..#* ..  *   .  \. .*.** .\.**      *. * .**. ...\.*\\ . .* .\.** *.*.**  . **.\.. ... \\ \  \ .. * . * #
#               #.*. .\ *\\.\  .! *\..\ \*.\ . \*..\. ..*.*.\ .. .....* ..... \.  *** ** *.\ *. .. ... .*\.\6..\. . .    \.. .*#
#           #  ##*#*#..#. \   ..**\. .\.* \**\. . . \...* .\.\ . .**.. *.*   * . \..***\*..\.*.  . * .** ..\*\   .  . . \. **..#
#         ## ##...*. . *.*....*  .*    . \. **.\..*..\* .\   . \\*\. . . .** .@*  *.!.\ .\.*.*.*\..\  ...*\ @** . \.* \  .\.. .#
#      ###.\.##.. #.  .  . \ *.\...\ *. .*\ *..*\ .\ *\*\.*.   .\.\@.   \*!.* .. *W\**.....\.\*...*.  !*..*.*!..\*...*.**\ ** .#
#     #\.***.*#!..\. . *\  . **.\ * *. *\*.*.\ . . .*..*.*.\\*\.*\ .*. . .. * . *.* ..**\ ... ** .  .*.W*  .\. .   ....*...*. \#
#      ####... ....*\ *\.\ . .*.*.\ *... * .     *..\ .....  .* .*. .**  .*.\. \... * .\..*..\...... *. ..*.    \ * ...\.* \.. #
#          #   .  .  \****\ ...\ .....\ *.     \*. * *.*\\.. *.\\\..*\.. ..\**.\** \. .* \. ** *\.*\***. .*  *...*. ...  . .\. #
#          #\ *. ..\  .**...  .\ . . .2\. .\*...*.** . .*\   .*.\*.\.. *\.\..**\.*\..  *..  *..   . .@...**....... .**\ .. .*\ #
#          # *..\*\ . ..** * . *... ** * *.*  \*\ *.**. * *.* .*.. *...\ . * ..*.*.*  .\**...\\   .. .*\ ..*\*  .. ....... @. .#
#           ## \*@  \*. \  . \. . * **.\ ...  .* *.**.\..\...\.** \. !.\\ **.  ***  *  !.*\*.  ...* * \.. \**.*   .**.    . ...#
#          # * .#..\... .* .\.* *** ..\ .\.*  ***.\ *\**.*.*..*\. *.\. .\.\** **..*.. .  .***.   .*   *. *...*.\   ...*.\* \ \*#
#          #\*.##*****..  .\.\. ..* *\ \ **.* \ .. .\.**\*\* .  * *   \..**.  ..\ . ..*..\* *.. **  * !   ...\ *. \  .* .*\. ..#
#           #####..  ** *\...\ . .* ..  ... . .***\ \**\*..\ \*\*  ***  *\**\..  *\.\ \.* *\..*\*.*\..*.* *\.* .\ ..* *..*.*  \#
#         ###....\. .#  *.*..*.\. * *. \*   *.....*....*..\.. * . . .. ***...   ..\...  *\* . *.**...*...\.  **\\..   . ..  .  #
#        #\* \.  #..*....\..\ .. *. .   .*... @.....* ..  *.* !  .\.*\..*\\  ** .*. .  \\  \.*. .*.* \  * .***. *    .!.  * .**#
#         ####* \ *\**. *. \...\. *. ..*....\ \*.*..\ .\*!. .\  *.  . * \.*\.\.* ..!  *  *....\.*. . .. .*\*** ..* *\*  .*...*.#
#         # *...\....*  ... **\*...**  ..\ . *....\..* *..*..  *.W  *** .**.*. .\.*\..** .* *** .*..\ \ \.. .*  \ .*. \.*..\**.#
#        # # .* . * **  .\. .\..!*.\ .  *..\ . ..\*. .*\\ .\.**.**.\\..*. .!. ..*.* . .. .  * * ****.....*..*..\..****. .....  #
#       #.   \. \*. ..*\*. . .  \**..\ *.*\*..**\*\ \.\ \ \ \ .* *......* *.\  .  * ..  .. ..** **\* .*\ .*\. ..\.** . ..\\*..*#
#       #.# #\.     .\. W.. ...*.\\ \. .****.....**  ..\ . ..*..**!.  \..\\.  *. . .*\...*   . ** .. *. \ \. . \* * **..\* \. \#
#        ##\#..  *\. .  *   *.\.. .* 4...\...\ .**.***. *\ .\.\ ... \\.* *  \. * \  **\. .  .  ..  **. \.\\..* *. **. . .. . ..#
#         #. ! #**.\ *!*.* .***..*\. ..**..*.*.**\ **..*..**.\   . \ . \  ... ... .**...\ !* **.\.* . \* .*.*.!..  . .*.** *  \#
#          # . #*..... ** * .*...8.. \ .**.....*....*\..\.....*.   \***.!.*  **\* \...**!* .**  .*....... \  *   .* .   ..\.* W#
#         ##.#  .* \. . .\*.\ ..  @\ . *\.*. ...*..  . .*\*   * \*...**.\.***.. @  .\\  ... .. .** .*  *\...\.* \..   ..** @\.*#
#        #.#  .*.\ .**.!  . *. *   ..* .* .\..\.. \..\\.**  .*  \...*...**.*\ *..\*.   \.. ..  . * *..* .\..*.*. . \...*.* .. *#
#        #*..*\ . * **  .\* ***. *\* . *.  ...\  @. *\* ... ..  .\***....*\. *** .*****\*....*\ .... *.. .** ..   *....*\.\   .#
#        ##* *.  .* .*.\* . .*. *.*. *   \*\. *..***\ .\    * .. *... ..\*. .\*.  .\..\.**  *.  \W* .*.\ *.\***\ .. .. ....  .*#
#   #####\#... .\\  .\* .  . *\ \..\ .***.*.*\.. *.\*\. .... *....*. ..\*. . *. ** .*..\ .. *...*.\*.**\****...  ** .* *\ *.*  #
#  #* * #..**   ...** **.\*\\.*..*\.. .*...*.* * *.  .  *   .\*\* .*..\*****...\.\ *. \  *.\*   .\...\.* .\* *\ . .. . .. . .*.#
#   #   * . ... .*. .*\.\..   .\*\ ..*\*\. .\.*\.*  . . .   **.    .\*  .\.\.  **    . .*. *  .\* \*\ .*. .\ . \.. * . ...*. *.#
#    #*\  *..*..\... .* . \*\ * .*..\*.* *. *\!. . * *  ..   ****.\..\ * * *\  ... * . ** .* ..*... .\ \\.\.\....\**..*.* **\* #
#     #**\. \*\*..** .\ ...\ .* ....  . .*.  .  \.   *.  . !....\*** . \ * ...*.*\ **.\.* *.. *.*. *\.*. .*..  *. *\* . * .  *.#
#    #..\# .. ..  **  ***\** \....  *..*..  *\  .*.\@*. .\  .  * .*.  .. *. **\  ..*\.*.  . . @.* *.! \*..\ * .* \*.\.*..* ..*.#
#    ##. *\...*.\. .\ ... .*  .* \**.\*     .. . .  ... *..*** .. *\ *   *\\..  \ ** \.. ... \... .*\ .** ...* .\..\ .. \  . * #
#   #*.*.#\.#..\* .*.  . .\\*\* .*\..*.\ *..W\ .   *\.\ **  ..\ ..*\ .*.*. . **.. ..\ . .**.  .  \.*.\.\.\ . .\.. .*.\  ..   . #
#    # #.  *.@.*\   ..   .  . . *\*  .**...*. ..  *.... .. *. *.\. .  *..\.. **.*\ @*..\.*... .    .*.  .*** ..\* *... \ .* ..*#
# # #.#\. .... . *.\ *** **.\*!*\.*..*. .\.*...* **.\* \*. \   \*. \ ..** ..... **\*.\ *.\***. \ *. .. ***!*.  ***.\ * . .*.!\*#
##*##..**..* .\*\**.*\ .  .  .**.*\**...\..\ **. \.*..*..\ . .* ..\.\*\.*\.   .  *...*... .*.\*. .. \* .*.*. * \ @ .**. .   ...#
##*##** \*..\ ..  .. . \..\\**..*.*. \..\.\ ..\  .\*. .. . \. ....! **! .*\ .*.\.**.*\!.***.*..*\*. .   **.* *.. .\...*. .\**. #
##*# #***.*\...*\*.. **\ *.* . \.*.\.   * \.\ ..* ..*** .\.. .\**\  \.*\ \.. .. . \***. .*... *...\**  .. ***\ \.****..*.*....*#
#*.\# *\. .** \.** *... ..... \  W****..\**\....*.\....**.. * .* .*@..* ..*.\.. ..\.*. ..*..\*! \\.****  **. *.\.* ..\ \**\   .#
##..  ** *.#***.* \..**.*.* *.. ******\**\* .*.\. **. \.*  \ \..\.\.\.. .\**  \.** .*.  \.* ...\.....\.  **  ..*.@. ... \. * . #
## #*# ..*.**.. . .* .*....*..* . . \* ..*.*.\*.. ..\*. *. .*   !*.**..\\**. .*..\... \.* . .!\*\\.*   . .\. .\.**\ .\*.\ ....\#
# # ##\. #....@ *.*.. .* \.. \.    *... . .*\ * .\* ..... ..\...*. ... .\** ****..\.. ..*.\  **\..*.. *. *  .*\. .*  * * *  . \#
#  #...*.# ...* ..\  .*.  * \.*\*. * \.\ **.. @ .***.\ \.....*  * \*.@.\*..@ ..\*.  ...\..*. ...\. .\.*.  \\*..\... .*.*.*\ .*.#
#   ## *\##\ **. .* *\ .* \\.\...*  *.\*.*\.\*\ *....*\ .*. .*\*...*.\**\. .\ ... *. * * *. *** .\.....\..\ .***\ .@ ...*. *.\ #
#   ##\W.#..\*.. .. ..  *. * ...**. .! \. .. .*\  . \*.  *.\ ..**\ .*.....*   .. . .   . .\.\.\  . .\ *..*\. ..!**.* \.*.\*\.*\#
#  #\.. \ *..*#\..\. .* \**\ . ....\ . \**.\.* !. *.*.* .*.\. .*. . .*.!.**  \  .**\ .\*. .*.\ .\*...*..**.*. \ \.!\ . .*..  ..#
#   ##  ###*..*..\  . \   **.. .  *. ..  !... ** **.***. .*....*  .   *  .. .  . ***.* .\..\   * .. . ..\.*\. . ...!. .\. \\  .#
#     # ##\#\.*** .  **\*....  .\\. * ...  .\!*\ .. \ ..* .\.\ . *  ..*..... .* *.\...*@\  * **\*. \ \.\  !* * \ .  .!\.\ . . .#
#     #*#.*** .*... ..\.. \\ @\..\* .  *. . \  .* ..\  .*.\ *    . * .\..  \* .\.\*\\.*.  .*.  .*\\.\*.* .*.*. .* . ...*\.   **#
#      ##\.*...\.\*.\ .\....\ . \.*..... **  . \. ..!***. .*** .\...  .  \... .\\... . \** .   @\...****. * *.* .. **\.*..  .**#
#    ###....\.\*...  . .* *\ . ..*  .\.  ..\*. . \... ..*  *..\.  \* .\.*.\ *\.. .. * .   \* .*..**.*.*** \.*.\.*. **..\* .\**.#
#   #*\.**  *.  \.** * .\ .  .\ *.\. *\  .\** .\ *  .   ....\ ..*\.*\* \* .\.  *\*\.. \. \ *\*.  .*.** .* . *.. .* *\.*\. ..**\#
#    #*#.\ *#***  \ \*   . * *...  .......... * .**... * *.\ . *\  ..\  .\*. .*.*\...\. . .   .*. ...**\.*.**. ***.. .\..  ..\ #
#    #*\.. **..*.* ..*. .*\*.*.  . *\. .*.\.. \ .*.*\ *..*\*** .* .   .\... ..*.*. \*  .. . .. **. \ .* *\  \ \*.*. .*.B\  .  \#
#     #. \.\..  ... \.   ...\.  \  .  * .*.  ... .@.*  * * .... * * . .  .*\ \ *\.  . ..***\* ***.\..*....* *.!\ .. ...* *. \\.#
#    #** * .\.*.    ... **\  . *.\\. * \..    . .*\\...... ..\*.  . *. ....  .\..*\*  **\** .\****..\ \..\. ..*.. .    ..\* .* #
#     ##..   ..* .** .* .*... \. .. \.  \*.@ .. \...\  .. \**..*\*.... * *\ * \  . *\ .\**    **..* *.. ....\.*. .*\.*. ... \*.#
#      #.\\ *.*\.\****...*.\.!.   \.. \  * \  .....  .\@\ *  * *!..* **\ .*\\  ..*.* **.. .  * .*.* *\*. \*.**.\  **.**..**.!* #
#       # *..#. ...*  .** *.* ..**.*\*   *.. *.**! ..*.   .*.* * .*.\  ...!. *  .\.. ..  .**... .*.....  .*\\*. * *.*.*\. .\ **#
#      #.\*###   . . .**...\..*.*\ * ..*  \*** .*.*.\**..  ...*!\* * .\.\ ...*  ***. \  ..* .* \.. ! * .* \.\.*.\*...*... \** *#
#       ##**.\ ..* .  * .. .....   .\ \..*.\.* . .@. ... \* . .*.*.*..\*..  .. *.!.* .! **\ * \.  .*.. .\*.... ..\...*. .....  #
#         #\## *@ *. *.! * \*\*\ *.* * ... .* . **\ ..\*\.\  .*.*.... *.. .   .*.**!\   .\  .....*.*...  .\\\.  .*....*  .*\  *#
#         #.# ##. .  . \ * ..*.**\**\\* **  .*\...*\...*..*..*.\.\.   ..\ *....  .\*. **.* .\  \\* * *..  . ....\*\**.*.  .\...#
#          # #*#**\\.....\ . .\ ...\. **.\.* \. * .  \.***.*\ . * ..@ .\..\. ..  ***.*.\ . *...... . **\.. \ . \*. .*...\.  .*\#
#           #.*.##....\.*..  *..  .\ * .*.\.*. *. .. .. .\ .  \ .. \.*.. *. .**\*\.... . \.*.  * .\ .....* . .\.*.*   .*   ...*#
#            #*\#.\.\..**.*...  .\****. .  *..\  ..@\ .\ \*.\*. \.!  . .***. @..\** .\. ...\* ** *. \*  .. .**.\. **.*.*.*.....#
#           #.*#.\.... *...* .\*\**\ \ !\.****    ...*.*. *..* . .\ *** ...*.***.\. **...* .*\.*..!* .  . *\*.\....*.\*.*.\!. .#
#            #*\ ## .*. . .*\.*. ...\\  * ..\.  ..... *.. * \.    * *.\  \ . .\. .\!\* *** *.**\\..\  \**..... ..\.*.....*  *.*#
#           #*.*. * \*..   * *  \\  . .*\*\**\.W\.**.**. ...** ..*......* .. .* ........*. * .....\ .*... \. *...  *.*\* . ..\*#
#          #*.*.*\* \.*\.*. .. *.\\..  .*@*.\ *  *.. *..*..**. *   \  * *\. .\.\ *  \   .*..* .\*  * * . . ...\  . *.* *  **...#
#           # . .*. \... * \ \*.....\.*.* \ *.*.*.* .* *. ...* *. *  .. .. *\!!.\.\. ..\*.  *. .. .* . @.   *  .\...*\*\.\.  . #
#          # #\ .. *.*.\...\ . *\. ...\ ..... .\* .\*.\*\. .\...* . . **. ...\.\.*. .. @*. .. .*  *\*..   .*\. \  . .*.*.**.*..#
#          #  W#*.*.. ..\  ** .**.*\   . *.*  * . .*...*..**. . .\ ... *.\ .* .  ...\ .*.. *\..\*\. * ..*......* *\.. *. *.\.. #
#        ##* .  .\.* * .*..\*  .. *..*\ \     ..  \..***.** .     ....*.    *..\ .. ***.. .* . @. .**.** . .**...\.   @.\..*..\#
#       # #*  \.\. ..** *\ ..\  *.**.. \*\**\* \  .  @*.\..\  \  \..\\...* \ *.. *\.**  . \* .\    .** * \  .... . *.... .*.   #
#       #.#.\ # *..\W...* . \.. .!.*  ....*\.\\...  ..*..\   .... ...\ * \ .@\** *.. * *. .. ..\.\ ..**. ..    .\  .......* **.#
#      #.  .* **\. **..\* ....  *...    E \ ... .\... *** .. \.\.. ...*\\  *\ *\.  . . ... * *. **\  .  .\ \ **  \   \\..\ ...*#
#       #*. .#.....     ..   .*.!.\...\*.*.   * ..  . \ .  ...\ *. .* .* *.. ..* .... *.. *\ .  ..* \.\  ....\.*   .. . ..*..\*#
#       #.\*   *  ...*\. ..  D...\**.*. ..\  \.. .****!.\ .*..  \. .*\ **.** . ***.*\*** \.A*.*...\\..   . .  *..* .\. !@*. \*.#
#        ##. . .*   .. *\!.  . . **....   *.. .\ ...\. *  .*.*.\..\***.\*..    *...*..*\ .*\.   **..\* * \ .*.! .*\ . . *.\* *.#
#         #  @...  @** .* .W\. . ..   * \.*.*.. .  . ..**.*.*..*.\*...\*.** *\ .. .. *  ....   .*.\* . .. ***.*  ....   .*.. ..#
#          #.#\\.. *\ .\..*\** @. .*..\ .\. .... **. ..*. * .\. * **.*.*.*\. . \.*.\ .@* *   * ..\ .*..*\.\** \  . .**.\ \*. ..#
#           #\.. \*.   .  * *. @\  **\ .\. .*..\ *. *. .  ..* ...\.**\. *... .***.\ . ....*. .  \*. .* .   *\.*.......*  .*.* .#
#           # ..\*....\ ..*.\* ..W\*\.  ***\\**. . .*...   ...*....**   *.\.\.*..\.*  *. .!*. \...\.*. . .*...** .*...*.\ ...  #
#            #\L**..# .*\*....*!...*     .*...... .  ... . \..\ *\ *.  * . ...\ \  .  *. * .\... **. .* . .*.\.*. \. ..   .\  .#
#           #.# .# ..  \..* \ *    *... *...... **** *\.** .\ .... . ..\..@.\ *!. *.. ** \  .*.. \.\. .* . .* *.*  .. .*.   .* #
#           #\*  *.  \\ *\  . .\ * *\ .. .. *. .\..\...*.* .  ..* .*. ..@   ..*    \  .  .\..*.*. *..  .\..*..*...*\ .*.*  \*\.#
#           #*.  *...\.\.** *.* . ....  \ * .**. .  \* * \ .**..**...  .** . **.  \.  \\.\.*....  ..\ *  .  ...** *  **\ \*..*.#
#            #.  *\#*..*\..  * *  *\ \...\\\ *.\ .*****.\.. ** \*. .*  .*\   .\ * **  .  .*.  *\\. ..  \* *** *.\ .\ \. *.*. \*#
#            #\ \*  .  .*.**** ..\ .* **\*.  ...*\!\.*\. *  .*  ... .*. .   * \..\*..\*.   **\.*\*\*\....*.*. \\ \ *\  . ..*...#
#             #. ... \. \. .@\  *\..@\ ...**   ... *..*\ .*\.. **\. *.\ * \ .*\. \ . . .\ . *...\. \  .\ *.!**\.\  .\.* * **. *#
#             #.@  \.* *  *\. \.\.\\.** . *.\.* **....*  \.* . .*.   *  *  .*.  !..*\ *\* .\\  \.  *..* *\. **. ...*.*  ...*\\*#
#              ##\. #.\# ** ...*.\ .* .*\.* **  *.  ..\*\.   ....* \.* ..\.*.\..**.\... *\ *. . *.**.....*.*.\.  *@*..\**\*\* .#
#             #\ ...\ .\ .. .\*. *\.. *\*..*..\ .  * . .*\*...* \*..\. .\.*. \.*. \ ..*** .* . \\   . . .**.  **\.\..*\.*.. . .#
#              ## #\ !\W\\. .*..\. ..\ .* ... .\ .*\*..\ ... *.  ..  * \. * \. ..* . ***.  *.* .** \   .\\*.@\*...\  \  \ *... #
#               #*## ... .  .*.. *\.*.* \\* * *.* *.  .  .\ .C  .. .  ..**! .\ .*.   .\. .*..* **\ ...\F *. ....*.  ..*..\.  \@#
#                #  #\ ..\*\.\.**..*.*  **. ****  .  *. ..@.* .* .    .\.*.  .. ...\.....\.\ .\.\..  .   .\.  \.*.  .***. \. .*#
#                    # . .*  **\. ..**\..*..*!..*...\* .\ *  ..\.\..  .!\ * ....  *\..** *\*.. *.  .  \.@ .     ...*\. .**...\.#
#                     ##.**  .*\.\ *.\.\\...\ ...* ...\*.**\ . **  ** *\.\.  ..\@*.*\... ..\..\!*. \ . *. ..\ \* \ \*  *.* .*..#
################################################################################################################################

Water 107
Flooding 4
Waterproof 11
Razors 12
Growth 46
Trampoline A targets 6
Trampoline C targets 8
Trampoline B targets 2
Trampoline E targets 9
Trampoline D targets 6
Trampoline F targets 4