#################
####\ . . #     #
#.*#.*#\.#      #
# .**...*## #   #
#\...\*...*# #  #
#.    ...**.*.# #
#* @ *.**.  #L  #
#.\. **.*\*.\## #
#.. \.*.. . .#*##
#*\ ...   .#*\.*#
#..\# .  .*.#####
# . .\#\.*R*#   #
# ..*... *.#    #
#################

Water 2
Flooding 10
Waterproof 3
Razors 24
Growth 15
