##########
#  #*#  ##
#  #\# #.#
# L# .#. #
##.*\  ..#
# .\ \   #
##.*... *#
#\. * R*.#
#..#* #**#
#   \ .#.#
# \   ...#
##  *.\.*#
#*  ***..#
#. ..\.@*#
#.\.. *..#
#\..  ***#
# **\\*\*#
##########

Water 4
Flooding 4
Waterproof 18
Razors 35
Growth 11
