################################################################################
#   #\#\*.\ \\ * . *. ..*  .**.*.*..\.*\...\ !\*.... \..*. . \ .. *.\ .. .\*  .#
#  #*. *.  !\  .   . \\ *.*\*.@*\.*\. ..\.   . .* . *. .\..   .*  **.   *  . R.#
#  #\#*.**.\.\**.. .  *** .**\\.*   ..  ** *. * *.*..*** ..     * .*.\ *.\...\ #
# #.  .*..   *.\. .***@....*.  ... *  \*.. *.....*. ...\ . \.*..   ..*.****  \ #
#  #\. .   .***    \..\ .  .**.* ...  .\.*.*\.*. .*. \\** W  * .\  .\...\*...  #
#  # ! *...*. *.  * .***  \* . .** \**.*.\.. \*** . * .**\ . .   .. * .. .\  . #
#  #*.....   ***  .\***   ..\*\ .. .\A\*  . .. ..    * .. *  **\*\\*..*\..   ..#
#  #.* \*    .**\.  .... \ * \ .\..* 8*\... \ ***. ..\ .\*.\*.. * **  .* *  \.*#
# ####. ..  \.... *\ .  *......** ..  *. \ .. 6.\. . ** *.. .\    \. ..*\*  .\*#
##\  ..*  #.  \.. *\.. *.\\**\.\  *\  .** .*\.\*.!\ *.  .. . .*.... **\.... *..#
# #   #.  .\*.*\.*.*.. *\ . . !.\...\ . .* .  .\ .  . ** .\..**.*.  .*  .\**.\.#
# # .*# ....**.*!. *W\.\ * ..  \*.*\.... .   ***.. \  . @*  .. *\* *@.\..*\.*.\#
###  ..*   * .\.\. *. \ \.. ..\..*..\  \. *\*\ * ... .* **\*.**.*..\*.. *\   .*#
#**  \ \   \ ... *\.\\       .. .*   .\.  .....*\ . * .\*.\...\\.\  . \.. \  . #
##*..#   \  *  . ....*.!  \  . .*... @.*\*\. \.  *!.*.  \. \\ *\  \ .\ .\   *\.#
# #   #*.! .*\*.   \.*.** .\. \ .\ * .. *\*  .**\.. \. ... . .\@\*.  .\**. ..  #
#  # *#.\*.   *\.....\  .\*  *!   *!\.. *.  \\** ..\ .*.  .. * . .   .*.*.  \  #
#   L **##....*. \.\\.   . ..... *.\ .*..*.*.\*. *.\ .**...\ *!.   .  ....\ .*.#
#   #*# #. # ..***  .*..* ** * ...!...** ...*!\.  \  .\\   B.. **.\.  ...*..\**#
#   ###\###** *...\ ..  @ .* * .*\.**. *\\  ..   . .*. \  ...\..* *. *\* . * **#
#  # ...*# \*...***\\  ****\*.**\* .@\ \*\.\.*..* \..\.. **.*..*. ..* \..*\* *\#
################################################################################

Water 19
Flooding 5
Waterproof 14
Razors 30
Growth 43
Trampoline A targets 6
Trampoline B targets 8