#####################################
# *.  \*\\.. **\..*\.\. \ .*#       #
#.. *..\..***  * .* .*#. . .#       #
#..**\.. ...*. * **. *****\\###     #
#\.*. ...\.\.\ .*... .... ....\#    #
#*.*.* *...* *  .\\..*\* *.  * #    #
#*. .....*.*..\* . \*.* ....*...#   #
#*    .\*.*... .  *.\.. .**.. \ #   #
#*\ . ..*..*\*  *.. \  .   \  . \#  #
#.     ...R***\.\.. ..\ .**!. \ #   #
#\  ** \.  \*. ..*..** . \    ##    #
#  .!*\ * .*\... . *\....* ##**##   #
#***\ ..@.\...*   \.. . \*. #*...#  #
#** ..  *\.*.*. . . \..* *.\.. .\*###
#\. \\ .\ \*\.*  * .. .\ !..\.\*... #
#@\...  . . . *... *\ *..   .*  #\.L#
#\ .*\\. **. ..*.\.. ...\.   ..  *# #
#.. \.\*. .. . \**.\*.\**.***\. ##  #
#\*\   .*..  . !.\.    .. .*#.**\.# #
#**.*  ...\ .\*\..   \\   .. *.#  # #
#  *.*    \ **... \...   * *.*..\..##
# ** !\.. . *..\. .....\ \   .....# #
#.\.*.**. ..**...*\  . .\..* *\* ## #
#.. .**.\.  .* * *...*. ..*. # .*\ ##
#  ...\ ..*. ***. .*\*..\  * #\*#*# #
#. *.\.*\*. .*..*\ *. \*\ *. ** *#  #
# \.**.*@  **\**...* * . \*.\.. \.# #
#####################################

Water 11
Flooding 15
Waterproof 9
Razors 31
Growth 41
