###########################################
#\*. .\.*** *..* .****.*   .  *.*  ** . . #
# .*.*.*... ...* .\9  \ *. *. ...   .\.\@*#
#  * .**. * ....\*.\  .*.*..\. \.. .  * ..#
#***\...**.*.  . *.*.. \***.!W..* ...*.  *#
#.. \.. ..*\..!  ...  *!*.*\.*\.* . \...*.#
#*    **....\** \  \. *. * * **...  . .   #
#...\..***. *.  .     .**\.  !... \  *\.\.#
#.*.*.. ..* .\ * \* .**..@.*..*.. .  . **.#
#.... ..\*..**\.* .*A \   ... *** . \  .*.#
#\W. *.\. *....\*.*..\ .\.. ..\**\....  ..#
# * \ *!\.** *. . . . .*** ..*!...\*. \.\.#
#.  . !... . .*    **    ... *  **.W ..* .#
#. .  * *   \ * .*\.. ..*  * .......*.\***#
#\ *  .** .   ....   **\.  .\ \ *...*. * .#
#..*.\.*\**  \*.. \.\.!.*.  .  \** ***.\* #
#. ...\..*.*. .*.....*\.*\ \!\.... .\\....#
#.\ .   ***\ .*.*.  .\.*..  \** .*  *  G.\#
#.* ..*. ...* **\.* ....\* \.*.*  *..**.\*#
#. .    .   .\..  \*** . * !\.**\\.  \. *.#
#...**\..\*...*.**.\.*\..\ .* \. *\ ** *. #
# . \.*\\*. \**..*  *. *\*  .. **.. .. .. #
#\. . *.\.  .* *.*\.\ *\ ..\*\* *.\..*.  .#
#.@   .  .*..* . .. ... *.  \ .\*** *....\#
# . . * *\.\ . . *.* .\..\... @ ..\.\.\.\.#
#   . .**. *.  \.....* . * .\ ..*.. . ..*\#
#\. * @\......  *.*.* *.\.\**.***.. .\ ...#
#*.**** *\ .\* .. . .\@.  *.*.*..**.**\ .*#
#*.\ *\ .*... .\.     \ ..... ..\*.\.. .\*#
#*  .. ....  **   *.\...*.\..* .*.\*\..* \#
#*.*\.  .\ \.\. *.*\..\ *..!\..*..*..  *  #
#* **. .\.*. .*.!*...  ..**..\**. .* **\  #
#*\.\*.**\. *.*. .*..  *\*.*...*!\ *\.... #
#\*\....* . . \.  .*.  . *\. **.. .\ **...#
#...*  **  \... *  .*   ** *..* ..\. .*   #
#\\  *\.....\ ..W * .\.* . ..** **\  *.*.*#
# \....   ..*. \* \.......  *. \*.....  \.#
#*.\...\.*. *.\ .\ \*. ..\. .  .  \*.  *  #
#.\. .  \**\.\.**  ..\ ..  * \.*\. \. *\  #
#   *\ \ *. \. ..** \*  ..\.  .\.\* **..*.#
#   ...!*. . **.* . .\\. \..*.*         *\#
#  * * * * . ..*.*..\.\  \.**.*. .*** !\..#
#..\!. *...  .* .... \.*\.*@* .  .*.\\ .**#
# . \ .!*  .* . .*...* .*...\ **. .*. .!!*#
#... .*.*.*\ *\. ***\. @.  \!**..* ***.. .#
#.*. ..*. .* **.*.\ .. .. *  .\. *..*..\* #
#@*. *\.....  **  .*\ .  ..\. .\. .... .\.#
# .* .\.... ...\ *.\ * ..\.    .* \.**\ *.#
# **. *.. ***.*.*.*  \ \..* ..*..  ... *\*#
#...\*.*..\.**\.\.\\* .*@ \...\\*. ..... .#
#  ...!*. *.*.* .** ..*\**...\..*  .*\   *#
# *.\**. ..\**.... .*..  ..* ...\** . .* .#
#...*\. . ..\* .  .\...\  !W * . ..  * .\ #
#.*.* \ *\*.*..**.\. \ .   ..\*.**  ** .B #
# . ...****.* ...    .\.*.  ..* *.  ...\.*#
#\ . \..\.  .    **. . \..  . .\ *..* \* .#
#. \*.\*  .  ..*.*\. . *...*. *\. \ .* .\.#
# \. \*\ ..*\*....** \*...* . ..* .**  .* #
#. *\.* *     *.. ..\.\.  ....  .* *\. *. #
#*\*  \   .!\..\*.*.****... \ .* *  * ... #
# .**\.\.\ \*. .. *..**.*\... *..... .\ **#
#.*\  .  *.** \ **.*\..*..\**.**\**.  *\*.#
#..* \*.*.@.\   \. \ ..\.**.\.....\.\ \.*.#
#**. .\.\.*  .* .  .!*.. . ...*.\. *.***.\#
#...  **. . . . . .**.\.. . .\*\ . * .\.**#
#*.. *\.  * *.   \*... .   ..... *....* * #
# * ** . \  \*. *.* . .\ .*...* *.  \.*\. #
# .!\* .*..*.. ..\.  \.. *..\.\ * .\. *. .#
# .\*  . . .\..   .  . *\. \** ** . .*..  #
#* \. ..** **  . . .\.  *.\. .\.*..*\.\ * #
#. .\ .* F\*\*. .\  ..*\.\ ..\. *. ...* ! #
#  . \.* .\.....  .*.\...* **** \ * \**.. #
# \..  * \.* ...\.*.  *.   .\... *\ ..*\*\#
#  \ . . **\* **!*.\ *.*** ......* . \* .*#
#\*...*...*\  .  *. .. .**. \.. \\ *..**\*#
#.  *.**\ *  * **. .*.. .*.. *...* *... **#
#** \...    ..! \.\ * * *.*. *.  .*. *.*..#
#*\ . *   .**\  .  *. \ .**.  \.*.*!**  . #
#\*! .*. .*.. .**...* ...... \.\.\*. . .*.#
#*.**\. . ...\ .\*\...*.\* *\. . ....\\ * #
#*  ... ... * .!...   . .* *!    **.  * .*#
#**\ ..\.*@ . ..  * . .*..\.\ .  **\. .  *#
#.... ..\.*.\**.  *4\\* .*.** . .\.**\ ...#
#\ *\* \ \*..*.. .\ . ..*.  ** .*..**...*.#
#  . *. ..*\\.\  .*  .... *..*. .* *.*.** #
#..*...  .*. \*  .!.. **.  ..****. **...* #
#. . \.   .\*\ .*.  *@.\. ..\* .\. .**  . #
# .\..\. .*..* * * *.\ ...**.. *.* **.* . #
#. \.**..*.\*..**\ .* * .....*\.** *\*.*..#
#\\ .*.* .**.  ..\ \..  \.\. ..  .*!.\....#
#.   ...\ ....\ \*..\.*  *. .. . *.. .*   #
#*.. ...*\*. \*\. *. *\* ... \*\*** *\\.*\#
#..\ *....*.\ .  *.. * .*.  \..*. **.*. ..#
#.** \..\.**.\  ** . .. ..  \ @  .*..*.  *#
#. .  **. .... \..*  . * . *. \ ......\.. #
#**\.*.. ..@\ ..\**.*..*.\*.\ .. *.  C. \.#
#    .  *  ..* *. \.**. . .... \.*  \ .  \#
#  ..*  *. . .\.**..\. \  .  . *\* \  ..\.#
#\  *. .*.\   *...**.*\!*.. **..... * .\..#
#.\*..*.. W* \. 7.*.\*.\.*  * \*.. \  ... #
#  \...* ..* .  * .* ** .* ..  .!!.   \ . #
#\ ..*\..... *\ .***\..\..\. .\.\ .. ..\. #
#.*.\*.\\ \ .. *.*.*!.** **.\...*. \  .   #
#  \*..  .**. .\..**   ..\. *.. ...\* ....#
#*  *..  .*...@..**.  * ..  .*  ... .\. \.#
#. *@**. ..** *.**.\. * .\.  *..    .*.  .#
#\.**.. . W.* .** ..  \\ ..\\...*.\* . \**#
# \* **. \.*. **!  .  *\.  *.**** ...  .@.#
# .* * .. \*. ...  ..\  *  .*\*.*\*   * . #
#**..**\.*.*\.   .   .. .\*. .  *..*. .!*\#
#*.\ ..*\* ...  *\* \..*.**@.. *....  .**.#
# * *\.. ..  * *\ ..  .  \.... \ .. \* ...#
#.*\***.. ..\. .    !. .\. .  ..*\ ... \. #
#...  . * .*.. *\..*\ *.. * *..*  \  * ...#
#.*. ..\..\ *  ..*\... *\ .*..\  *. .* . .#
#\* \  ** . * *.*.. .. *..   *.\. .\ *\. *#
#.*\....  *.\. *\.\. *.. . * *  ...  .** *#
#.*   *.  ..*\.**\. **. ...\  \.* \ * .* .#
# .** .W.   \* !... .     \* .** .. . ..\.#
#\*\*.\. ..@* *.   .*...*. .* .\\..\*..  .#
#.\* .*\ ..**.*\\ \.. .\.  . . *. @....* *#
#*..\.**W  . .. *\..\\* \. .*\... ..  \. *#
#* . **..\**.. \* .\**\ .\!\...   .*...  .#
#.\. *.  *. ..*.* ..*..  .\. .* \*\.\. *..#
#.\ **. \.\.*** ..  . .*\.*. .*\..\   \*..#
#\*W\\ * *.**.. \ ..*.. ...*. *. .*.*\... #
#*.\.* . .*\.   . ..*\..\ \.  \.  .@\**\*\#
# .    * . \ .*\ *  *.  * . . .*\. .*.\.  #
# .  .\.\  .* *  .*..* .*   . ....\ * .** #
#   ..*. .* .*.*R\.\*.  .**.\*\.**.*....  #
#E*  *. . .**  ..* .*.  \..**. **.\.. **.*#
#.* ... ..*.**\ \.  . * \*\.** \. *...*.\.#
#*1 *..\*  *\.  . *..** .*.. *..* *.\ * **#
#*.* **\....\\. \!*.  . *.. \*. * .  .*..*#
#*.*. .\  .\  . ..*. . .** . ..*. *  * *.*#
#*.W\.* .   ..  * ..* . \..  .\.*.  \* \ .#
#\.\.  @  \  .*.\* ..\...   .   \*\ *.*.**#
#  .* ** *. .**  .\ \ *.. *\.\ * .  \.*...#
# .*. . *.**.\. .\...** \..\ \ ...\\... \.#
#*  \.*.* .. .   . .\...  .* \. *  *...  \#
#.*.  . * . .\.  ...* .\.\.\ .*\..  ** *..#
#.*  **\.  **  .* .\.. .*.* .\. * ....* \.#
# ..*.... *. *\ \. .*   .*. ..* *\\*\.*.* #
# **.....\. ..*@!.\ \* \ **  ..\...\. . . #
#. . ** \*.\  ** *.. W. *.. \ \*.  .   * *#
#* . .*.*.\ \.*\ \.*.*\.*  .   .*.*. . . .#
#.. . \ .\.*.... ... .*. ..* * .. \ *..*\*#
#.*.. *. .**.*.\ *\  *. .. ... .\.*.**\..\#
#\..\\*\.*....   .* ..\   *.\\ *.\. ...\*.#
#     ..**.\   \..  .\ \\.*.*... .\ . *  .#
#**  \\.   ..*....  ..  \.*.  .*!\.  . . \#
#.   . *\..* D  \*.... \.*..    ..\     . #
# .\.. * *  ..!. . *  *.*. !\.@\ ...****.*#
#   ...* *. * *.*..*.*.. \.. \  \.*. .*.**#
#. **\*....\.* ..\*\ ..*  . . . .\.**.....#
#*......*.\..   *..* . *\*\ .**.* ..\*..* #
#\  .\.**\  . . *. . \.*.. \.. *.\. ***  .#
#*. ...@*  ..\ .\. *...* **  ....\  ....\*#
#. . ....!! ..*\** * *.. .  \*\ * *.*\*...#
#.*.*\ *...\ ..  \ \* .\*\* . ..@.*..\. **#
#*.  ...  ..*\ **  ...\ *..\ \ .\* \ .  *\#
#****.*..  *.. .  .  * \ .*... . **. * ####
#\*.**\ \\. *..*\.**.. *   * ..*\..  *.* .#
# ..***\ \.\.\..*..... *.**. .\.*\ .**..\ #
#. ..    ...  * ..*\.\  . ***  . !\ .*. *.#
#\\ \.* .*\.\*.  * . .. .**.. *.*##.**\*.*#
#. * .#**..#.*# .  .* .\. . .***.*\\\..*###
#  .  \..  #\.. ..\ #...\  ...#* *.**..\.*#
#\\*\*   .* . *\.*..#.*.  ****  ..#*.. .# #
####*#\.\ *\*.##...*..*.\ ...\ \.\.##.##\*#
#   ##.. \.#. #@\\#* *. \ \  ...*.*# #  ###
#     #\*...# ### \*   .*. #.   .*.*#     #
#      #.\ # #   ####L#.##.\....*##.\#    #
#       #*\.#          # .\. *\##  ##     #
#      #* ##            ##** ****#        #
#       ##                ## .W\.#        #
#                           # #*\#        #
#                            #\*\ #       #
#                             ###.#       #
###########################################

Water 0
Flooding 0
Waterproof 2
Razors 24
Growth 21
Trampoline A targets 1
Trampoline C targets 7
Trampoline B targets 9
Trampoline E targets 9
Trampoline D targets 4
Trampoline G targets 9
Trampoline F targets 7