#########################################################################################################################################################################
#\.* .  . ..\..\..*\**.**. ..\\. *.  .  . .  .*  .\.*. *..!* .\*...* . *. .*\* .\.\* ..*..** ..\** \*.. ....***..\.\ *.  .\  ...**  * .\.@.*..*   ..\*  .*.   .* #      #
#.   .* * .  * .     . .. \  *.* .* . .. .. * .     * ..* .* .*..**\*.\.\  .*.  ... *.... **  *..\..*...\\..*.. ** *...    \\..*.. .*.*  .*..\. .@*\.*   *...**.  ### # #
#\  .\.*** .**.*.  \*\\.\.. **.*\W*  **\ .. .*  .. .\.***\ . ..\ **..*..* **!\.*.**..!\*9\*..\...\*...*.. \ .\..  .***.\***.\.. *\.\.***..*...* .*  *\\\*... *.*\ .**#.##
# ***  ... ..*..\ \  . \***.. *\... ..**.\ **\*   * *...\*** \.*..*\ * \* \..*..*.  .\. .\.\. \***..*...  . \...*\.**. ...... . \ ***.**.*\ .\*\.* *  .*.\*. ..\.* .. \##
#!.\. .  \. \.*.\*.    .\.... \  *.  ***.  *...\*.. ..* **\. \....... ..*.. ... .*.***  \  *... *..**\*. *\.\.\... .*.**  ... * **!.\. .  .\ .. *.\. ...* .  ... *.L### #
#   ...* . *.**\**....*    . @ \..\.*.** \ . .*.\..\\.. *\.   * . ..\ \*..\.\. \ .!* *.*!.*..** . \..  ..**.*. **.. *. .*..\*..* . . \....\   **\   \..*\   \*** ...# # #
#\ .. .* \ \ .\..\*\* *..*.* .** *...**.* *. . . ...*. .\ . ***.  . * ...*. .*  \ \*..*.\ . \\ .... \.*. *...\\...\*...*.* .\****  .  *.\.****.. \**..\.*.W.\*..\ \ ##*##
# . .\.\**..   . .\..\*.\.... *. . *..\.\*.\ *\.  . ***\. . . .\*. **    *\**  ....\..* .*   .\* *\   . *\.. . \\ ...\***\.  *.**  \ \* **..\. .\..\ .*\.  ..*#. \.**\*.#
#* ..  ... \.  \.*... .. \*.  *  .\*** .   ...   \  .*! .*.   **.*\.\  . @. *\. *.... ...\ .@**.\. .**.**. \*\..\.. *...**\ .****.  \*..** .\..\.*.W. .! A.. .. ..*######
#.......*..\*  .\. . *.*.\  *..   .\.\.\*.*\.. .** .**.*\.  .\..\**\.*\\. .*..*\..*.* . ..  !..* \**\.**.*  *  . . .****..\.\\*. .  .**\..\*.* ..* .*.  ***\.*.* .*#* # #
# \.  .* * @..**.. . . .\.  *\..   *.   *\***  **.   .*.. \ ...\..** * *** .\ ....  .*..\.    *  *.*. .\.....\ * * \****. \ .*\*  **.\. *\*. . ..   * *..\.. .\.  .##*# #
#*\  .\* ..* \*.. . **.\ .\\..\  .\..\ *.\.\\* \*...  ... . **..  .. .....\. .**\.!*   ..*\...*\*\** .* **. *  .*. .** . .* ... .  \.*\ . ....* ..  \ ..*  .  . \.*\. *##
#...\\.*.  \.*\. .\*.**  . * \  ...**.*\.**.*. ....\*.***.\\..** \*\   .  .\  .* *.* \.* * * .* *.\. *... .\* ..*\.*\     .**. ..*   *.*\... \. \.*  ..** **   *  *. ## #
#  . .  . ***\**. *.*.\* * * * * \ ** .. *... . .\.. \..  . .\..  !  .   .\*\.*. \*\  *\ . ..\*   *. .    \..  **.  ..  *. .\*.  . .*...*  \.*...\\ \.* . *\. . \  .#   #
#\* *\!* **\.*.*\   . .***..** *. ..**  .\.\*. **@     *\*\  *..  ..* *.  ...\* *  \.\. .   . @ \*** *.*\* ..**.\*....**.\\.* *\... *  *.  . ..\ .. . . . .*..\.. \##   #
#*!  . .**.*.. .*.* .*...!*!**   ....*..  *\.\ ..* \.\* ......*\*.*   *..  .****. *.\ .\  @.*..* ..*\*.* .\*.\ * *\** *\..\..*..*   . ..*.**  \! . .\... .\..\*..R. \#  #
#**.\ \**.*.*..   ..*\ *\.. \.*.**.. . ..*...*. **\  **... . \. ***. .*. .*.. *..\... \. \.\ .\..*\* *\. *..  .* .*   *..*\.**.*.*\. \.*\ *. .*  .\.*. *  *.*.*. **\#   #
#########################################################################################################################################################################

Water 0
Flooding 0
Waterproof 2
Razors 39
Growth 36
Trampoline A targets 9