#############################################
#     #. # ***..\.\.*.*\*.* ...*\.*\*.! .. .#
#    ## *.##... .   *.*. \.* * . .*.  .\*\.\#
#   #\ .## *\.** *\ !\. .  . ...*    \     ##
# ####* # ##.*.. .. \ ...*.  * *.*\\. . *\.\#
##****. .\.. .\  ....*\ \***..\****..  \  . #
#*...#. **..*. .\ \**\.. . . . \*\. *.....\ #
### . .\ *........ .. \.. \ *\ ...\... ! \..#
#  #.  **.\*  . * \**. . **\  \.. @  .\**..*#
# L\.*\.** .  * . **.*.\ * \       .. ..*\..#
#  #.*###*  ..*. \..*\*....  *\\. *.  ... .\#
#  #R..# #  .    .* .*.*\.\ *!. . . \**\  \.#
#  #.\# #*.. *.*..*\..*. .. .   \. *..@ *\ *#
#  #\#  #*\ *. @ ****..\ *  ..  *...*.  *. .#
#############################################

Water 4
Flooding 3
Waterproof 4
Razors 9
Growth 31
