###########
#    L.#  #
#    # .# #
#   ###*# #
# ##\ ...##
##.#....# #
# .\**. *##
#\.*.*.*#.#
#*.\..*\..#
#**** . R #
#*. ..  \ #
#.\.*\.. *#
# .*\*** .#
#\*.#.**. #
# . .\\*.\#
#.*..\....#
#*\*.... \#
#**.\.. \ #
#*.*@.  .*#
#. ..*..*\#
#.\..* .. #
# ...*\..*#
#*\..*... #
#*\\... ..#
#....\. \*#
#* **     #
#**..* * *#
#. * * * .#
#*  *\ * .#
# \ .**** #
#...\*.\**#
#.\  . ...#
#.*.* .*\ #
#..\*** .*#
#  **..   #
#\*.\.  \*#
#. ..  ...#
#  ..\\*\*#
# .....\.*#
#* *...  .#
#* .\**.* #
#*   ..* .#
#* ...\*\ #
###########

Water 30
Flooding 8
Waterproof 17
Razors 8
Growth 33
