#############################################
#         ###.##                            #
#       ##\ **\*## ##       #               #
#   ####..  *##.#.#  #     #*###            #
# ##***   #*..# . .*.# # ##.*.. #           #
## ###.\. *. ..\..\.  #*#..#*.*.#           #
## #  #.* .#*.  *#.  .#..\. .*.\ #          #
##. ###\.*.*. * *... . ....#\ .  \L         #
##*#\ ##.****...*. \   * @.*..  *#          #
# \.# .* \...*  *...*  . .\  #  ##          #
#  \#\.  .\...  .* * @ *   .*..  W#         #
#*\...   **..\\ ..   \.!. *.*\ **\ ## #     #
#..*#. *.....*.\..\.*\. * *.\.#.\  *.#.#    #
#. .*..\  \.\. *\  .* . * . . . .!\*##\.#   #
#..\* \#  .* .W. .\*....\*\. . .   ..\.#    #
#   .. *.\.\*\       *.    . .. .*..\.  #   #
#. \ .*. .\.* .   ..* \.      *#\.. .\  #   #
#..*.*.. *  *     .\   ****\. . \*#    ##   #
#*\*.\ . .  . \* *  ..\**!\    .*..*.. . #  #
#...**@\. \* ... . .*\*\ ..* **.* ..#.##\#  #
#\.\..\.\ .*@*...   *.... \..*\..* .*.@# #  #
#*..  .\ .   \*\*  \ *.\*...*..**  ..#\.\.# #
#.. .   *** . .* .. .** . .. *.  .*.*#..#  ##
#..* . *..*.*....*..*. \*\\. ! .. ..\# .* ###
#.\.* .* *..\*..*** .\ *.*.\...   .\.*#\. #.#
#. \.\ *  . .. ...*\*. * ...*.\.\*\*.#.   ..#
#..*\*\**\ . ...  . .* .\*..*..*. .* . .** .#
# .\*\.\... *\  .\. *. \.  .\.\.. ..\.\.\#\##
#** ..\.. \...* \*..\...*** *.@ .. **.\. *###
#\*.* *. *.*.   W..*.*.*\.. .\.  \..\..\..*.#
#*. *\**..*\ .**........*. \.  * .\   *.\*. #
#*... \   .** *. W.  .. *.  .*\.**\*...*.!.*#
#\.  *.* @.*. **.... \* \W.**..* .. \ *\.*..#
# *  .*....*..\.  * * .  *\**..\..**. ***.* #
#\.  ..*\. *  *\* .*\ * ..* ...    ..\ *. . #
#\ *.  .** .  * *\..* .\    \ *\   . .*. \.*#
#...*\ *.*\ *@. \.*\ .**\** *.. \* .* .*\.\.#
#*\*. *  .. \* \.*.\\***.**..  \. *...*.* *.#
#\... **..  ...* *\W \.*\** * *...*..  ....*#
#! \  .*** .W *..\ .\ \ ... . . \  \.\.. *..#
#\ ..*.\*.  *.\\*. ... \.*. ..\*.*\. ..*\..*#
# ..***.   *    .* ..\ .*. * * . * \. * . *.#
# *.*. .\** .\**.*\  . *.\ \ ..*.. .\.. ....#
#.\..   . . *   ...  *   \... .  .\**...@ ..#
#...\ ** .....  ..*.*.\ . *.\.** \ .\*.\.  .#
#\.\*.** \*** \.\ . \*..  \ *\ .*.*\..*\ .. #
#..**. .... . ..***....  .. ** *. *..***\. *#
#. .*!. .\*\.*\*..... \ .  ..\*....*..\.\*\.#
#*  .\*** .. ***.\ \* ..\ . .  \.. \.*. *. .#
#\   .*.*\ **..*..*\*\*  ..\\ *.\**\ . .\.*\#
#..*. . . .\ \*\.*.....* .... \...... *...*.#
# .*\. .!**. .*.   \  .@  *.*..\*. \* @..\*.#
#... \**\*.*... .\* . .**..\.  .\*\ .\.*.*..#
#.*\ ..\*. *.  *..  ****.\@*\. * **  **\ ! \#
#\.   . !\*. .*.. \....  ...*\*  *...!..@  .#
#** *. ..\..*\*.\...! ..\  \\.. .\.*. *\.* *#
#\.\.*..\*..!*..   *\ * *. ...\.   .. .*@*\*#
#* .\.* ..  . *\..**.\*\....* ...\. \.  ...\#
#. .* .*.@\ ...@.\.**.\. .\..*   ..*.* .  ..#
# ...* ..*.  .*!.. .. **\.*\ . . .*...   .* #
#\ \ * *\ .  .. \\*\.. .  *. .* *...  *.\ . #
#* \!  .*.* .**.\..  . *...*.\\ *\ *\ ...\\ #
#. .. . .......** . \ .*.**...... **....* \.#
#\\ * .......*.\\. .  ..\*@ *...  .* .\\*.. #
#.. .\**\\. ..  * \..* .*. ..** \*.\  . . \*#
#  ** *\**\ *\* ... .   *\.... .. \.\*.*....#
#  \.  . \. @.*.\ \ *   .  .. .*\ ..* .**.  #
# *  *...!\* .**  .*.... .  ..*. . \..\ .. *#
# ..*.\ .*.*....*** \*..\\ \*\.*.*     . @ .#
#*  . * .\..*.....  . ...  ...\*.. \*.. .!..#
#* .**..*  *\\**.**..\* .*\** ..** ..*! .*. #
#\ *..\.. *  .\ *. .. .@.. .*.  ..\ **\.*...#
#.... *. .*\.  *.\  .  .\*\..*.**.*\..* .. .#
#*.. \.*   *. \ .. .\. \.. \ . .* . .*.\ * .#
#.* . **\.\*** \*\.\.. ..\...  .. .\*.   ..\#
#. .**.!*..\*\***.. *.**.**\.* *.*. ..**.\**#
#....\ .\.. \ .**..*..... ..   *.*..*.. ..\##
#   .  ..  *\. .\ *.*.\ *..* ...*.!*.**\\...#
#  .*.**..*.. *. **\.\*  .   .*\. ! . \ *\ *#
#\..  .. *. .***.** ... \*  *...*.\   .#. .\#
#  \***. . ..*\..\.*... .  * \ \.\ .\  . *. #
#*. .... * . .**\**.\  * ... . ***   \*. *.##
#.. ..  *..*. ....*.  .**. \.  .*.*  .*..  .#
# .. \  . \ \  \  ..   \*. . \*  \.  .. . *.#
#.\.\  ... * .  ..*\**\ *..*....**  *...\ .*#
#\.*\ \ *\.*   \. *..*\ .. ..* \\\  ..*.# .\#
#...* . ..\. *.. .*.  . .\. .**. \ \\...  * #
#\ .**..*. \..**\ .  ..*  . *.  .#*.. .\ *. #
#*  .*.*.\  *.**.! \ *\. *  ..*.\*. * *.*.\ #
#.*\.. *..*.* .\.. .**.     .\.  * *. *\! #.#
# .    ..\.\.\ *.**.**. \..\ *..#.. *\#**  \#
#*\ *..  . .... *\** ....  ... \## \.##**####
#*...  \.*..   ***\* .. #.\   *.*#*##  ##   #
#. .\. . .*.   . . ..\*..\* ...## #         #
# * . ...*\  **.\*  *...\ .\  .#            #
# \ .** R\*\ ... *  . \ . #. ##             #
#\.*. .   \  *   .  .\.*\.*#.. #            #
#...  .  *.. \***\*.   ...*\  *#            #
#*.  . .** *  *.  .\.*\* .. #*#             #
#** *\* *.*.* *\.  * ..*..  ##              #
#############################################

Water 0
Flooding 0
Waterproof 19
Razors 40
Growth 30
