##################
#  #.*. *. ..*. .#
#  #.* # .\ .***.#
# ##\...\****\ \\#
##\.  *.*...* * *#
# ## .* .*..  ...#
# # ###*R.. *.\  #
## #**. * ..   **#
##. ####..*. ****#
### #* . ..*..**.#
#\  \*  ..*..*...#
#L###**.**. .*. .#
#    #. *.*.*.*..#
#    #* .*.# *\.*#
##################

Water 5
Flooding 11
Waterproof 13
Razors 4
Growth 17
