############
#   #* #   #
# #  #\ #  #
##*##\ . # #
##..* ###  #
#..*\...\# #
#* ..# L # #
#R\.** .*.##
#\.. . ..*##
#**..  .\# #
#*.## .**.##
#\ ..  *.###
#*###.#*@.\#
#.# #.\.*.##
#\#  #...# #
############

Water 9
Flooding 19
Waterproof 14
Razors 40
Growth 47
