###############################################################################################
#         #*...W. . . *\ .. ** .\ *.*... . .*.\ *.\. .  ... **  .*  .  *..... .\  ..*..  !* * #
#          #**\*** * @* \*..*..\ *.. *. \*.**\... @..  \*  .*\.. .*.*  .\..  *..*..\ \  .@.*. #
#         #... **. *\.. . \....* .. ..\.. \. *   ....\ ***...   ... ..**..\ \* \.. *.... .\*.\#
#        # ##..\#.*. \.*..\*    .   **... . .\\......*.\...*** .\*.\. *  .*...** *2\.. .*\..\*#
#       #*# . ...\#*\ ... W\   ..F.**** . ..\*   * * *\. . *.. . .\ \ *** .. **\\. . .  . .*..#
#      #..@.**.... *..** ** .   *\. *.\*..*..* \.\ \**.\   .*\.\ .  ..* *\. @. .*\...... .* ..#
#       ### #\....\\  .  \.\  *.\   *  *\.\..\.\ \..*. \. \ ... .  .** ...... \*..  \ .. \..6 #
#          #* \ \.  \.\.. * . . .*..***..\ *   * .*.\.\  *  \ *.*.**\..  ***. ..  D*..\. . ***#
#         #..***. \. ***.  \\..\*..*..\*.\ *.*...*.\.@*\..*. .. ***\...  **.\ . .*\* ..  \  .*#
#         #\*.\*.... *\   . . *.**G****\. ..  **** .* ..\....*. .B.  \ ...@  * .*.*.*.\  .. ..#
#        ##.*\****.. .. .***\\.@\* ... ...  *.W*. .  .\** \... **.. ..  **\.\!.*..\.* .\..*. *#
#      ##....@\...... ** ...* *\.*. \.. ..  * *.*..    .\ ***..*...  . ***..* .\... \*.\ ...**#
#     #*  \\..   *\*\ ..*\*..  *\.. .* . ..\. \.... @   . ..*. *! . .**.\.\\.* **\*  .. .  \..#
#    ##. *.*.*. ..    .... \..*\.*. *E  .* . *..\*.*.*  \.\. ..*   \...* \ **\...*.\* .  *.*.*#
#   #**  **.* * ...*...\.*\ *\   ..\...  **...* .**. . *..\* ..*\.  *@**.. ..  .*.\...\ * ..\*#
#  # #.*\\. \ ...\! \*.**. .... **\. .*  .*.\ *. ..\  ...\. \ .\. .*..\.*. * .\ *\. \** .\ ...#
###.##..   !.* .*.* .*. *  .**.\W .  *.*\*... **..\.**.\... *..**.\*. . ...\ *.. **. *. \  .  #
#.*.\.\  *...*\*.*W*\.***\  \* . *  ...* *   \* **.*..*.\.. ..!\. .. .. . \. **. *.*R.   . **.#
##*#**.**. .\.* .\ \*   ..\*.* ..\   \ .... ...*\ ..  *. \W\* \*\.*.  \  .  ...  *  \*   *...\#
# #**#.*\* .. \ .*. ..*\ **.\*@... \.. *.*... @\. *@!.\  .**\...  ..**!*\ .   \  ... .  .\..\.#
#  ###\*\. *. .. @.\ *.* *. !* . **.* \*.* .. ..\.**\ .  *.. *\.A.\ .. . .  ...  .*! .**\ ...@#
#   #*.\. \#* . .  *\.* *..\ \  *\.*.\.**.    \  \*.    .\.\.\ . \.*  * . .  .   .\*  ..* * .*#
#    ##.#. * !  *..  *..**  . *\ .\.* \ .**  **.*..\* .* . .\.*   *.\** @. ..*...\ ! ...* ..*.#
#     #**....\  ! .*. \ .  *\ . ..*.. ...\ \.*\ \. *.\.* .\  *.C\ .**.. @* . **.  .\*.*** .* *#
#      #.**..*.**\.  *.. . *..   *\...  . *. .\ *\ ***..* \..*   . * *  .*.\ \. \....\.\.\..**#
#     #.*\*.\*\!. .\.. *  *.*\ 5\.*.  ...*\\.\.. . ..** ...\..  .. * *.*\..\ !. .*** **..... *#
#      ###.    .**\**..  \*.*.**\*.  .** ...* .***..**\.***..\  .\ .*\   .... \  *\!\.\@**\ *.#
#         #*. \ ..**\..  @.*\.... .\   \ \..* .\*\ ...*.*.\.*..*.\* * *\ .. *.!@ *.*.  . .. *\#
#         #*  .**.*.. \ \..*. * .\** **.\   . ... ...\. \  @.    .*.\**...*..*.**   . **  . . #
#          #  .*. .*\...#*..7*!*  ..\*.\..   ..* *..\*\..**\*  . *.\ *..*. \... \. *   * .** *#
#          #*L#.\  ...\...**.\ .\****.\.* . .\ .W *** ..*\. *.\ .* .*\* . ***   \ ..*  \ \.*  #
#          # ##..# .  .\ \... *\\*.** *...*\ * \ .\..*.*\. \*\*  \*. .. * .**.\   *. .\.\* ..*#
#           ##.*\ \*......*   .**\ \.*.\   * .  .**. **.. *!.**  ..  ...*.!.\ ..\ . * * *.  ..#
#            #.. .... * \ ... .\.*.*** .*...* ..    .\* .... **  .\. *\\\ \\..* . * .\*\*    .#
#           ##*...\.* **.*.  ... ...*. \. *\.. ...*...*.** . *.*\ ..... ... *     * *.*..*. *.#
#          #*#\.* . *!*. *  * ***  *   \  \.\*\  \*\.*.\*.\ \.\..*.*\ **    . .*.*\ ..** .\ ..#
#          #...*    .\.  \ .* **\\*  \ \. .\* .  \.* **.**!..   **.. \ .!.  .* \.  . *\.* *..\#
#          #.*\*#.....  ... * **. \.\\ . .\*\ ....   .**.* ..\* .\ * .*          .*...* \**.. #
#           ##  ..*  \ *.* * .... .*. . .      \.\ . *\..\.\**.. *...\! * **.  **\. . *   ...\#
#            #\*#\ \..   *\.     * *.     *.  .\. **. .* . *\...*.* . .*..*.\.*..\  * .\!\ \**#
#            #.#.   #\. * #. .*..\ \..  . *..  .. *.. \. **.  *.*\.\\. \*\. \*. \ * . \.\ .!*.#
#             # \.#.....*\** *.\* \...* * .** .   .*\ .**...* .\.* \.  ...*..* ** ..*. \* * *.#
#             #*.*.. .**\. .   ** .....**....**\*\.*.\*.*\.\@. ...*\* .**.**\ **... **\.. .\.\#
###############################################################################################

Water 0
Flooding 0
Waterproof 3
Razors 49
Growth 25
Trampoline A targets 5
Trampoline C targets 2
Trampoline B targets 7
Trampoline E targets 5
Trampoline D targets 7
Trampoline G targets 6
Trampoline F targets 2