#############################
#            # #            #
#            #\.#    ##     #
#   # #    ##  #    #**#    #
# ##\# #  #\#*#   ###**##   #
## .\. *##\.\.\L##*\#* .\#  #
#.#    ##\##.     \* *.###  #
#*  \ \#\ #  *. #.#..* \#*# #
#. *..#.@ #****\   * ** ...##
#*....* * \*...*. *. . .*#.##
# .#  \#. . !..\* *#\..\  ..#
#... \.  . *\ \**.*. *...#.##
#** .. .  . ** .\. ..***# \ #
#.\. * .   @\*  .*W. ... *  #
#\ .* .**. *.\  .\ \\.. \.*.#
#.* \... *.\. .\* .*  *....\#
#\. . \  *** * *. *\  \* * *#
#..\. *.*. * .. ..*.\ ...\\.#
#. . . .** . .. . \**\.... *#
#\.**.  .\. \.. *.*..*\*\.\.#
#* ..* . . ..*@ . .. \.\.**\#
#.!  * \ *.**.*\  *  .\.*.#.#
#\.  . . ......*\.. *.**.R\.#
#****.*\*\ \.**.*  \. ..\ .\#
#*.***. \.  \*  . **.* .. \*#
#.  ..**  **\.\.* .. . \* ..#
#. \  ..*\.....\* .\.\. \.. #
#.\* *. .*.** ..\\ *\   . \ #
#*\  .   .\.*.!  ...   * ...#
#. ***!*...*.** *...   ..* .#
#*.\.\ \.. *.* *.. ..  \*\*.#
#..*.\ \ \...\ **..*\.*.* ..#
#W*  .. \* * ..*\ ..*..** *.#
#\*.\*. *.\*\* ...* .. .\  .#
#  \.\ \ .  ..*.*...  .  \. #
#.*.***..  .. ***.\*  ......#
#\.. .\ . .. ...*  *.*\ .*\\#
#. *.\.*  .\**\ ...  .  *   #
#\ @**.**! *.. . * .. . . *\#
#. . . ... * ....  .  **. ..#
#*.*** \ . *\*\.  .\!..*\*.*#
#  \...* ..\*.* .  ..\.....*#
# ... *. * ...  .  .\.......#
#.\ \\* . ..\..**. .\**\\*  #
#*.*. ..\.  *  *\    .. .*.\#
#**** . .** . \. * ...\ *\ .#
#....\..  .!...! ... ***.* *#
#\  .. ..  ...\... * \ .\...#
# *...@ .* .\* *\.\  .\  *.\#
#..*. .*** .*. ..* \ \.  * .#
# ..*\...\. \. \ .....  . ..#
#. *. \ ..\ . ...*.!\... .  #
#\.\..\.   \ @ * .\ .  .\**.#
#*...**.\...\.\. \ *..\. ..*#
# * . . *. ....   . .\ \   *#
#@ .!\ *. .\.*. @\ *...**.*.#
#.** \ \   .*.\ .*. *  .*. .#
#############################

Water 52
Flooding 6
Waterproof 2
Razors 49
Growth 27
