##############################################################################
# *. .\ *4 *.   \. *..... \  .!\ ....\** ** \..*****..#*.\#*## #\##          #
#*... \.  *\\  ..**.\\ . . *\.. *.\* *.  \* . \..*.*. .**. .#*@#...#         #
# \*\  \ ..\*.**..\*..*.. .. \..**** * .*.\ ...* .\...\ W . \*.  !*#         #
#\.. \..*.\*  ***\.*\ ... *\ ..\ .\.  ......*..*.  * * ..*  .\.. .#*#        #
# .*.. ..* . . ..*.\**   *..  \ ...*  * *\..*\.. ...*..  ..  *.\ . .#        #
#.*.  ! ...*\.  \*. *.  **.\* .* *.*.*  * . ..\. * ** .. ..\.#\#\.##         #
#.*.\*. *\\\*\\...***  .G.  . * .@...*.... \ *  . \..  \ . . * ..#*#         #
# * .*\.*\* *..** . \ * .\    .  *\*    * \. *.. ****\..  *\.. *.#.\#        #
#*... ..\\....\.**..* *......*\.* .*...*.\.. \**.....\  .... ! . ..#*####    #
#.\.\....\ .. .\** *.\*.*  *.*.**  * ... . .  *.*..\    .F \  .\.#* .**. #   #
# .**..*** W\ ...*  \\*.  .*..\ . .\  ..  .*.@. .*** \\ \.*\.\ \. *.** *#    #
#.*..*..*  *  * \* *..\.\\.*..... \. * ... *..\ \..* .* ..\.   .*** ..##     #
#*.. .*....\. .  *\.\. **.!.    ...***.   ** *\****\. ...\* ** .*.* * *#     #
#....*.**\@. *...*..  ..\.*\\.*. .*..* .*.** \@.....*..\ !..\. .* \ *. .#    #
# \* **.*..... .R***.  W . . \*\ !**. **\ *.  .  @...\ .. .   .\. .*. *#     #
#\.*.**..   .. *.\.\..   * *\.   *.***..*\. .*.* **..*..  .*@.*.* ##*\.#     #
#..\ \.*  .  *..** *5 ..*.*. ** \  .*.   ... ... *.\ * * .\..#.* ..*# #      #
#  ..\ .*..* .*  .\. \\ .*\.\*\*.** . .*\..A\*..** ..\   .  . **.*** #       #
#**. .. **.* \* ...  ..\   \.\ **..**\..*\*\. .\*. **.**\  ..*\.\.\.### #    #
#C*\.*...... .  . * .\...*.. .\.@.\.* *\..\.\* *.@*..**..*\ \\. #... *\#.#   #
#***\*. **  ..    .  *.  \.  \  ... \ *.\. ***\..*.. .. ...\..* .\\   *#\##  #
#*@.  ..\*. @.. \ .**\*.***.. *  \..*..*.. .*\....*. *\...  \ *  \ .\ .**.*# #
#.*. \.\..**.\.  .\... **..**  .\.** ...\*. .* *. .* ...\..  .*\\. *.   ###  #
# *  .**  ....... * \  ..\ **     ..   .. . *.\.***.\*\*.@. *.*\ *..*  * #   #
#\***.**\*  ..   **  .*. ** .. .* ** \ \. .\. *\***. . ...\..\. \*..\. #. #  #
#*** **.\. *\\ ....* ..* *.  \ .. .* * ..**.\ \*\.@ *  .. *\.\*6   *.  *## ###
#.**\\..  ** *\  **   .* **. .*\.*.*..\.***. .*\**..\\..\...* . \ **. ##.##.\#
#*..  \ . . . .**\.  .  !\.\.\\.. ..*\**\.. .** ..**. *.  *. .  .*. . *. *. ##
# . .***** * ** * ***\*..**.* ..\*  .*.  . *.*!\ **.. .* ..  ..*..** ..  .#.##
#.  . ..*\..\.  .**.**..*.\ .  ...\* .. *\....****.\   *..   ..\ .*\.@ ##*## #
#..!***. *\.D   ..\.**  .* .\. ** ..*.  .**.. .*.  .\. \* .\ *..*..*\.#  #   #
# ..***  .*. \.. .* .*...**.*..!*3  .. *..*  ..*.*\.. .B*..   ..  .* *.# #   #
# ..... * .@\.*\  *\..** *\... .@*.. .\  *  .\   \  \.**. .*  .....*.#.##.#  #
#.   ...\. \.\** *..   . . \ ....* *\.\ ..**  ...\ .. *.\\ . ! *. .* ...**#  #
#\ .  .  ..    .\. ** **.\ . **. .** \ .*.*. **\*@* .\... .  . . . .*..*#.*# #
#. * ..... * .\. ..\. *.\\*.. .*. *...\*.* \..\..*.   .*\...*  . . **\**  #  #
#\ .*\ *. \**.*.\*..*.*..\  .. .*.. . ** *...*.\****\. \ \*\**\ ..### ###.#  #
#. \.**.*.. . . *..**\*....    . \*.\\*\ *..\.\ *\...   ...\*. .**.# * # #   #
#.\   \...*  .* *\  . ..*\. ..* *.. ..... @\!.\\*.. .\  * *.  *.*.\*\*#  #   #
#\.!@ *\ .*.*.. .**    *...* \. *\..*  ....*   ..  \ ....\.\.\....   ####\#  #
#. . .* .***. *  .\.  ... ..    ..*.\*.  * .  *E . .**.**..*. *#   * . **.#  #
#\   \*  .*.. .\**....*.   *..\. ** .  *.  \  .\ @* \.**.  .# \*#\..**   #   #
#..  ..\  .\****.*   ..\. \.\ *...\..\ . * \*  .*\! .* *\**.#\ *   .#*##.L   #
#.  .**.\..*. **... .\.\.* *. .\**  \..***  .* *\ \**. . *\ \ \.  .*.**.#    #
#  .\..*.  \  .. ..*9...*\* ***..\\ *   \   ****.* *** ..*..#.#\..#*\.#\#    #
#\ *  .. .\ .* **\.*\ *..*.*... \*. .\ .. ...**\..\...   #*# #\.# * ...#     #
#\ ..**.*\..\..\. ... \ \..*...\ *.*  . .  * **.\.** \ .* *# # .#.##*.#      #
##############################################################################

Water 0
Flooding 0
Waterproof 0
Razors 12
Growth 4
Trampoline A targets 4
Trampoline C targets 9
Trampoline B targets 5
Trampoline E targets 4
Trampoline D targets 6
Trampoline G targets 9
Trampoline F targets 3