######################################################
#                   #\#   #                          #
#       ##          #*#### #     ##                  #
#  #   #* #    #L###.\*.\..# #  #*\#                 #
# #*# ##. ##  # * ..##** .  # ####* #   #  ##        #
##.*## ##** ##**... ..*.. \ #\ ..#.### # ## .###     #
## *##.##...* .\ ..\***#* . *. #*. # .##\# #\. \##   #
# #\#* \* *###*\.  **..\.  *#*# *.#\ *#\.####\###*## #
##   *. ..*\..****.*. \.\\.. .* .!*. .....\  .#\ ***##
##@.#  \.#**.*.* * ..*\ . .*. .*\.\  *..*   . #*.#\# #
# # ..    . ***. \ *.*.*.. *  .....* *  ..\  \ ** * ##
##.*.* \**  .*.*..*..\*.*. . @ .. ...* . *\.@. .*\.*\#
#**.\*.....   \.**... \ *.\  \.  .*\*.   .....  ..\.*#
#.*  .!   .\.*  .... \ . .! *   *\*#. ..***. .\  ..*.#
# \.*  . \** ***  \ *..*\  \. .* **  .\... ***.*  * \#
#.. *!  \. .\**..*. *.\\  * .  *  .  .*.. *.\#.. #.\ #
#* .*\*.... . .   .. .    .. \ . .  * ***\ . .. *. #*#
##* * .. . .*\.  !*\@ *  *. \.. \\ **..*.*..\.*... *\#
#\*\*.. ..  ... *.\.. *....\..\ .. .*. .\.\..*\.*. ..#
#..*..  *....\.** \   .. ** . ** *  .  **.   ..*\ *\.#
#  \**.\. *. .\.*..*..* **\ .***  .*\\.*.  .*  .**\.*#
#*\...   ...... *. \.\. *\ ....*\ ..** *\.\*.\\*. *\.#
#**.  .** **. *@.. ... .. *.*....**\.. \. ... \ .....#
#* * *... .*\** \ \.\.  . . *.*.*.\.*\**** *.\\**. *\#
# \..*.*.\ . **.. ...* * **.\.  ..  * ... *.  .*.*. *#
#\.* ...  .*.*.  \ ...\*...*.   .\ . ***  \  .\.*.  .#
#*  . *. . **.* .**.. .** .*.\* * \ *.*.  .\ *.  .. .#
#.\*.*...*.* ..\ ***.\ .*. . ..   . .. .\.*\ ** ....\#
#.!... .\*...*\  .*\@.**.* \.  \*..** ***\.*\.. ** \.#
# * .*\. .   * .\.. *** .*..  *.*.*.* *.*  .  ...*  \#
#\ .*. \ .\.... .. . \.*..*.    *.**..  !. .*** *....#
# \..\.* *.* **\..\\* *\*....*.  @!.. ..  \.... *. \ #
#!*..    \ ...\. .\  ...  *. \* . *\. .*\*.\.@.  ..\.#
#!. *  **\  . .  . ..*  *.  @ ..*.**\@...*.  .*  ....#
#. .*  **.\*@\*\.  ...** *.\  . \.* ** * .*.  *  \. .#
#\ \.@ . . . .*..*\   * .*  \.@\. .\. .*...\.*. . *.\#
#. .\.. \ *.\ **...\. . .**.\ .\.\***...\  *\.*.\*   #
#..\..*.*\.*  **.\.** .. .*. \... *....\. .* .. ..  .#
#..\ ...* \*..... .*     *\*\  .* *.!\  \. *.  ....* #
#..   *.\  *\. \ ... .* ..*\.***. .\* *..\.\ ..* ..* #
#\  ... .  *.\. .*\**\* . .. **** @ .\.*\**.*** .....#
#... .\.. \** .*   W*  .**\ \.*.. ....*.. ...\  .  . #
#.*.*. \*  .. *..*... \.. ..*.\. \*\ W.    .. . ***  #
#\\  ..* .  ...\ *.* .  \..****  .*. .\\ \.  *\* *.\.#
#.** *\** ..   **.** .*...\*..@....*\  \ \... ** . *.#
# *\. .\* . ...*.*.\.*!.\** *.\.  .... *..*** !* *.\*#
# .    .*    ****\ . ..\\.  ..*. .* \ \...*.\.  **\*\#
#\  .\*..  .... *..   .**  **!.! .\ . * ...   ..*....#
#*  ..\.. *  .*\  *\.\...\. . . . * .    .* .*\\.. *.#
#**. \  . ..\*.. ** ..*.. \.\ . ..   **. \.. ..*\*.*.#
#* * .*\*.\*. .\.\*.. .   .... *.*\ *...* *\.....**.\#
#.* ..*.\. .*  ***. *...**    *... .. *..*** *  *.*..#
#.*.....    *.   **\.\\ .*\ * . *.\ .  * ...\!. *.*..#
#..\  *\\.\.\\...*. *.\ *\ . ... ..**.@..   .\ \* * *#
#    *..  . *    ....*....   !\.  .*.*\  .\ .* ..\.  #
#*\ *.*  * ..*** .*  .\... .\ .**  ..*\ \.*\.!.*  ..\#
#.*..  .\   ...\ *..*****..  *. \.\.** .*.** \ ...*\.#
# ..  ..**.. . .... .. .\.  \..*.* *... *\ \ * \..* *#
#\ ..\*....\. .\  .    **.* .**..*...   *.....W .\.\.#
# ..\ *.\.*. \.. .   .*\*....\.. .. \\ *\   .. . ...*#
# \. \. . .\ .** *. *.....\.* ..*. ... \ @. \.* .**..#
# .\..*   * ......*..\*.......  \*.*..  \. \.\* \.*. #
#  .* .*  .\ \.\* ! \ .* * \!\ . *.******...!*..\.. .#
#\.\. \.. \..*. *  \. \. .\.\..* ..\*\.\.*.W\*\.* ...#
#**.\*.*... ... *.*...\. .*.   *\.**   **.*  . ..  .*#
#.! .*.....\*  ***.*.\.@  **.*  .\.\..\ .  *.  \   ..#
#.*  .. *.**. .*..\..  .. .*... .. *.* *\****..  *  .#
#..*   *.  *\*\@..*. \.    \***\*  *.\ ..*.*...\ .. *#
# .\.\**\ .* **.  * ... .*  ..**.*..*   \.*.. ..  . *#
#    .......\..\ *\.  ..*... \..*.@*..\\..  .. .* * \#
# ..*\ *\. .   * * ..\  \.. ..\ ..\*.**. @\.\....!\*.#
#* .* \...   \*.*  ...  . *..... * ...\.**\ \ .. *\\.#
#\* .\  W\\.\. .\ !  . .*.\    ** \  .. *..  **.*.\*.#
# .*.. * .\*.*. *. .. .  \ . .***\  *\ ...\*.\....\. #
# .*. .. \ \ .*..*\... . **\. \. .* *  **. ..* .*  \.#
#** \*. *.    . .* ..\ .  **\ ... . * ...\  .*\....**#
#\.*..*\ .  *.*** * * \*..\..** *. .\.*.  \\ .* !\.*.#
#  .**.  *  *.  ...\* ..\* .*.* . *.. .*.* * \**  \*.#
#...\.* . ..*\. .  ** .\ .\ * \ .. .  .\*..*..\** ..\#
#* .*.\.\.**\* *\. .\    !.  *   .\.   . .*... ..***!#
#*.*. @.*.* ..  . \ ***\.  .*\.* \ .\ . .**\ ..** \..#
#.*.*\..*. .* ..*.*...*. .*.. ..\. .***.@\**.**..**. #
#.* *...***\. .\ .**..\.. . ..\.*. .*  . *.*\.\  .\\.#
#.*.***..**.*. .* * . *..\.** *..\* *.  . *..  . *.*.#
#.. .\*. ......*. *** ..**\.\*.**. \.  . \. *.**.. **#
#.   *\  *\ . ** **..\*.. .  *.* .\**.\...***@.. .. .#
#.\.** *.* .  ..*. *\..* *.  \ .\  .\ .*. .....*. .. #
# ..\....    \..*! \. *. \.**.\ .\*.   ..   *  .\ .* #
#*\  \. \*\.\ .!.\*.\ \.***.*\**...*.*  \   \.* . .\ #
#\..\  ..*....* ....*..\.. \* *.* * *!.... .*\.\**.*.#
#. .*.\. . ...\.*  ..*..**..* *\.*\..... *\....\\.\.*#
#.**  *... . .**.\  \*.*.\.\...    .. . . .*. .. * \.#
# .\**...* ..\ \. * *..\\ \ .   **. *\** * ..    * ..#
#**... *  * \ ... . .*..*\. *.**... .....    .* .\   #
#.. **\. .\.** *  **\.. ** *..\\ .*.*  .**\.  . .!\* #
#\. *.*     .. * \.*\ . * *.. .*\. .\.**..*\**\  ....#
#*. *..*.  * *...\\.*.*....* . .* \ .**...\..\  * .  #
#@*..*\   \.*..*. .\**.  *..\*.\. .* \\. ......*.*\  #
#**\*.  .*.***\.* * .. ..* \.*.** .  ..  ..**.*\**\*.#
# * \.!..\ \@.. . . . \.*\*. * ..*   .** . *. \*\.*..#
#* \  ..* . .*.**.*   **. ..... \..*\.*.*   *.. * . *#
#  .   *...  *.*.**..\.\ . *\ ...\\. .. \.  \. ...\ \#
#.  \   * ..*\..*.. .  W.  .. **\ *   *@. . .*.*\ .*.#
#.  ..\ . . ...  .\ ..**    *......\ \...\  \\ ..\** #
#\\ *.\.**  *\ .. .! ***. . .  \...*.. . *\**.. .**@ #
#*..\*. * \W*.\.\.\* .*.. ..*.. ..* \. ..* *.* * ....#
#\ *. *\. .*!..*..*.**.***.**. *\ * ..\ ..*.**..  \. #
#* . *\* * ...*.* .*.. .\. .*.\*.\..\ * *..  .*\@.. .#
#  .**....* ...*  .*.*   .. \.*\ .*\  ..\.  \** * * *#
#\*..\..\...**\*** *..  .* .....\ ..    *\ !.* *. .. #
# ..\  *.     *.*\ .\.*\*.   .*.*\*.  \ . ** . *. .**#
#.*\ .*\.\.***.\*\ \.....  * ..*.*.. . ..**.\  ** **.#
#**.. ..\* .*\.*....\.* \ .\  \. .*.*.\.*.. ..\**...\#
#.\ .  \.**..*!*\.\ **! *.   *.....\. .*\*.  . ...*\.#
#\.\  .....* *.\. .  . ***... *.  ...  ...  .W.**.**.#
#...\ **\.** . .  .... ..! * *   ..\ ..**.. *.***\. *#
#.\  .**..*  . .. \  *\*\.\\.. *.    .*... .* \..** *#
# .. \ *  \*\ \. **...* *\. ..\**. .  .\***  \. *. *\#
#... .* \ !\.. ... .**\.\* *.\.*..**..\!*..*\.*.*. . #
#*\.* .. \*. \*  ..\. . *\ . .\*. *\\..**  ..*. .\ . #
# * *.**. .*..\ * ** .***..*.....\.*@..**\ . *  ..** #
# * .*. . *.*\**.\..  ...\*. . * .\.\*...   ** ..\ ..#
# ....**.*..*..\...  * .@ .. *.\ !*  ..\ .* ..\.** \\#
#***.\.\...*..\\ *  .*....  *.. * * **.*.\.. *.*.  . #
# ..  *.**\.*** .\**.*    *\.*..****. ..\ \  .\.... .#
#*.*. .\** \ .*\ * \** .*.\. \*..\.\ \. ... \..\ \  \#
#*..\.  .. ...* .* ** \ **. ..*****...\**\ ... *...**#
#.*.!* *. . .** . \.. . *.    .\.\.*  ..\.*.*\...* * #
#*.**. **. . .\.* .* .*  \. *.  .*.\\ ...***..  \..\ #
#. . * ..\. **.** .. ***\. *.* ** .. ..  *.\\ .*...W*#
# .*.*  * *... .\ ..\*\.*  .**. *  .*. **.*. **\.*.\.#
#.  *..*..*..\  ..\.. .*.    ..**  ***\..\.\ .\**.* .#
#*.. . \...\ .* *.\.*\*.** **.  ..*..\.. **.*...... \#
#* ..* .* \**..* *. ...*. .*.*.\ .\!\. . .*\ .**\*...#
#.**.. ..* .. .. .\* \**.\  *. ..*.. ..**\* ... ... .#
# **.... .**\  . \*.*... .  . *   .\ *\.\..\...\..\..#
# . * .\. \*!.*@*.\ .*\...**...\.* . . .*    \** .**.#
# *\*...* ..    *** \. . **.  ....   \  ..\* \.....*.#
#\*.**\.**.    \  *\.. . .\.\  \.* \ .*  .*. .. *  * #
# ..*\*.. . .\ ..*.. \..   *.. .*.\ . ..  .* *. . ..*#
#.*.*\.R*.   * . \. ..*.\ .  *. .*. *** *.\*.\.  * \.#
# . W *... .   * . \ ..\..*.\ ....\  . ..\*.\.  *.\..#
#\* \**.\      . @ ...\.\ .\ *\.*\.. ..\ !..*..*.   .#
# . ...\. **.    .*.*  ..*.*.\. ***  *\*\. .. *. . \ #
#\..*\** . *\ *  *...*.  . \.* \*\*\*@.**  .*..   .. #
#.**. *.  ..*.  .*  *.*  .\ .*\....* \.... ....   * \#
#\*..\*.  . \ . ***   .** ...\.\ .**. *@\*. *\* * * .#
#***\*. .... .*\    .*\.. *.*.  . .. \..**.\.***.*.. #
#*\* .*\.\.*\ \*\ \ ...*. .*\ \.\ \*.\..*. ****\.*.**#
######################################################

Water 24
Flooding 9
Waterproof 1
Razors 2
Growth 6
