##########
#  #*# # #
#  #5*# ##
## #**..\#
#\##..##L#
# .# .*# #
#\\#.\ .##
# # .*.\.#
# .\*....#
#\. .    #
# \..\  .#
#*.  .*  #
#*... . .#
#@\.R.\.\#
#.\\. .  #
#\..@.. *#
#.***..\.#
#\....A..#
##########

Water 3
Flooding 8
Waterproof 12
Razors 42
Growth 23
Trampoline A targets 5