##########################
#**...\.\   *\..* .* *.*.#
####**.... .. .... ..... #
# #\##.\..*. .\.\  *  \ \#
# #*  .  .*.**  *R **\.*\#
#  ##  # .. .* .**.... \ #
#  #*.... ..  \ *\ \ \*.\#
#   # **.  \. .....  .\ .#
#    #\**...* \ \.  * .\ #
#     #.*. \*\* .. ** *.\#
#      #* .#. \ \*\.*.\*##
#       #   . .**.*... .##
#     L#.\*  .\ ..*\*   ##
#    #.** \ . *..*  *.\.*#
##########################