###################################################
#.   *\.*.. .\.@\..  \.* * .\**.* * *.*.*.  *#    #
#*. .#.*...\..... * .*..\* .*.. *... *. ...\#     #
#9 . ..@* .*#.*\*\ ....\..  . . .*\ ** \..  #     #
#..\.***\*\.**! *... .. \* .**. .....   .R  *L#   #
#...*.\.!\*  .  .  \ \.*.* \*\*.\  . ...*  ###.#  #
#\.*. *.*.  . *... .   . .*..  ..*. *.\ ...#.\.#  #
#.@\*A*. .\**..\\..\ **\.\.....*\. ....\.# # . #  #
##\*  . ...*\** .\  *!. \*\. \ *\*.* \.. *\.\##   #
#* .\* * *... ..* . .*..  \*..\.*.**..*  \#...##  #
#\ . \.. .   **.. * \. .\**W  ... .. !* .\*...*\# #
# *  * ..*\.\.....  \ \  .* .\@\! \!.*..... *\*.# #
# *.  ...\ .  .\* **.. ..*\ *... \...**.  .. *.* ##
#. .\.#*.*..  . .\*\.**.\.**.. *  !*.** .*.**.\..*#
# ...\.*.\...***\.*. .** .*.*!*.* .* \.* *.  *#####
# * .#...@.  ** .* .\.**... .\.. . ...*. ....#    #
##\ .\ *..\* \.*.. . \....\....  .**\..\....#.#   #
#. #\. #.\*.\*** *  \.* * ...**\. ** *\**\*.. #   #
###################################################

Water 4
Flooding 17
Waterproof 0
Razors 10
Growth 21
Trampoline A targets 9