############
#      #*###
#     ##*#.#
###L##* *#*#
#\ .\ .**\.#
#.* # \ .!\#
# #.*.** # #
# . .\*.  .#
#     ..\ .#
#... . **.\#
#* ...\ * *#
# ..#!*.. *#
#     *! ..#
#\.**** ** #
#*\...*\*\\#
#.\ . .*  .#
#  .*  *\**#
#   *..... #
# \  *\  .\#
#\  .*  ..*#
# !*..**\ .#
#..*. \*..*#
# *.....\*.#
#*.\ ...*.\#
#. .\**.**.#
#\*\...***.#
#*. \ *..\ #
#. \ .*.\ \#
#*\ . . . .#
#.  ..  .. #
#.*\  .. \ #
#. .  ..*  #
#**\.* ***\#
#... *\.*.*#
# .!*. *\.*#
#.\*.\.**\.#
#..*. *.\*.#
#*  .\.    #
#..* .  \ .#
# .*\.. .*\#
#.  .*. .  #
#** ..* \ *#
#**.**. .. #
#.**..*..\.#
#**\ *.*@.*#
#\..\. .* !#
#**.* ..  .#
#* **@.*.* #
#***.*..*..#
#**. .*\..\#
#\.\*. *  .#
#.. R*.*. *#
#\  ...\* .#
# ....*\.  #
# *   .**..#
# \.*.* @ *#
#** ..*   .#
#..    \ \\#
# @.!\ \.. #
#*.*\*...*.#
#\   .*... #
#*\ ..\*\  #
#* \.  *...#
#*\***.. \ #
#.. ..*   .#
#.\..  . .*#
#* *  .*...#
#\ . * ** !#
#*. ..*.* .#
#**. .*\ *\#
#.\... W!* #
#*...* \ *.#
#\*  * ***.#
#.*  .. *. #
# ..*  ..*.#
#..**.\ .. #
#  . .\.\.\#
#  .\  @ * #
# . .\*.   #
# ** . **\.#
#.\. \ *  *#
#*. .. . \.#
#....*\   .#
############

Water 9
Flooding 1
Waterproof 2
Razors 26
Growth 34
