##############
# *  ..\*.\..#
#*..****.*  \#
#. ***.\.* *.#
#*. **R**..*.#
#. *\W\..*.* #
#*.  ...*. ..#
#* \..  *  .\#
#\ . . . .\..#
#.**  ..   .\#
# .. \ *.  ..#
#\\... . .* *#
#. .. .* . *\#
#\...*!*\.  .#
#.* .. ..* . #
#..*\*\ ..\ .#
#\.*... *\..\#
# .*.. *.  .*#
#*. *.* @\ **#
#*. *..*. @..#
#** ...*  **.#
#@*  \ *\.\..#
#*. * ... .*.#
#\    . . .\.#
# .*.\ *  ..\#
#*..**\* .***#
# ..*.* . *..#
#\. .*\ * . .#
#.*.**.\.   .#
# ..**\ *\\ .#
#. .\. ..  .*#
#. \ .*.   ..#
#\..*\..  * \#
#. . ..\  ...#
#**\ . *.  * #
#*..\  * .*. #
#  .*.*\...! #
#*..!\. @\*#\#
#*\.\**   .\ #
#* ##*..\. **#
###..*. .. .*#
##..   . * #.#
#\\.#\  **.#*#
#\#**. * \*!*#
## #..L.*#\..#
#   # .  * . #
#   # #...*\*#
#    ##. * .##
#     # \.#.*#
#     #  ##*.#
#      #*# ###
##############

Water 0
Flooding 0
Waterproof 10
Razors 6
Growth 14
