##################
# . *\ \.** *\**.#
#... * * ..\ .*..#
#*.W\* ..*.   ..W#
#*. *\*\** . .  *#
#.. .....  . *...#
#*.. *\**.\*.. **#
#*.* *...@@\..*.\#
#*A.....\..*  *..#
#!\..\  .* .  . .#
# ***.*  .. *  ..#
#* \  .*.\**\.  .#
#*6 @\.**  *  \. #
#**   \..**\ *.*.#
#.\.  ...*....!* #
#\  \ *.\ .. ....#
# \...**.*    .. #
#\ *.\.! R\  \  .#
#.*.* \. \. ..*. #
#....\!  ..*.\. \#
#. \. *  *..\.. .#
#.*  \* ..\.*\*.*#
#**...  .*.* *\**#
#***.. \ *.\*\*.*#
#*\.\\ *...* .*..#
#\ **..*  \..**.##
#.*.\*..\**. .. \#
# . ***.*\  \\*.##
# *#*\.*. ...\.# #
# \  W\.\.*...\.##
# # ..  *\. .   .#
##   @... .   .###
#.# *\.. . ... *.#
#*.**#... .*.\..*#
#.####. \ ..*#*.##
##   #..##\*.### #
#     #\# ##*##  #
#    #. ##\..* # #
#    #*# # *L##  #
#     #  #\#     #
##################

Water 0
Flooding 0
Waterproof 4
Razors 20
Growth 35
Trampoline A targets 6