#########################
#  # #\ *   \..**.*... .#
#  #* ..*.* .*\*. ***. .#
# #*# * * *... . ..\.*  #
###*#.#.***\... \.\.*...#
#  *#*....\. R\*. . **..#
###.**\\ .****.. .  \.\*#
#  ###.\** ..***\*.*.\..#
#     # ..\  .*. .....*\#
#      #\L #  *.\ . **..#
#       # .# *. **\...\ #
#        #*.*.* **. # *##
#         # .. **.* .*.*#
#         #.   # #. \#. #
#         #.## #\..*# # #
#         # ##*### .#  ##
#          #  #   #*#   #
#########################