############################################################
#        L   # #                                           #
#      ## # ##..#                                          #
#     #.#\*#*..*#              ##                          #
#     # .**#*\**#             #\\#                         #
#      #..# #.##         ## ##..#                          #
#     #  .*#* . #      ##* #*#.\*#     #                   #
## ####...*..# .# #  ##.#**..##@.######.#                  #
#*#..\  * .. . @##.##..\  . * *.. . .*# \##                #
#.\ ...\.*\\ . .#\   .  *\ \**. *   .#.\# .##              #
#\.###*..*.*..* .#..  .*   ..*..**..*# . ...*#             #
# \ .. . *.   #\*....\\.#     *\.\  . ..\*.##              #
#.. #* .. .*\*.*\.\. *. \\* *\ . *.\.. .#. ..#             #
#..\*@ **. . .*.  .... . ..*.***. \* ..*#* *##             #
#*. *.  * \*.. * .** .*.    . \*  .\**\# .*#* #            #
#**.\ . .\.**.\ * .** \*\.. .*.*... . .# **.**.#           #
#.*\..  .\.*. ...  @** **\   *.* \*   *. ..#* #            #
#..  * *\. .*  ..  \*  *..   ...*.*\...*.* *.#.#           #
#.  * \.* .*.\.R.* *..... . **..... *..# . .#*\.#          #
#\ * *!\\  .***\...\.\.*.   . . \.* *. #\. #.. # #         #
#*..\. .\.. *.. \.* * .\...   .  ...*  .**.**.# #.##       #
#**. \\\ .\* .. !* ..  *W . *  . .  **.*..\.#\ #\\* #      #
#*.*....  *   *  .*\.* .. ..\. ..* ..*\.*..\  *#***..#     #
#***.\. .*.\..**.\.  \ *. ..*    *.* *. .\\.*..**** .\#    #
#*.**.\. . *\ **   .*..*..  *. *\.*.. . . .*** ..*.. .##   #
#..... *\  * ..*. .*... .\ *!* . *.* ..   .#...*..* .   #  #
#\ . ..*\.\*.. .. ..*.. . . ***\. **.\*. *.  \ ...* \ \#   #
#*.  . *@\** *.\ *...@***.\*\.. *. \*.\ ..   .\#.\*. ##### #
#...  *.* .* \ ..  .\...  *..\* *\*.*\*.\*\**. ... ####..*##
#..  .\*. ...*  \..   \. ***.\\ .... ..\ \..\.. * *..\.*\.##
#* \   .  .\* \..\  *..\..*...*. ..*.*.*.\    * *.. *.*#. \#
#\    .* *. .. . * \.\..*.*.. *....  * ...\  .***.  .#.  **#
# ..* \**.*   .*..*. .. . .  *\.   ....    .  .* ...   .*  #
# .*. ..**. \.*.\ *\.*. . *\.*..**.**** .   .  .\ \.\#\ \ *#
#  .**  ..  .*.  . .  . . . \** ..  ***..\ .. . ...* .*# *.#
#\  .. * ** ..***\.\. .*  *.!.* ** *.. . .. \. .  .. .\.\\*#
#. *    ***.  . ...**.\* .. *. .....\*... * .*** \...*. . *#
#*..  * \*.. \  *. ** ..  **...\*.   ..\.*.\ *.\.. .** *..*#
#*. .***.*. *.\** .\*** *.@*.  * . . .*.  *.*.* \ \..  . . #
#.\ .\.***...*.*.  *..* . .\. *. . *..    ....*.*\ * . *\*.#
#* .*.  .\* .\ .*. ...*   .. .\ **\.\* *.*.\* *. . * * \..##
#.* .\\. .!* .\.*.**...   * \.*..*. ....*.\ * .  *\* *... .#
#*\.@. .* ... .* *.\  *  .* ..*. \..  \**.. ....*!.\.\*\**##
#.**.*.*\. * *\..  *. * \.* ..***.  .* ....*.  *.\  . *.*.*#
# \*..\*.@* .**.*** \ .   **.\. *\*\ \  . \ .  . .*\**.\ **#
# .....  .* .\!.*.* .\\*  **\*.**\.\ *.*  * .  .*   .. . *.#
#*\ * *\...*\ *....... *.*\  . .\.. .* . ... .*..*\*   ..* #
#*@.. .... **\@\* \..@..***** .!.*.* .  *.\.\..*.\**. .*.. #
#\!.\.  *\ ...**.... .*..\*...  ..*..* .* W..**..**.  *... #
# ..*.  . **..** .\   .....*\.*.\*.\.**..\ .*..\\  \\*\.\.\#
#   *.... *. *\   *.*..\ \ *.\\*. .. .*. .. *\\ .  * .* \**#
# \ .. .*** .*@ .\*.**\!\   *.\...\  *.* \...*  . *.\... ..#
# ..  *.*.. \**\.*.*..*** *.\ *.. .. .**.*   ** \ ..   \.\ #
#\ .\ *\..**.   ....  .*  *\ .*..*\*\*..\*... ... *\. .*..*#
#..\..* \ .*.\.** *  . . \* .*.\ .. .. \.. *  . .. *\ .*\ .#
#*. .\... ...\ *\ . *  *  .* .* .   **\  .\.\*..*. \*\** . #
#. **.\.*   \ .**..... **. . *.* \.*....  . .* \\ \..*...\\#
#*...*.. \.\.*.*.. *  *.@.. **.  ..\  *..*****......**\ .# #
#\. \*. *.*** .\W \.\***..   *\ .*\*. .  *\.* .... **\ **  #
#*.*.*\.*\....** ... .* . .*..\* *... .*  . .\* .*.*.     ##
#..****.....\ ******  .\ ***.  *\..*.*   *.\ **\ ** \  ****#
#  *..\     .\.\ *\*.  *.\.* . . \......... .** **\  .*..#.#
# ... \.*. .. *  *..   . ** * .*..*\ ** \*   .\ ..*\.@\\\ @#
# **. . .   ..\* .  \   ...**..*.*\* .*\.. ** . \ ..  . \..#
#...  .  *.. .. *\.* .***.*. !.*.\.*..**..\. *...* .* *. \*#
# ..*. *\.*\*\*..\*.\.\*. \**  .\ \.*...  . @. \ ..*\ .*  ##
#*. *\ .. ..  ...* **.***..* ...*.!**\.* .   .. . **..\ ..*#
#..\*\.. *\ ..\ .. *...\* *..\.\. \.. @. *  *. .*.\** .** .#
#* ... .\ *.*  *\\.. \... .*.\  ..... *..\****\* .*.*...*.*#
#   **! *..\   * *\...*\  .W.  ** \* * *. .\..*\. \ .  ** .#
# \***... .. **\ *.  \..  ** * .\ .***      . .*\ .  *...*\#
# .. . \. *.... . \  .*. ..\.\.*.\...  ..* *...\*.*....\ . #
#  . ..*  .\ ..\* ..\...\  *    . .. **.*. . *.*\...  *. .*#
#. * .\.\**..  .. * .  \. .*  . .   . . .*\.....*\*.\..*  *#
# *. .*.  .  .\**.   \...  . .  @*.***.. *.*..*** \ *..*. *#
# **  .*.\ \. *.*..  . .   \  . \.\.\\ \  ..\*\.\..**  .* \#
#\.. .*\ .*.  ... ..**\\.**\*.*..\  ..*.  * ..* ***.*.\. ..#
#****\..* ..*\ *....... **.*.\.\*..\..**\*\ *..*.** .... \\#
# . \  \..    ** .\\ ..** . ..* ..\  ... . .*. ...@    \ . #
#\  . .***. .....  \.@ *..*.\*. .*...*     \.. .\**.. *..\.#
#.*\.. **..\***.***\** .\  . .* ..* ..\  .  \ *.**...*.\# ##
#\    *\ \ .\. ...**.* **.\ ..*.*.. *\ . \ .. .. *.\ *\*\#\#
#*\  *.. *. . \.  *. * \. *  *.*.  \**     .*... ..*  . .. #
#\..\ ...   *..\.*\  \\...** .. ... * .\*\. \*. *. *.   .*.#
#  . .***.... ** \..\.*.\ ..* \.*.  .   \*. ... *\**..*\\.*#
#*\  .*..*.* .\. .. .\*.*  .** *.  . \*...*...  \ *..*... .#
#..\* *.\. .!** \..\** ...**.. .@*\* \... *  \.*\*.\. *.\*.#
############################################################

Water 55
Flooding 10
Waterproof 10
Razors 34
Growth 9
