###################################################################################
#                                                     # ##\#      # #             #
#                                                #####\#*#.##    # # ##           #
#                                               #.. *.*#.#..*#  #. .\#\#L         #
#                                              #\.  . ##.*\*.#### . .#.#*#        #
#                                            ### # **..\.\.*##.*#  * ..#  #       #
#                                        #  #.*..\.****#.**# .**## *#!\.*\.#      #
#                                     ###*##* *#   .......****.*#. .  . ..# ## #  #
#          ### ###                  ##. \.#.* .*\. *.*....*#** ..\ \**\..*##. #*###
#        ##\ .#***##  #       # #  #.\*. *.*.  *  ..*\.* *   . .** #.** .. .*..*.*#
#       #\. . * *.  ##*#    ##.#.##*. . \.\\* #.\.. .  \*  \\*\#..** ***@# @. *#*.#
#      #.*  .*. ***\.. # # #*..\ *#*.#. . .\. ...*\  * .*. **. .*\ *\.\ .#### #* *#
#   ## # * .***\ .*.  .##.##\****#**\  ..** \*.....*.\*.*** ..*\   .. **.\ #*  # *#
# ##. #.@.\.*.\   *.**\  . *....*#*@*.*.*\.#*** .\.@\*.\*.\*. *. ** *..\**. \.*. .#
##\ .\. .* .\ *...*..# \** .\. ....*\ **#*. *.  ...!@.*    *\..\ ..\*\*\*.*\.*.***#
## *  #\.\ . ..* .*. .* .#..*. .  @\ . @ *.*. @\.\.*..*\.**.*\. .\ . *.*. \ .\**..#
##\..#\. .\* . ..* * ..  *.*.  * .*.. *.*\.  \!.   * .\.W*..* **  *.\. .  .\.#.. ##
##    ## **\.* . . ...*    \ \.* *\.*\.\. .  . . * .\\ ***.*  .\   ..*   ..... .. #
#! .*\  \...*.\ . . . * .!..\  . *\*..* .\.  *.*..   *\...\*.  *.... .. .. *. .! .#
#.. *.!.... *.\.*  \ *...\ \ . **\.. *.*.  **.*.\* *** \...\  **.*\**.** \* .*\.*.#
# . \\  .*.*. *\.**.*.*...   * ..  \ .**. .*.\. .. \*.\  **\. \. ...\.**\ *. *...\#
#  **. \. *.  ..**..*.*  \  ..\ ..*.\ ..\   * **.  .\* ..*\ #..\**. . *.. .**\..**#
#\* .\.*  .. .* \. .@......*  . . ...!*. *..@ ***!.\..\\**. .\*  \..**\! \...\.   #
#*.\\. ..  .  *..*. *.  *. ..\...... *  ...**.\*\ .  .***.  *... W.. * .\* \..   *#
#. .. . \ .  ..\ *...* *... \ ...*.. \ \  \* \ **  .\*W*.\  . ..    ...  ... * .  #
#*\. . ..*** *.*. .  .\.* \..\\.....*.*. ...*.**.\ *\. .   ** *  \..* .*\    . * .#
#\  *  \****. *\  * *   .. *\ * *** @ .* .*.  ... \.. . *...\ \  .W\\**. .... .!  #
#. \. *.... * ..\ .\. . *. .  ..*W*\...   .**...*  **   .. .*.. .\.*\*. ***... \ .#
#.\.* ..!\. *\  ..* .\**\.   .\ * ...\ .\\*.\*...!...*..\.. ..  \ . *\ ..\...  ...#
#. *W .\*...* .*.** ..*.*  * ..*....\...*\.* .\  .*  * ..*\*  *\.  ..***\  . *. .\#
#.*. **....\ .\.... *\.........*  .* .* @.\ *.. \ \  ...*..***..*. .  ..   * .. **#
#*. ....* .  *.*\. *.*..  @.**.*  *@**...* *.*\ !.**\. \.  ..\\\* .    **\\. . .. #
# .   .  .  .\.*   ..... ...*. . .*..* *  *  .*.*  .*.\  ** \ . *  .*.*.* . *. \\*#
# *.*\* *.  .  .  \*\.\* @\..\.*.\.\.. .  .  *. .\..**...  . \ *.. ...\  *.. .* \*#
#.\.  ..*...**..*****.\. .  * \.  * *. .\ .* .* \.*. .  ..\*...\*\..*\*\**\*... ..#
#*\.\...* \  .  ....\.* \ .*. *..... ** *. **.  \..**.\. * .\*\... **.  .  . @*. *#
#..  *... .*.*\*. . *\. *...  .\..\*.. .. ....   *\.*. .\* ..*.\.* *. *.*\*  . * *#
#..  ...*  ****\..... ..*.*\ \     *. **\\.    * ..*    . **.. **..*.* *\. **  \ .#
#.   . *..\ .*.. .\ ..* ... ... . * !..  ** *.*. .*. \.\ *.*. .\.*...*\   *.   .\.#
# . .. ...  * \**\ *  . \. \ .** \*.  .\.\. . ..\* *..\ .***\ \ .\  .*.*...  *..  #
#   *.  @\. *.*\. *. ..**.. *..*....* ***... .\@.. .* *\* .. .....** ..\  .*.* .  #
#** !.\** \*...**\..W..\*.. \ \* .*.. .\.*..    ..* . \.*. *  .*. * **\ . .**\ *\.#
#*\ ..**.*.\  ***..* ..\.\. ...\. .* .*. \. ... *\\  .. . .\.  .. .\. ... . *@ . .#
#  *.\.. ...\.\.* .*\  .\*  *\@.....  .*. .**\. *.. *.**..\.*..*.*.\ . * ****..*. #
# ......*  **....\* .*.    \.*.  *\*.*\.. . .\*.**\ . .*  ..*  !\   .\.  ..*.*.*. #
#  .  *  \ ..\* .\*. .\.\\..** ..  \ **.*    .\ \.*.  \* !\ .  ***..\*.\* .\\\... #
#. .  * \.  .**\ *.**..* ..*.* \* *. ..\  *..  .  . .*.. \. *\**...@  ...*\.... **#
# \   \!.** *.. *.*.**\  \*.*. .*.\.\.. *.*!  .  * \*.\  .*... \   ..\.. \..\  ..\#
#...  .. \.*  \..*.*\. \ ..**. ..\ .   @.*  \. \.\*.  .*  .\. ** . . ** .. .  * . #
#. ..*..*.  .\.. \..\*.** . *. *\    *....    .\*\**.* * *.*.**.  \ **. . . *  *\.#
#*  .   * ** ...**.\...**......*.  . * .\ *.*  !.....*W*\.*. ** .   *!\. * .\.* . #
# . * * \*.\ .* **** **.  **. ..  \     ** \\*. .    .\    \*.* . \ .   .  *..!\ .#
#..*. . .* ..\.. .*.\\  **\*..  . ..\.* *.\ *. *\ ..  ...* . ..\.  * *\ . ..*\. ..#
# *.   \\.\*.*  \   . ....*...\\  . .....* .*  . .   .*... *  \. \** .... * \.*.. #
# ..*\ . *. \... .**\*\ * * ..   ******\.\..\ \    . .  .* *. . *\ \*  \ @... .*  #
#\* *.  *\* .\.*\*\*    \ * \. \.... .**\. .* ..  \. . . . ** * *. *\*....*. \ . *#
# **. \ *..\*\ **. *\* * *..  * .  *@\!* .*.\ . * .\!*.\.......******. .*.   \..*.#
#\.!*\ **. ***.\.*...*  *.\* *.*\* \* \. *.\. .* **\**   \ *..*......\ ..... * \* #
#.*\.\ . . ..  . .\ **.*. ...... .. .\\ ** .* .  .\  . .*  **\.@ ..**.*.\ *  * .*.#
# *** .   *\ .** *.*\.\.\ \ * \ .**\ *\\ *.*.. . .*.\...\*\... ..  * *....* *.  .\#
#..  .\* \. . .\.. .....  ...*\.. *... *** . \    .\*   . **     *. .*\.. . ..**  #
#\   * **. *  *.*\* .  ...* \...\ *.  \.\.*\\*\..*. *.\ ...\**\.\*.*\. \ . .  .** #
#*** . !*.   *.*\. ....  .\ .  \ ..**\.\.\. \.  ..*. *. * * .* \ .*.*    .  * ..\.#
#.. .\.. \..*......  .** \ .. .\. *....** \... \* *. ....\*. . *** ..\ .\ . ..**..#
#\..** .*..\.@*\  \ *... @\... .  ..    \\*.* ..*.\*  *\..*. * \.\ *  .*..* \*..*.#
# .*. **....*. * ...\   **..\........*\ .*.\ . \ **.\..\ *.*\  \ .. *. . .\.*.**..#
#..\ ...* ...  .\* \. *\*...*   *.* ....\***\.*.. .!..*.\*..\\...  .\  . \  **.\\\#
#.*.. .. .\.**  ..*.\*.. ** *.\\.*.\*. .   .*  * .  \ **..@!.. ** W@*  \ . \.@*  *#
# *  * \.*\ .\.*\ .**\..*.** \*. ..... \*\ \  *.\....\.! *\.!..*\.\.* ...@*\....*.#
#*\* *..*** *.....*.*. .. *.*..*..*. .*.*....*....\ *   \* . *.* .*\.  ! ..*  *!. #
#..\*\ ..   .* ***....\.*.**.\ . *.**..**..\*\*.*.  ***\ .\ ..\. .... . *..* *** *#
# *\.*.*  *...* .*  . * . ..\ .. \ ** . ..*.* **.\.. \..*.. . .\.. .*\...  . ***\\#
#\....\\ !*.\ .*\ \.\\ \ .\.*. .\**. .**  * ..   ** *. *\.\.\. * ...* * . .**..   #
#\     *. *  \ ..@..*.*.*\.*\ . .\..  .*  ..  .*...*. *.*\  .* ....\  . *\ *. .*..#
#.**..\.* . *.*  . .*.* ..*    .* *.. *...*\  \*\.  .***...  . *\. *.**\*.\*  \ ..#
#\* .  .. *\   . . \. *!*\** .*..\\   .\..\***.*\**. ....\. .\*.*!\..*.\*.   . * .#
#...* !**.*..\. .. .**@\. .!. . \*..@.  .*.\**..\... *.** .*. .* * *..**.* \*\.\. #
#* ...**..*....  . *.*..** ..**\!.\ **.@....\*\.**\\ !.***.*.. . .*\  .*..* *.\.  #
#. *\*... ***.*.* \.**.*..\ *\..\* \.\ .  .  . .. *  . * .. *   *.\....*...*. *\ !#
# .*.. \. .\. .*.  \*. \ \ *** \*.\...\**.  * *. \. .*.\.  .* ..* !.*. *** ... .*.#
#.**...  *.. . .\.! . . ..\.. .*...*.. ..\..*. *\.* . \..*\ .\.*     * .** *\. .. #
# \\ \*. .* *.* . . *  . \.*  @* *..  \\  \   .. ..  * * * * * .. !.*\. **.** *.\.#
#. .*.. *4\  .. ** .. *** ..  *.*.\\..**.* \ *   .\.\.*..... .    *  *. ...*.*.\ \#
#\*.. *..*.\**.**\** \.*  *!*....\...*\.\*\* .   .. . .    * ..*..\ ..\ *.\**...\ #
#* \* .*...  .! ..\\* *. .**. \. *...**.\...\\ .\.  .\**@\.\*.\ .**  . ..\** .\ *.#
#..* . *\ \ \*.\*\ .\ ..*.*..*..\...@.. . .\.\.* \ ..* \.  .\. .\..!..\.\....\  ..#
#* .*.*\*  ......*  . *.* *\.. ..\ .... .!**W  . .. **  .\.\..*.. .\  . .   \..  .#
#.* * ** .  *  *...\. .** .  . .\ \ \ .*   \    .*. .*  .* .* . .*.  *.*  .. *\.. #
# . . .\.  .*. ..*\.** *. .\.. \ . ..* .. .*. \*.\. *.*.* * **...\ *.*  ..\  .** *#
#. *.\  *   *   .*.. . **.@.*. !. .\\. *.\*@* .....** .*.*.*.\.***** \*\*  .*\ * .#
#.*\ . ** .W\ *..... \ *. ..*.*\*.*.  *. * ..  . ..\.  \**\..* .**.*.. .. ...*.** #
#..*   ...  * . *..\\ ... . ...*\* W.@**\.* . *.. ... ...*..**...*.\.       ***\. #
# ... **. .*.\.*..   ..  ...\**.*  *  ... * @ . ..... .**.   @.\*..!..  .  **..*\.#
#.* .   ...*  ... ...!.*\.*\.**..\*.\.. . . .  . .\\* **\\. .**..* *\\ ..* *. * \ #
#.. \  **..* ** .\ *** ** .**...\.... . *\ *.  .**.\. \  . . .**\.\..\*.\  \  *** #
# .. \*** .. .*.  .*...\ ..*....  *  *.** \.**\ **** **\* **.*.. *  ....*.. .\*\. #
#.\\*..\. *.  *\  \. ..... . \..  *..\**. **... ***  \**\..\ .\.\...*\*\.  \**..*\#
#. . *.   .. *\ \.\*  .\. .** *\.*\..  *.\ ... \. . *... . ..  **\@* .\ ..@*\* *  #
#.  .*.\ . **.**  *...\.. *.***...*.\    **\**.. .....  .. *.*  . *W ** .\. .. .* #
# \* . . . .\ ****.*\*  * .\*..\* .\..  . \    \.* ...* *\.* ....**\...*.*\. **...#
#  .   \.* .* ..**\.. .  .**\* .** * .  .\..\*   .\. .*\.* . .\ *.*\**.. * .*....*#
#  *. .* . *.*.*.*** \@.**..*.. !*!.\. \ .\ ..*......*  **  \ .....*\\.  ..*. .*..#
#\ .  ..  ....*@..** ....@**. \  .  .\ .* .. !*....\*.. *.. *** . *\ *\ \* .  .\**#
#.. .  .\  \.\.* *.W\.....\....  * .. .....\.\* \@.\.**   * *\ *\*\ .@ \.\.\\  \ .#
#  **. \*\..   !*...  .. **.. .\ .  .. \ . .. ...*.***..  *\ .** * ...  *.    ** .#
#\ .* . *..**.... \...** .\  *.  *.*.* .\. .  .* . .\.  *.\ .\*.  . . \* *. * * . #
#.* ..  . .* \.* ..*.  ..  !*..\   * . * .\ *..***. *.  .  ..* ..\.** ....  *.W *.#
#. .*.. . *\.**   *.*. *\.\**\...\ .  \*  .  \. *.\ \*... **.. * *\.   ...*..   ! #
# . *. ..**  .. .*...\ .*.***.  \ .\**...\\.*.* .  .... *..\...* \*.\\ .*.! .*\.**#
#*  *.**\\.. **** \\*.*..** .. . .. ...*.    \.*.. *!*  ..  \ *.....**\ .*\*  *. *#
#*. . *\*  .\ *..\\.*.*\**..  ..\ *..  * \   \\*\.  .. .   *  *\.* .. * *.*\ .*.. #
#.\*..\.. . ..\ ... . *****  .   ..*  ..*.*.\.\.   . \..* \.*...**  .***  .  ....\#
# .*.\ *    .....\ * *. \ . .* *. .. .*.\ . \ \ **.* !*.*\ .*.. *.*\...*\ . . *  .#
#**\...*.\..*.\*. .* ... .**\. ..* .. . . \..*@...*. ..*\.W**.\ ..\\.  ....* \...*#
#.\!\ *. .. ..*\\*\..\\.\.*....**.. .*  .*. . ...*..\**.. .\*...  .   .\ \.  .\  .#
# .**  ... \*... *.  *\ ***.!  *. *.\* .*.*\.*.*\.  * *.. . \.\\..  ..  .. *\ . * #
#*.\**\*.*  .\.. ...*.. .**  \@. **** \\...... .  \.  ** *    *. ...***\ \* @**\\.#
#**..* ..*. .*! . ...*\.\!. **. .!** ..* \ \*\  * *\  .* .  \*.\*\. ..  .*.@... * #
#*.\ ..   .*.... \   .   @ ...* !*.*  .... **..**.* . .**  ..*.*\ *.\\.*..\.. **..#
#. *  ... ..** *\*  .. . .. \* .\.\   *. \*\..\*. . .\ .  .*\* .*    \ *.*   .****#
#  .\\*..\* \......*   ..\**.***.. * *.   .*..*..    . . \.\**.* *...*.\... . ** \#
#.  **. ....   ** *   .  *.\.. ..\ * **.\.  . .W. *.* * ..* .**\....*.. .*  ..  \.#
#\*. *   . . *.\..\.*... .**  .*** *.... ..  \  . * . \.*. \...  .....***\ .\  . \#
#.\. \...  *\ * .*  * *\..*.*\*..**.\.. @ !.*.* *...\..*.**. **.. * *.\... ....\. #
#  *  . ..\ ..\.*.\.. \.*   .. . .. \.\ . \ ..*\*.\* .***....* \... *\** . . . ..*#
#..*.. . .. **. **..**..* *.\ *.***..  . \.\.\. ..@\* ** .*.*\..  . ....\..   .  .#
# .  *...*..\.\ ..  .\ ..\.*... *...   .\..***. * .*..\..**....  \..  *\. ..\.\. *#
#*..\....*     *. ..*. ..*\... .* ..**.\ . *..\.. **.*.*\ .****  .*.. .*..\..\. ..#
#\*\ ** ..\  . *\  *\*** .* \.**.\* *.\ \*.\. ..*. .*\ .. @**\*.. ...\.\.\...**.. #
# *.** *....\  * *.. ..*. *..*\ .*...   ...*.*.. W  . * *.\.... \. \.@*.   \.*..\ #
#*\.\  *  .*\..  \*. .\.. * \..  *.*  .  . \..@**\ \.\* .*.*.  * ...\.\ .\**..* * #
# .. ..\ \... .   .   *\...*.. .\...****\*..\.\.\ *. * **. ...\... . ... .*   . * #
#\....\*.  .. .\.*.  *.*\  .. .**..\..*\.@.\.  . ... ...  . *\ .*....\.*\.. . .\**#
#  ... **\   ** . . *\\. \. \.* .. .\*** . * @\ * *\ \... . . ..\ \  . . *\  ... .#
# *\.. ...  ...\\* .*..**.\   \.. ...*\...*@* .**\  ..  *.*\. \ ** .*. \*.. . .\..#
# \  .\  \ .* * *.. .\. .*... .*.*..* *. * *.\* \ \.\ *\.\.*..\ .* *.\  .\.. *.\ \#
#   . **...  \* ..*** **.   .*.....\*..*..\.*.* .. . \** *.*  **\.\*  *  **  *\!*.#
# *. ..*\* * ..* .\*\.*...**.@. .  ..\ \* **. .  ...\..*.... \.* \..... ...\..*..*#
#\.  . *.. .   .*.. .!**   *..* * . . . *\..\*.  .*...*.*\*.  * ..*\*.   \*  .   *#
#*\**.* .* . .. \ *.*..  . .. **\*  .. *.**.*\*\...!.\. *\ \. .. \. .  *. ...*\*..#
#...... *. .* ... *. ..  \*.*.   . \*\.*...**.*.\   ..*.*.   ** . *.  ..*. .*.*** #
#. .* \*\!. * .**.**..*\.\. .. . * *...*.\ ..W.*** \\...*\ \ * * .***.\ *.  ...\..#
# ....***.\ *\ .\ *! \ . ..\*.  .* .*\ *.**   . ..*.   **    . . ...\.*. . **\\** #
#* .*..\..\** . * ** *.  .\....  *.\.. \ .... ..*.* * .\. .** * * .* .* *........ #
#.\   **. @.. ... ..! @.* . ....  *.\  ..  \ * .* .\.*\*. **..*** ... .  *.. . \ .#
#*. * *\... *. \. * .\  . .   *. *\*...  .\.. . . . *. .\...... \\....\ .. .\*...\#
#\.\.. .    .  .*@.\ * \.  !* . \*\. *. \* . .  *\ ....*\... *.  ..  *.*\** .*.*. #
#. *\.\.\ *\ ! .**\ *.*.*   *.   .*.*\  .*.** * .*\.   *.**\.\.\. .     ... \.* ..#
#.  .*.......  ..*! .\... . . * .\. \.   \ .. . ..*  ****. .  *.\  .\ .*.  ...*  .#
#. *.. *.  ..*.***.W*. . . \ ** \*. . .*. * .**  ..\ .*** ..\ *. \. .*\\*. . . .\\#
#**..*..\*..* ...\.  *..  \**\*. *\*...*. .*.\!\. .  *..*.*\* ... .\ @..  .\  .*\.#
#..\.*  . .. . * .*.*..*.* . .**. *..\  *  .@ *.  ..*.. *..  !  .*.*    \ *.  *. *#
#*\   *  \.\.. @*.*.**. *.. . \.. \*. **.* .* .\ **... *.*\ *... . .   . *.W.\\.  #
#..!..  ..**...**\*. .**. .    *  . ..\* .. ..**.\. !\*. .!*** .* ..*** .\ .\ . \\#
# \.  *\.@ . *\**.\.  .....*.\ . .. *. *. \.\.... \..  \  *. \.\*.\ ***.. \..* *..#
#\. .....\*  *. . *\   ..\*...\*  ...  .\    .*  *.    * .\.*.*.*. ....* ..*\.\* \#
# .... ...\*  *.\ .**.\ .*..  .*  ***.. . .    * \.  . . .  @. \.\.. . *. *..  \* #
#*.*@ ..*\**  *...\..*  ... .\ . ...    * **\.*...*\*.  *\   .. . ..***.*\*@..  * #
#*. ...***...*.. *. ..    .. ..   *\ *. . \..*. . \ . *\. **.\   .**..**.\..\*\\\.#
#\.    .\ . . .\*. .\   *. \.   *  . .\.  .*.* . *.\.*.  ...* .\* .****. .\*....  #
# ..**.**  \**.*... . * *. .    * .. . .\.\  \ ...*   **\*. *!\... .W...* **\. * *#
#*!...\.\   \*..*\.* *...\  .*\** *   . .*.*\..\*.*\ ... *****.. . \   ... . ... .#
#\..*.  *  \.* ...\\ @  ..* *.... ....*  . *! @ ..**..\ \\ *.*.. .*    @  ***.\ . #
#*. .*\*\ *...... * \*..*\. .\.\ .*..*\. . *.*\\ *..*   .* *\*   ..*.\.*  \. .... #
#.. ......**\..\  .\  .\..  .* .!\.*..**  \ .. . . ..* . *..\.. ..*.....\    . *\*#
#** .*.* *.. .**..    *.\. @..*. . .. ....  .*** \* \ *.*\.\...**.* \  .*...  .\. #
#. \ ..* *\.\.@.\ ..\ *..*.*\ . \ *\\ .  .\. \ . **   **  .*.. .\ .. . ...!.. .!..#
#. ..*. **.*. .  *  ...\.. ..*.\\*.. .\ * .*\.  *.\  *...**  @. .*   *.  ..  \. . #
#.*  *\  *\!.   **\.*\ * *.  * *!* .* * * *. .\\* *\****... \.\ .* \.*. * *....*. #
# ....*.* . \ .\ .. .\  ...\ .\@..  *\ * .**W**\*\. \*\ \*...\* .. .... . *** .\. #
#   \   *\.  ...  \   **\ *. *.**\@  .\.\...\.*.*   ...  *. .*..*. ..\.. \..\   .*#
#.*\  * *.* *  ..  **  ...\*.* * \...*  .*. . . *..  . *  .\.\. .\.... .. *.. ** *#
#*..\ *.. * .\. *\ \.\.** *.\... .*.   .\**.. . .. . .**.**.\!  @*.\\* ..* .*.\*..#
#.. * .@. .\.*.\.. . *.**.. . * \.\* . * *..**   .*\. .\....  . .* * .\ \. ** .! \#
#\ \*.* .. * . .*.\ ..... **\***. *  ..\ .* .**...*  .\!   .   *....\*.\.\*.* .W\.#
#* \**.  . \ ..\. \  ..* *...  *.*...  .\ \ .*. .**.*.!\*** . **.     ..**\ .* *. #
#....** . .**\.  ..\ .  .\  ..\...   .  *. .**  .\*.    .*  ..**\. .    ..*\.* * \#
# ..*.*.*  ..@\*  \**.   ..* .\ *.\.* .. . ...*     \.. \  ****.....\...\**. .....#
#* \.\ .... \. ..  .....\ ....*@.***.*.\..\ \ . .\.\.* \.*.\*..\   .\* .***. ..*\.#
#.  \**. .  .* . . *\   *  ..... \!.@ * . *\* .W*\. .@\ ..  . .*.    ..\...***.*..#
#  * @.  .   .*.*. . .\*. *   * *\ .**.. *\.. .........  \. ..\..*.*\.*    \.* .. #
#.*..\.\  .    *.*\. * .\.   .. . ..\. \..*. *\ * ..\.    ..***\ *... .\.  . ....*#
#.*.\..**. .*. ..@! **  *\**.*...*\* *  . .  .**\  \. . *\ .\. *..* \*... *  . . .#
#\*\.*\.\..* ....**.*..\.*.\*.. * .. .    .*  .*** . *.*.*.** **.  * .\*. *\*\ ! *#
# ! *\... *. \. \\.***   .\* *.*\.  ..... .*\\ ...  \*. .*.*\\.*.   . ..\ .*.* . *#
#\\\.\*. *.*\..\   . .**   * **..*   * ..*.* *.   * .. * ...  *...**\ .  * .\*\*\*#
#..\..*  .\.*\ .\.*   **.**.  * ..***.*. ..\ ...\..\ *. .*.*\.. . *.***\*. .. .\..#
#*.  .\..*.*...\.*.  ..* ...**.\  . .*. *****\.@.*\.*.*... *..*   .\..*.*. .   .\.#
#. .. *\ .*.. . \*W *  *    \...*.*\\ .**..**\ .. .*.**. * .*.. \..   \...* *  ..*#
#*\**.. .   .. . .*\.\ * .  .\.\.* * * \\..*.\. *\ .*.*\\\..\  **.   ..\ *.*\.* * #
#.**.**. .\    . *.\  . \* ...*  .*..\ . . ..   ... !*\  * .*.**...   . .**\. *.. #
#\.*..*.. .*....  .*   **..  .* .!\** *.*  *\ \ *\*.    \\ . .**\.  \  . *\ **\.  #
#.   . ****.\.. *.**  .@*.  \ .. **\. *\.*.. \. ....*..\ *\.. *\.\ *.  .*. .*   . #
#.*.\.\**.. .  .* *.*. .*. * ..* *.  .\...  . . \*\\*.. .\..  ..  \.\*  *   .. .. #
# W..*....*\**.* *\..* .. \.. **\.\*\*. \ .**.\..\ ....  *\ .* \   \*..\.* .\.\.\ #
#\.\ . * \. *. ..\ \ . *.  .   * \.. ..  .  ...\  \** .@\** .... \.. \* .\**\*. ..#
#*\    \ .**. ..  *.\  ** \...@ .....*..\ ..*. * *.*.\*...\ *..  .\  W  .* . .*.\.#
#*.\.*.\. *.*.** .**   ..*** ...   *. .    ..@...\  *   ****.* . .. @\.......\ .  #
#**\..*\ *\.*.\.* .\* .  \..\..!.   ..\*\.* \.*\*\* .\\**\\ **.***. . \..!*   .\. #
#*@*....*.* *\ .*....* *..\ .\ .. .....\ *  . .....   *\ *.*\.\.**\..!.*\ ... *.. #
#*..  .  .. .*. **. \*.\. *.   \.  \\\...****.\ ..* ..* \  \ *\ *. ..\ .*   . . . #
#..@ *   . . * *.  * *\   \..  *.. .*.*... .  *.* . .** ..\..* ...* \.\ .. .** \ *#
#*** \\\\ ..\ **.* . .   .  . ...*.. *.\!*.  ...*  * .. *\*W *.. \. .\.. \ *.* *..#
#\\.  ...  .* *\* *.*...*...* @\ . . \ **.@.* ..\ ..\.\** ** .. *.. *..*   .....**#
#**  .*. .\..**...\*.\.*..*\. .   ...*..\ \.. * .*\ .@.\*.*.. ..... \.*. .* * .*. #
#*  \\.\. . \... \..\ *.**.*\** .* \ .*.*\.!\*. *.  ..*.  .**\  . ..\ *** *\.*\!\*#
#   ...\ ... ***.  . .\ ...\. **\ ... .... *  \.. . .*\\.**.\. .   ..*. *\.**\  **#
#.* *\.**.\..... .. .**\  .*. .. *\ **\.*\.* *.\ *\.\*   ... **.. ..\.* *\ ..*\ . #
#**. **... .. . *\   ...... **  ..\*\..\. *\.\ *\.. **\.**.  .. * .. ..  *\ \* .**#
#..\.*\   .\*.. *.\. !\.   ...  .. * *\. .\.*. \.  E* **.... .*..* ..*\*..*.\!.*. #
#.  .. .*  *!  ..  \ ..  ...\*  . **\. .\ *.\. .. .* \.. .*. \...*.**.... .. ...* #
#\*.\   .  ** ..*. .  \ . \*..  . . ..\*.*.\. .****...\. *. \*! ..*\.*** \.\ *\*\\#
#  * ..**. *.\.*..   .*.\ .*. *.*. * . **.   \ ..***** *   \.*.. ..\ .*..  .   * .#
#\.*  *....*\. *\..*.\**.\ \*.\* * *\  \      * \.. .\ \ . !**..   *. *.  \. * . \#
#  .\ . .\*. \ \.. .....  *.\* . .*...\.*    *. .   .**..*\ ..**.\* . *.  \ *.*.*.#
#** *\*\*..\  . *.\.**** *.**.* .\..**\.. *. W*\   *\..\..* \ .  **\**\. . .. *.. #
#\.\. ....  .\**.\! .\*.\**.* *  .*.*\.\  * . ..  ...  * ..*     .. .\ *.** **. . #
#..*. \.**.  \*.. \ . ..\.\ * .*...\..**.\*..**.*.. * \..\\*** \.. *\.!.. . .. .**#
# \..\. .\.*\.*..* \   .*..\.... **..@*\\..* . \.* ** . .* ..**. * *\. ... .*! \. #
# ..\    .*\. \ .....\. .\*..  ** *..... * ...*@\*..   .*.\. ..**.\...  .  .. .!\!#
#\ ...*.*\W   . .. *   *@* *. **. . **. . . **.*.\.***   ...  * .* .* . \     .\..#
#\.   ...  \.\ . **** ...\..  .* . *.*  ..*.\\**.  .*.  @..**\.  *  .  ... .\... .#
#.\. *.\  * **.@....\...*.  \..   .\..\.      *  *.\.* . .* .**.*. *. \\. . @**\. #
# * *.  ..*  .*.  \ .\*... .! \. .@.\..**..*.\..*. .*.  *... . .....\\ ...*..\** .#
#\.**.**  . \\.  **.*.. . * **.  !*.W\ .......*.\.. * \ ..\*\     .. * *\. . ** .\#
#*  * \*.*. ..* .....\* . . *. . .**.*\.. *.... **..\  .\. .. .  @***. .  * \  .\ #
#\*@\ .\.*\\....* ..**. .*  ****. 1*.*.\ .\*   \*. *. **.** ..*\..*** ..\**  . .* #
#**.\\ . . **..  *\*@. *.. \.***. **.*\.**\. *@..**. .@\ .\.*... .*.* .  .*..*. . #
#.*.*.... ..*.. ***...***.W!..\**.*...*..\  .*. *.. *..* . .\    *..  ..**..\***\*#
#.   * . ....  .* \** ..*. .   . .**.*...**\*\*.*\      .\..*. .*\* .. .*.. . .** #
#\. *.   .. *.* .*..* . **. \*\.  ..\*. ..@.* . ..* .*. *..*. \ ... *\\... **..**.#
#. .\\... *  .    . .. .*.*..   .. *.. . \.    \....*.*. ...*    .\ \  .\ *\**\.\ #
#  **.  \*..*.\.   **\   ..*. * .*..    ..* .**. ..*. *.\*...\**\ .* *..... \..*. #
# *.** * ...* . . ..\.\.*. *..\\***  ..\\ . @*.\  .. .* !  \ .@. * ..** *. . .*..\#
#.*@.. *.  **.\. ***.   *.\* ..  ... .**..**... .*** ***.*..  * *.! .\* .*. . .. .#
#\.  \.... * .  .*.... **...     .@**\   *...   .* ..\*..  . **..    ** W. .*\ .. #
#* *..***\   \  ..  .\..*.\.\. * **\\.  .*!* *.*..\**.. \*. **..  ..*\\* \  .  * \#
# * \.*. *. ....*.**\ .\.  \   .....\.. \...*.*\.*..\*  **.*\ \*. .\ .  ..*  .\   #
#\... ** .. .@\ **...*\* ** .*.* ..\ \*\.   . ...\ \ .\.\A\..\ ... ... **.* .@\ ..#
# \...**** .*...\  \..*  .*  . \\\.\.\. ..*. *\.\ \. .  *. **\.*.....***.*. **..* #
#. *.... *\*.\*@*.\** .*. \.\\ .*.*  *\* *.  .\  *.\ .  .  .*.*\.*.  ...*... .. *.#
#. . ...*.@ ..5.*\ . . . *\  *  ........ ..\*.*. .. .*..* .. .\ .\.     . \.  \.**#
#. ..*.\.**.* \     .\ *..* *.**.\ *.\*.*. . \**. \..\...\...*  ..\..  ... *\ .*.\#
# .  .\.\. .. \.\..    . **.\..*.. * *. .  *@ .....*  * ..\ .*\*. .*.. .\ *. \ * .#
# . \... .*\. ...*..*\.*.. *.* .\  .***.!\ . \ @  ..\..\*\ \\.   **\\. .. \..\.\..#
# .*\*\* *.... \.. .\..\**.***..* **. .. ***\\.   *.. *.*.  ** *.*..   .*.\ \... *#
#\. .\ .\ \.\  ......\.......\*..*.\..  .\.*.*  \..*.*.     ...\ *.\  .*..  .\ . .#
# .\*.** **..\... ..\.. .** .**  .\     @.\.  *...  *\ ...** . \*.   *..\ .  *.***#
#\...  . . .  *.*. .*B * .*\ *\** \ *\ ...\  .. ... .. *  *...\ ** \..    *.  \..*#
#*. ...\  *..*...*  .  * ..**.**.. .*.. .*.  \......*..\ \ * .. .* .*\.  .  . *..*#
#. *  . .  ** . *. * \ .\.*.* .. * ***.*\.* .. ..\. **.*..\!* .*.*  .  . \ *****..#
# .* \.. **** \@.*.\ .. .\.*..\ ..  *.. *..\.. *\ ..* ***\ *.! ..* *.*.\ .*..**.*.#
# ..\.  \...* \. * .!**.  *..  \ .. .\.\.. .*.\\. .*.\......**\. .\.. ...  **.* .*#
# *..* .  \ ...\ ..\..*...\*.***. C\\**..*\*.. . * .D ...\. *\. ... .\ .**\..*.\ \#
# .\*.. . ..*.\* *..  \** . *.\.@  * . .*. *. . ..* ..  ..*... . .*  ...*. ....\ .#
# * .  *   *.  . \.  .*....\..* ......*\.   .. *  ...\* ... \ \   ..\. ..      . *#
#*\ **..*.. ......*. ... ....@\ \ . .*..* *.*. \ . .. * .*\* . *.* *.. .  *  \  *.#
#. *!. \. \.* *.\..\*W ..\ .*\....**\*...*...*.   **\ * .\..  *.*.. .  ..\* \*....#
#*.... !\...**.*. ... *.  .. . \.\**.....*.*..\.*\*   .. . *..* *\*.**  *.** ..* *#
#.\.\ . ..\\..  *. * .*\* \  .* ****\..\.  ..* .\.. @   ..\.W \ ..**.*  .... \ ...#
#\ . \..\ * *!*\. .**\  \ .. *.\ **\*. **\*.\....\ ..  ...*\.\.\*.\. *. * . \.\.. #
#.* *.\..\. ..*. . ....*..**. *.\...\\\*...* * .\  \.*..\ \...\*\  .  ..*   .\*** #
#\.\ .*...*.\ .\ .  \ .*....  .\*  *** .\.***. ..... .*\*  ..\.....\ *  .. .\..*.\#
# \.\....*.. .***  *...**.**\.*.*\*..  * .\** **.  *.\.  \.\ ...\. *\. . \  @\ \*.#
#  .\\  \. . .. ..*\  \.*\..* .\      *. . \  \.  *.  *\ . .   \.\. ..*@..\ *. * *#
#   \  .. .\  \. *.... .* *.\ * . . . .  .* \. .\..**.\*\.  *  .*....\.\\.**.*.***#
#**   \**  *\\ *.*   **...\   \.  *\*. .\.* ..*\*\ *. .**.**.  ..*\ .   *.*.\. **.#
#...  .*.\..*. *..***. ...  .*..*\.  . .  *...\ ..*.** *......  \.@...\.\ . W**!.\#
#.  .\...*\. ****\.. ..\*    *  ...\*  .  . .*   *\***\\**    *.*..\.* \. .. *\ ..#
#\*.*.*.\*  \.***.\* .\ ..\. *  ....*. \\.\..! * . \.  ... .\.\\   *\. . .\... *\*#
#\.*\ \. .  @ ...\.*.*. \. *....\**\.\..*.*\\..*\ . *** . ..*\  **\  .**  .\.  \.*#
#.\ ..**.\..\  *..\* . ..*\.!** .. \ *. *\\..*...\   *. . \\*.**** .\.*.*\ .\ .. .#
#\..* @\. *..\... .*.* ..*\**\. .\...\ .\.  ..*  .* .\.R! .*. *..*   *..\.*.@. . .#
# ..! *.  *\ \.*\ .*\\\. . ...* **.  ...\ ..  *  ..**.  **.*\. *.  \ .. ...\*** ! #
# \.* .**. \.W .\.*\ .** ...*.\ * *. . *..**.** ...*. . \. ... . \ .. * .***..*.  #
#  *. ..**.. ..****@ * *  *  .**..  .. .**.....* \**.  *.@\*    \.\*..   ..** * .@#
# \     . ..\. **..\ .*.\ * ...\   .. ....\**. .\ .\**\..... \.*.\ *....**.*. ***.#
#...\...\. .* .\.* . .*\. * .  .**.*. \\  .*..\  \*.*..\.  ** .* **    .\.*. .*  .#
# \  .\ \*.*.   ...** **. .*\ . . **...**. ..  \ .  *.** \  \.** ..*. *\ .\ \ * . #
#\**    ....@..**....**.*.*... *  ..  *\@\.\.  .** .\....  \. **\*..  *.\ .. \*.  #
#**. . .\\ *  . .\.\.\* \   . ..*  .  ..\.\.*\ \...    .. ..  ..*.*.......**  .\..#
#..*...*@ .. ... *... . \. .. *.. * . ***\*..**   .*\ ....*\.\..\.* W.\  \..   * \#
#*   .\.*.!..\.\....\ ..**.  **.\*.. . . ** **.\*\..* .  .\ *.\.. *.**.    ..* \  #
#.\*\ ....\  *...\. ** *.. .\. . . \...\*. *\.. **.    \*   .***.***... **. .\... #
#\ *.  .. .*  *\ \\ \.*.**.**.... \.*.. .  .. \.** *  *. *  \ \...*.*.. .*\**..** #
#  *.  . ...* . *.. * * \*.\. .\*..  .. *...*. . \*.*  . . .. . .*\!.. .*\..\.. *.#
# .*    \ \..* .*\  .  . *. . .*....*.. ..* @\. *\\  . ..\  .*\.\... ..\** .*. .* #
#. . *.\ ..\.* *   ***  .\ . . .. .*.\*. .\*.. .\.  .  \.  * \*@ *..*\*.\.  \. .. #
# . ..*\ **... ...\*.. . .*.... .   \...\*!..\.    *.*! .\ ...... * **.\.* . *. ..#
#.\\ ... \.**.\**  \ .*.* . **..... .\.  ..*\ .\ ...*.\  .. . *.... .\*.  *\ *. * #
#\*..*** ...*   *\. .. *.\* .* .*.*. .\ !... *\\ ..\ * . **\* .*.  *. .\   * .****#
# . .W*. \ \. .. .*. .!*\ . .\  ***\  .. * ....*.\ *\** ... .  \..\.**\W. .  *...*#
#...*.. *.\ ..\  \..   ...* \*  \...*   \..  \ .   .*..\.\**  \* .* ...   .* . \ .#
# . \** \.*.*......**.\**....\.\.*  @  ...*   .\.  . ..\.  \.\. *..* *\.  .*.**   #
#  ....\  .*****..**.. * .\ **. .\*.*..\.. .  *\***\.\***.\.*.**.\..   ..**..*\*.*#
#*.. .*.  ..*... .*.* ** *.**\ * .\ . ..**. \**.*.. \ *. . **.* .* *.  .\..     .*#
#.    *\ * .@. \ **\..*. .*.. *.* !.\ *... @..\..*.  *. *. .\ !.*. ..\.\ .\.   .*\#
#\..*\.*\.\ .*** \.\....  ....\*.\*.*.\ *. **.. **.\*. ..* * *W\ ..\! .  \.. .. .*#
#.**\.\...\..***.*\   *  * .*. *. . \*  *.*.*.* ...*\*.*\**\ **. \..*. ** *\* !.* #
#*\...\  . *  ..  . .*.*\.*!*. \. *.*.. *.*\  .      ..**\*.\.*.\** .*.*. ...*.*..#
#. ..**. .*. \.*  .. !... *\ .*. @.**.\ \...\.  *..\  ..  . \..*\.* *.*. . \ * .\.#
# . ..*.\.. .\ ..**  *\* *.*.**\\..*. *\ \* *.. *   . *\ .*. \ \*\ ..\.*. .W*. *.*#
#  **....   \..***..  .......** . .*   @*  \. *.. \ ....\*  .*. .\ ...\*.\.\@\8\..#
# *\ *. \ \.*.. *\* ** *\ .  .**\  ..* ..!  ..*.* .   .  *.* *. \.*. \ . *... *.. #
# .! ! *... ..  *.\ .. . !   \.*..\* * .. . *.. ..  . . @*\*..\!*.\ . .**.**.. * *#
#* .\**.   .**\*\.. *. *    *\.***** .\.*  .*.\ \..* **....\*\*.. *    ****.. \*  #
#*  ..*. .. **.*..* ..\.\  .....\. . .\\* * ...*  ..\...*....*...*\. * !*\*. \.*  #
#*\@ ..*\   .* .. \ .\ ..\. . *..* *.*.\*.....\** !\ *..*!\  *.\** . ! ** . ..*. \#
#..   *.**.* .\* . ..  .  .....  * .\* *..**  *.. .. **.* ** \*...  \*.\.     ... #
#.**\*..\.. .  @..*  ..*  ..\.  .  ..* .*\*\ *. *..*. ..*\ \.*. . **.\ ** ..  .* .#
#..* ..* .\***\\ .  *...*\. *\   .  **\ . \*..\   .\ . ... .\..* .... ..*. \ . .\.#
# * ...* \.*.\.. ..*..\..*.\. **\. @....*.. ...* . **.\**.*  .*.* *\ \**..\..* **\#
###################################################################################

Water 0
Flooding 0
Waterproof 9
Razors 36
Growth 29
Trampoline A targets 1
Trampoline C targets 5
Trampoline B targets 8
Trampoline E targets 4
Trampoline D targets 4