##############################################################################################################################
#**.... *.\  *.\ .. *\\ @.. .*\** *.\*..*.* *\. *.**\.\.   ... .*.*. * *. !.*.. .*..*.\  ..  *.  . \* .....*\*##.# # \#      #
# .. \*.** . **\.\  .*.\** **.*.*  \.*** \...*.......    *    .*...  .  *..*...\.. **.\.*. . \ .\*. . .*.\***\\#**#\#.#      #
#.!.*\*\*\*. *. .   *.!  . \. .\.**   .*\* \...   ..    ..*..  .  \.... .* \.*  *\ *... .*. * *\**.  . **..*\.. ...*  L      #
#\.\..*  !.. *@ . *..\.  .\.\....**. .*\.*  .   *  \..\ \ . .*.\ * \. *.\.  *\*.!  ..*\*..* ..\.* ..   \...\ .**.# .##       #
#. **.\.\ .@\*** .*.\ *.. \     **.**..\...\   .\*.  *.*. .*\* !.\.\.*\\.. *.*.\*.* ....*!\.*  . . ! .. \\ \  \\  .*.#       #
#.*.\ ..  .* **  .* *.. ....*.  ..\.  .. *..  ...\*. *.\.\  .* ...\....* . \*.\ . .\..*\. .....  \. .@ \..\*   . .**.\#      #
# ...***\. ..\.\ **\. . \..\*  *. .**.** .. . .*. ..**\*.   *\ .   .** .  *.\.*. ...  . .. \. \... \*\W..# *\. * .\*.*.#     #
#*.   ..\.   .\  .\.\.*..***** ! ..* .*. .\** **\ . \ ... \\* . \ . .* * ..\.    *   *\ .  *..   * .** *. .. \*....\..**#    #
#.**.\ .*.... .**.*..*  * \. .  \ .. \\.. *\.\ ..*  . * .*..* * \ *  **.**  *. *\.* ...\ . .. .**.*..* . *.!*.. *.*.*\**.##  #
# .\*.  .... **.* @ ..  .  \...\ ..\*W.*  .. *.*..**  *.*...*.. ... ...  . \ * . ****....\..\   .\.\ .  .\. .. **. ..\.\#..# #
#\* .\  **.....*..   *.  **  *\*.\*  .    .* . .!.\.. .... *..* *\.   \.* .* ..*..***.  *. \.\  *. . .. *.. .\.*.\ .    \.####
#*.*\ *\ ...\ .*  . *... ..\*... . \...*..\. . ..\. **\**\.*. . *. .\* \.\.* \ \*.. ... .  .   *..   ** .*.\*.**. ****...\\  #
#***... **! !..*.*. .  * .\  .*\.*   **.... .** *@. ..**.*\\. **\ \.   \*  ..*...* *.* .. . .... **..\..*.\.....***..\ . ..###
#\ \\  ....\*. . .  .\.\ *.*.*..\.  .*\**\.***. **.* *.@\..\.** *    .**..!  .*.\*..**..*\..  \*  . \**... .** *..\ !.  ##.# #
#.  \**.  **.*. ***    **....  \ .   ... *. *.  .\..\.**  ***..** .....*.  \...* .  .. ..*. \ .*. * W ..\*  ..**\*...* #  #  #
# \ .*\..* *\* .* .*  .... *    \ .  . **.*  ..*\ *  .*. ...   .*.**.. \.. ... .!*.*W\.*.!  *\ \*.*** .\ . .* *.*.\.\.\ #    #
# .*.*.. . * ** . **\ \.*.*****\ *\ . *. **..  \*****.*.\*.*. . ..*.\ *. .. *.   . .\ . .. ..*.... .*@** .\**  \.. .* #.*#   #
#*..  .. .\.*...!..\\***. .* . ..*** \. *\*   ..*...\...\. !\  . \. ** *. \  .\ \ *.* ... . ... *.*... * * . \\.\.* ..*..#   #
#.* @**.\..\.* .\\.@.*.*.\\. ......*.. *..*.  . .\  .  ** * .*....**\ ......\\\*\ . * \..*   .*.*..*..*\** \ ....  .* ..#    #
#\\\*\.  ..  .\* * *\*.\....\**.\*..W\.*.*.*.*** .\  . .\\*\**.***.W.\.!\\  !\ ... W. @*.*\ .*.@\..!..\\..\ ... ...*...\#    #
#*.W.**. .\.*.\. .  .***.. *..* .\**   ..* *.*...  \*\ ..*** ..\. *.\@*....\.  *..* .. * . *......*!  ..  .\.*\.**\..#.###   #
#.*  \..  . ..*. ....*....**. ..**\.\ .  \ ..** ..*....**.*.*\  *... ..*\ .* .*\  * **   . .. .*  *.*   .**....\.@* .. # .#  #
#\.**.  .  . *. *.\......*.*. \ ...***\!.*.*\.*.   W..\*.*\ ... *  ....\. .\\ .  ...\.**. * . ..*.*\. *..*.*  * .... . \*#   #
# ....* \. *. .**. **\ **\ .* . .* * \  .\ .. .   R**. **\*\  . .*.* .*. \* . .** *\*\.*... .**\  *..**  * . *.*\*  *. ##    #
##############################################################################################################################

Water 24
Flooding 11
Waterproof 12
Razors 40
Growth 36
