###################
#    # ##L        #
#   ##.*.*##      #
#  #\# **.#.#   ###
# ##.  . . .####\*#
##.#\. .\* * ..  ##
# ***.! .\ .\. .#\#
###..* *.  .*...\.#
#*#  *\  ..\... *.#
#.  *.**.* .*.*#.##
##.#.**.\. .\..!..#
# \ \.*\.* #.. ...#
#.  . ..\.  \\.. *#
#.*. ..\  **\ .. .#
#\.\.. .\ .  .  \ #
#.**..*  **.\*  ..#
#..!**.\**.**. \  #
#*\*..*\.\\.....  #
#. .. . .*.*. ***.#
#  * *.*.. .  .\.*#
# .. !..*    *.*.\#
#  *\.\ * .* .   \#
#\*...*** .**   .*#
# .\...*.**. \...*#
#  ..*.\ ..**.  .*#
#\*  \...*@ ..\. *#
#...\!..** ! **\ *#
# .  .\ .  .\..\*.#
#\*\   ..\.***\...#
#...***...  *\  ..#
#  .* ***.\*..\* *#
#\**. . ..*** ..*.#
#..*  \ ..*.** *. #
#  .*.  *.* * **..#
#*.... ..**\. .*  #
#* **. \ .\. ... .#
#\ *. . . **W*\..\#
#.*  .* \. .**\!  #
#** .. . .  ..W\. #
#\. ..**.*\ . *.* #
# ..\.*\@.** *...*#
#  . .*.*\.. .*  *#
#\*.\ **@***.*R.*.#
#.* \.\ ..\.**! * #
###################

Water 0
Flooding 0
Waterproof 14
Razors 43
Growth 23
