########################################################################
#                                      # #                             #
#                                   # ##\#  ####                       #
#                                  #*#\ *.##..  #                      #
#                                 #\** .####\##*#   #                  #
#                                 #*# .*##  .# . ###.#                 #
#                                ##\.* *.# *. .\*.  .#                 #
#                            #  L...#..**\ \. ... .*##                 #
#                           # ##\*#*   . ....\** .*!*.#                #
#                       ## #* .*. .* .. *\.\  **. . *#####             #
#                      #* ###* *.\ .   .* \*\.. .*#\.***\.#            #
#                #     #\*#.  #*\... *.*. .* ** *##*\.. ##             #
#            ## #.# ###*.. .\ \. ...\*.** \ **  .*...#\..*#            #
#           #.\##\## * ..*!# \  ! ..\...\ ....\... **. * #*## #        #
#           # ##. *.*.\*\#.   *.**  .\**....\\.* .... .##**. #.#       #
#           # #*  ..* **.. \* *. \  . *.     * \ .  \.\.#*#\#..#       #
#    ##     #  #.  .**.*.@... . \ * .\. *\* .! .@\**. @.#\ \*.#   ## # #
#   #.\##    #\..*.*.*.. .*** ....*..* .*\* .\..* @\. *!..*... # #..#\##
#  #.*##.# ##..  .\\ .\ .\\....\.W\.*.   ..*..\. . .*\*\*.* \*.*#\ .\.##
#  #!*\* ##..   **.. .. *.  ..  .*.*     *.  @  \ .\  \*..* .*\#.**.#. #
# #**.###.\ *\  .*\  *..*.\ .* .\ \. .* .\* *. ..* **...*.**.**.\\.*  ##
##.*.\*.**..\* ....*\*** .! .  .*. . *.*. .*. **\. \*.#\.*.. ..\* #..# #
###*\.*  *!\ \  .  ***..  *\*@.. .. .*.*\. .* .  .   ...*\ \  *..\. .###
#.\D* \  .* . *.*.*\.\ ..\*....\* .  .\... .*\ .\.\\ #.*\.\ .*.*\ *.#..#
#*. .*#.  ..*  ..***.\.*.*   .\ *\..   .... \.  .*.@.. ....\*. .* **\.##
#..  .    * .**.\**.\*..*\** * .*... ..\    *..... \  .. .  *\ \* .*.# #
#\ * * *.\\.**.  **\. **.!*.    .*W. . ..** *. *. * \.*\. \.*. \** .\.##
#. * \ . * !**.   ..\** ..*  *.@.. .*\ .*...* @..*\.. \    ..   .\.\.\.#
#  .    *\.\...*\*4.... . * \.\*.\ ***.@* **. . !.\   . *..\\.  .**# # #
#*\. \... *  ***.*.\  ****. *\ ....****   ... ..\.\.* \...*.*.  ..*.\#\#
#. .   . * **..\..**. \..\  ...\ ...* .. *..*@ .*\ *...\..*.*. . \\.. ##
#...\.  .. . \ .**..* ..  ..\.*@...*.\* .\ **..*** *\  .*\. .. \.\ *..*#
# *\*..  .\***.\.*\ .\** ..\*. \.* .*..** .   **\*\*\.* *.*...*... # W.#
#\A..  \...*..  .*..*\.*\.@..  ...  * \ .  .\..\..*** \.*\...\*  . *. .#
#.* .*.   .*.*  ..  ****.\  .. .  *..\***.\ . . \.*\.   \. @  **\.. ..##
# *\.\**\ ***....  ... .  .**  ..\.    *.* \ ..* *. . . ..\.  \...**. .#
#.**  **\...*\.  \* .  ..  .. .*.  *\ ***\ !.*\*.\..\.*..*.....*....* \#
#*** ..\. \.\.*.W   ***....\*. * . .\ **...  ...   ..***.\. .  .\*  \ .#
#... !   \\*...**.\ ..\**\  *\ *..  . ...\  . *. \***\*.  \.*  ... . . #
#  .  \*.*.\*\*.\..\...**... * ******.   ...  .. ..\..!** ..\.. \..****#
#\  **...  * .*.   *\   . ..*\.   ***. \*..* .*\    ..\...\\.\ .. \ \*\#
#   *.. *.*\ ..**\ .** \.*... . . \*..  . \.* .*  .****R*.*  .* . \  \.#
#  \.....\*.@ *..** **.\ *.***..* .\. .*.  \*\*. \ *. . ... . ** ..\ .\#
#.*... *.   ... ..*. \ .* \..*..*  . .* ** ..\**\.*. \ . *.  *\ .  **.*#
# * ...*  .\.  ...\.\...**.\**..  *  *. ..  \.    .\*.\*....  .\** .. .#
#**.\\*.. *. .  *..\*.. .\.*.. . ** *\.  . *..* \ .*.\ ....\\.*.\*. \.\#
#.\. *.*  ..\.... *\..* *.\\\\...*. . .   **!\.   .. .... .* .@ ****.* #
# .*.. .* \ .\.  ***. ..\* \ .\\@. .*..\**.\ .      *.. . * .\. . .*...#
#* **...   .**\  ...  ...*  .\.* *  . ...*. \*@ . * *\\*..* .  .*.\*\. #
#.*.\* **  \.*  *  . \  .*\  \.* * .** *** ...*.* *  *\..\*.\**.*\     #
#   **!.. ...  \  .!.  *  * .  . *  *\...**.....\ *.... ... *..** .*. *#
# . .**....*    ...   .*..*.*.. \..!*\@.\ @ *..... . .**\ \*.* .***....#
#**.  .\ \** \   *\**.*** !*..    ..\*.**\....*\ \ .**** ...*..\ **.\**#
#. \*.*   .....*** .* ... *. .* .*.*.. *.  . *** *....\.   .** * .*..\ #
# ... ...*.*. ...\ .. ...\.  *. ...*  *   .. *..*. * *.!.*.!**.*.*.    #
#  . \ \ .\*  .....*...* \  .  . . . *. *. \ .*\.\ \ *. **... ....**  .#
# * *...  ** @  \.\.** . ..*  * .\  . .. ..... *.* *. .\ .  ...  @\*. .#
#\ .\ ****..\.\..\ \! \ \*.*  ** ...* * . ** .\*.   .**.\.\ *.\ .\ ... #
#*.\ \  *\\*. *... **\.  ....\.*  *.*\*..*\  ... \ .*.* . **..\   *. .*#
#.B!. .\.**   . *  .*.@ *.\. . *  \*. . .*..*.  \..\...\ .... . .\\ .* #
#*  .*.\.*....*.\*.   * .\..\ .. . .  \ .*.**.. .*.*.  . **\ \ .*. . .*#
#\  *. ..\*.\*. \\ .*  .**....\*\. * ..\  .... \..*   ** .\ *..*   \..*#
#.  .**\.. \*.\* * ** ..\.*\ .*  * .  . \*.    * *.   \*   *. *C   .\.*#
# .. .\ .   \****..\..\*..\ *   ..* . .\..  \**. \ *.   .\\.\ *.\. . *\#
#**  ** *\ \.* ...\* * . * *.* \*\**  \.\ .. ...\  .\ \    **..*. *  ..#
# .  \*** .*** *.\ \ *\     *.* . *.\ .. .\\.......\.*.!\ \.* .*... \\ #
#\ * .*...*.*. * *\@.\** **.*\  . *.  \  .  ..\  ..* **..  **  *. \**  #
#. ..* *\** *. . *\*  ...\*..   *\*.*\  *** .  * .\\......\*.*..  . \. #
#\  .**\*.....   ! .*\\  .@*. \.... .\..*\. ..  ....\*. . *.*.  !..*.\.#
#\ .\.\ \ .. **5.. ...!***.**\. *. .*. ....**\*.  * ** *..\* .** .*..  #
#*. .. .. * *.*.. ..     .*..*  . . .*.*.*\.\.\..\.\\*.. .... *.. \**. #
#...*   .  \  .. . * .*.. .*.!..\ *\ *\* .*\  * \. **.* ..*.\... . .**.#
#\..!.**. ...**..\\.*   * .* *.***.. \..\.*\ *.. *\\ ..*.*\**  *. . .\ #
#..\. .. .\.\ \ *... \  . *..*  \.**. .\..**\.  ..    \.\..!...*\ ** .##
#....\*.*. \* . .\ \ .. **.  *\ ..** .\.@  *. **  .  . .@ ...*\  *.\.**#
#\\. .*...* ....*  .. ..**. .\..  .*. * *.\.*.\.*.**.**@.. *....\.. .\.#
# .. \*  .... \  .\\*    *. *  * *\\.\\*  .*.*\ .\*  ..**. .* .\. *\ * #
#*\..**.   \.*.*\.**.* *.. * .. ... *. *.*** .\ ..*..***.* .\  . .*. ..#
#.* .\.**..6..**..** *.**.\.  . \ \.. ..  *.\*..\..\W..* \ * \.*. .\.*.#
#\ \\***..***\..  *.\.*..\. @*\ !.* * .  *.\**.*.... .\.**.* *\\ .\ ..\#
########################################################################

Water 0
Flooding 0
Waterproof 14
Razors 41
Growth 11
Trampoline A targets 4
Trampoline C targets 5
Trampoline B targets 5
Trampoline D targets 6