##################
#....\  ..*W.*.*.#
#..\.. *   * . *\#
#B.  * **\ *  *. #
# . \\......\...*#
#* \.... .  .. *.#
#\ .*..*  ..\**. #
#*  .   \.   ..**#
#.  *\.*...*  *..#
#*  .. . * * *.*.#
#\  **.\*.*. ..  #
#*. .*\ \\ *.*.*.#
#@..  .... \*.\. #
#**.  * ** .. *.\#
#*..**\ \.  *\* .#
#.. .5*..\ \.*.\ #
#. *..* *.. !..* #
# .*  .... .  *  #
#....* **..**.*\*#
# .. ..... .\.\*.#
#.*. *.   ..\..\!#
#... ....*\*.** .#
#  . .......\...*#
#.**..\ ...\*..\.#
#.. .A*  . *.*. .#
#.* 4*.*\\.. ...*#
#\.... ..\..!** .#
# ..*\.\.  *\*. .#
#.\.* * *\*.\\\..#
#..* ..\...*.*...#
#.\. \..   ..\  *#
#**.  . \ \  .*\ #
#\.  \\.. .*.... #
#.\.\ . ***** . *#
#*  .** . ..* ...#
#* . .. \.\ \ **\#
#.\.**.*.\* .**\ #
#\W...\.**.. .  .#
# *..\. ..* * \*.#
#*. .     . . ...#
#*\   ....*.** *\#
#.\*.. . .\..\ .*#
#*.** \*\ **  .\.#
#..\....  ..\. . #
# \**.**..\  *.\.#
# ...\*.*. *  ***#
#\.*. . . **.  *.#
#    .**. \** .* #
#\\  ..**... **. #
#  * .\.. . *@.. #
#\ *... !\.*\.. .#
# **.\*.  ..  ..*#
# . *  . \\ .**..#
#*. *. .\..* ..\.#
#.....  9 **   .\#
#* .\.  ...* .C .#
#...*.\  .*\     #
#*  ....* . *.\.*#
#..\ .***  *R.*..#
#\.   ..W\  .\.*.#
#. *. ..\* *. . *#
#\ ... * **\. *..#
#*\...  . ..* .  #
#\.*.!.* ** *\   #
#* ***.*.\..*...*#
#*\...**@.\ \ **.#
#  .* .\ .  . *  #
# ..* \.**..*.*..#
#\  \*!.\..\. *\\#
#.  .  \      ..*#
#\  *...** *.\.\ #
# \ .!.*.... . . #
#.!  ... ..*..  .#
#.. .*.*.* . *   #
#\ \ .\ ** .\.  *#
#..\ *... *..\   #
# . ..   .....* *#
#\. \..*   \ .*..#
#...\**\***. *...#
# * ...*.\**...  #
#*\ .. \*..*   . #
#. ...* .. .*. .\#
#\\*\!** . .... *#
# .**...  .    .\#
#  ...  .*.   .  #
#\ . .*  *.*\.** #
#.  .. *\.*!.*.*.#
#....\*\.. \.\...#
#. .* *.  *   ..*#
#*\ . ..\**..@ \*#
#. *   *.....\ **#
#*\   .\. **.. ..#
#* \.**.   . .\ \#
#. .\..\ ...  .W.#
#* .**.* \.\*\ \ #
#.\\.*.\*.*.. ..\#
# \ *.. .... .***#
# . \* *. **.***.#
# \..\ ...*  ....#
# !*\ *....\ \*\ #
#*.\ \* *..   \*.#
#*   ..\. . . \**#
#.    **. !... .\#
# .  .*.\**. . \.#
#  . ..* .\.   W*#
#. *.  .\  \*\.*.#
# *.\...*\.\. .. #
#*@ .*..\.*     \#
#*.\.**.. .\   *!#
#\..\.*\.*. ..**.#
# #W . ...  . *..#
#   #***  #. .*  #
#*.\ *.. ..** \.##
#.. .* \ *.*.\  !#
#* .*. *@.# . . ##
#\ #\  ..   .\*L #
#.\... #\.#.*.*.##
#***.. .**. .## ##
# \  *  ##.*#  # #
#. **#*\. *#     #
#*.#.####*.#     #
####*#   ##      #
##################

Water 2
Flooding 2
Waterproof 8
Razors 33
Growth 33
Trampoline A targets 9
Trampoline C targets 4
Trampoline B targets 5