#######
#\   *#
# ..**#
#..  *#
#\..R\#
# * *##
# *  ##
#*#\# #
#*##  #
#.L   #
#*#   #
#######