################
#*...*\. .* **.#
#.\ ..* **.  * #
#\ * .@** .. *.#
#*\. \.\*. .\* #
#.*.\ * . ..\\.#
#... \. **.\ * #
#\*.*.**. . *.\#
#.\*\..\  *. .*#
#.... ..\*  ...#
#\ * * .*. ..**#
# ..\! *. ....\#
# *..\!.  *  . #
#.*   *.*** \ *#
#.*.*  . .* ..*#
#.* . .. .* .\*#
# . .* .*..\. *#
#...**\ **.*\* #
#.  .\  . .*.* #
# *.**.....**\.#
# .  \. *\. *\ #
#\.. ...*\. . *#
# .* \*..*.. *\#
#. .\!.. *  .*!#
#*.  .\ ** *. @#
#    .  *. ... #
# \****.*\*\   #
#@...*.*..*... #
#*..@. ..\  .. #
#.* \    \ \* \#
# W* . \** . \ #
# \\. . ** .*.*#
# ..*\  ..  ..*#
#*.*\.*   *. **#
#\...R.* .** ..#
# * *.....**   #
#  \.*\*\ *\\..#
#\ .!**.*... * #
#*.****.*.. .**#
#**.*.. \. **. #
#.\*\*\*.*..*  #
#  . * . .. * \#
#.. .\.*\\ \...#
# **. *\..\. .*#
#.* *\...*.*..\#
#*. *. ... ..\ #
#. .\ .\.* \** #
#    * ..* .* *#
# .  \..... \..#
# .\..*  ..  . #
# *..\.**** .*.#
#*.\. ..\..\...#
#**.   \.*. *\ #
#.**\ \.*W* ...#
#**\.*. * . !\ #
#... . *.  ***.#
# .*. ... ...  #
# \.  . * . \**#
#*...* . .\ . .#
#.\.\ *. \*.   #
# ** \ * *.**!*#
# ....*. . .. \#
#\*\ ..**   ...#
#....* ..**  \\#
#..*.  .**\. ..#
#. . ..\.      #
#\!W***.*. . * #
#** . ..\  * . #
#*. *     .\ . #
#   .*.*..   * #
#* \ ..\.*.\.@\#
#*..   . .*....#
#.  .* .* * .* #
# \ .**..W..*. #
#.!. ..*\* ..**#
#.    * \ \* ..#
#  .**\...!\ * #
#*. \*... . .. #
#*.\..  . ...  #
#. *\. *.\. \*.#
# ..*  ...*\.\\#
#* ..**  ..\. *#
#* * *.*.* .  *#
#* . . . ..\ * #
#. *..* .\ ...\#
#*\. .\ \  .  .#
#.\  .  .**... #
#  \*\  \**** \#
#**.*..*.\*.\.##
#..*.* . .. * \#
#\* *\ ..\\* . #
#\....#\#  #\ .#
#.* L#...  \   #
# *\.##\*  *.\*#
##*##  ##\*.*..#
#\..# # ..\*# ##
## #   #*.*##\##
##.#  #...# # ##
# #    #..#  # #
#       # #    #
################

Water 0
Flooding 0
Waterproof 5
Razors 45
Growth 26
