##############
#*.\  \..*@ \#
#*\\ .  **\\##
#.* *.. *.* .#
#.....*\.*...#
# * ..\* ... #
#.\.   *\...*#
#\.  .. # .*##
#.. *    \.###
# **\..\..*. #
#*#**\*. *.\ #
#..#*    !.  #
#. .*R\*..\ .#
#####*..  L*##
#    #....#.##
#     #*\ ## #
#      #*#   #
#      #\#   #
##############

Water 14
Flooding 11
Waterproof 3
Razors 49
Growth 3
