##############################
#...\.\..*  *  .  .   .   ..\#
#\*. *!* . *...**.* .. .\  ..#
#**..\  .! . ....\*..!\  *  .#
#..\*..\ \.\*\  . \!*...**. .#
#\.* ...*..*..*.@* \.\\... ..#
# ..  * \***.*\..  .\  * . .!#
# .\.*. .*....@\. ....\*. .  #
#.** *..\.. .\*    *\ ..\ .  #
#  .  \** *  .     . *  *  \ #
#  ..  \. ..*\*... * . !..\.*#
#\ * ... .*\..* .\*  .@ ***.*#
#. *      .. ****  .**. **   #
# ..*. *. . .. .\.*.*\ **.*.\#
#**   .\ .\ *  . \*.. .\*.* .#
#.**. * ........ \**\* ..*...#
#\  * . .    *   .*.*......\*#
#! .@. \  **..*. *.  .**. ...#
#@\.\ .*  ** .\ *...  **..\**#
#\ . * . .*...   !\. ....\ * #
#.   .*.\ **\..*\*..*  . **..#
# \*\ .\ .*\  *.\*..!\*..**\ #
#*.... ..*.*. . .. .*..*.. ..#
#\  *..  .\**\ .* . ...\.** .#
#.\.!\. * ..\ .   *!*  \..\ .#
#  *\**  . ..\*\ ** *. *.... #
#.\*..* . .\* * *..*  *.. ! .#
#* .  *  ... .\ *W*.\...@. *.#
#.*. .*\ .*. *. *.*.* * \\. @#
#.. ...**.*\.\*.. .\...* .***#
# **\. .*.\*.\.\..**  \..*..\#
# .\\..\.  *..!.*\@ ...  \*  #
#\ **   . ......*....*\ ..*. #
#..*. . \.*.    *. . **.. .. #
# . * ****  \ *.*\  *.. ***\.#
#.\ . * **.\ \.* *. \!\ ...  #
#* \.*\.*  ..\ ....\....* \..#
# . .* .* *...**\. . . ..... #
#...\**..\* . *....  *.@\. .\#
#R  ..\\ .*  **. .*  ..** . \#
#\\ *\..* ..@* \..!..* !*  \ #
#* ..*  .  **.... .*..*.. *  #
#. . ***\..\***  . . *. *\...#
#  *\@****. *.\**   *.. ** .\#
# \ .\. ..**.****..*...*.\ .*#
#*..\. ***..**.\ @.*.\ *... *#
#. \. ***.*\**\.*** .*\ \ .*.#
#*. * 7.  .* @*.*\**\. .\***.#
#.\\....   A ..\*\.. \...*** #
#.* ..*\*... * . . ..\.  .*. #
# * .....  ... @ ..  * * *\  #
#.* * ..*\ . ... ...*\.\** .*#
#.** \ .. .*.** **...* ...\**#
#\.\....* ..*.* .. * .  * .**#
#  . .  !**!*\**  *.\  * \..*#
#..*\.\ \.\.*..\* **  .*..**.#
#  .......**.\* .***\.\.\.\.*#
#*. * *\*\..\.. ..*..  ...  *#
#\.*.   ..* W*!. .\..*...\\*.#
#* .\.*   .\...@**.*...   .. #
#. .. .\.  **\  *. *\.*. \ !.#
#*\  *  *.*!**.* . \* ....*. #
#.**. . .. *.*.\*  *\ * . ..*#
# **  *.. ..*  ..\  \.* \.*\*#
#.*. *.  . ....  \.*  * \.* .#
#* .**.. . ..**.\ .*  * !\.\ #
#\..\*.. *....\\\.\*. .*\  ..#
#. \.* ....* ..*.\.\.\ .* ...#
#* *.*. .\*. \@.\.*   ..\..**#
#* ....  * \*.*\.** *.*.  ..\#
#\*\ ..  .*.. ..\.* . \*..\**#
#... .  .*.. . . .** ...  ..*#
#* .\.\.\..* . ..  *\.\  \ ..#
#\ \. *. * *  * ..\.. .# #*\.#
#*.*.\....\.  ** . * *. \ \###
#*... *.\ ..* ..\* #. *   #.##
# *\.\**.\. * . *. .. . *  *##
#.**.** *   . . \. *## \. .* #
#**#.\... **\*\#.\#.*#.*#  .##
#*... . \ ..*.*\###**  \. \..#
##.*  \ . ****...*#.\#... @  #
#* .\ ..*  . ..\ .#.*.\# .#\##
#*\* * ** * . *#*\###\* . .*.#
#\..\.*..\   #.#.#  #*\*. ...#
#W *..*   ...\ ###   ####.####
#\.*   .** .*.W.\.#      #   #
## #\.!*\.\L \.*##           #
# .*   \ \##. ##             #
# *.#*..##  # #              #
#### .\#     #               #
#  #*\  #                    #
#   #. #                     #
#    #\#                     #
##############################

Water 0
Flooding 0
Waterproof 14
Razors 6
Growth 30
Trampoline A targets 7