##############
#     #\#  # #
#     #*###*##
#     #..\.*.#
#     # #.#*.#
#    #*    #*#
#    ##.* !\.#
#   #\#*\  *##
## ## W.* #\ #
#*# ##  #\#\.#
#\  *...*..#.#
#. *.\ \*L*\ #
#\*...#\.*4.*#
# .# .*  * . #
#*  ...  .\  #
#. .  *.. *..#
#\*   .. .\ *#
##* .*\.\ . .#
#\ . . *\ *\\#
#*.*. .. *\ .#
#..**.* .. .\#
#\. *.. \3 ..#
#..**....*.  #
#   \.\ **.\*#
#  .\ * *.*..#
#  \ *.*\.C E#
#\ .\. *.*..\#
#.  * **!* . #
#\. . . .\   #
# .7*.. \ * .#
#.\*  \   *\ #
#*.** . ***. #
#.** \  .* .*#
#*.* ... .  .#
#F*2  \. . **#
#*.*\* \ *.\.#
#*@\.*\.  . .#
#. . *  * \**#
#. ....*\*...#
# .\. **.A\.*#
#..**** \ **.#
#.  .***. B.\#
#.\..*..\ *. #
#**. *.... **#
#\.  .. .\\ *#
#*.*  .. . .\#
#... @ .. ..*#
#.* @...*. .\#
#.\ .@D .**..#
#.*. \.  .\R #
# .. .* . ** #
#\\ \ .\  *. #
#..*..*.\*. .#
#  . ** ..*..#
#\  ...*** .*#
# ** *.\\ *.*#
#\ . .. *\.. #
# *   @.* .* #
#\ .\ *\.!...#
#*.*.* . ..* #
##############

Water 0
Flooding 0
Waterproof 14
Razors 12
Growth 39
Trampoline A targets 4
Trampoline C targets 7
Trampoline B targets 4
Trampoline E targets 3
Trampoline D targets 4
Trampoline F targets 2