#################
# #.1#          #
#  # .#         #
#  #\.L         #
####..#         #
#. ....#        #
# \*.*#    #    #
#7.G9. #  # #   #
#6..\ # ##4..#  #
#\..*\E.*. *#   #
#F\ *A.... .B## #
#.. . \ C . #.\##
#*..*. * D\ 3 .*#
# ...R.\..#.*#.##
#\ *\* *\..*. *##
#################

Water 1
Flooding 1
Waterproof 8
Razors 13
Growth 40
Trampoline A targets 1
Trampoline C targets 6
Trampoline B targets 1
Trampoline E targets 4
Trampoline D targets 3
Trampoline G targets 9
Trampoline F targets 7