##########################################################################################################################################
#. *..****  *.* *.* . *.  .. \  .* ..  **... \.*. *\ !.*.  \ \*.\.\* .*\ . \*    ...\.*.*\.\ .  .*\.\. .\ ..    \**.\ \.    ** * *\\.... #
#...\.*. . .. ..**.   .\ ... .\**  . **\*.    .*. **.* .  ....* ...*\.*.*.* ..*.\.\....@.....  @ .. ... \.*  ...*. .*\.    *.*\....\**   #
#* ....* *.  . .\.*.*.... ..  ***....*...\@ .\ .. *. * \ \\*.\* .*  * * *..\.** * ..!. *!\. .\ .*     . \\  .\.. * \. . .W\*.**  .. .* .\#
#..\   \*. .\.. .  ..  * * .\ ..* **\*  \. . . ** ..\.  . @... ...*.*....\ **...   . .*  ** ..***  **  ..@. . ..*.@.   *   \....*\.. .   #
#.\   \..\  . .  ** .*..\****.  .*..   .  \  *.*.. ...  \\... .\ *\.*.**\.\.*  ..**    \.... !*...\.**.*\ \.  .**\*.. *.\   .\  . .\. .\ #
#.  **.. . .*.    ..\.***.*.*..  .**.\*.**.... * ... ** .\ ** .*...\  ..**. .\ \.\.. .\. **\ .\..\*  ..**.\**. **.* . .*.  \* * .\*   .. #
#* \..    .  .*..  .. \ \ *\ \.. \. *.. .. ..* *..**..*..* .\. ..** .  .\.. \...  .* \ **..*  .  *..\ .. ... .*\*....*.. .  .\  !*.*. * .#
#\.  .. .@\\ \*.*.\ \.W.. \ ..\ .. **  *\.\ \  .  .   .. .\.\.. .*\ ***. *.\. ..\@*..*\. **.\. W.\*\ . *.**\ .. .*  ..*.*.. *.. ...!\.   #
#  \ \.  *.* . \.* ...   *.. ....**!. *..***..\.  .     .\...\\.*.* . .*\.  . \..**.. *  *.  ... **..**.\  ..  * ***..* ..\*.\.  \...  \ #
# ..*. *\.\* *\ .*!\*\ * \.\* *..*.  .. .*... * .*..**\.  . .   . ..  \.*.\   *. .\. .  *.* *. . ... \.*..*\**  \.*. .*   @   \.  \.  *.\#
#. *.\*\...  ..  * . **..* *..*  .***\.**.**.\.  ..\.. \*.   ****  \.\. *\ .\**.*.*.\...* . ** *.\*  **. ***.* ..\. ..*   \.. .**..* **!.#
# .*\.*.*** ..\ \..\* .\ .\. ..*\**..!. . *. ! .\  . . .*  .\....*. * . ..   **.*\   .\.. **.. .@.*  \  *..R\.*\.*... . \ .*.  .. .*..*  #
#!\*...\..\..**........  @  . .* ...*   ***  .\ * .\   .. .\.. ..\....  \.  .* ..  *. *  .**!\ . \..\!\*. . * \. .      .  .* *** \... **#
#\***.\ .**.*.*\*. .\. ..*\***.**.  .  **\.\  !\** .  .  .. . *.\. .. @   . \.  .. ..\..\ \.*.. .\*  ... .. *\\.. ... .*.**\.*. **..*..*.#
#. * .**\.*\.   .. \ *!..\  . ..  ...\*.*  *\     **.   .   .      .*.*. * .* *\....*   *...\  . *... \.   \**.* **  * * . . .\**.* .. ..#
#. ****..!*.\ *** . *\ **\ @. *.\..\*..  \*\*. ...*.\@.\.! *..*. \** \. .\. * .. *. *   .*...... .*\.*.* ....* .\ **\.* .*. .!. .** .\. .#
#*  ...* W    *.** ..*.\\ .* *.@*. ...\ \.. *!. .  .. .*   *. \.*... . .\* !  . \@**.    ..  .* .\...\**.  . .  . *...\.  . *\...*..*... #
#\   \*. * .* **  \.*\   ...  *... \* ..*\.*.   * .*. *.* **\...*. *.\.\** * *\ ..... \\..\ *\  * \...*.  .*\.**. .*. *... @ \. .. \ .* *#
# .*...\* * . ...   .*.   \* ..*.  .\ * \.  .. *.\ \*\..\ ....\ \ .***. ..\.\. . * *. .\.   *   **.***. \ ...*\    ..**..\* \..*.**  **\.#
#\*.\* .. \ . \ \ .*.. *.\*\   .. *@...***...\ .\. ..* *..\ \.*..\*.*. *. .    **..\.  *\ .@*.\.* .\.. .*..\.. *.  . ..* .. **** .\  *.. #
# . .\  **. * .   \   *\. \...  *\. \. ..\..* *. .\. * .   ... ...* \.. ..* .   * .*\**@. ... .*.. . W\....  **...@* *  . ** *.*\.*  ..  #
#. ... .*...  .   .\. .*  .\ ***..\ .\.. ***.*..* .\.**\ *.\  ..\ .*.  .\  *.  \.  !.. . *.. ..  * * ...\\.  ...*\.. .  .\.. W   ..\   .\#
#.\ ..  ..\. .*\.***.\.. * . .**.   **\ *.*.  ** *.....\**\@ ..*\  ..***.\.*.**.  *..\.. *.*. \. .*. \ \*!.* *.*.**.*. ....*\ \.. \**\**.#
#\  *\. ..\*.    .**..*  .***.*..  !..*\*\\. .\* . *  *. \.\ *\ *** ..*\* .*..*   *.!   .! .*..*..**.. ...*..\ \.. ** .* *\.***.* ...*...#
#  ***.   ...\***.*.. .\ ....*. **..*W. ** *   .*  . .... * \   . *.. . .* *!*\ . ..\.  *   . .*.\...... *\. @....... *..*    *. .\*.. ..#
#\*\..\.*.    ..\..*\..  ... *! ..*\ .....\*\. *..* .\. .* ....*..\ . . .\ . * . \.*\*.** *** .**. .\.\..\   *...\*\*  ..*  .\  \..*.**. #
#*..\. *.\.. . . . .**  * *. *. .....*.*....*. ** ***..*.*  \*.*. .\ .*.\. ...*  . . . .* . . .\.* \.\.  *..*   .  ..** * \.... ..  !. .*#
#.\ .** *..*.  .\ ..\ * . . \.   .\ . @*** .*\..* *@...\.\  ..\ .....**.  .. \! \   .\.*.. ..  *.. **. * .*!    .\ . *..  .* \     .  **.#
# . . .. *W.*..  *  ..\.\. *.\...... \*\.. ***\..\*.\ ! .*.\...*\. .* * *. *.. *..*  . .\**. *...\. .. *. *\\..** . ... ...\. ...  \..*!.#
#W*.* .\* .*.  * \* \ *.*...\ *.**.   \**. \***. ** * !.*  .*\ .*..!*.\ *..\*\.*\** .**.*W\.@\*.\*.    \* .**\. .*. *  . ... \ .*.\* \.  #
#.\ \. .* ** . !... . .*.**\*.. ..*\ \  ..\..*.*\.* W *\..\***. . .  * * . .*.  .**. ..***.\!.*\ ..\.*\.*. ..*  \.\*. . *. *\.*.*..  ..\.#
#..*....*\*.**\   ..    **...*  \*. \. ..\** *. *.. .**.\ *... **.\   .* *\    \**.* **..* *...**..*\.. . .  ..\. ..***\!. . .. .\   . *.#
#  ..**\ \* *\.  ..**. ..*\** \\*.*\!. *\**\ \*.. .\ .\*..*..\...*.\.. .*.  *\.\  .  .\. * *.**..*\.*...*.*!. .   .*.\**.\  .* ..*  . *.*#
#\.* *\ \.**.  . *.*  .*\.**.. \..*.  .. *.....** *\ .!.  *.  .    ..    *. ... . .*... *.!...\  ... \\ \ *\*.*\...@.*\* **.@. . .\*\*\ .#
# ..*..\.**.. *.\.\.  **.*.  . .*\*.\\*. \ . *  .. . \. . .. *\*.\ . .**... \  .*. **. \ . \*   .\**.  *\*\.* *. \..**!\!    .* *  **..  #
#.\.*....... * \.   ..*.. .... ..\..*.....*...*\ \. .   *  .*.   . * \ .* *.. \ **\..\   .\..*\... *\  . .*\. *\ ..****.*\*. ..   \..\.**#
#\ \.** *\  ***..*  \.*.*. . **\\.* ..... .\.*. .. * *\*.  \. * \**. !.*. .  . ** * .*  ... ... * !\ . . **. ..*.. .. *....*.*\ *.   ...\#
# ..*.. . . .\. .\* ..**.*.. . \..*\   . \\ *.*... *\..*\ \ * *...\.. ...  * .\!\ . ..* . \..* . * *\..* *\   ** *  . .*... \. .\**. *.\ #
#*\ *...\*\  .* . .**\\*.*.  *\.  .... **.*.\.\ .*\. .. ..!.... * * .\.. *! . .  .*.\*.\. .*.. .*. ..* . .  \ ..*\.*   ..\  !**  ..*.**.\#
#* ...*\ *..   \ .**....\.\ \..\ .*    .*.\.**.\*. .\ .  .*\  \ ...  \. .\  *\\ *  . * .\.*.**. .**. .     .*.**\.*. .\ .\ .*\.\** \ *. .#
#@     !\. *. *  *.  .!.  . . . *..    ...*.\\ .\.\ ** .* .*. !  .\ \.   .  ..*\. *\. **\.***. \**..   .. .  ....\* .  \.   . *.***    *\#
#  .. ..@\**.*.\....* *  .    \.* ...* *\ * *. \  @.*.\*.  . ..* *.*W.\ .*.  *. .. ..\.*\ \. W.**\ ..**...\*  \.  * . \. ...**  * . **.*.#
# * *** . .  *...*..*.*.\ . \..** *. . .*..  . ..*\  . .\ * .* *\.....!\. * .\@\ \..**. . .* **.. .*. . **\. .\ *.* ....... *.*... \.. \ #
#.. .\.  *..\..  ...  .. * .*..*. **    * \.*.  \.   *...... .  . *\.*\. ... *..*.*\.**  \*. .. .\ **.*****\ *.* ** **.** .....   *.*.*. #
# *   .\*........**..\**\.\.**\ . *. .. .*.\ . \.**.*.... . .  ..\*..* \   .  \..*. \ .  \.. ..\ * *\ **\.. .*\\*\..*\*...\ \* . \..  ...#
#..\. *..\. *! **.\.  .* .*****.  ..\**.* *\..*..*..*...\  ...**.*. *.\. *.. ....* *\..\..@*.....\*  . ... .\.  ..  ....***\...* .***.*.\#
#.* ..\ .* \.  ..*  .  .*..\..!**... .. .*.  *.**.  . ..*.  .\ * .\.  *\  *\.. *\. *.*.*   .*\.*  . . .\ * *.\....*\   .*\.*!. .*..\**.  #
#.. .**.\* .  .   ..\.*. .\ ...**  .. *...*... ... * \ *.\.. .*.. .\ *\ .*  @\.\.*.* .  ..\.* *. ***..*  .\..    \. ..\ .*..\. *** ..**\ #
#\.*.*..*.  .  .....  * \ .\. *. @..\...\*. *.** .\    . * *\.\  * ..****.\ .. .. .. *   *..*. . * .  !\  .   .\*....*.... * . ..*\  *.. #
#.\ \  .* .   ..\.   \  \*.*\ *.\.*..  ..**....* .* ** . .....* *.*** *. . .    \..\*... ..\   \. \   .*\*\.\*  **!*..\ **\*\ * **. \*. *#
#*  . ..* *\. .*.\.*. .*@   ...\.\*..*  **.    .\.. .  \ **.**\  *.\. .*\ ..\  * \  ...   \****!\*.*.\ \.\  . \\.\ .*\ . .  ..*.* * . * *#
#.* .. .\*\.** .\  .\..*\ *. ... ..\.. **\.. *. ..* * ....\. . ....**  .**. \.......\ . \ . *@**\\.  .* * .  ..  .**** \   **..\* ..**. \#
# .\ . \  .\.*  .\*****\ . *.   .*\@* .  . * *.*\..\. **\ \*\*   \. \.* \\...**. *   * * . ..\*.**\.*.\\.\*.\*   \. ....* ***.\.*.  .... #
#....\*\ .* ..\. .\*.*.*  ..\.\. . ..*  *\ . \...**   .**\..*... .\*.....*. .\.  ..*.**.!. ..\.*\*...***. **\.. @.. *.\  .* ..  W. \*  ..#
#@.\*.\.* .*\        .\*.*\ **  \ . .*\.\    .*..*. .. .\.* .  ** * .*. .\*.. .. *  *.*. *.\..****.\..*\.... * \.\ \*\.\.*..  .* **.* ..*#
#. ..  . . * .* **.* *....*.\  @    \*.. *..*\.  * .  \.  ...**..\\  .\.***@  .......... *..*..\.*  ...  \ \ ...* ...  *.. ..* .\.. .* *.#
#.\* *.. ...... ** *** .. \**  .\ \   . .*@ .  ..\*  * *\*\ ....\.. *.\\.\\ *.@@.  *   *..*.* .** .@@.\ \ ...\. .*.\\ **\ .****. *\*.**  #
#\*...*  \  .*\  .*\ .\.. .**.*.*.. .\ .  *.  *  .*\*..*. *.. . . \.. . *.\*. *. .***\*\* **.  .**.** ...  .. .  .* ..*. \* *...**.. ..**#
#.*.  .*\..\  *.*...\ .\\...\*. .\. . *.* . .*.\ *... \..\.\..\ *   . * .* *..\. \*.**.*. \.*..\.. . .....\*...** . ..  **. **..\.  . \*.#
# *.  ..*  .* .\.**\.... .*\   . *  !.. *\ \\. . .. \  .**.*\.**. .   .*\.\ ..* \..  \ ..\ .. * *****\* .\ \* * ..@\..\\*.    *. *    . .#
# ...\..*\..@..* \  \ *.  .... *\ .*..\. *. .\  *\. ..*..*\ *\\*.** *\..* *..\* .\.*. .  \*  \**.\..\.\ . . \W*.. \.* .\\   . *.  ...\ ..#
#*. . * ..\..\..\.*..\***  .* *. \@..* * .\ \**...*  . . ..**\*.*\. *...  .\. . \*.. .*. .... .  .. **\* ... ...  . . \ .***...*\..* . . #
#*.**.  . .*  \.*.*   .* .    .*..*.*.  \ !**\.*\.. * *\ \. .* ...* ...*...*\*\ \..*  .. *    .*. *. ..*\  ..\  ..*.\. .**...** *. .* **\#
#.\.... **       *. . *.\ *.*.***.. .** .. \* ...  *. .  **.*. ......*..  .* ...  *.*    .@.. \.. !. *.*.*   .. \  \..\ .\* .\ *\.\ . .. #
#.   * .\ .\ *. **\*.\ .*.. *\.\.\ . *\  .  . !  \ **.  \\.\.*.. ..\* .*. *.\. . .*.\ *. ..* ..*.**\*..... \*    ...*  \ *. .. *...*..* \#
#\* \..*.*\..*..*.** .*\.*\*...*\.\ *\*.  \.     .*..** ..\ *....*  ..\ * \ . .*.****\...  .***.*\**..*.  *** \ .* *\ \ \.\ .  **...\.. .#
#* ..\.\ .   ..**\**.\ . ...  *\ \.\.* .... *\.\.*\.  @  *     \    .. ..* .*\..*\* . ** *\.**\..* \ .... *..\..   . .... * \.**.\.  \  .#
#*\\!. *\.. .\***\*.\..*.   ..*.*.*....@\ * .** ..*    .*\. .\* . \  *.\.. !** *.*.  ..\ \...* \ . .  * * .*\**\ \*  *  ...\.*.. .    \*\#
#.  . .\.* ..\   *  .\ \ **..\. \ .** ....\ \**.. .    .. .\ .*\* .. !.* *  .*.\...........* .* \  ...*\*.**..***.. .\@. \.*\...*. *.\. *#
#. \ .\. .* . \.\**.\.*..*. .*.  .** . . *. !.**  *.  .. *\. \*.*\ . \ @.  . ..  . *.* ..... .* . \****..  ** .*.****.... .* . .*\...*...#
# *..  \..*.\ .. *.\.*\ \.. *\.. \*... .\*\.  . \..@. * ..*.\.*\\.*  .*  \*. \ *  .**. \.     .* *.*.*. \ .*.\ *..**.. .  ..*.*.. .\ . \.#
#*. .**\.\.\.. .. \* **\.* ... .\.*..@. **\.  \ .\*.*\** *\..*.   . *.*   * ...\* . \. .*\ *  .  ..*. *..  . . ***.**. .*.. ..*... .\ ...#
#.\* *!.. . *.*.. . .\* *\*...\ * \  .\.*. * ....*.*..* **.  *.\.. .\ * .\.  .\.  . .. . *..  **. *\**\*\.*..*\W@*  .\ .*.*. \. ** **\.*.#
#* .    .\* ..\..*..*   \. *\ *.* .*.* ..\...\*.  .*    ..* .*\ ** .. ....*@.\*. . \ \ ..*\  *.\ ..**.*.* **\.  *..**. **.*...  .!*..@*.*#
#*.* .  * . \ . . ..*.*..*..  . *. .  . *. \. .\* *..*\*..\. . \...\   .\  *... .\. *.  \. *  *.* * . *.. .   \*..*..  \ .. . .\ \.\..**.#
#* .  *.. * *. .\.\ . *.\. *\ * ..\\..*\.\ ..* .*\.*.. ***\..\...*.*\*. *. .\ \. ... . .    . .*. .  ..  .  * ..... * ..\ .\. .\ .. ..***#
#.  ....  .\. ..   . *. *\ \.W**\*.  .... .\.\ \* *... * .* . .*\**... *.  .\* \. ....\  \ \   \. \** .*...\*. **.*.* .\* .**  \   ****.*#
#\* .   .!** \* ..   *\..*..\ ***\*.\** * .** . ..*  *..**..\  \.\*..     * .*  \  \ .  *     *.*. .* .\ \. . .\.*.**  ..**\*  .   .*.. .#
#*.. .\ * ..   \**\ *\. \.*\.* .**.*.\*\. **..\.\.\ *. .*@\*. \ \ *..@*\...  .\**   .. **.\.. .*.  @. ..\.*.\. .\*.*\\*. ... . *\    **.\#
#**.   .\.  *.*.\. . .* \ **.. \*   ..**\ *\ . **  *\  \.\ *\.*..** \*.\*..W***.* *   *.\**   *\.. .*\*. ***     * ..\.\*.\ .*\* *   .. *#
#**\.\.. **.\ . .. ..*.\. \*.\. \*\*  *.. \*..***  ...*..**. .. ... . .*..*@*...**.* .**..\.*.\. *  **\!  *.\***.*.***.....* *\*\.* ###\.#
# *.  . \\.. \.  .!\ *. .*...* ...... .  \.@**.\.*** **. W* . *\ . **\ .....\ ..*...*.....     * .   * ...\\. .*...**\  .*. . .. .  \. .\#
#* *.*.****\..    \***  \\*\***.\.**..* . .\..* ... *.\** *.**.*!\. ..** .   ****..* *.. \ *...**.*. .  . .  .**   \ *  ...*\  .\  ..##*##
#\* .. .*\*.**\ . .* . *....*\.\.\.*. *.. ..  .    .. . .*.....  *  ***...\ .*..\ * *\ .....\*\.\.  ...   *.*.\*\.*\ . *.. * ..@.\\.*.## #
#.... .  *.W*\.\. @.   . .*. .    \.. *.*.*.  .  .*.*   \..*..  ..*.....   . ..\  *\.*.  ...*..\*..\ .\\**..**.\....  **.\ \#* *..\ .#\# #
#   .*. ..  *.  *.\.\..*\ *.\. \* . \ * ...\\.*\ .*... *  *.   .  ..* .\...*\.*  ..*.. .\ **..\ ..\. .*..\ * ..\.\***... .   * . *.*. *# #
#** *.. * ..\**.**.*  ..  . *  **\  .....\.  ..*.**..  * ..  .*.\  .\.... ..**. .\... \.. . .* .   \ *..*. \*\\. .\* .   .\ .... .. @ .# #
#*.\..\.\..\***.\. .\* ..**........ .*.\ . **.\..*..*\ **  .. \*..  . *.**. .** ...* *.* .!   . *... ....**.. ..*\.*\ ***\.. *....  .*\# #
#\...   .*. **.  ..* .\ \.*.      . * . .. ...*\*\**.\ ...  \**.* ..  .\*.\  .**.* * @...**\..*\*.\.  *..\ *\.  .. \.*.. . . ..**.  ##*# #
#.\\.*\W ...\* .. *.*..\* *\*..*..**.*.  . *. ... .\*. ... \..*..    *..   *  . .. **.. *...**.*.\ ....\ .*\\  \ *..*.***\... *#...*##*# #
#.**.. . . \..*..\.*.\.*...*.\.. .*...\ .\**..\* \ .* *\ \* .*.*\ ...*.. *..  . ** .\  *. *  . . . .*  .\.**\\ *\*  *.\.* *\.**.#.\## #  #
#**..*     ....\   .\!..*  . . * ..\  . * ..   *. . \ * .**\.\**...  *.  \ .    .*\ . * .*.\* .\ \. .*...*!\.*  .\ ..*.*.\# \ *\ ** \#   #
#\.*\\*.\*..*. ... . * .* . *...**...\  .*.* . \..   *. ..*..* **  ....*..*.*\*  . *.... .  .  .....* .\ *.  ..*..*.*.\ \ * \.\##.*#\#   #
#.**... ..  .. *.    .*. .\\*.\*.** ...* .*..* .*..*. \.* .@*...**.   ..*\..*** ..*\*.*\.\ . .  \.    .*.*   *\.#\. \\ \ ..  *. .#*##    #
#\. @...*\* .\@..* *\**.  .*.. \.*....\...  \\ *. *.@   ....\..\@*  .* \ . . .. \ .  ... *  ...\..\* .**.. * ..  **.......#*..#  .#      #
#  * .\. **  ...\  **!* .. . \*. .... ..  ***...**. ..   .\.*.  . ** .  *.*. * .. \.*\.  .  *.  .\...*..*!..\  . #\ *  * . ***\###       #
#.\\ **... .*\  . .*.*. ..\  .. .*@*.* . *.** .*. * .  **.\ \. .* *.\ * *\...\   **...*\ \  . *..\ .\...\*.*  .  **#*#....\..# .#        #
#\   ..**\ *. \ ..*.*\.   . !**..W. ..*   ..*\* \. *.. *.    ...*  \.*.  *\ .*...!   *. \ **\ ...*.* \ . . .*.# ##.*#.\ .  #\* #         #
#..\  .**.\.  .  .**\ \. *\.\.\\.\ .......*\**. .*\. . . . .  \  \...* .. .\ **. .\ ***\ .***.*@.* *..* .\**\..# #..\#*  .*.##.#         #
#*\.*\**.*...  *. \.* *.\. \* *. ..*  ** \.....  .. .* .  .  . \*\.*\.\. *\.*.*  .  ..*   \.\* ..\.\#*.\ **.# #  #*..\ *\..## #          #
#.\ .*.*..**   *\*. ... . *...*\ .  \*.!. \. \.   *.\*. .. .* *..* .*...\\  .\. *\ .. .*..\* *. \   *** #.. *\.# #####.\* ..\#           #
#\ *.* ..\ *...**\* * ... **.*.****\ ..\.. \  ..*\*  .     \ \.*. *. . *. **. \.\. .*  ..*..*@  ** ##.#***\*.\*##.#  #..\.* #            #
#. *  \... .*.\.. *.\* ...*...\*..*.. \...\..  \. . @...  .\.... .*\.  * ..\* *    ... @.\*\.   .##  # .\... *.\**#   ######             #
# .\* . \*..*.\..\.  .\*. . .  *\ .\*\. \***  *.* ...* *.*@.   .*..\. **. .\.\*. ..\****  . **   .#   #*\ .#####*#                       #
# *  **\..**** *\ .. ..... **. .  ***. .. .  ...* ........ . !*** **  \.*.\**..\ *\..*.*..*.#. *.#     ##@#     #                        #
#... *.!\ * **.* * **...* *.. .. ...*\. \\ .... .  *..* **..\ \.. *\.*. ***.**.. * . .*.* *   ##.##      #                               #
#. *.\  W..@ .***\ .* \... ... \  \*.* . . .*.  *. .\.*..** .   * ...  *... ....***..*.\..*  *\#* .#                                     #
# * ..  \*.\  .*\**\.*...\..\** *.. ..* *\.\. \ ..\ .\.*\.. *.**. .* . * *..*. . **#.**\*... #.\# #                                      #
#**.  *.*\* .*... **\..* \.. .\..\  ....\*! *\  . ..** \. ...\*.  \..* ..\ ..\.  .. ...##* . ### #                                       #
#.*  .*   * .. *. .*  .\  * .*\ ...\**  *  *\ @..\  .. .. *...* ...  . ....*\...\ ..*.*#** ..#                                           #
#\*.\* .   .*.\... . * *.*\ ..*.@* .@.\.*.\\ * *  . .   * *** *. .\  .*     .*  . .\ *# ..###                                            #
#.. ..*..*. .*..* \.....  ..\.*...* *   *.   .  .  .  . * .. .* .*   **\    *\ .  ..## #* #                                              #
# .. !\.*** .*  *   *\ .  ..* .\  ..\. .*. .* ..\  **.. ...\..* *. .\!\..#*..*.   ...#  #**#                                             #
#\. * . ...*.. *.*.  * \.*  *.  .  ..   *.*.. *\**.*.  *  \!*\. **.    . ..* .**** ##   #* #                                             #
#\. *.*. *  ...**... .  *. .* * !.\.. .. .. .\*!..\  .\. .\.*  .. . \..  \ .\*##**\*#   #.#                                              #
#* \  . .\.**\ .. ...*.. .****.  *.\*\**. *  ! ..*.*\ * .\*. \ * . ..\\ ##...# ..*#\#    #                                               #
#**.  *.*.*. * *  *# ..* *.. . *. ..  .** ** \  ..\. ...\* .\.*...  *.*\#*.* #.#\.# #                                                    #
# \.... .*\! .*.  *..\\\ .*.\.\ **......*\\. * @.*  .   .\   #.* *\ . **..### # # ##                                                     #
#..**.**  ** ... .W\. *.  .  \ *\ .*\*\***\ \. ...\* * . *\.*\\*... ..\*..#      #                                                       #
#  ..*. *\*. ..\ ..*.. .*\ *\. ....*. *\.@ ...  * .. \*..*\****.****..#*.**#                                                             #
#. \*.\*  .\  ...* .. .. .. .* *  .*....*...* \.... *!*... .*!* *\.\*.##.##                                                              #
#\.\*  * \  *.  **  **\. \\...\*.*. *. *.* *\.\*.* . *..!. .* **.. *. .##                                                                #
#.\. ...\.\*. .\. .. .*. .   * \ . *.*.@*..\ .*..\\ .....\  ..\.*   #* *#                                                                #
#  *.\* .***.  ..* *. .*..* *.  ..**\ *\.  *.*.   *@*..#\    \.*.\.*..##                                                                 #
#\* \.#**.. *\ ...\.**. *.***. \  .*.... .#\.#. *\#.* .* .**..#.\#*#  .#                                                                 #
#.*.*.\. \**\* . \  *   \**\\*\..*.\.. * .\.*.\*. \. . #\.... ##**.##*#                                                                  #
#\.* . .. ..* .. .# .#  ..* \**** .*.\.. ...*\ .\ .****.***.\  ###  \#                                                                   #
#.. \.* ..#*..\*\.  \ ... *  .** ...*.* \ ###\# .\**\...  #@...#  ##.#                                                                   #
#**.. ..* #\....*.\..\..*.*\ *** ..*# .*. .*#.#\\.**..\#. \.###     #                                                                    #
#\\. .\..\..** *.\ .\*...#.*..*\ ***.*#*.*## #.  ..##L .***.*#                                                                           #
## #\* .\#\..**###\.#.#.* #.\ # . \#.*#\.#    #\ # \##\##..##                                                                            #
#\ .*\ \ \\  *.. \###\#.\##* \!\# # # *\#     #*## .#. \#\.#                                                                             #
#.\.*.\*.#  **#\ #   #* # #.#*\# # # *.#       # #.# #### \#                                                                             #
#*. #.##.\  *# ##     ##  #\#*#     ###           #     #\#                                                                              #
#### ## .**.#              # #                           #                                                                               #
#      #*#* #                                                                                                                            #
#       ##*#                                                                                                                             #
##########################################################################################################################################

Water 0
Flooding 0
Waterproof 0
Razors 37
Growth 17
