#####################
#     # ## ### #    #
#    #.#\ #\\*\.#   #
#   #\!....* ..\#   #
#  #\.***.\\ ###\## #
# # *@\#* . . ...*.##
#  ##\##\#. *.. .. ##
# ##   \*. \\ .*##\*#
##.. .**#*.... .. .##
# #*  .\. * \.. *  \#
## #.. *\ \    .. \.#
#*L#\*.* ..* ..*  * #
#.*\*\.\. *.*.*\****#
# . . . *\. \..  \ .#
#* ..\ \.. \\  ... .#
#\.  ..... ..*\ @.. #
#.. . ..\   \**.**  #
#\#*.* .*.\..\. *..*#
#.*\.*  ..\.\...*.!.#
#.\ *!.*. ...*.**.\*#
#  .   .\. .** *.\ .#
#..\ *\. .  \* .*  *#
#.   * .* *.*.R...*\#
#.  ...\.*\.\.* \ ..#
# . *!* \  .   . .. #
#\...\ *. .  \   *..#
# ...*. ...  .. ..  #
# ...*** *.  * . \ \#
#..*.*.\ * .\..\. \ #
#\*.. ..\.. ** * \.\#
#*..*.   *..\...  *.#
#.*. *..*.\*. .\*...#
#* . * \.*..  . *.*\#
#. .*.*.**. \.*\\ *.#
#*\ .**  .\.\ ... ..#
#* .... . .*.*..* * #
# . **   \*  . ...  #
#*\ *\*  .! .\ \ * .#
#\.** .   \* * .  .*#
#.*.. \ .***.  *..\ #
#\.*\ .* *** *\. **.#
# .. **. . . .. . .\#
#\*. *. .**\*...  .*#
# *\ .. *.* .*\...*\#
#.... ...*.!!. .  ..#
#\.*  .*.. ..* \* \ #
#*\\.*.** \...\.. * #
#* ...\....\ *. ..* #
# *\*\.. .*. .   .. #
#*. . .*  *..\*\*\..#
#####################

Water 43
Flooding 2
Waterproof 3
Razors 29
Growth 14
