#########################################################
#                      #      # #  ####   # ###         #
#                     #\##  ###.# #*.* # #.#* .#       ##
#                     #*  ## \.. # #   ###\## *#      # #
#                      #!#  #*.**#*.#\ \  ..# #  #   #*.#
#                      #..# #.* *..\ *. . .*. \## # ### #
#                     #\*\##\. \##.* .*****..\.#\\ #**.\#
#                     # \...  .. * #\**..... . ..\\#*.###
#                 # # ###. #* *W   * #.\*   .    *..**.\#
#                #.#*# ..\..\..  .*\  *. *.\.\   .*.. *.#
#          ###  #** \* .*#  . .. ! * ...*.\ .. .*.\.* .*#
#        ##\.\###*.#.\A\#* .# *. .!...* .\...   ... .* .#
#       #  *###.#*##.*#@ *   .  *\* . **  *.   * *  .*\.#
#       #*#\#\  .** .*.. .#   \ \..**.... **... *\.@.\* #
#        # *.##* * \ . .*...... ..***.*\ *..  . . *.\.*\#
#      ##**..##.****.\  ##\*..*.. * *.. \. ...  !..\  ..#
#     #.*.  \#* ...\**.. ....  .  ...  ... **.*.. *. . .#
#    # # . ..\.@.* *\   .. ..  *   .*** * .*..\ ..***\ W#
#    # .*. R.**.\ .. \.******.* ..  *. ! . .  . \**.*  *#
#     L*..\.**. **\. . .. .*..\*.\ ..* ..*. \*\* .*.!. .#
#     ##.\* *\***\. .. . .\*.*.*** \ .\... \ \.*.\.\* . #
#  ###*.*#\.. **...*. . \. ...  . * . ** . .\\....  .*.*#
# # @ .#\ .*\ \**\..**\\!. *. .  .*. *@*.@ ... ..*.\***.#
# #.*.. .  \#  **.  ... \* .*.    . ..*. . \**. \. *\  .#
##@ \#***   #\.. **\  *\.\. ... . .* ..   *.!.*.. \*   *#
# #..*\.*  \   .....\..* *  * . .\ *! . .. *  . *. *\ **#
### *!* .\*. .*.  *..**.*\...\..* *\.@ \.. . \..\** *\..#
#\@\#*.#\@\.W.* *.\.\ \ . .\* *@.*!. .... * ...*.*  ....#
# . ..* *.*.\..***.*.*.\**\ *.*.*.. .   \*.\.  . .. \.**#
##*. \*. * !.\*.\* *\\  .. .\..** \  \*\.    .***.* * *\#
#.*.\..*.*.\. .* * . . ** \.*  ..* \  .* .* ** .\*. *..*#
#.E *.  *. *.  * .\... ..\\*.\.. .. *\\.. *. .\*.. *..  #
#*. .\  ** .*.*....\.\.. ..* *\ .. ...\ * ..   * \  *.* #
#*\. ... . .. .*\....* . ...*!   . . *. *\..   .\*\*\**.#
#. *.  #.**.*.\*.\ ..*.  .. .  ..**..\*\.* ***.. *..  **#
#* \ . \...\\.**......  \ *  .**\.\.*!\ *.  . . \.\  **.#
# \.* .\ \** \.* .* **.\...* \.. !* ..  .* .... *...\.\ #
# . .\...* .*. *..* \.. *. . ..*\.\.. \*.. ...\ .* ..\ .#
# *\ *\. .. . ..   .*. ... *.  ** . . *..* .*  . **\*.* #
#* .\. .\. .  .\....* .  \ * . .. .\  *  *.** *.\.*.. *.#
#*  . *....\...*...\.!\.*  \*.\.*...  ..\ . \ *\*...\ ..#
#*\*..* \. *.**.*. *.\.\..\ *.. *.**\ .\*\*. \.\.. \....#
#*\..**.   * ....\.*\*.*....     *..* !  .     *.. .W *.#
#  #.*   * ..   .*. .\ * \* *\.**W*.*.. * ...  \* *\..\*#
#*** .\.* \.*  .\* \ .\ \.. .. \\ ...\ .* .\ .... .*.\..#
# .# \  . .*.* ...... .. . .\*..\. .\*  .@\*.  ..\ .\. .#
#  \* .*.. . B..\ .* .*.*. *..  ..\... * ..@..*  .\*. ..#
#\*.* .*..    @ * ..***.**..*** . **.\.*.\ *4.\.***\**\ #
#.*...*\.  * ..*\  . ** .*  *. .\*..\ .\. \.\ *!*D..... #
#\. \...!*.**  * .*!. .\*\ .* .*.*   .*. *. . . . .**\.*#
# \ .*\.**.*. .\*.*..\*..** .. .*. \.\.  .\. \.\\.. \..*#
##..*.. **\ .   .*. \* * \..\ * . ..  .*  ..*.\\*.\ ... #
#.... ***..   . @.\  *..\ .*.*. \.**..* .. ...*.* ** \ .#
#.\ \..\ .* .* . *.\. .* .\....\..*\***.\.. **. . **\.\ #
# #..  \ *\.*\ ..*.    .*\   *\  \ \.**** . *.*\**... *.#
#\.\..* .\ . ..*..\ .*  *.*\*.. .\*.\. .... .\ .@ .. !.*#
#.# \\ .....* *..8.... \.  .... . *** \*.* .@ . *** .\.\#
#.*   ...*@.. .\*.\  * .* \. *.  .\.* * *. .\  *\.. ....#
# \.* *  .. *...\*  ..\..\  .. * *.  *. **\.*.\**   \* .#
#.. *. ..  ..*. *.\.*\.  **\  ....* ..  .** *\.\.*** .. #
#*..*\*.C*.\\*  \. *\ ..*. .\\. . .\.\.. *.\..**.... *  #
#..\.    !  *.*.\\..* *  ****\   .. ..  ..* *.*\ \ * . *#
#**...\.*..*   \**\.. . *.**.**\ \.\ * ...\.. *..  .**..#
###.*....\    \....\ .  .*** *.     *..*..*.**.*.***  \\#
## \.@  *..1*\. . . *. *\ .*..*..\.*. ....* \. ** *.. .*#
## .*.** ... ..   ! .* .  .  \ ..* . *.\*.\  *\.\....\*.#
#.W *.\.*\.\*.... .  *. .* \**.. .\ .*. .** ** ***. *..\#
#* \*   ** *.  * ..\... *\ .. . .... .\    *\*...*.\..  #
#.*..\ \.\ *\* *\ @.*...* .  \  ...*.\ .\  . ..*..\ . ..#
#.#  .  . .*. *.* * .**.\\*\ . ... *.* \*.*. ..**. ...* #
## *.@ # * .*.*.*\.  .\ .  .\.**.*\. *\.*.. ....\.. ...*#
# #\*#    \ #*. .*\ *\*. . **.**\.@ * * ...*     **  \ .#
#  ###*.*\#. .\*\*..*.*. @... **.. ..\* *\.. ..*..*\*\.@#
#     #. *\##  \.**\ ..*\. \**\.*. .  . \ .\. .......  *#
#      #\##*\*\....   \\*  .** .\.*\* *.**\ \  *  \*.\ .#
#      # ## .*.  .*\.\ *... ...     \.  ..* !\ . . ...  #
#       ##.*#.\ * .  .\... .*.   . ..*....\.*.\. . *\ \*#
#         ### #.\**\ .. *** * \ \.  *.  \ . . **  .*   \#
#          #.\. .. *. \  *.. #  .   . \  *. **..   * * .#
#          #. .. \...\.*\*.  \*  .*.. . ..\ .* \.*.  ** #
#          # #  .*\#*..*#*#\*.. * . *.\  ** \.. .#....  #
#          #.##. . #*  .## ##.. .*\ #  .\.*\.  .***. . .#
#           #  #.*.\..*.#    # . * .**\ *** .**....**.* #
#########################################################

Water 61
Flooding 3
Waterproof 4
Razors 18
Growth 23
Trampoline A targets 4
Trampoline C targets 1
Trampoline B targets 8
Trampoline E targets 1
Trampoline D targets 8