#############################################################################################################################################
#                               ### .   ....\..* .. . \ *.  .  ..  *. .. .*\.** *\ ..!.\*.\   .*  .  . .***   * * ...** .. .    \*.*\ *   .*#
#                             ##* *.  . !*.\*.* .* **   .*.\.\.\.  .\  @.*. ...\ .. \* \*\..   . *..* . \ ...\\ \ **\..\* *. . .\**..*    .*#
#                            #.\*\.  . ..**.* \\ .  .  . .. . ! @ * .*.. *   .***...!...\ * * * \*. .   .\@*.  *. ..... ...* \ \......  *\..#
#                             ##**  .\**.@ .\ \*  .  *.  * \ * \..*. *\ *. ** \*.    *. ..  . .  ..\ .  *.*\. *..  *. .  .\\*...** *.\.*.** #
#                             #\..   .*.****. .@.*. *.    .. ... * **.** ..*.\.*.* ...*\.  . *  ..*.. \*.*..*.\.** \*** \.\. \  . \*** . .  #
#                           ##.##.  .*\ ..**.\*. *. . .* .*.*\\ . ..**..\* . .\*..*\\*\... ...\.  .. ..\ .\*.\. .. ..\.. .. * . \ *\..* *\*\#
#                          #*#*..  *  .\  .*.... \*****..\.**. *.. *.* .. * *. *\\.* ..*\ . .*.  \ ... .* .. . \.**! .. ...\..\. .*.*.. .** #
#                         #.\ *\  ....   * *... *.*.*.***.\* *..  .  .*.@.\*...*  **\ *.* *. .  \. . .*\  @*\  . .. @  \** . . . \*..\*. ..\#
#                        ##*....\.  . ..**\ . \.\ **..*..\*\...   * \*. ..*.*\.. ...*....\ *.*.* *   *. .\. ...  ***.\*.@*.. \**...  * \  ..#
#                       #. #.#\  \. *   **.. .!** .@\ ...****  ......*@. .. ...*** !!.  .* .*. .\*.\ .*..*\.\* . .\. * .. ......\  \..  * **#
#                  #  ##.. .#...  .#*\ .....*\*...\\. ..*  \.\ .* .\ *\ .   ..\*...*\..* *..\ *  **.. ...@! *.\.  \...* *\... . . .     ..\*#
#                 #*##*#  \. #.. . *.**\**..*..    .**   .*  !  . ** *     **\ ... *  .. .* \. .   *\\ . W ..\*.. ..  \.\.. . \  \  .  **...#
#                 #\ \*.***. .*\\.**.*.\ .   .\  .* .. ***.*. **.**.\  *.\..*... * . .\.  \...!.\*\. *. \  * .. \  . *!.. .* . .\.* ** ..\.*#
#                ## .#  .#\  \.\ !.**.\.   .*.... ..*. ...*.  .\. . * .. @ .. \...\\*..  .*\ * \ \ ....\..*.\*\ .\  *  *\\ .. ... .\ .**  \.#
#              ## ** #*  #.*\.*. .\ \* ...*\.. . .. ...\***.\. * \.\.* . .\. .... .\..*..\.... . ...\* .. \ .. .. ***..   * .*** .*..\..W\ \#
#             # *....#.\\. .. **\ *\*..\  .  *\.\*\ \ ** ** .\ .  . ... . . .\ \.   @ *..*\. . . .**.  ..\.  .*  *.*.. ..*.**\...\\. **..* \#
#             #\...#**. \ .**..\. .\ .\ .*\  .*\..    !\* * .. .  !... .*  * *..\. .... ..*  \. \...\\ *. *.* ..    *.  .\ .    \.\**!\..  .#
#              ### *\ \*...**..  .***   .* ..*.**.* ..*..*.  .. .** \ \ ..** .. ***. ..*. .\ . *\.*.  ..**. . .*...*. **\.. \.*.*. *\* *\ .*#
#              #  *..! . .\*.*...\.\. .*\.  .....***\.*.... *.\*\..\ *.*\*.  \.*..\*\\ .  .. . .  . ..\ ..*.* .. \..*. .  . ..**.* ..\ ...*.#
#              #\@*.* ..* .. \ . .   \* * .**  * .*\. .. @ \. * .\*    .....*\**.  *..\*.   !*..\ *\*.*\....\* *. .\. *  .  ..***\.@. .** .*#
#             #*..!. *#\.*\ \..*\.. *.*.* *****..*..\.* @*  *..  *.*  *..** .... *.\\  *\***.. *..* * *.   @...W\ *. ....\*. . ....*.***\ * #
#              ##* . .\  .***..*.\**...\.W*.. * \.\  *.*\ ..  .  . . ....\.  .*\.  .   ..**. * . ..\*.\..\.* \..*\\*@. \ * \  .. ..*..\.. ..#
#             #. * #\.#.. .\\\*.  *!*... *.*.\*\.*.. *.*..  .  ** ...*...*.*  \*  \ ....\.! \.*.   .\..* . .\..\.. .. \ .. .. . ..*\.. * .. #
#              ##..# * *. *..*..    .  .\. .*..*.\*.*!. *..    ..\  .*!\ *\.\. .\@.* .\  \*....\*.. *  *.\.*..*** \** ....*...*.*!..** *.\ .#
#                #.. #.**.!\** *. *.*..  *\ \   . \...\.*. . *  ... *..*  ** .  . **..@*  .*.**... .*.\.** \  *..*..** \.   *\.** ..\.\.. * #
#                #\**\  * * .\.*.\ *..\.\\.*\*\  . * \*... *\. . \  .\.. .\ *. ..**\* .* .\!.** ..  \ .  .*.....**.*.. .*.\  .*.* * . \*.* .#
#                #.\.. \.\@   ..  .*** *. .. ... \ .* *. **\ *! ..   .  .*. **.\ .......  .\.*.   ..  ..  .   \....***..* *.* \.* \   .....*#
#                 L.#... .. ...* \ *...  .. *..   ***\ .**..\.\. * ...\ .. \.*\.  *\.  \ \ \.* *\* ..*\\** \ *.*\ **\.  . . \ . .\.\. **. ..#
#                #\..\@***\... . . * .\\ **.\   \.! ..\**\.*.**. .... *.  .*  .** @*.  ...  ..*. . . *...\ .*\***.\ *.\\*..\ ..* ...  ..\*. #
#                #\   ...\.  .** *.*...* \.\   *. *... *. \**...\\*\   ...*.. *. .*..   *. * .*. *. ...\ * *..** .*.\ . .*.W \. ..*  ....**.#
#                 # **! ** ...@... . ......*.**\ \.*.  . ..*\\.*.** .*.\.***.....**..\.\*.*.\ .\ .. *..  .\\. .\.*.\ . . ...*** ..\ .  .**@ #
#                # # ...*.   .....  *. ..  .*\*. \*.*..*.*   . ...*.\.. \*..  \.* .* .* ... *\ .  ..\.  . . *!.. *\.*\.\ . *****\.*\**\*.** #
#               #*## \**.!.\.  .  .*..  .*. .\.*.*..*.*. **\.** . *      ..  * \*\..\\* *.\.* . ***.* *...  ..\ *.. .. *.  .* *..***.\.*  .\#
#              # \ .* ....   .*.* .*  *. . \ ...*..* ....\.. \ .. * ...!..    ..*.*.@*.*\***.\.\@..*..\*.****.. ..* .\ .......**.... *.\\** #
#              ## . # * .  .***\.\\\  \ .. .*  @.**\.   *.\\ ....\  \.*.  .. *  .\ ****.*..*@  *\. .. *.\* ..\. .* .  ..\** .* \*  .\  .. .\#
#             #\#\..*...\*  .*.*....\ .*.*\*\**.. .*  * .....  .\ \..\..*.\.*! ... ..\*.\  .\... ..\*.\\ .\.\*\*\.* . ...*  *.\.. .... . .\ #
#             #*#*\*.\   *..\. .....*. .\*.*.... * .*.*   \  * \*..\ .. . .\. *@\.\**\*\..*..*.\*  ..   \    *.. \..\..\ ...** *.  *.  @*** #
#             #**. . .*.*..   * .. .. \.*. .  *.. * ..*.... * . .  *\  \.*   \. .*.\ ....*  W.\ .**\. *..\  **\* !... .. \  ..*...... *.****#
#              #*#.. ..  **   * \  ..\.*.*\\.*.* .*. .\*  .*\. ..\.\...\ ..*.. * *    \\ * *  *.!..W.\. \..**\*. *.  *.\   **\* \  \  . **.\#
#               #\*\..** .. .\   .   . \ ..  .* **... ..  *\.\ .  \\ *\.*.\\**\. @*    *\\ * ..* \  .* \.. \.*\**. . \.  . .****..*.*....*  #
#             ##  *# \... .... ..*\.* *.. .*  . .* ... \  \..*.*\ . *. .**.......*.    . *..*...* ..\. .*..  \ ... .....  \ . *.  ..*.\.\.*.#
#            #**! .. *.. \**. .\ \**.\ *.. \*.. . .\ \.....***!* . ... . .. . .  ..** .. * \ * ..* *.  .\*\  .*   .     . .\..\  \ \...** .*#
#             #\. . . *..\ \ *\*\*..*\..\*\.\ .\. .. ** .* ....   *...\  . **   .*..  @\*\. ..  .* .. **** !\ .\.. ** \.   @** *.....\.\*\\.#
#             #.**\. .. * \.**.!*\  *. .*.. *.... .**.. .* \\*.  @.. ..\.  . . . *\****... .** \\.. *\\.*. *... \ **.. \  *...  *.. ..*. ..*#
#           ###\.\. W  *.\ .*..\. . \.  . ...\ *.*..* ...  . .***..\.**.*  .\...... **.*\ \ *..  ..**.. *.*.. .\. .**\.. !.* .\.. *\ * \.* .#
#        # #\.\. ...\*..*.. ..\ . .. .   ...\.*... \* . .\ \.*.**\.  *.\! * *. ! *..*. .*\ \.  *.  \*.* ... .*.. ...\.** .*.. .. \*.***..\. #
#       #.### *  *\ *\.\.* .   ** .   \ ... * .   .\.*.\**.\*..****  \..  . .  ...  * **....\. \... \\*\ \* .      \.\...*.**. .... .. .\.\ #
#       #.***\*.\*. ** *..****.\. .\ .   . ..**.  . ***.. \.. **\.*..\.  .  \.  . * . .\.*\* *.  **.*.. ..!. \ * *.. .**  *\.** ...\*.* *!*.#
#        ##.#.*\* ...\ ..**\***.  *... \* . \*\ . * *\...\*. *.\  *.   ..\***** \ * . \  .\.*\ \  ..\  * \ .  ..*.. .*.\ * *  *\!.\..\.***..#
#       #. ...\ ..\*.W@@ \* .*.*\ ...   *.. .* !\ .\ .** *. .*   *\*\*\** *.. . ..@ *..** *\.. W ..   \*.... *. .\* .\@.*..\**.*..\*\**.\ ..#
#      #  ...**.* .#...   .R.***.* ..  .** . \\. .* * .. **\ .  .* ..*.\.... ..\ *.\   * \.*. .\.\. \ *.. *\.*.. .\  *\.\.\ .\. . *..\.*\. .#
#       #.**.\.\* \ .*\* .  \*...*. *   \.*.  \..**...  **.*.**. ! *....*  \ .   . ..* *.. . .** !\. ...*\.\**\. . . ..  ..*  * *\  *.**.*\.#
#    # #\.*\* .  \. . **.. \ .*. . .\*@ .*.! **  \\.** ..  \*.. ....   .  ..   ..*.  .\.\. *  .* \. *.\.*...\.   . * * \.\ * *\ *.**. .\*.* #
#   #*#*...*.. *\..\  \. .*  .\ ** *..\. .  .*..*.... .  \.\  \* \\   .. **@!@ \ .!*. * .\.**.*\ *... **.\ .\.. .. * .*.*  \ **..  *\ *. .**#
#  # \   \* .*.*.\   *.*. **.\* .* ...* ..*. .\  . .   .*. .\*.**..*.**\ ..* \*.*\*\* \* .  .  * .**.*.\ *.. * \ .*.\*!\.*.  **.. .. ...***\#
# #**# .*.* *.   . .*. . **. ..*.. .  *.  *.  .\  .\ * ..... . ..*..\ *.. !. ..*..**...*.\* *. *. .. . *.  \.*  \..   .. .*\  .\.  . \. .. *#
#  #.##   .\..\.\ .\\.  .\*   \\*\.  *..  ..*... !**.. .\     .\\.. *\ ..  \*.**\ !*. \. ***.  .*. .**..  . .\ \.***...  ..*.\* *. . @. *...#
#   #  # @.*....... .**. ..  *. .**.\. \ **...\*  *.  @   *. ...\...*.*.\.  .* ..  .. *. ....\* ...... .  . \*** **.   .*\ .. \ *.*....\.   #
#     ##\. **. . .. ... .  ..** ..\  ..   .**.*...\\*\..*\**. ..*.*!.*.**@ .... *.\ .\.**  . \*. *\.\     \. .*. *..\***.    ..**..\.**.  . #
#    #....**\  . \ \ \..   **** \ .. **.\ *.\.*.\.*. !.*....* .\*\.\...**. .*.*.\*  **...* * ... .*.. .. ..*.\..*.\\**.\ **@.\** ***  ** .\*#
#    #... ........*.*.  \ ...*.\  ** *.\. .\..** ..*\.*\  \... .....*\.*.*. . * . .   .. *** *.\*.\..*..* *.   *...*** *....\.   ..** *.\. *#
#   #.  *  .*..*.\.**\.*.*..*..  \ .*.*\*  .**.**.\.*.!.. .    .. . .**\.*\* ..*\. .*... *.  .\*. ***.  *.\* *   * ..\*.* *.  \ ..*.*\. . .\#
# ###  \. *  .*\.*\..  **.. ** .!..\.\. *  . . .\\  **.**\  .*.* .* *..  . .*\*\..**...\  ..\*\.....\..*. *.....\*. * !\ ... \.... *. \*.*.\#
##. *.*.. **.W. *.*  **..*. *.\*\ .*. *.*   .* . .\.*\*.....**\..*.\..*.*  \*....\. .. .* .\... *.. * ** ***.\.\.\*..*. .**\ .*\* .*...*\...#
###...\\ \  *.*\. * .\. *..\**.* . .* *.. .  .  ** *\**\  *\.\@\ *\.\ \*..* *. . *\.*.  \. ..\.\.. ..**.....\ \.  *...*  .*.****. \.* *...\ #
#\ **#. *....*. .*. * **...!..    ... *\ \..\ ...\\  .* . ..\ .. **.*...**\  . *...*\...**.\..****\* \.\*.*. ... .* \  .  ..\ \.*. *\..   .*#
##### *...*\ #.\ *.  * \.  \ *.  . . @ . *  .*\.\*\*. * \..@     .\.*.\  .* \ *\..\.*\ ..*\*...   *!   .* *.*\ ..*.\.. .*@****.*.*.*.. .  W #
#    #\*. . ## #\.\*...  . ...\ .  . \. *\  *. ...**.\* .* .. .\. \**... **  .\..\. .*.*.. .\*. *  !*   .\*.*.*..*.**   \ **\..* **..*....  #
#    # #..*.#* #   *  . **\..  .* .* .  .  *.  ** \*.*.\ .  *  .* .\\  W.!.. \.*  . *. \ @.  *...  .*. *.*\*.\.* ..\. *......\   !.\ . .*.  #
#     ##\### #  **.* **..*. .*..* \. .W .*\ *  *.....*...\.**.* **... . \ . .\..*. *.!.\ .@.  *\  .* .*.. .*\  . .\*.**.  *. .. *. *..**...\#
#       #   #\* .** **\* *. ... \  .\.W..*..\.\ .. * !\.*.*!!..\..* *\  . .   \.* \ ..\ *\*   ...  ...*  .*..*    W* * * *.\*. **\ .* .\.\..#
#           #*.   *.** .\.\*.*.*\..**...*\ * ..* \*..\. @\.\.\.*****. .** @* *.\. **.. *......*W\..   ..  .*..** \\ .\.  . *\ . .  .. . ..*.#
#            #*.*. .. \*.\ . ..... .***\\\ * *..  .*\   \.*..!\*....  \.. .**... \.\.  *\ ..\ * .  . *  @*\..\.. ..\\**.   ..  * .*..\ . ...#
#           #**... \\*...   .. *\ .\... *  ..\.  .*... . .\**  .   \.*.*\*\.\ .*.   * .*.\  .. \ . . .*  \.* * ..* . *...... .\. ....*.  ...#
#            #\ .*.. ** \....* . *\...* . \.\..* . .\ .*.. .. .  \  ...\.  *. *. .*  * .  .  ** . .*    .. . .\ \.**\*..  ....** *\ ... ..*.#
#           #....*\#*.*.  *\ . . \.* .*..  *.  . ..  W..*...  .****..*\ .*.**\ ** *\ .*. *\. \.*.* ... . .*\ .** *.....\*. * .*  *!.\ ... **#
#           #\. *. \.\..# *.\ * ... \.*. ... *\....  *\.\\ *  *\.*.\ * ...  \...**.*.*W..... .*.*\ ..     ..* *   *...\*. .  \.  .**\* . .\.#
#           ##....*. *..**. **.\. \*. !  \.* **. \.*\.**\*..* .  . @**.\\ *   .  ..\...\    .*. **\.  ..*.**  .. *\*..*.\ \  *\ *.\ ..**. *\#
#          #**. *..\ .*.. * *\.. *  *\ .\  \  .** *....**.*.. *.*.*. *   .. * \ **..\.**.*\ *.  **.  *....\.\.*\ ....  .*..*\..*.*.\ *\.* * #
#           #.*\..\..\.* .. .!*...*.  * *. .*. .....\   . .  .**\ .* ...\   W.  .*.\* *\. . .* .\\.  *...**\ ...* *.. ...\\..\ .**..\.*.\..*#
#          #  .* \.\\#\* \**...* \*...*..\ *.*\.* * * .*.\*   ...\*. \.. .\ \.* . * . *.\**\** \**.*\ \**..\* *. **.** \**\ \ \@.... *..* \*#
#############################################################################################################################################

Water 55
Flooding 1
Waterproof 3
Razors 2
Growth 10
