####################
#L .  .****  \.*.\ #
##. . .* \.\. ...* #
##*.*...\. .*   \  #
#\* .R. ..\ *\  .. #
####################