#####################
#  . ...***.**..   \#
# * *\* .\..\. .\.  #
#** ..* * ..   \ \ *#
#.\   . \.. *.\. ..*#
#.*..   .  **..*.\ .#
# * *. .\ \.**.*....#
# .\*** *\**.. . .* #
#\*...\  ..***.\.*..#
#*.**.**..\**\   ...#
#.@ .W..*..*.*.  \  #
#***...\.*. !..\W\ *#
#*..*. @\*  **\.\...#
#.\.. .!*.. ***  *\ #
#.. . @*.*.**.\.*. *#
#\\.  .... .....  **#
#*.  * .*..@*. *. ..#
#.*  .\*\**..  . ..*#
# . \ .....\*\ *. ..#
#  *   .. \* .**!* .#
#...\*... .*. *..*.*#
#* . .*.  * ... .\  #
#**   \.* *\  \ .  *#
# * .* .. *.*..*..\*#
# *.. . *.. *..\  .*#
#.\*   .... .. ** ..#
#**. \..*.. ..*...**#
#****  ..*...\ ....*#
#\.*@ . \. .  .  .@*#
#.*\. \*.*.*..  . \*#
#* *.. .\.!\   . * \#
#  ..\*  .. ..**..*.#
#.   *... \.\*.\.\ .#
#**.!.\.. . \.  \ **#
# ..   * *.\ **..***#
#\ *.@.\*\ . .\...**#
#@ .*.\!..\..* \ . .#
#\ ***..*\ ..... \ *#
#* ..*\ * . .. .*\..#
#.\. \.\.\..\* .**\.#
#  *   .... ... ...\#
#\.*.\*  **...\.\..@#
#...  \  .. *   .*\.#
#... \. .**..  ....*#
#*  .    .\. \ .*...#
#*\. *. *  \..  . \.#
# **.*  .\*..\*.\\..#
#* .*.... .  . \\ . #
#.. R.* . *\ ***. . #
#*.*...\ ..... . ..*#
#..*\\  \*. .*     .#
#\.\. . . *.. .\ ** #
# ..** .*\..   *\ *@#
# .*..... **.\*. \..#
# \. W\ \.. *..... *#
# . .  \..* **.\ \**#
#*.*.. . ..\****. \ #
#**\ \... **.*   .\.#
# .  .*.. *\ .  \**.#
# .  .. . . .*\..\..#
#.* . .\ .* *. .... #
#\..\ @..  ** !\  \ #
#..\.\.   *\\.. * *\#
#*\.. ***\  \.. . *.#
#\ *. .*.* ...... **#
#. *.** .@.\*\. !.  #
# \ .\..\\. .*.. .*.#
#.  *.*..  .*\..  ..#
#*....* ..\ ** \*.  #
#.\ * @ . ! .  ....*#
# ..\*\*.* .\. .* ..#
#     #...\.*.. . .\#
#*  . *\ . *.*\. * .#
#\.@\....\ \ . ***. #
#.....**\ **..\!. *.#
#.\.#.*. \.. **\.*. #
#*#**...##..\.***.* #
##*.#  . # \. .\...*#
#*. \ \ .## ##*  ..##
##\.#\ ##  #  # \*.*#
# #L#.#        # #.##
#    #         #\## #
#             #.!#  #
#              #.#  #
#####################

Water 51
Flooding 8
Waterproof 16
Razors 47
Growth 3
