##################
#.*. *.  *.*... *#
#.   .*.****..*\.#
#.*\*..**..*. *  #
# ..R. .. *\.*. .#
#** . .* ...  *  #
#.\.*.\* .\...*  #
# * 1. ...*  ..  #
#\.. .\\. *\. \.*#
#*.* .**\ **\..*.#
#*... ..* .. \ ..#
#..*.*\ \* *   @ #
#.*  ..... \..\* #
#.**. \\ \..   *.#
#.\.  . ....*.***#
# . *.  *.  *.. \#
# *..\.\.\ * .  .#
#\..*. .  .* .. *#
#.\ .  . * .*....#
# * \ .* *..*** @#
#  \ . ... .... .#
# . *@\.. .\  \. #
#*\ . *..\*..*.  #
# .@ *..\.\* ..  #
#\*.*. .*.*..* *\#
#*. ....*\ **\...#
#*.. .* \ ..  *!.#
#.*** \. .\   \ \#
#         .   .\*#
# .*..  \..\*  ..#
#  . **\  *.   *.#
#* * \\*.\. .  ..#
#. !* .*.  ..\\..#
#.. .  .. * ..  *#
# \. *..*.. ****.#
#..*... . .\\.*. #
# ** ***\. ** . .#
#\*.\.\ ..* *  . #
# .*. .\. .*.... #
#.\*\ **.  .\..*.#
#. \ *\. *   .*..#
# . *.*\ @*\*\..*#
#** **** .**.. .*#
#.\.......** .\. #
#   . *\*..\...**#
#......*\ ..* **\#
#*.  \..*\* * .@.#
#.\ . @*...*\.   #
#    \. *.*....  #
#.\ .....\.\.\@\\#
#. \* .  ...\  *.#
#*  *\.\.*. *  ..#
#\ * *....  .**  #
# ..\*.\. \ *.  .#
#* ..... ..B*..*.#
#*..* W. C .\..\.#
# .*  . \.\.*... #
# *. . ..\.@*.   #
# *.*      .\\.\.#
# ...\.* .*\.... #
#   ..... *. \  .#
# \. .**  **.* \ #
#..   \\.  . ...\#
#*.   ..  **.  \.#
#..*..  . ..*.*\*#
# ...\ . . .2.  \#
#\.\* .*  \ *.\ .#
#*  \. *  ..*..*.#
#\  .. .  .*.\*..#
#*\   . ****\. ..#
#....*.* .*. .\\.#
#...** *....  .  #
#* **  .* .    . #
#\ *.. ...\.  .*.#
#.. *. *.*\ *..*\#
#*.\.. ..*.. .**.#
#* **..  *..*..\.#
#.*..   ...\.***.#
#*\  \.\.. *.\  *#
#...*.. .\.\ ..*\#
#\ *  ..W*  *. *.#
#  . .* *...\*. *#
#\..\.*\**.  .. \#
#. *..* ..\...\..#
#...**. *.* .* ..#
#    *  .\*   .\*#
#\..*.   * **...*#
#  *.***\*  **..*#
#.\  *\ *.***** *#
# * *.*.**\...*.\#
#*\ ....**.. .* .#
#....* . .*\...*.#
#  .*.  . ..... *#
# *... *.  \.. ..#
#*\   **.\ \ .. .#
#.. .*.**.   ..  #
#.\ \. *..*.*  .\#
#*\..*.*\. *   ..#
# *..* !* .*\ . .#
#..*...*.. .* . .#
#  \ ..* ..\...\.#
# .\** ***\*\.* .#
#.* .\*\*.\. . * #
#.9.*. .*\\.\.\.*#
#. *. * \... . \*#
# .*.\... **\ \  #
# *\.* . ****...*#
#*  .*..*.\.\.*\.#
#..\ ..  *... .* #
#\.*..\ \.\**\**\#
#.   .. *.. .....#
#*. \! \ *...\.\.#
#*\  *.. \!.\ ...#
#. \. *\   .@@ \.#
#\\. . *** \.!\  #
#  ...\ **\.*\ ..#
# .     .*  . .**#
# *  \* .* \\*\..#
# ..* . ..*\.**  #
#* \*\ ***. * *.\#
#**...*... *  ...#
#.* .\* ** *.*. .#
#*... \ ***.\ *. #
#.***\   .. .*.. #
#*\....  \. \.  *#
#\*.\.\.**. . . *#
#..* ..  .\....\.#
#   \ ..*.* *.. .#
#***.*.\. * *. . #
#..\*.\.*.*.   *\#
#     ***.. *. \*#
#* **.. *. .*. ..#
#.*   *\.* ..*  .#
#*\ **. * ***.  .#
#*. *.\.\ .\.**  #
#\ *\     ..!.. .#
#.\\* *.* .* * . #
# .\* * \  *..\  #
#  \ \. .  ..**..#
#.*...\* ..\.. ..#
#* \*\.*. .  * **#
#. *.\*.*.* . .\.#
#... * *.\. . *..#
#*  \.\. * . ..*\#
#. .\ *  \.  *...#
#..*   . . .**.**#
#.\* *...   \.\..#
# \.\\ .* \..*..\#
#.  * * .\  *.*  #
#   .** *.\.**\ *#
#\*  \.\*..*!\...#
#..* .. .. *\.*@.#
#. . .  **\..**\.#
# *.*.\ *. .*.***#
#\..\ !**\* . .\ #
#   *  \ .\ *\ *.#
#.  ...  *. .*.. #
# .\ \ \ . *\*.* #
#****\..** . *\. #
#*\...\**. ..*! *#
#  *.\ ..*\**..**#
# \.*.*  ....*\.@#
# .. .    *.*.* .#
#  \..    \..\*.*#
#.. .  .*\.. *.\*#
#  \ .*\...**\  .#
#   .\*...*.   . #
#...**.** .. ** .#
# **. .* *....   #
#.\* *....* * *. #
#**..\.**...*\* .#
#.\* . *.. *..*.*#
#.@* * .*\*** ..*#
#... *.** ...***.#
#....* .\ ! .... #
#..!*....*. ... *#
#\ ..*.*  *** .  #
#* *..*.\.**.\*. #
#\ . ..  *.. ..* #
#@** *.\. .\\  ..#
#*\.**\* *.*.  \ #
# ...\ ...\.\ * \#
#   *.  .*. *.\ .#
#  .*  *!*  . *\@#
#\..** **....\@ .#
#.**.**.  ...*. .#
#\\.\.\\  \*.*.* #
#*.   .. *.\..*  #
#\\...*..*.* .*  #
#*.@ *. *.\*\\.**#
#. .\. * . .** . #
#****\ *  **\ \. #
#*\..*\*. .** .. #
#.*.A   .\ .*..**#
#** .\ ...\ .***.#
#... *...** .\\..#
#.. .*.\. ..   .*#
#...*.\.!. ..*  .#
#.\ .*. .   @.*\.#
#.*  ..     .....#
#   .\  *..\.*\  #
#  . *. ...* ..*.#
#. .* .*\* . **!.#
#.***  *.  . *  *#
#\.\  ..@\***. *\#
#.*..*..*...\. W*#
#.. .\..**\..  \.#
#\*\** \.*..  .* #
#*.... ..* \.\.. #
#**\\ *.. *\    \#
#..*.**\...... . #
#*. ! *..*. \..**#
#*.\*  ...*\. *  #
#*\** \* .*..*...#
#*..* ....* \. *.#
#.. *  ... \.. ..#
#. \\   .\ .*..*.#
#\.. ..**.*.  \.*#
# * .*..*..... *.#
# .\.\. .*. . *  #
# *\.   **. \.\. #
#\..   *.\.\.*.\ #
#\.*****..   *...#
#\  *... ..**  *\#
#\.** .\. .*.\..*#
#. .* **\*..*.\..#
#  *.*\*\*  .   .#
#.\.*\.*..  .   *#
#\*.\*..   .*. * #
#\.    *!. . . ..#
# * \*\. . . * ..#
# .*\* \    *..* #
#*.*.*\* * .\  ..#
#...*.#.*\**  .*.#
#.  .*\...*.  .\!#
#\  *..  .#\. \  #
##... . *\ *  ..*#
#*.* . *.. .   *.#
#...#..#\.*...*..#
##*.*.##  . .*. ##
# #\**   .\* .#.*#
# L*#########.**.#
#  #         #.###
##################

Water 0
Flooding 0
Waterproof 11
Razors 47
Growth 37
Trampoline A targets 9
Trampoline C targets 1
Trampoline B targets 2