#################################################################################################################################
#. * *  **.  ... \.\\    . . . \*\*. . . .  \ ... ...\*.*..*. * \. * .*.  * .    *.\  ..*.*...*....** \... .** . ** .*...@  . .*#
# *. \*. \ ** !.** * . .. ..  ..\ ..* \   @* .*.*. *...  **\*... . *..\    **.\*.*..*  *. .\ *\.*.**..*** \.*.  *\.*..** .. .\###
# 7*..*.\.  *.  .*.. ***.*\\* ***. ....****.. ..* \. *\ *\...**\.*\ @* *.\.*.*.C ! ***\    ..\ .* .\ . .*..\..* *. ****.    *#  #
#\ .*...\*..\ *** * ....*.  ***..  . .\!.! @*D. ..** ..*. .*\... \@.*\ * *..\ ...* .\!...\*.. .A. !    \* *.*..8.**.*\.*  .\L#  #
#*..\.\  .*\* \.. \ R .\.. *..*.*.* F .*\   .*.  .\ **\.*\ ..     *.  **\.   *..**. .  \..* \*@!. .*..* . **.*.. .....   \#.* # #
#. ..!  \   .\ **...** **\..\ . ... . .. .**  \.*. .**\ ..* .** .  . \.\** .*.*.\.\  .* ..*\...  . * * \ H\. .\ ..*.!*  . #.1 # #
#\ . .\.***   ...B.*.. .. . ..*  .**.6*.**.* *..*. @\..*\..* ..\ \*.......* .*. .\E *.*  ..... .\.\* . ..\**.\ . ..  ... .\ #\# #
#.\.*..\.*.*.. ..\ * *.  ..  .. ... *\ **  .*.....*..\*. .\*\.*. .* **.*  \.*.. *....\\.*. . . *.*... .. ... *..    \.* W .*!#  #
#   \*\ .*.\  .**\*.*..* . ..\ **.... G.**. .*  .*..*.\*.*..* \!\..!\.\   . .\ 2 * W *.\..  *\ .*\ .... .***\ .. * \.*..*  #\ # #
#** .\.\*. \ \*.. . *.*\* \ \.*..\.*. .\\..* ..\ .\.\*.****.\ .\. \ .. *.* \*.. .*.  *...\.\**.\**...\ * . * * *.******\*.\ .#  #
#################################################################################################################################

Water 7
Flooding 15
Waterproof 0
Razors 1
Growth 25
Trampoline A targets 8
Trampoline C targets 7
Trampoline B targets 2
Trampoline E targets 8
Trampoline D targets 2
Trampoline G targets 8
Trampoline F targets 6
Trampoline H targets 1