##############################################################################
#                    #  # #                                                  #
#                   # ### ##   ## #   #                                      #
#                  #*** # .*# #**#\###.#                                     #
#                   #\\.@*\# ##.*#*#*.*#                                     #
#                ## # # *## #.. .*****\ #                                    #
#               # .# *\... ##@   .. ##. #                                    #
#              # \...*. ##* *..  * ..** *#                                   #
#               # .*\*** * .* *@ .   .\\.#                                   #
#     # ##       #*# *.\ . .. .*\  .*. ..*####                               #
#    #*# *#     #*..\...\*\..\ *  *..*. .*#. .#                              #
# # ##*\ .#     #. . **  #\\*. . .#.   . .#..#                               #
##.# .*.*..#### ## #..\. .*.\*\  .@\*.**.. .**##                             #
#   *.# ###  *.#...**  *...*.***\ \.#\ .#\ *.##.#                            #
##\..  ..## ##.  . ***.\  .\... *....   #. . .#.*#                           #
##**. *\* . *!#*..*.*.***.. .  \..* *   .  ... . #                           #
#\  #\*  #***#.# \.\. .. .  *\*. *.*\.\ .\\ *...\*###                        #
#*.\..*\ .**\ *##*..*.  * .\. . .*\\    ..*  . ..*  *#                       #
#..*. ...*.\. \ *. @\ *.*\..  *.*.*.. . .\. ..\. ..\.#                       #
#\..#  \ .\..\! .\ ..*. .*  .* **\. ! ..*.*****.  #.  #  ###                 #
#*.*\* \. * ***  ****.\. *.\\..*.* .*   . **..  * . .*###*.\### #            #
#. * \ . *. .\ **. *. \*\.   \ * .* *.\* ..\ . .## .....# ..#*.#*#           #
# .*\ . \*..* \..\ *.  *\.. ..*\  *\*. *\ \. *  . .*.#.\ !..## #*#           #
#.*\.*. .\...\.\..*.\ .. **...* ...*.  . .  *    \...\*   \  \***\#          #
#*. *\\*.*.  . ......* \ *.   . *  ** * . ..\.* \ ***. ...\. *#\# #          #
#.*.*.\ ** * * . .*. . ..\ .... * ... *    \ \*.**.* \.  .* *.**!*#    #     #
#\\.*. ..\.**..*.*.. \.**\* ..\ ..** @\ .*...\.  *.. . ** *..*.. .#   #*#    #
#.  . . .  .**.. .*\*.... . .**   *... **.\.@ \ \  .*#\* .*.**\*.*#   #.*#   #
#\*. @ *. \*..* .\  .\**\  ...*\ .\ .. *.\  **. . . .@*\.** \.*# .#   ##*.#  #
#.. ....*..*...   **......\....*.. ..\* \! *. . *..\..* ..\ ... . .# #. . #  #
#  * \ ... ....\* ... \ * .*\ *... .*.. .... **.. \\ .  \.**  #.\##  #.. .#  #
#  \  *  ** . ****  . ...\   ..   . \\ ..*\**.*.*...*.\....**.. #\ #####  *# #
#\.*. *. *. . *\*. \..***  . . . *\...  .* *. .\*.\\  .** *\*. * .*. **.\\.# #
# *.**.\.. ***\*\.**.*..**.@.**....\**.\*. .  ..* .\. @*..\.* .**.*\ .. .* # #
#\! .*.. .\\.. .. @.*  \*\ * .\.**..... .\. *\W@.*\..\..\  ** ...   **\ *.# ##
#.  * \.**.   *\\  *.  .. ..\\ ** .\...  *  * .. . \  **  \.**...\ .**.\**##.#
#**\.\  *.  * . .. . . ..*\. .\**\.\.  \ *\...*. *.... ..*.\..@..*. .* .\*##.#
#.. . . .\\\.*.   *  **..\*  **.*.\. \\. .!* !\..\.*.  .*.\**..\.\ .**.*.* L.#
#* .    . .\..* .*.*  .\ \*\\*...*....*  *..\*@  * ...  . ..\*.!.*. .*.. ... #
#*\. .*\    . .. * ** \.. \.\.\  \   . \*...\.*.....\*  .\.*... **.*.#\  . \.#
#*.  *..**\ ***.* .*.\.* ...*\@ ..      *.. .\.\ . . . \ .\.**..*.* \ .  **.\#
#...\  \. ..\ \ * \***.*\  @..*  * . . ..\ \ .. .\ * .\ * .*.**\ .\*. * .... #
#**.*\*.....*  *.*..\..*  ..  ...\**. *..* .*. .  .. *  . \...* **.*..\ .*..\#
#.*\**.*\.  . .\... . . ** .    \\.\* .. * .\*.  @\*.*\* *.**.*... . ... *.###
#.*...**.@*\  . .\ .*\.*....*   ... . *...  ...!.. \ .W. . \ .\\\. .  *\**. \#
#\*.\*..\.* *\ **   .@*\*.  *\.\*.. .*. \*\*   .    . *\\..  \ ...*...  \.*.##
#.. .*.*.***. *..*\ .*. *  *.* *\.\. *. .* \. *....*  ... * *   *. **.. .*!\.#
#.\.\.*.*... ..  *.\*..**\.\.\ .     .*.\* . ..\\.. .\*\...\..**  *\...*..#..#
#.**. ... .* .. .   *. *  .*.. *. .. **... ..****.. \.... * *.\..@\.*\  ** *.#
# \.**.\.. * . \.. * ..*\**..  .*    **..  *\* .*\** ..\ .*. . .\...\ .\\.##.#
#....\.*   . .  .**.*  \ ** . . ...  .*  \ .\.... \*. * ... *** ..  *  . \..##
#**.*. ** ..* \.\*  **. \.. .\*.@..*.**\  . **.\.. .. . * *.*\**. **. \*  *.##
# **\\.**\...* *.** .\*.**@\ ..*. **..*.*\.*.. .\\\ .  .\...* ...**.*... .  ##
#*   . *  ** . \**\  *..\.\*    **. * ....**\..* ..\ * *  !  .\.*.. *. *\   ##
# \  ...\ . *  . \.*  ...* *  * ..\...*\.\  *\ *\ **.**. .  * *\**\\** * ..\\#
#**.. . ..\ *. *  * * ****.***.W**   . .**. \.   .  \***!.   ..****\.*... .# #
#..*.*. .*..*. ****...* .*...* **.  .*\  .  .... ..\.\.*\  **. !*\. .   ** .*#
#..\...\ .* . **.\.*.*\.\ .* * .   *   **. .  \.* \.\**.. ..\**.*..   . ..*..#
#\* ...*\..@..****\ .\**.\.\.*.. * ..***..\*..  **.. . \ . . \*    \ * * ..  #
#**\ \ *..\..\..*. .* *\@ .. ... *\ .\.* .*\*..***   *@. .   .. .\. \! *... \#
#..\ . .*\     *.*..\ \*.***  *. . * **.... .**.\*   . ..*.*..*\ ...\ . \. *@#
#.\ .** ** .\..*  *\  \....\ @*\    .. .** . .*.*\ *@  \ *.*...   *. .\..\..*#
#\\.\  **.. .* \. .*..\.\ \ *\... . \...** *. ... \..  . .* **.\. * .  .\ . .#
#* *. \*..\.*...\. \. **   *.*.\*\  .* ... *  . ..  \    *..***  !.. *\.  . *#
#* \ ......***.\.. @\..  .*..*..\* * .\  **..* ..*\** .  \. *....   .* .  ***#
#..**.* *\. * \... ... *\.*. **. . \.. * .. .* **\.....@*.* .*\*. \ .* \\.***#
#*  .*. ... . . *** ** \. . .*.\ *..*\ *.\ . *..\ .\*. ....\ *****.\**..*....#
# . .. *\...\*\ ..\*.*\   .*.*.. .\.* \  .*  \.*.....\ ..\*. \.@*.  ... .\.W #
#\ **.**..\* \.. * .*.\.   . . \...\.*.  .  .. .. *..  *. ** . . \ * \ *\ \ *#
#.\.* \...... ..\\ ..* \*.* .**.* \..\ **** \ *\  .\ *\ ....  *\.. ! .* .   *#
#\... . .   \*....* ... .... **. ..*. ..*.*\..\.\.\ \* **..*\*\ \.  **.* *! .#
#*  .  *  .*. * ...   \  \\  ..**. ..*\.*  .*  ..@* ..*..  ** ..     ..*!\\  #
#* .\. ... . ...\.!.*.  .\ * **.@.   ..**. ..\.. *.!. .* \ *.  ..    *..\.*. #
#.\. *.  ***.  .*  . .  .**.**.*\.\. .*.*.\..   \. . .\.\. . ..\ .* .. *\\*..#
#\ *\..*.\..*..*. . ... .\.*\.\*\  * **.***   **.*.**** .      .*\.\..\** \\*#
# ..*.*. **   .\.    .\\ ..*\. *..*..\. ...\...**\*.**. *.*   \.\ .**@. . . .#
# *\*. \ *.\  ..  **  .   **....**. *...\....* ..*.\...*  . ** .* .!*.*..  * #
#*\ \* .! .***.. *.  . ...\\ . **..\*.\.\.\ .*.\ .\..*  \*.**.  ...*\*..\ .*.#
#*.*.\.   ..\. \** ..*.   *.  .\... *\ \.. .***    *\.* .\... ..  **  * . .**#
#\\.*  . \ .*\... * *.*\\ . \ ..*.\.\*\.  . ..** .\..\.* * .* .\* *\*...  **.#
#*. * . * *.\.. .  .*.\ *..*.\ .\ .*.... *\.* .. \..*. . .\*.. .*\  * ..*...\#
#*  .. *.\*  \ .*\*.*.  .\*..  ....*\.\ .\ *.\ ... . *.  *.\.*\.. .*.  .**\..#
#.*! ** ..\ \ * \ ... ** ..     \* ..* *.  \ ..*. .  *.. ** .**\*\ ..\ .. . \#
# . *..   *  .* .   ..*.  .  . .**. .*.*. *.  .\*.  .   **.*\***. .* *.*.\.\ #
# * *.\*\*.\ .*\  \****\ ...\.  ...*\*\*..*  .  *...\  !\    \**\  \ .\..*.* #
#  .\.. . .  *  *.\*. * ***@*. ..\ ..\.*.*.    ..\!!... .. \ .... . * ....\* #
#. .  \. *\**...* \*.\...*.\.\ \*  .\.*. .  ..**\.  ....* ..**. ... .* .***\ #
#!.* *.* \ ...*\ \  . **.* .\.... .  *.* *..  *.  . .....*\.*..* **\**.\. @\*#
#...\  ..*  ....*..\ \*.\.. .. .\... .. *\ ..\. *.*\@\ *.*....**.*. *.... \..#
#\ \ \*.*. .* .\.* **. *.* *. .  \   . ..    .\ **\ .. *\\***... .....W. * . #
#* \.**\\..******  *.. .\\ .\   .. \*. \. \\.*...    .\..\**.* .\  . @**\ * .#
#*\.*.* . *..\..\ .\.. ..*   .  \   *\****..*\@* *\*.. .  *...  *. *\.*\** .\#
#\.\.*. *.* * \*  *  .\!*\. *\.*. . ......* .*. .... \*@. ..\ .\..*.*   ..\ .#
#.*...  \ \.\\.*.* ..  \.*  *.* .. *.\*.* .* **\  *..**   **.   . *.\....\. *#
#\**  . .. *.* ..\.  .*. *\.* .\ ..*\.  *\.*.*...\*. **. *..@  .*\*...* ..! \#
# ..*\. *.\. *   .\. \  .**\..** ...  \*\ ..*.*\..\.  * ..  .W *....\ . * . .#
#.\\*.*.*\  ..\.   .\*.. \. .*.    *.**..  ..\. \*.* @.  **\ **. *.    \. . .#
#..**..\.\ ..*.      ...\*.\  . *. *  *** *@\ ...\.*.. *.*. *\* *. .**\  R\. #
#  *.\*..   **.**...*   .***.\.*.    *.\. ..\*  \*\*\. .. ** .. . *... .\ ..*#
#..\  . . *..* ..* .*  . .\ . .*.   \.  .  .*\ ..* .\.   .... . .*. . \*@* ..#
#* .\  *. ** *..*****.\..**   \.\*.*   .\ * .    \*   *. ....  *....   .# .*##
#... . . .. \.  ....* .\.\*\ ..**@..*.*  .    *..*.*..*\ *.\ *.. . \   *.. ..#
#.. * .*\*\ W. * *\  ...*..\ ..*..\.\*@\.*  *\. ** .* *.*.... .\. .* **.\*\\.#
#*......\.   ..\ **. .. ...*. .*  \\..*  \ * . .**. ....* . \**.  ..\.\  \*\*#
#**. \.\.\ \*\.*...*..*. . ..  .*..*\.* . .\   .*.*\  *\ @ \..\\. .*  ... **.#
#.**.*..  *. **.\\..\\.*   \...*.* .!\    . *.. . . \ \.*   .\* .*     \.*.* #
# *. .\***\  .. ..\  * ..\* * \. .*..*.\*.\*!  *\.\... .*.*.  .\.\ *\*..* *\.#
#. **   *.... ..*    *. .**.* ..\..  .\...*.*\.*   .*\ ...*        .... . ...#
#** ..* *. \ . ..\ * .*....\ .  *\*\\  *. .\...   .* .  . *\ \.  ** ** ..*.\.#
#\. \ . *\  **   .\*\ .*..  ...\.*.*\  **\!   *     .  * \*. . \..\...!* .*.##
# * *  \..* *..  \...  * \ *..  .**.***..\ *  . *.*.*..*. ..\\\* *. .#\.  .\##
# * . \**.. .*\. ..\.\..\.\ *\ .* .\*.. * * .\ \\....\** .* .\.\ *\* . ..*## #
#.*   ....*  . **** .. *.. ....\.     \.. .. .\. *\. !..\  **.. ..*..*\.###  #
# .\*.*.\.\ \**.!.***. ....**.\.\.**.* .*\ @ \ **  *. .. *\..*.  \.  !. \ *# #
##############################################################################

Water 0
Flooding 0
Waterproof 4
Razors 13
Growth 39
