##############################################################################
#                                                   #*# #   #                #
#                                                   #@.#.###.#               #
#                                                  #**..*..# #               #
#                                        #          ## .\..**#               #
#      #                    ###     #   #.### #  # #....*\#** #  #           #
#   # #*#          ##      #.**##  #*# #*.* *# ## ###\.\. \*.*# #\##         #
#  #*# * #    #  ##\*###   #* ##\# #*##..*#\\ *... ..*\ \* ** .#\ #\#        #
#### \ .*### #\##*#*.\*\#  ##.##*###\.# # ..**..*..*\. \.\..**. #...#        #
# *# .*\*\**#. *#\*#*###  # . . \ .*#\  \  \..**..*.#  ..*  ....#@ .#        #
#.. ##\.*..#*. ...**..*#   #. \ .\#***.. . .*.*.* ..**   ...   *\. .\#       #
#\.*.. ..* .. .  ....  #   #....\ .*.  .*.  # ..*\ ..*. \\#\.** ..*##*# #    #
#  ...\\.*  *.. \ . *\* ###.*\  .. \ .  *\.\*\ \*..*.\...*..**\ **.*..##.#L###
##  .\* *..\#... #.*. .*\. *#**.@*\#  .*..\.*** *.*.*.  ....\ ..*\ \... ** *\#
# #\*.\ . .**** ... \.#@*   ...\#* . **.*  .*** *\   \2\ @..  **.\*..*\**.*.*#
#\**.\..#. ..*** *** \**.\.*.\ **\ ....*   *\*\*. .*. *.*...@*.  .. .**....\.#
# #  ! .*.. . .*.*.* . ..* *\@*.\ .**. *.* .*....*..\*\ **....*..   ...*  . *#
#\.*\.***. \. ..\.*. ..\\*.. ..\.  .\.\. \ \  ** *.. .\ .*.*.*.  . . ...**  .#
#   . .*\  .. * . **\* . .\ *\ *\  ..**.\. ..*.  . * *....\***.*.**\...*\. **#
#  ..**.*.. **...\\.\..*\. \\*. .*.*.*  .\  ***\*..\* ..*....* .*\* . *. *. .#
#. . ..*\.* \.\ **.. \*.**  ..** \ .*. . * \... *\ **\**.*\...  . . . *.*.\ .#
#\* . *.\ \. .  .*.*\..\ *...*.....@***  . * .   ..*\. . .  .  .\* ..*. ..***#
# .\ \..  . . \.******\ *...*. \. .*\..\*@.*\..*  \.*\*\.\\     .*\ \. .. .\.#
#\**@@  \. .. *......\.\..\.*\ .. \*.\. .*\.\ ** \ *.*\ \   .*\ . .\. \ .*...#
#*... .\. . *. .** *. *.   .. .    *\ \ .\ ****.!\.  .   \.*. ***.... .*!..*.#
#*.  !*\..**@*.*\. *. ...**. \ . .\ *\. *.\.*. ..  \.. .     \.*..*.\. * . *.#
#.*. * .  ....*. .. * \* !**\** .  \.*..*\..*..\  .. *** ..  . .*. .*... .*..#
#.. .. .* \\  **.* .. *.\ .***...*  \* \*....  * \\. **.. \  *\.*\*\*.*\  .\*#
# *.  ***\.\ .*. .\. \...**\\.**....*...\*\. *\.\.**. ..... \\....*.*\ . ..* #
#..\.* . .*..*\*... .  \..*.. *\  *  ..* .*.\... ..****. * *..**.*. ..\ .**\ #
# .. ** .**  .!  .   \..  ... *   *\ .. .....* \ .*\.*. \. ..*.. .*.* .  ..\ #
#** **.* .*.  * *..* . .* * . . .*. *..* .. !\.. .* *\*  . *...**\.. \. .\ ..#
#***.... ..   \.\  *..* *..*\. \. ..* .\ *..\.\ . * * . .* . *.**..*.  *. .**#
#*.** *.. .A**.* .*.* \..\*.. . *...\... . *.. **   *  ..* \ *\ .. ..  . * ..#
#......@\.* .\ .\.\  ...\.* \ \*. .. . . .\\.*... . ..*.\* .*\ .\  \..\. .*. #
# . **.** .\*.. ..@..** **..\...*\*  * . \ ..\.. .* *\...*\.. \  \...   \ *..#
#. \.*.*.\.*.\*. .*\**.\.\*\...\! ***.  * ..* *.\ **** *... \*.*\.\ ..  .*. \#
#. * ..*      * ....* .. .\.    *.*.. .*. .\**.. . \ .* .*.    * .  ..* *.  .#
#.\*\ .\    ....*..*\**.\ *\.@*...*\ ....*. .*\ . ..  \  .   *...*\..\*\.\* \#
# **   *.*  .*. .*.  ... ...\**...* \ .  .. ..  *. .\..  .  ** . . @..*...**.#
#.. \ *. . ..\   ** . \.  . ...\ \*   ..*. * . ...\ * .. *  ..\.   .!..*. ...#
#..  ...     . .. *..* \ **.\  .* . . * \  !. \*  . *. . .\. .*.*  ..* *..*\.#
#* *. .* ....@* . ***.\  ..*. *\*. .* *  *.* \*. . .*  .**   **. \**.   *.. *#
#*.\ \*.    . **  \ .\*.. *. *. .\\*.... **.*... ..*  *..*.@.*.  ..* .. .. *.#
#.*** .*.*.* \*.  ..**.\ *.*.\ * ...!  . ** **.*\   ..*... .**\...... \.  .\*#
#   ...* ****..\*   .* .  .\..*.. \. \  .  .\*\. .. *\* .. . .*. . ***.* *..*#
#...\**  .\* . .*   ..\     .**..*.*\.**.\..*...!\* . \. ** *.*\\  \.\ .\** .#
#\.\*.\*.\* \..   \.\  \*..\!*. \...*.*.*  . .**. \ * .\ ..\@*.*. *..   *\. .#
#   . *.*\.* * **.*   . ..*. .*\. * .*\*. * ** **\ .  *.!\.\.\ *.\**  \*. ** #
# **\ .*  .  \ .\**\\***..\* . **  .*.... *..*.*.....*. \*\. * . *\.\\ ** .**#
# . ..  .. .*****.\.\.**** *.  .*   ...\..**  .* ** .*. \ .*\. .  \.  \..... #
#...* \  .* ..... *   .*.. **. ..**\ .*.\  .\ *  **\. \  *\***\.* .\. ..\.\ *#
#*\.. ..  .... \* .  *....\. . .*.*.*. ... *. **\!*..*.!**.. *. \.*.* .*.\*..#
#*..  *\\*....\..*. ...  *. ...\* .**   *\.\ ... \.\...* * *.   . .**.** *\ .#
#.*. .*  .**. ...*\**\*.*. .** @ *..  ..*\ .  .\* *.\ *. ... . ** *.\ \*.**. #
#\*. @.\.\*   \... .*..\\. . . . \..\*...  .*.   *. **.     .*... *. .\.\.*  #
# *\ .** *  ..  ..*...  *.. .. .\...\.. * \ \. *..\.*.*\ *  ....... ..*\**.\*#
#. *\*\. .  .*  ***... ..     . ...\  ... !  .**\ *.**..\.\. .*.\.\. ...*.* *#
#.*.*.*  *..**. ...\.\.. ..  ... *. *\*\*\..*.*.**..*.  *. .* .\. *.\**!.** .#
#\.\. ...*. *..*\ . @..*  \ *  \ .\.\* ..*   .\\.\ *.*.*...\.\ *!.   ..\*..  #
# *..\* .\ \* ... . *.** !***  .\  **.**   * \... ..\* ...\.. ..\* \.*.*\. ..#
#*.\.    ...*  * . *.** ... .....\ .\.*\ **..* .  *\ ..*.\*@  *. .  *.* *.  .#
#....*. ***\ .*  * .*. * *.. *.... . ..\. .*\..**.. *  .. ..*..\. \ .*. .  !.#
#\\\*\ ..\....*\.\.. ***.* * * ..\ .  . \ .\...*..  *   .   .*.* .\ . .*   . #
#.  *.  * .*\ \*...\.*.... * *... . .** . \  .\.  *\.  ...** .\.*\.. \..*.  *#
#. **  *@  \.. .W *  .\  \\.  ..   \ *\.  ..\ * .*.. !*  . \ * *. ..*.. .*.*.#
# .\* ...****..**. \*. .*  *. **.*..*....*   *.*\.\ \ . ** .*.  ..*... \.. ..#
# *\\*.   **\ .* *... .\*.. ****..***..      **  ..*..* ...***.. .* . *....*\#
#..*...\\..\. \. *. * . *  . !\* *.\***. *..**.* . . \ ** *..\  *.\ ...*.**\.#
# \..  *.\*.* .  . .* ... \ *  . * .\!.\ .*...*.*\...*.!. ...  ..\ \ . .*.. .#
#.\ .. *. ..*  * . \....    ..\** \* *\ *..  *.\*.*\.*. . .\..  ..   *\.* \..#
#*..*@..**. **..* \    \ .. \* ..*.*  *.* . * *.\\.*...**..*.  \ ..\*. .*\  .#
#*\ *..\.\...\. .  *. \ .\ ..  \.\... . ***.**.\ *\. ...*.\*  .\.\*\.\.*.W*..#
#.**.  ....\..*\  ..**..! \.\  .\..   ..*.\*.\.....*.\ .*\*...... * ..*...* \#
# \@.**\. ** *.*.*. .. .**.\   ... ..  .\. .\.*.** .\... **.**\* .. \***.. ..#
#\ **..*..*..*..*.. .. .\. *\.*\.   .\\\.\*\****.**.  \. .*\.  ..@  ...*. \ .#
# .* .. \..\ ..**\  *. \ * **\ . *.*  .**.!\.*. **.\. @ ..*..**.\** !....   \#
#...**.  .  *\*.. *  .\.*..\*... \*. . ..!**...*.. .... ! \! **.  *.\*\*.  ..#
#....\ .\  *..\   ! \ .*..* *  .**. * ...\*.** **.   ..  ..  ***. .... . \ \ #
#***\**** .\ **\. \.*. .\ ...*. \..\.. .*.\.*. ..    *.\.\. ..*\..*\!*.* .*..#
#.*\.*.  \.  .*.. . ... ... *.*.*.*.  .*.  ! ..***. *\   ***     .*..*.\ .!*.#
# \*. . *..***\ .*  . . \* @*\\ . *\  ..*.\ \*\ . \. ..   ****.* *.\..*..* .\#
#*.*  *\*. ...*.\.... .  \ \. ...\.*.*.\.* *..*\\....*  *\..*.*.*..W.!..\ * *#
#\.. .. **.. *.*. * *. * ... . \*......*\. . . .. \  .. ... * .\*\.* *\*! .. #
#  * *.\..@* ..\..@ .\.*.** .*... *  *  ..\@  . .. .*  \*. .. \*.. \ .!..**..#
#.*****W\ .\  \  ..\ ..... .*.  . . *.. .. \  .* \..***..\ * . .*.\. *.. .**.#
#*. .*W..**\  . ... .\ ..\ *W* \ \.*\*\.***.\. \ .  *.* \..* .   ...\.    ...#
#\.*\**\..**  \ \.  . . \ .*..\. ..**..*.  \.*** *.*.*.  . ** .\.  !.\** *\..#
#. ..*. * \.* .    .* *    **..*. *.  *.\ *. *.\ ... \  . .\    .\.  .\..**\*#
#\* *.\ . ....    ... . ...** ..*.\ .*..***..    \\ @ ...\ . . *\  .*  ....* #
#.*.*... .*  . ... *. *\.*.** .W.... .\ ...\ ..\....\...\..\.*.*.*.\ **\.  ..#
#*\ **  \*\. .*@.*.\*...****.  * ..  *..*.    ***..\..\..*..\. . \*  \.\... *#
#\ *.\ ...  \ . *.*@..*  .... @.  \ *.. *.* ... .\ .. ..  . .*W . . .*\.\ *..#
# .*\**. . *.* *...* *. .*.**...\*...@ .. .\.** .  ... . * **\*\.*. **** * \.#
#. .\..\  **\. .. .\. . .\\*.  \.*\ \.   **.@***.\\  ..  .\.....**.*.\.**.\.*#
#. .  \.\.*.*..\. ** *  ..* .*.  .\..  .*.*. *.....  . ..  . ..\* ..*. *.***.#
#\.\* \.. .\..*.\..... * .* *. \* .   .**...\ ..\ \..  ...\*.   * \.\.\*@*...#
#*  \\. \.  \.\ *.@* .***..\.  . \ ***. . .\**..\... **. .**....*  * . .\* *\#
#....\ .*.*. . \..     .*\ . .\ \ . .**.  * *..** .\* . .**... . ..** \ .. *\#
#.*.. *   @*.** *   \*.** *.!@.*\ .*.**.\** . ...*\ * .* ..\.  * .\. \.  .***#
#*.\..*   *. . \.. * . ..@*.*\*.. \.\. . *.*\*  \**  \ ..* * . * \** . \  *.*#
#.**\*.* *  . **.\ . *.\  . *..\\..   \..\..... .*.\* .. . ..* ....\. \..*...#
#\...\..*.@   .. @ ...\.  **. **. \*..*.**.. .\. \**. *\ .  *\ \..***  * .. \#
#*.*.. .....*\. \**\...\ . *.*\.... . .. .. *    ..\\ \.*\.  .\   *.* .\  \ .#
#.*.**\ .\*\*W.*  ...     .\.* ..   .\ \ * \.*\.. \   .*.\.\*@**. . .. ..*.**#
#\*  .  \*.\. **   \\* .*. . . .* . **. ..* !\ ..\   \.... ..\.* . .*@\.\* .\#
#.. .... .  .\*\ .* .* *\.\ \*.. \  \..\  *....*. . .\   ..   . *.**.....\\ *#
#.  *. *. .   *. .\*..   ....* . .  ..**  *.* . .\    *. ** .\*@....*.   ..**#
#* *.  .  **.! \ **. .**  .. *  * \.**.. * .*.*\..*.* *...W*\* \* \.*. .* \.\#
#\..\ *.\.*\ \ .*..  .*.  *..*.  \   .. \* *. . ..* \.. **W**.****...*\**  * #
#*.. \.*...*.. *.   \.\...\ \.  *.\ *\W  ..*..\* .. ..  *.**..*.*\   ..@* .*\#
#...*  ....\ *.***.... \ *. .. . . .  *\* .*   .   \*   *.* .\* . \ \*..\ **.#
# .\.\* **\*\** \. ..\ ..*.\*.!\ ! * \*. * .* .* ...\  *. .*@*\ .** .....*.. #
#**  .. .\ .. *..  ...* .  .. ..**** .....* **..\.* .  . .** ... *.. * \.  . #
#.*. \..\ . .\.\. . **\.* * \ ....*** \ .\ \.*.....*\ \ * .* \     .... .\.  #
# ..\.. .. .\ *@* . .....  * .* ****\. \  .  .*\.\*.*..\. \..   *\**.*..  .\*#
#..** .\.* *..**.*.. \   *.**  \...\****. @.\.!  .. \ \\*\*.* *\\.*.\ * ....\#
#*...*\. .*\*.\.... * . .*.**.\...  .*....*.** ...\*. * ..** \\...\   \   \*.#
#.. .....*. \ * .   *\. \  .\\...  .\..*. .\*. .\*.\*.\. ...\.\. **.  ... *. #
#**.**. *\ *..\*.*  .*  .. ..   \*\..**.*. *\.. ..* @\* \ ... *  .! W  ..*.\.#
#. .**\ \  .*.*... \..  *  .   .*..**...* **. . *. .\.**.@.* ..\ .\.\.    . *#
#..*..* .\.*. .*..*\ \**  ....  ** ... *....**... .  ***....@.  .*. .  *\*** #
#.\.* .** \..\\**  .**. @*    ......\ \.. .\.*...* \*.\.. *....  *.  ..**..* #
#..*\ **.\ *\*.**.\.*......   .. . ..\ *..*.. * .*.\*  * ..\\  .**\  *  * **.#
#\*. ...!*.\ .W.\*. *.*.*   ..*\ *  *.*!* ..*\\ .*\. ...  .\ .!..*..**\.* .*\#
#...     \.* **. ** ..**\ @**\. ...**.. ... .. *.\..\.  ....\    .  ..*.\ \*.#
#\ \** . *\.\.\. *. * .**\*\.. \.. .* .. ..!\**.  .. \ .. \*.\ \  *. *.  ....#
#.*.\.\*.\  * ..*.  **\..**. \..\**@* . .*...\.  ..@ .  . ...*\.! \ \.*  \** #
#.\ **..  . .\ .*   *.**. .  . \...\*\....\ ..*\.*... ..*..\\**.\ ...*... ..\#
#...\ *.   .* . . * . . *. \.*.. .\*..* \ * .\ .*. !.\!\..\.\*.  * **.**..\* #
#*! !..\. .*.  .  .\.*!*\ *.*..*.* ..\ *. .* **\*\**.*..**.\ *\. . .*\*\..*.\#
#..\.\** . * \ .* *.\..\.*!\.*....* \. . .\. . .  *.\. ..***. .*  ...*  .\*\*#
#.**  * .*.* *\*.. ..  ...\. .\.* *  ...*. *@*\ .\*. *. ** .**.*.  *\**.*.\\*#
#\.* \. .*....*..   W.. *.*\  *\ ..  *.*.* \\\*. *\*.. .*.* *\.**.*\ ....** !#
#  ...**\*.. *.\\. * *.. . .. *.*\    !* *\.**.\..**.\.\.\. .  ....* . ! .. *#
#.*.\...W * ... .. *.*..\* .*.***.*.** *  .*.\ . *\*.. .* .\ \.\ \ .\ .\  !..#
#\. .\.\.*.  . *\ @\..* ....**.   @..\ * *.   *\ .\.\ . *..*\  . .. .\...*.. #
# . **\...! . * *   .***  . ** .* ** ....  * .\!\*. \.* ..*\..\.* .\.  \..\..#
#*.\\..*\.  *\. .  * ** .\ .. *\.\.. .\\ *\*!\* .*\\ .. **.*\\ *.*.. !*.**...#
# *  \...\.* .  *. . *.*.*  \\ . * ...W. . . *.  . \  *..\.* ..\\ * \\.**\*.*#
# \** **   .. .*\..W\.*...  . *. .\ *.\ **.** \..\*.. .  *.* \ *. ..  \*..  *#
#*... .*.*  .\.\* .\. ... *..*.*.  \* *. .*\* !* .*.*\ .\. ...*   \.*.. *\.*!#
#. \.\.. * *.. *.* .@  * \.**.**.\  **** *\..  \ **.. * *..*. . @\*\. \. * . #
#.\.  .\ .\  * *\**..\..*@ . ****...W@\.\* \ .* @\*.. * . ..\  ... *.*.\ . \ #
#... * .\**...*. .** .. \*...\*.. *..*\**. .. \ ..... .  . ...* .*.. \.*.\..*#
#\\. * . .  W .**\.. *@\. ..* .  *  ***.\..     . \ . ....****\ *. * W*.\*. *#
#.. *\  .*   \ *\. \ ***\.\ ..*.*\..\**\ .  ..  . .*\ *.  *  *... ** ..* *\\*#
# * ...  . ..***.  .*..*  * * ... . .....\..   .   *..W*\ * \ \ *. *\. .@....#
#.*\*\.  *..W...*\..* . *.\.*  .*\*  \ . . \. . \ *.*  @ \.*  ***.\.**. . *..#
# ..* . .*.!* * .\*.* .*\\! . \* **** **\..  .*  ... .* .. . .....*\ .    ...#
#**\*\\*  .*\ .\   \.* \.\. .  ..*... \ .  ** *   .. ..\.  ..*..  ..*\  **\.\#
#.\..... . ..  . \*.\ \. ** . . \.*\.. .  ...  \ ** .\!.\ *.@..\  .\. . .** *#
# **** . **\ *.. .\.!\     \ * .  \*.*. *.......\ ..  **...\.*** . . .   . **#
#......*..@*       * *\ \.. .*  *. * \  \..\.*. .. .** *.. .*. ...* .\ * *\*\#
#. \  \.. ..\  ...\  ..  **\**. \.** .*\. .. .. .\ *\ *\W*..**\   .*\  .** .\#
#  .** ***\...   ** * .. * ... .. .... .*! ..\...*.\ *** ***\..*\*.* * *..\* #
#.*.\** *.W**  ..\\.** ...  \ \\. .* *  *\..* .\. .\ *....@.\ .. ...*. . * . #
#* . ...\   **\* *. ...*  ... \ ..\!\\* \.\ * *. **.\     *..\ !. **. \  \ ..#
#\.*\ . .. .\** **. *\.\*\. *. .\.\.  **.\...*\. ...... * *.**  ..***. **.**\#
# .  .**\. ..@.\..  . *.    .. .* *.\ ... . **... *. \ .*\!.*\ .* .**R**\* *.#
# *..\ ...*\.\...\!\.*  .*.  . .*\ . *.*.*.**\!.* .*...\.*.\ .\.\\*   *.. .. #
#.*...* . ..   .*\\   \ ... .!**\.*  .*...\.. . . *** \ \.*. * ***\.. \*. *\.#
#.* ...\ *.\...*.!\ ****.  .  ..\*.*..* .... . . .**. ...\. \.\**\  \  **.. \#
#*...* **.* \. .* . .  \ .\  *  ** .\ *  *\ ..  ..*.    .. \   * ..*...\*\  .#
#*. .\ .* ...* *. .  *. **.. ..\... * *..\  *.\* *.\..\ **. *...  ....\ .    #
#**  ....*\.*\ .\ \ .. .....\*  *...*.\ *.  ...* .*. *...\..... *..\.* .* ..*#
#*.. ... ..*..* * .\  .**\  *.\\ * .** .    \ * .*   .** ..\\.  ...\ .  ..***#
#*. * . . **. \ . **. * ..*.\. *... *\.    .*..  *\.. *\  *@*    *\  *\..\*.*#
# *    ..\** \.\ . .  ..*.*  * ** \.\  \* .\*.   ..* ***\.\\*\.. .*\*\ .  . \#
#.  \.*\*. .\  . \*. .  .*..\. ..* \*. .*.  ..\ * \ .\**.*. *. \**.*.. .... .#
#.* .  **.    .*\. . *   .  *. .* *..\.  @@.\** .* .. .\... .\  . .\*. .\   *#
#.\  \.\..   * *..  **\  .  *.*\ ...****\\. *.. *.*..\.  \  \!.  .  ..\ .....#
#*** . *. .   *!*   .**\  * ..  . .*.*.*.  **\* \.\ . \...*\ ..   *\****.\.. #
#*.\ .. \. ** . @.\   *.* ..\. \.\.***. ..\\.\*.**\.* ..    ..  .*.*.\\.*.*. #
#*. .*.! .  .**.*. . ..***\\.* **. *\. .. W.  .*.\. .... *. .\**.. \..  *.*  #
#..* ..  . . **\. . . !\ .** **..\**.\\.* .   ..*.*.\.   .\.  .*.* .. ....\!\#
#\**\  *. . .\* .*\\. .*.  .*.\..* .  *.  **.  \...\.* .  .\   . .  .*\ .\   #
# .\.*..   *.*.   **.  . \ *.* . .   **\*....  .*  *\..*  *..*     .*.  ! \. #
#.. ....*\.*..*!*  .*.*.* ..**.   ..*\*.* *\*\  .**\  \.*\.*@..\ @\ **. . ...#
# *.!*. .*\!*.....\ .* \.** ..\..*.\*.....*..*..*** . ** \... .**** .* \.*  .#
#. .**\ *.\.!  \*.***. *..  .  * . ..  .*.*... *\..\ . ...*. .***. ** . **..*#
#. . ..*.*.   **\ *.*. \.* .. ..\*.. * **..*  *\.  !**\...*. *..*\ ..*\*..\ .#
#..  *.   .  .  . *\.. *.. ..\.* .**.** *.W. . .@  .*..**.* ..  ** *\ @***@  #
#\. \.\* * .* *.*..**..  .  ........**.. *\   .   .*.. .**...*\!** *.\..\....#
#     .\ *  . \*... . \..  .  ..  ...\ *\..\*. .. \.  *   .\..  . *\ .. .  ..#
#*.. * * ..*\  ..*    !\  *.\ * *. *\.*.\.\*..   ... *.  ...* .\ *** ..* **.\#
#*\..\W\ *..  *..\!. . *\ *  ..\.. ** .  ...****\ **..*\  .\ ..* \.. * \...\.#
# . \.  .\.*  *  * \ ...\*. *... ..*.* ...  *..* .*. . *  @.! .*\.\.*\...* . #
#\    .  .*  * .\.@.*\....* .@.*  .*** . \ *.  .  ..\*. \ . \ .*.*..   . \ \ #
#... ...* .W * *.\*.\.*.* .\ ..*** **. . .*... *..*\. ... \..  .\. \* . * \.*#
#.\* \*\. *    ..*\ W*..*. .* \*.. ..  *..  ***..*.  .. *   @.. *\\.*\*.*.***#
#**. !\.*.**\  \.\ \.\\.*** *..***...*\***..*.. *.*\* *\. * .  .\*.*. .*.\*\.#
##############################################################################

Water 0
Flooding 0
Waterproof 11
Razors 7
Growth 49
Trampoline A targets 2