#######################################################################
#.*** ...\*.*.* @ .*.. .*..*\.*** \ \.*.  *..\.\...  ........\ .\.*.* #
#.**.* .* \*  . .***..\\ . .*.*.* ...\*.... .\. .. \..\..*** *  .\. * #
# ...\  .\..*. ! !..*. *     \. \ *\. .\... . **\ \*  \..*.!\.\ *** .\#
#\ . .*.*.\.* * *. .\ *@\ ..*. .. .   ..  .. *. ..\\.@.* .... .....*\ #
#\ ..   .**.. . .  @* .*.**\.\\  *  .\* .    . ..\ .*. ..** . * \**.  #
#..**\... \*\**\ *..\.W\*.. **.**..\.** ** \**  ... . \  \. ...*..\* \#
#  ..\@.*.\.*.*.. .* **...* ** .*   * .\.. .\*..\.\.**\  .*.\ .*@ .*. #
#*\  .* .* *. .* .. *.\.\ .\** **  \.\..\  \.. .*.***..\\.\* .*..****\#
#\.\  *!..\    ** .* \ .* .. \.*..\\**.  . *. .*\...  . *.    * ..*..*#
# .* . ..\. .*\!.*.. ..\. .  . .  . \ . ...  . ..\ *.  *.\*   .. ...* #
#. . .* *.* .. .\\ *.\**  \   .. * .  ..*\.\.*  .*. *\ *. ..**** ...**#
#\ *.....*.  .. * ... .. *.*. \ .*.*.**.* ..\.  *\. * ......\*\.  . *.#
#\*.    *    \. ***   \ .**\.*. *. . *.\...   ..** \.\ . **\...*\.*\ .#
#*.   *. .**\.* *.\.\ ..*\. *!W*.***\..  *  *\.. . .*\.\ ..  .\*. . * #
#***..*.*.\. \* ..  . *.*  ..  *.....*   *.\..***..  . *   * * .\ .\\*#
#*. *. .. *\. **. \  \.\.***\ .....\.\ *.. . *..!.***.\ .\**\**  ..*..#
#* ..\***.\**..\. .*\.*. ... * .\ . ** ..*....  * .*     ... ... *    #
#..\....* ... ** .*.      ***  * * ...\.*. .\ ..\.*.*  . *.* \.\.*.*..#
#* **. *. \. *..\. *\ .**. ...\*.. \*\.*.*  *.*  ..*\ \.** . ... **\**#
#*\.*  *\*! \.**.*.\.  ..*\ \.@.   .. \ .  *. *. .*.*\. ..\***. ...* .#
#.... ....*\..****. *\.. *.\.*.*\.*..* * !*\. .\ *.    .*.. **\  \ . .#
#** .*\* .\.**.** \.\\ * .  *....**@..\   .. * . .\ .*\... \.**    \  #
#*..   .\ ...!**.. .*\.**   ..\. ....\.*.*\. !**\*  .\...\ .*.\ . ***.#
#.\*.*.*..\ . *.\.\*.. .***. **.***   *\.. .  .*.\*.. *  * \.*....*.\.#
#. * ..*.*..  .* . @. \..*\.\.\ ... ..*. .*\   .\ . .**\**  .. .   ..*#
#.* .\ * \* .\.....\.  .....  .\\\ \*  **..**.\...*...  !  R *. . .. *#
# \\. !.\ .  @\.. ..** .** \**.**\... **.\ ..**.. .. . \*.**.*.**\.\.*#
#*.\. ..  .* . .* **.*\! \..  .\*.. **.. ..* .**. ** .. .\..***\.W\*.*#
# .   .\ . * . *......... . ... ****.\   .**.*.*.\.** \.  .* . .\...  #
#. . .  ** .\ .\.... *\ *** *. *.W*. . *  ..\....  .. . * **.... .* . #
#**. *\.*. ..  *....*.*....\.*  .\.* .*\*\.\. . .\   . \. ..*\*\**\   #
#\.\  ... * .  .\..\  .  . \.. * *.. **.*. .*   \ .  ...    ..  .*. ..#
#.*.  ** \.* ..... *@\*\.* *.*.. \.\. .\.  .** \.* .\. ...\**.*  *  *\#
# .!. . .  .  .  .  ..**..*.**..\.**  *. .*.**  .\ *  ...  \**  \ *..*#
#\ \.**\!     .. .*\. !*. ...   \ ..  *** \\**.. . .  .**  . \*W  ..*\#
#.\*. . . ..\*.\. ..\ **.   .  . *   .... .*...W.**** ..*   .. \ *  \*#
#\*** *\ \.. \**** . .*. .. \** *.\.\*.. \** . *.  .* .*\****\   .\ .*#
#.* ...*... \. .\*... .\*.* . ** .*  *\*   \*..*.\..\. .. .... **.* *.#
#\ .\\..*..  ..\ .\ \*  *.*. *..\ ......* . *. . * .   . *\.  . ..*\.\#
#.. .**.\  * * . * W . \...**\.\    .  .*\ \.! * *\\.\.  .**..* \\. . #
# .  ..** ..*. *.\   *.*. *.*** *.* *.\.. * !* * .\.. \ .*\.*.....    #
#\... ..*..  . ***  .... ..\.**** . *... **  *.**. *.*. ..* .  . . ** #
#   *. *\**...*..@ *.*\.\.\..\...\**.* \.* .\.** * *.* \***\.*... . . #
#*.*.. . .. * *.. .*@. **    . \.*\* ..  *    . *  .. *.*\ .\.* **... #
#*... !  .* . *...\..  \.* .***. ...  * .* * \ \** *\.. .*.* *..*. ** #
## .\.*\* .\* .. * .    \.* .\*....\*@**..  *\**.*  ..**  \. **.**   .#
#*. * ..*\ ... *\.. *  ..  . ...\.*  **\*\ \  .* \. ..... .\... **\* *#
#..*.. ... . *.\.*.   .* .\.! **!\.\ .... *.  .. . .* ..** *..  .*\* \#
#.*#.\ ..\**.... ...\.!.*.  *\*. *\.   .*!*. *\.* .*.  ... \.\* *. ...#
#.#  .. * .  .*.*.. .  .. *\. .**..\*\....*\.@* *\  .  ! *. .  ..\ .  #
#*##** *.\**. . .    .\.  .* **.. ...*  .** ... .*   * . .. . .**. . .#
#*.\.. ** **   .!.*.. *  *  \*.*..*\\.  *.  *.*...*\ .*** .* .\.  .. *#
### .*\.....* .  *.\ .\!..  . *. \ ..\ .. \*.. \. ...\..*\*.   \*. ** #
#.##. . . # .*\ \.  \* .. .*..   .\* .     *\.. ..   *\** *  **.   **.#
#.##.* *  * .   .  ..\   ...*\*. *.@*    . .**\    .\.  .\***.*    .\ #
#.*.\*.\.#..*. ** \ ****.*  . ..**...\.. \@ *\*... **....*...*.\\\  .*#
#.. *..\.##     . !\.. * *   *..*\   ... \.*... . .. .....\. \.   ... #
# .#.*..   *.* \     ..*..\..**\W*..@.  . *.. . \*  .\..* \  . .*\  \ #
###\ *. #*.* ....\. .\*\   *..**... .. .. \*..****\.*. .. . ** *. * \.#
#  # .#.#**! * *\.   ***\ \. \...\ .   *..*..\ . *..\*. *. .*...*\* . #
#  #\# ##\# . #...\ \*.* ..  .*  * ..\\.  . *..*.\. ... \*  ......\ *.#
#   #    ##*# .*\    .*.. * * .* .*\\.*. .*.*\  \*    . .* **\ *\\****#
#          #.***.. ****....\.\.. .**. . \..**. ..*    .  .\**  *......#
#          #...\  \** . * .  .*.  .\*. \ . *\* *.\.  ..\.  ... \... * #
#           ##**# ..\.*.\ * ..\\*\* * . . *.* .**...    . \\ *\ .. \. #
#             #.##***.!*\.* ..** \. . . *.    ...\.!\\.* *.  ** \    .#
#             #.## .. .*..\* .*. .*.  *... * **.**.\..**\**.***..    *#
#             #.#\*.....\ .. .. ..\..**.\.*\ .. ..*.  \ *.\*..\ \  *\.#
#              # #.*...    ...**. * *......*\*.**.. *\..\ .*!*. .\.. *#
#                 #\ .**..*.* \\ * * *.. .\...*** . *.\. . .*.*. . * .#
#                 # . .. *. *\.. \ .....* * .. .*. *.*.\. \ .*   **. \#
#                 #.\ ****  *. . .. *..\. * *  *..\\*...*...\*     .. #
#                  #.**\#\  ...*.* .\ * ...\.\\..\  ..\..  . . **\\*.##
#                   ##... * * .* .**.*\  \ ..  .*.!\.  *\*\. ...\ ... #
#                     #.#*\ .. \.#...  ... \ .\. *. \. . .*. \.\......#
#                     #.#**. !..   # **. \.*.W.  .....**   *\. ..*...*#
#                     #. ...  ..   #***.\ .*..   \* \..*...** **\.* **#
#                      #\..*\  * \. **..* .. .*....** * . ... \.*\ .\ #
#                       ##.# . ..\ ..** ** .\* *.****\*. \ .**. **.\  #
#                         ## .    \  .* \\ . \ ...\.\ *... .... .\\.**#
#                         #*  \**#  * *\  ** .\ *.*.**..\ W ** *   **.#
#                         #*\.. \ .#.\.# ...  . *  **. \. @ . \#*. \..#
#                          ##..## *# **## * * \ .\...\ . **!..@**. #*.#
#                            ##  ##*.##  #\**\*  *.\**.*...*#@...\ ..##
#                                 #\ # ###*\*  #\*.*..**.*#.\ #.  .#*##
#                                  ##*# *@....\..*.\.*.\ .#*.\.\.  ..\#
#                                   #@\.@.\* ..# *\* \*.###  *  \.. ###
#                                   #*#####**#... .#### # #*### #.\#  #
#                                    #    #*##.* ##    L   #   ##.#   #
#                                          ##..\ #             #*  #  #
#                                            ####              #.##   #
#######################################################################

Water 0
Flooding 0
Waterproof 11
Razors 31
Growth 20
