#########
#  ## #.#
# #\.##*#
##.#*  *#
#\.#.. *#
#..\  .\#
# \*\ ..#
# ..\  .#
#   **\\#
# .\.. *#
#* .\. *#
#.  .*\.#
#.\* ***#
#. ..\..#
# \  \ .#
#\  ... #
#..  *..#
#. \.*###
#  .#.*.#
### **\##
#  #\.# #
#  #R. ##
#  #*.L #
#########