###################
# #.#.# # @* @ \ \#
## ...*#  \. . * .#
# #. #.. \  **.A  #
## .\F\.  .G*..*RH#
# #*  *.  * 5* *.C#
#  #\.*. ..\*.*...#
# # \.. *...\ .\*\#
#  #..\..D  . **E #
#  #.\ * .  ..*..*#
#  #\.\*... *.**..#
#  # # * !\ .B*..9#
#  ## ..**.. ...* #
###*1..... .*..\**#
#\   2.**\.*...3\ #
######7 \...#*** .#
#    # ...\ * .. \#
#     L*\....   *.#
###################

Water 7
Flooding 16
Waterproof 14
Razors 6
Growth 33
Trampoline A targets 7
Trampoline C targets 7
Trampoline B targets 7
Trampoline E targets 1
Trampoline D targets 5
Trampoline G targets 9
Trampoline F targets 2
Trampoline H targets 3