####################
#             # #  #
#            ##*#  #
#           #\...# #
#            ## #  #
#           ##.  # #
#          #*. ...##
#        ## #.  #. #
#       # .## .** .#
#      ###\\# \**.*#
#    #L...****.**..#
#   #\.\..#*..\. *.#
#  #\.*. * .  \*\. #
#  #.#.*\   *. .. .#
# #. ... *\*.\* \. #
## #\*. .. * \ *...#
#.##*\\  .\   \*...#
#.# .\.* *. *.R.\ \#
#\**..*..\. *...** #
##..**.*.* \** ***.#
##**#*..*.  .\.*..\#
##\##.... . .*.**. #
#..##. \***   *\.**#
### #* .\.*..*\ **\#
#    #*#\*#..\ \# ##
####################