#########################################
### ##....\*.  *\ ...\ .. \.! ..\.* *.*\#
#\.\L !  .#.. *.\  ...\* *  \\..* .* ***#
###.* .*\. .   * * \.\W..\ *!\..  ** ...#
# #@*..... .*.\ . **..  .\.\...\ ***\* *#
#  # ....*\ .*..  .. .W. . ...  *.\. * .#
#  ## * \.*..*.R **\ \ ** ....!.... **  #
# #.  ... .*.. \. .  *..\*\\**.*\  .!* *#
# #.. **.\ .*.@ * . *.....  *\ ** *  .  #
#  ##....***..\... ..\W*.*  .* ..\....**#
#    ##**.\.#* *..\ *.**.*  *. *\ *.\\ .#
#      #\#.\ !*\ .**.\@.**. \. ..*\ *.\ #
#########################################

Water 0
Flooding 0
Waterproof 11
Razors 37
Growth 48
