############################
# #\.. .\ * .*.  ***..*  * #
#  # L.. **. **\ ..*.\. \  #
# #.   *... *\.*.**\. ***..#
#  #  . \ \ ...   ..  ..*. #
#  #* **... *  .   \*\ R***#
#   # *.... * .\ *. *. *  *#
#  #  .   **.  . ** .* . \.#
#  #*\** .\.....**.\*  .\. #
####.\#\    ..  \*...** . *#
#\ *. \..  \*\**.* \ **  \.#
#### .. . .* ... *.* *.\  *#
#   #.** *.*.\. *.*\..*.\ *#
############################