##########################################################################
#. . *... . .. ... !. .  . @@\  ..\.*. ..\\ * .*. *. ** ...*.*.. ..##    #
#***!* . .*\ .\**.    *... .*  .** \*.. \..*\  .*\...*\*..*.*.** ...*##  #
#.\. *.*. *..** ....*.\*\  .*.*\.  .** ..  . *.\.*.*\... ...* ..\.**..*# #
# .*  .*\.\. *.   *\***.*. ..\..  .  *.  .*\*.***.\..***\ . .  .*\*# . # #
#* .*. !..* .\ ..**..W\ .\\.\*.. . .\.*** ... *\.*.**. *. \  .***.\. ..# #
#. ... . ..\. .\ *.* \..***\ *.\.   ** *.   .\.* \*\**... *.*....\    . ##
# ***   .   .  .  !*\  ....  .*.\\ ....\  ..  . .. *. \ ..\..*.#... ..\ ##
#..*\ \* \ \ *\***.* . *.**  *.\.* .\... * ... * ..* .... *. *  .#\*  . ##
#\\.  ..  ..* ..\\ . \ .\* ..@\.*  ...*\ **.\\.. *..\ . .*....\* *.. \*# #
#.\** .\ *  *\ ...  .!   ***.. .*.** \***..  . *    .. .\.\..  . *\..* .##
#. .. \..  . \*.  .. .  .\ ...\ ...*\..W ** ...*..  *. * . *..\*.*.\..\*##
#..*.\..\*    *\* .  \. \ \*. ........**.*. .*** .*\ . ...*\. . .*\  ..\.#
#\ ..****.....\*. .*... W. ..*\ . * ... ...\ ..*...\  . .*.. .@ \** . *###
#..   **.\ .\@..*.**   \ \..\*  .*.*.... * .***  \ ..\.. *  \.\ #.  .\***#
#.  **..*. * . \ .\*  @*.@....** ..\   \\  *. .\.    .\\**\.....*.\.  .*##
# *\... *.... !**..* ....   * \.. .  *   \.  ..   **  .*\**.   * . .*.*# #
#\.  ..\*...**.... . \   . ..*.\   .\.*.  * .\ \ .*.*. \.\ .** * @\**##  #
#.* \..\@.. ....\ *.\.\  \*\..*.\.\ * @*\...*.\\ . \*\.**.\.*..######    #
# *.. . .*....*. *. .*.\*..** .* . . ..\\*. \.. \*\. .* *. * . ..*.#*#   #
#*. *. ....*\**\ *  *.***\*. ....* * *. @   ..  ** .. ..*..*\!  .###*#   #
#\. . *  ** \*..\*\***.\**..! \ .  .  *.@ \. . *\.*. * .*\ .*... .  *.## #
#..   . . ....  .*..*.  .*\. ..\. .*\.*.*. \. ..******\*. .*. .*\*## \*.##
#..\* .*. \*.*....*\*.....***.* * *** ..*...*   *\\. ..*.\.\ \ ....#\\## #
#..*.\ ..\ . *** ** \ *.. \... ...* \. .*    \*.**\ * ..\**..\*\ .!   \L##
#.   .**  ***...\ *   * . ...\.\  ..**\ .  .* .*.*.\. \\.*.\.*@ . ..\  . #
#\ \. ..*...*..** ..* \\ .  ... * *... *  .* \\.@. *   \ *.  .\  .**..*.*#
#.*  W  .  . \..* .*\ .**  \.\*. **\*.   *.  ..*. .\ **.\**.  ... .....*.#
#*\.*...   *..*..  ...  ..*. ..***  .**.*\. \.\*.. *.\* ...   *\..* .\  \#
# **.   *  ...\\*.*\ * .\*\*\\.*..** .* .*.\.. ..*..... ..  * ..* \..* . #
#\.* ..*... \.*****..... ..*   \..\. ...  . *..*... **\....*\**.. #  *\..#
# \..  . .\*. .* !\    **. *.\..** .\ *.  \*..   \..\.* * *\ ..*@ ...\*.\#
#\   \.*..*..*.*..**.**\*.\*. * ..*  . ....*...\. ...*.\.. . *  #. \*.\*.#
#*..   *  .. *\\\ ..**.\. *.\ . .\@*.  . \ . **. . *. .*. \  *..*.... .#*#
#* \ *... *....\.  *\. ! ..*. \**@ .* \ .\.  *\... \.\ *\*#\ ***.*   #* .#
#..  \*@\ *  .\. .  .* \  .\  ...\...\.  .\ ***\ \   **. * ...... \*..*###
#...\.*... *.\.*.\ . .@..\**\.. .. ..  **@.\*.\..  ..\.\..\*#.*  .#.###  #
#\.\ ***.\*\....!\ **\   **. \..* !*   ..**...* **..\* .  ...** \*##     #
# \. .\.  .* @.\* .\*.\**.****.\\  *  . ..  .*.*. * * .*\ #  .. .#       #
#\.. .  \  *..**.\  .\. * .\.** *. . .\...** . \.. ..  \.\*. . ##        #
#*..   *.  * .\.**.\ .. ..*..\**.\.. * \ * .   .*\. \  \ * #  *#         #
#!\**. !  .*\.\ .*\   \.\...*.**. \\ .* ....\ . ... .  * *..#.#          #
#. .\.... \*. * .**\ **.  !.\.*.* *.  . .\***!*.* .*\ ..*** .\#          #
#.  \.\ .* . *\ ....!.\*\.*  ..*.*..**.\*** . *.*. . *  ...\*.#          #
#\. . .*..**..*..*  . .W.\\ ** .* .  .\...\  \.** . .\ .* .*.. #         #
#\ .\**.. .*.*....   .\*..... * ..\ ......**.  \. *. . ... . \ *#        #
#*.@*.. . ..\.*\.*. \.**  . .**  ..  ..\*.**\   . !\..\**  \.###         #
#***!\.\ *  .....\*..  \.  **.  * ...*.*.*.\* **  *#..*.\ .!*.#          #
#\*.. ..\. .\ . * .* ..\.  ..@**\. **.\.\.*\.*** .*..\*\ \**\#           #
#\..\  *  *\ . *  *.  \.@ \*.\  *. ..\. * . *... *\ !.. . .\..#          #
#.  \.*.. \. ....*. * \* \*\.\*...*\ * *\ *\.*  ***.   . . . #           #
#. .. .  *\**.*..*.*\..! W\.. ...**  *..*.*..*\ .*.* @\ \. \ .#          #
#.* .**.. \ .*. .***.*\ ! *  .*\...\ * ..*.\ \#\#..*.**\#* ###           #
#* ..\ *  ...* .*... . * *...\*\. ..*.!.*.*.* \ .\...*..#. .#            #
#.* . \* *\.\. .* \.\\ **..**.*.   \***.\ . . .  **# #**\ #*#            #
#* \ ..* ..\* \  *\***  *\ .*\ *\*...*.#  .. #*  .# # ## ##.#            #
#* \*\ .   .* .*..*.*.\ ... . *.*.\* .*. * . #####      ##..#            #
#  .. . ..*...  .\\. \.* **   .\\\ ***\. .\ **\ #         #*#            #
#  . \    *.\.. *..\ .\.\ .*......  .* ***..###@#          #             #
# .*.....*. *  .....\.**. .*..!\* **.**\...*.  .\#                       #
#  ....\ ..\* R #** ** \..*. \. . .... #  ... \##                        #
#  *. * \#*.\ . ..\.. ......*.....*  ... .*  ..*#                        #
#\.. ..*.\. #\\.*.*. .\  *. \\\ .*... \ ... \ ...#                       #
# \.*.\ \#* \..\\**. \ .*... . ..* .. ..* *..*\#.\#                      #
#..*.  * ##...#....  . *\* * ** \.\  .* #*\.\*. .#                       #
#@ #\... .\ .\* \.\.*.*. \ . *.\*\.\*\  *#.###*\.#                       #
#* # *\* .* *..  . #..** . * * . .\@\  .# .*.#**#                        #
## . * .#* ...* \ \#\ #.\... ***.\#*.\*.## . .#.#                        #
##\.*#..#* *\..* ..#   ..\ .\*.*..\***#*#\   !##                         #
# ###\.\.##.#\.# #*#\#*...  .. \*..### # ##\.#                           #
#    #*## #*  # # # # #**   \. ####        ##                            #
#     #    ##..#     #....*.@  *#                                        #
#            #\#      # \\ .#..\#                                        #
#             #      #\*#. . . .#                                        #
#                     ## #**.\**#                                        #
#                         ##* ##                                         #
#                           #*\#                                         #
#                            # #                                         #
##########################################################################

Water 51
Flooding 5
Waterproof 0
Razors 47
Growth 27
