#######################################################
# .. ..   .** .  .... .. ...  .**\...*  .  .*.*..#    #
#\ *.**. ..* *\**. . *...*      ..*..# *****.\...#    #
#. .... \.*\ .*.   \ .  .* .* . .. *. \... .*  *#     #
#\*     ... .*.  **.. .*\* ...\.   ..*. ..\ .\ #      #
#*. .. *..*.  * * .*  \. . *  . *..\*. .\  .\..*#     #
#. .!  ** . .*.\..\***. .  ..* \. ..\.  .  !\ ..*#    #
#.*. **\..  ...  .*..**.*..  \@. *.\.\ . ... .\**#    #
#.* \ .  ..  ..\  \***...** ...*\...*. ...  *\.##     #
# *. .*...\\\  ..* ..  *.*\..    .. .*. **  *..\# #   #
#\..  ..*..***. \.\  .\.**. .\*.\.@* \ \*. *. ..##.## #
# . * .\.\ \..*\.*.**  . .\.  ** \..\*\... .  *.#. \*##
#.*.\.  .**.\ .. ..\*. \.*. . .. *. *. .. *\*\*..# \.##
#.  \.* ....... . **\  **.* *\ . .\ .  \ *  ... . W# .#
#*\   ** *. * \ *.!\* ..****\ .\ \*.*\  ***. \..*.\####
#.... .R *\..\.*.*. .. .*.. .. ... ....*..*.\.*.  #   #
#    \..*.. ...* ** *.. . *. ...* *\.*\.* ..* .\. #   #
#  ....*.\. ***\.*....* .\.*.. .* \  *\W. . \ ** *.#  #
# ..  .\..  \.**.  ..**\.   . *\.. *.**#.     #.  #   #
#*  \  .   *\ \\*\.\*..  .*\.*.**...* .. .*\* ####    #
#   \. .@.\* .\  .. \   .*** .**. .\* \ . *..\#*L     #
#** ... \*..  ..*.\..\..!..* .\...*.. *. * .#\\**#    #
#.**  \ ..\. . ** .*!.. *. .\*..  ....*\..\ .#\..#    #
#...\ *  **..\.\. ..  ..***..*\    *.\.\.*.*\ . * #   #
#.@ . .\.** \.*  .\. ** .  . .. \ *\.\  .. . ***.\#   #
#*..*  .*.\. .. * ....*  ....\.** ..*.\ .. .\.##*#    #
# *\.*  ** .*..\.  .  .   .*\. *. ***..*\.*\****#     #
#*.* \ ....\. \... **.\. \ .. \.\ ..****.\**W#.#      #
#######################################################

Water 0
Flooding 0
Waterproof 8
Razors 16
Growth 47
