############################################################################################################################################################################################################################
#                        ##*. .** ** .  . .\*.\ ***\ \.  . \..\.*.. .. \. *\.**...!.   *  @*\.\ .. ....*.* .\*.@ ....\\ ...   .. .\.\*!** \.... .*  ..  .  .\ * .. *  \.. *. !.\.\. .****. ..\ \...\..!\.. . . .**.. .3 *@ #
#                       #* .\  .  .\  .*\ .*.*. !.\* ... *  .\.. .*.** \*..*\..\\* ... * *.*\   .\ ....  ..*.*.. *. * \ .@   ..*  .\. * * ..*\*.*..\*.***. *.*.*. !!\. *.*..@.\.\.\  ** .\..* . \. .. .... . **.*. . *.*\*\#
#                      #*#\* . *  \  **  \**  ..\. . \* .\ . **\**. \@* *  .*\ .. ..*. \.\..  .\.**.\*.. .......  *.. .*.*  ***@* **\.\*..*\. ... . .\* . *.**.*. . . ..  ..*.*.  ..\ \*  . *\* *  .\  *..\ \.\ \   .\.* !.#
#                     #..\..* ..\ ...*\ ..W*\ *. . * ..* @*\ . *\..\..* **.@\*.*\   . .***\*..   ..**.*  *\ .*.. *. \* . *.***.. .\.*.*** ..*.\. .  \...**.**.*.\.  *.. .  **.**\\... ... ....*\... *. .\.*. ..*\    . . .*#
#                     #  **..  .**\*....*\... . . .*   *.. .*.*. \   .\** *. .* * *. *.*\.*\*.. \**.\.\ .*\* *. ..\. *. . *. . .  *....**. *. . .*.\**   ..\.*...*  .*...*..***.*.*\ *    *  *.*\   *.... . ..*. ..**\ \.**#
#                    # .\..* . *.  . @ . \ .** *..\. .\.*\. ......\*\* *.\.*\..\. . \. .  .. W .@.. .  *.** .*. .\ . ..\.   \ .\..*  .*\*\..* .  . ..\*.\. .*.*@ \ *\..*.. . *.  \. **  .. * ....\ .* ..\**  **\..\...\* *.#
#                   #**..  .  *. . #*. *.. \.  *..*   *.   *\ ... *.*!.* .5.*. * ..\ *.   *\ *.***. **. \**\ **.**  . ... *  **  .. ** *.* .*.\ ..  ....*\ .*..*. *... . *  ..... **.\.* * * .\..*..*.*..** *\  *.*..    *W#
#                 ##...* \*  ***\  * \.*..* * *. . *  \*\*.*.*\..   ..\..    *\. *\  ..\.  * * *\\.*.*...\*. *.... \ . *.\*. .\..\***  \ .  \ \.*\.*.\*\..* ** \*..\.   * ***...\. *.. ..* .\*!\..* .\*  *..*..*. .\* .**\*#
#                #*#.\ *  * * .*. ..*. *  .\\. ..\ \...*.\ **. . \* .. * ....**. *@*. \*\*....**.* *\.*  **.*.. . ...  .. *.  \ *W*\.\ \.**. * .*  * ... *..\* ...\**\.*. *.*... ....   **. ..\ .\* .... ..*..**.   .* *. .#
#               #\. \..*..\ .. .   ..\ **.   .. . * \ *\** .**. . . \ .\. . \.** *..*   . ..*\*. * \  *. *  * \.*   ..  * .*...   *..  ..\.. .*... ...*\..@ ....\.*.* \.  *  .\  **. *\. * . ... .. ..  *...*.\.. .*.*..***#
#              ##.**.  .. \ \ . ..**\*.*.* \* *   *\   ..\.**. . .**.*   \.\. ..\.*  **.. ** .  .. .\..*..*.*\!\. ..*..\.\ .. *. .\ .. ..  . ...*. .* *.  ...*.\*\..* .*  \ . .**... . *.*..   *   !**..\\.\\\*\*. .* .**\.#
#            ##*.\... .* .   **. **.... \.\ *.. \ ** .**   \. .*.**..\\*7* *\*@....*.... **.  \.. . *.*.. * .. . *\**\*... *.\* .  .  * ... \* *.. ..*. .. *...*. *.\   . ...    *...*..*.  *\  \ \\...**!. **\ \ **.. **.\#
#           #...\.   ..  *.**..*.*.* *. \*.* \@  .**.\*.\*.***.\\\.*   . \.... *  \*..   ..   .  *\.*.!*  . *  \ .*.*...** *   .* .. *.*.*.\..\*.  ...  .*. *\ * .*.\...  W  *\**. . ...!.\\. ...\.*\..*. .*.. ...*.\* .  .#
#           #\\ .   \ .  .*...** * .*\ \ . .****.*\.\.* .. .*.. \. .*.\ .. . . ..* .*..  * .  . .\ ..\ \.* ** ..*   *   ....*...*. . .  .\*..  \*.. \  * . .....*\ *.* *\**.\. ..\. \..**. .\. .   .*\\\.  .  \ ...**\ .. \#
#           # #. #*#.\ * *\ ...***..*\*  . *. *\ \*  *..\* ... ***. *. \ *      *\..*.. *. . ..*.*\ . .*... ..*\.\....\*   *.* *..**. .*.*.\.\. . . .*.  .* .\\.!..  \ **..\. \.* *.\*.**\.* **  *  * .\  \   ..  @.*....\.#
#            L #\# *. ..*.   * *.@  ...\. .*.\ *  .*.\ \.*. .\*.*.\*\* .\...*\.@.*. .*..*. *\  *.\   . *.\*  ***   \** ......\ * .*....\..**.**.  \... *\  **. **.. ..*..*.** *.*.. **\..\ * .\\ \**\   \..*.   \.* .*.*.**#
#               # #. .\..* .....**. *\    .*\ .. .\.*. .\..*. ..* \. ***.. . . *** .\. * \*...W*. *\ \ . .  . \.**\ .\.  .\  .\..*.  *...*\\*.*\ .\.***..\ .4.\*\ *.\.. .* ...*\.*..**.\\  .\ .\.. \**\...\*\..*.*\.   ..\*#
#                #*\ .* ***\ .*...* ..  **..*. .. . ..\. .*\W \*.\ .....*\ *. \... *\.*.\.*\*.\. .\*. \  . ..* *.*..  \..\ .\*..\**.\.   \.*.. .*..**\.\.6 . * ...*\..  .*.  ...*@ \..    *  .\* * ...** . ... ..*. .\   ..#
#                 ##**. ..\ . ..\\!. *\.**\ @.. .   .*. .\. .* *..  .   .*..\ . . **.*!*...... .\**..\**   *\..*\* ....  .. .\. .\.*..\\.. ..  * \ .*.  *.  *...... **..*.   ***..*.   *. \\*\.. .\.\..**\  .  .\.  .... .\#
#                 #*...* *. \.*\*.. *.. !.. .* *\  *\\*\ . ... .**.*..* ..*..   .\.**. \. \\*  ***.*\** .*..   . .\. .*\\..* .  *...\ .*\.* \.\...***  ..*... * ****.*. \.\* . . ..\ **  *.\.@*.. * ..  ..  . . . .   \.  .#
#                  #.  .\*\ .** . . \...   * * \.*..!*.*.  .* **.....*..* \.\  .     .* . ..\ ...* * ..     ..  . .* ..*.* .*.**. *..... .     \ **...*.   *\*.\....*.*..* .\*..*.  .*.  ..  ** ...   *   .*** *\  .  .   .#
#                 #  *. .# #*.*  \  .  .\ *...\..***\. .\. .*.\\*\  *.*.*   . **. . ..\ \ *\.. .***. \..* ..***\.*.* ..     ..*\ .*.*.\.   ..\...*...*. .. ..**.*.\ \\.  . \.\\ *   *\*\*..*\ *\* @\.*.\ \*\.* . * .** ... #
#                #\.\..    \  . . *\. .** \    . ..\  * * \ *.*  ..*.****\.\*.* .. .  .. *.*@W  .*.*.. *.\*... *..  ..  \*** ..*.*...**  .  *** !  **. .  *.* .*.* . .. *  ...\. *\ .@*.\ .**.\..\.* ... . *@. ..*. .. \\. #
#               #.**#*#.\ ...\ . *. .   *\.  *.@ .  ..* .\. .*.*\\ * ..\* * ..  * . . * .     ..  . \.*\. . . .  . .\ ** *.\.   ...*.\.**  .***.* .* .  * \*     ***  \*. .*.** .@.*..   **.\ .. . . *.*.  .*\*.\... .\*\. #
#            # #.\.*#*     \ ..*...\*. *\  *\*.\**  \.*.. \. ***   ....   W .*\... . \.. .\  . W . \.    \ ... * \* .\\. ...**.*\ .*.*.....*... .  ..*\ * ..\ *.*.*. .\ *\*. ..\  \*..\...\..   \   .\ .* . .. *  . * .*.*.#
#           # ##* \...*.**.\   .*\  ..\*. \*.* **...  *.*.  * *.\*\* . .***\*\  \@\. ..**. **    ... \. \....*..*.. *... * \.. \ . . *** .  \**.  .\*.. *.\ .**\.**  *** .  * \....*\ ** *  \..@*\*\ . ..\  \..\ **.. .*..\#
#           # ****.#\..*....\  \.. * \..*.  *.\*..\* *@ ..\. *......\.*..\.**.*.. * *.\*.  \ . ..\ \..\..**  * .   .*.\ .. .  *..* .\\.**\** ..* **..* *. *. * *. .\ \**.   .. *.*\ .\.* * **\ .\***.\.\  .\.*   \.\  *.*  #
#           ##.\..\..*..\@\ *@\  *... ***. **..* \.  \ . \. ...*.  ..\\*.*\@ ...* !.\..\.!.*.. * **@\ .**\*..* . .!*.. .  . .\..* .. *.*. .. **.  ..*...*..  ..\* ..\ .**.\.  .**\***... . .\** . .* ..*\*\  * *H..\ .**.\.#
#          #. #.#\..**.**** .** **..*...**.*.\....\*..*  .\   \.. .  .*\ ... . . **   ** \.\ ...\ **. . ..*.*.*  . \* \..      *.** .. . .   .  \**...* ...**.\..   .*..\*   . @***.\\.\  .\..\  .*\.  ... \ \ .**. * ..*\*#
#         ##\*#. . ** \ ...\\\ *.\* . **.. \ . .*\*.. .*\.. . @.    . ......*\.  .*.**\*\ ...!.   ***** \ ...*\  . \.* * .*.\.* \*\. ..**. .\.\\ . .\.. ****. ..*.** * . . *.. * .*\ ...*. *. .*  *.*.\ * \.*.\.. .*\....*.#
#        # * .. *. ..*.  **. .\. !\ *.\.\   .. . .  .***....\.  * .\ * \ .**... \\..*... **  .\ \ . *.* *.* ..\***.....*..E\..   .. . \.*\\ * ** . .. *\*\..\ \ .*..\. \*... * . .*.* . . *. .*.*   .\. \.. ....*.*. .\..\.#
#         #. * .   **.. .* \\* *   .. .    ** \ .*.\.\ . * ..\*\. \.\* .\*\*.\*...\!.**..\.\  .*  .. ..\.*  *\  .**@.  \.* .\* .\  *\..\.*.  .. **   .. *  *.\.* \...\. . ***  \*.*.  . .*. *\. \  .*.\ . *...**..\ **.*.@.#
#        # \ ..* *\.*\* ... *. .*.\  . \*\*.\***. . * **..* . ..**.    *.*..\ \ ... ..* .  .*...  .\..\.*.*\*  \*.***.*..   *.   *\.*.\ *\*\..  **\ ...*.  * ....\*\  .  ..*...  ..* *      ...*.\..***. *.. ... \ **.\. \.#
#         ##. \*...*.. .* **. .*....   ..\\ ** . *..\ ..*... ***.*\*\..\ \..***  ..  .  ....*\*!.\*\    . ..*....**.\ *.*  **..**..**   .*. .  \.. ..**\.****. ....* * ..\ ....\..\ *. .\ * \**\ !.*...    @ ***\.\.. .*\..#
#          #   *.. .. . . \. ** *   .*  . . \ \.\. **  .***.*..\*... *\  *\***..  . .. .*. .. . ..* *  **.. .**.*\*\..* * ....\*@ .* . . .\.*..... *.*.\\..*. \..*..  \ *.\*\\  . .**. *..* .*\..\ * *.\*. ...* *.*** . . .#
#          #. ..\\* .**\...\* . . . *\.**  . * . .\ * \ **.*.  *. \ .\.... *.*   \.  . \.W.** *.*.*... ... .. .\..\.*.. .  *.  *.\ .\** ...** .@.  .*****.  \.*.**.  *. *.. ..* \. .** * \* *.*..  . ...... \...**.\. *..  #
#  ##     #..**.\.* \..* . . \.....*..*@..* \. .\\.*\.*\*.  .* . .   . .. *...*. ..* . .\*.\...*.  .*  .\ * *** .*.  *\.***. . \*. * ...\ ..* ..\..*.\. ..**..\ ..*.*.\.\*\.*.* . . .\ ...*..\.*.* .\..  .  ...\.*  .***.\ #
###. ##  ### *.  *.  *\.* .\* * \ *.  .  *   * . *    . * .\.* .** .  \ ....*  .....**. .*.. *\*.@*\.*\*. . \..\**\* . .*.**. \  * * .**  ...* ...\. .. *.. *. . *..*.. .*  ....*.       .!** \**..** \ .. *.   \.    *..\*#
# .  #.##**.\. .*.   .* *.. ... .  *.**\.*.**.. *.\*. . **  *\*.... ...   ..\.  *.*\...\ . . . ..*\*** .\.. .  *. @* .\*.*.*\ . \*\.\***\*\ \*    . *.\...*   *..\..\. . * \  . .* .* .  \\....\*..\ . .\.\ *....*.*  .**\.#
####.#* #\\.  . **\....  .* .    *..*\.**...\   .\ .\ .  .\.....   \ **\ *.*   ***\* \**...\.   .*..**   *..*.**   . ... ..\.**.....*..\*.*..\*\.. .*. .\.. ..\. * . *.\ *... * .* *  . ..*\.*.***..... *.. **. *!*. .\\@*.#
#  #.#*\#*** .*\*\\\   **.... *.*.. .. \*\.@ *\* * \..\.\   *  .*   *\ .*..* .\**..\*..*..  *.\ .*.*...\... \.*\ .\ .  .. ** .\***. .  W.*   . .*     \ *. *\. .@.** ... *\*. .**. .\...D . ..  \*@.. *. *..*.* .\ . *.\ .@#
#  #.\.. .*\* . ....* *\. ! ..\ .  . .  \. \\. *\W W * *.*\. . .\.*.*. \*. * **\*.*.. *. \***\...   * .\.\ *.*.*\@.   ! \ .. . ..* *** * .**  \ *** . . *. * *  ...\* *. . ..  ***  . . *\\* ...*...**.\  \.*.**  .. *W*\*.#
#   ##.   *.*.* * *  \**.  *....... **  .\  **  \  .*. .W*. .\.*.\.*. * \ ** .\ ..   * . ...**.. .*.\*\*\ **\*.A..*   ... ... *.\*.@\\ *\\*  *.*... \*. ..**** * .....\ .\**  .\.\  .. *.  .2.  ...\*** *....*. .  *\\**C.*#
#    #..*.**. *. .\**.***.\.\. ** * *  . *. !\**W  .. .**. * **..*...   .. !...**.**..*   \ ..  . .*..*   \.*@    *\**.\ .\.   *.. .*....*. ....\..*..*\ *.*.\ *.  . \..*..\ \ . ..  *. \.. * .\   \\.*..*.* . .*. *..*\. .#
#    #  *.\. .*... . *.\***\*  **..*. \  *\...\.\\..\. .. .*\... .\*\. *.*.*  **\*..*\...  .  .. **\ *. . . .\  ..*.**\.\..\ *\.... .*\.*W * .\.* \* \..  \  **!\. \..**\ *. .* * .@.\\ .  \.   * ...*..*.\* . \** . *.   .#
#     #*..*.. ...\*.* * *.* ... *. .\\.\... .\.*\F* .@*\.  .. \ * *.*.** .**\.**..  ....\** .\ * ... @ .\*.. ..* **.*.     .*.........* \  *.  *** .\ .\..\.*.. @\...*.. **** \  *.   . .\..*.* . .\ ..\** ..\* ...  .**.  #
#    ###\\**.\.. \...* *. .\. .\@*\ .* *.@..**\  *. .**.*\ ..  *!\.\\. .* .*..*\\. .  * *\. ....*.. *.  *\\*. *.\* .. .\*..  *.\.\.\ *.\.* .\..\* **    .\ ** *.**.\\**.\.!..\. *.  ** .   \.*. *. . * ...*  ** *.\.**..\. #
#   #\   #..   ... ...*\* **...... . *.. ..\.**  \ \ .\ \* *\....  .** . \ *****\.\  .*..*.\ .. .\   * ..*\.. ! *. * ..*\  ..*. ...* . .\..**.\.*\*   ..*  . ...... ...*.\*\.......*.* ! *..\  .\ *  .. **.*** *\** .\\*.**#
#   #*. **\     \\  . .*.**. ..\*. \*.  \.\. **\   *.R*..\*\.. * .. *\\. . .**..***.. .  .*. ** . \ .**.\*.. \* *\ \  .*.*..\. *\.!\*\ \.   .*\ .\.\*\* .*  **..*\.  *.** *  *.. .\. ..\*.\ .. *.** ** *. W..\ . *.. . . *.#
#   #.\ *\ ..#* .* *\  . *. *.*.*.*.\*.\  . .*.. .**.... \ **\ .\*\.*. * *\ .\.*.\..* ... .....\  .  .. *@* ...\..*.. **\.** \.*  ..*.*.* . **\.....**. .. .*. ..*  ...*.***\ **  . . \ .   .*.* .. \ .\.*\  \   *  *. ... #
#  #.@ .... \... . ***\*. ..\. \. .*. **  ...\ .. \ \ * ..*.* .\.*.*****. *. *. * *\. \\ ..\* .. *!.\ *.\**  **  .**.....* .   .*. ..\..* * ...*.*\* *.  **\**. ***.\.\...*. * ..  \.\.  \  .. \  .\* ..*.!*.. .\...  ...*.#
# ##*#  *#\     .. \*.** *  *. . **   *..*  G.\. .\.. ** .. .. .*.\..\*.*.*   ... \.*.***.  \. . .. . ***\.\ *\. ***. *  .\.*.\ ...   ......*..*.* !\*. *\**.*. .\.\I*\....\\**\ .\.***.*.*\ * **\ **.... ..*\... \... \ .*#
##***.*\.*..\. \\.\.*\\.. \*  . *..   * *!.... ..*..*. . ... \*.*   .*.....\*.. . .* *..  . *.\  *  *..*.. * \!*\W.*...   *..**.\\ \.\ *  \\ .*\ \ . . *\.*@**.. .\ .. * ..  .*.*.  .. * ... \*.\ ..*.   .*.* .. ..  ...\  #
# #.#..* .* .*.*.*. ..  . ..  .\.**   *..\...W. .. . ..*.**\  \..*.  ..\ \..*.*.\ .**  . . \\.  ...*. *  \***.*.  .**.*\..*. *\ .*.* . ..\\.   .** . .\**.*...*****. .*.* **.*. *.   **\\.\.\..  *...* **\*.* \ \.* .*.  .*#
# #  *\*.!. .. . **. \..  **\\. ..*\.*.. .\* * .**.... .*.\*...* \. \. ...** *\\.W*.\ . * \*.. . *.\*.\.  @*. .*..  .W.* * * \ \ \ ..  .\.@ *.* .\ !\   .\.* \ *.\.! * . ...   .*\ .*\.*\  ... *\.**.***..*. *..\* .\     *#
# #  . ...* .**  **.*.\. **. \.. \*\ .\ .* *\ .*. *****  *\. *\.   *.*.* . .***   *.   .!..*.   .\....... .*\ ..  **  *\.\\.\. .  \ \* * \...*.* ..@.*..  .  \  \ * ** .. * . **. * .  .  **.\..@.*. !@**.\.\.   *  . *..*\#
# #@#.   ..\ .. .. ..\  *.* ... ..\*.** ...*. *  *. **\ .**. *.*. ....*.  . .*\..*   \.*..**\ .\ *. . \*\*. .**\ .*.*\. . .*   .*   ..    ** ...  *..!*.. *.\. .**..**.* ...*.....*   .*. ... \.....* ..\ ..*.\. . * \.\*!.#
#  #*\\.\.*   **\ * .**..\. .*. ***. *. * **.** *  ..\* .\* .*\*. * . *. .\*.... *. .\ . ..*.. .  . *.. ...** ..**.**  ..  **.  \...  \. *..****. *   . . . ..  ***.. *.***..\  .*  ..*****.   @\ ... \.* .* @ .* *.\.  .\ #
#   ##.#.**..  ....*\*..\  .*. .*.*  .*\*.\. .. . ..  \. *. ....  ..\..*...... . ....    ..*  .* .\**\*\  \...@*. *.. \ *\* * .*.  ..*.*.  .....* ** *\*.   \*.\* .   .. .* ...  . .\*.. *\.. * .*.*  .....* .*\* ..\..    #
#   #...\**     .*.\ *\\*. \\ . *.*  *. \. . .\* \.\  . * \**.\*.*  *. .\ \**.   @*. \ *.\.. * .\ *.*.. *   *\.  ..* \. *  \.  *\.. \*... *\\*. * .\@*..* ..*. .   ***   *\. *\  ..\. *.\\. ..* !* .. \ *\*\*.*.\ .\ \*  .*#
#    ##..... *.*.. \   .*..  \  .!.  .*\.\. \**** !.\* .. *.. .. . .*.    *\*.*\ .*.. ***!* * \**.*.*.  .  ..*.  . ..  \W *.***. *.* *\. \.  .*..  ..*\\  .\.... *.....\. .***  .*\ *..***  ..* *\.* .... . ...\*@*. ...***#
#   #.***.!.*.\\. ..\.\*\. .*... * \* ..* *...\ *!**.@..\*. ...*.. .***.*..**\* *\..**.\*.* . .*\.  \ \*..  *\** \...*..\\* ..* .*.. .  ..* \.\.* .. *...  .. \.\.**  * \..\.\.\.*. ..\*.!\**\  \ .* .* \...  \.*...   ..*.#
#    ##*. \**.  *\*......*.  .*\.** .\..\ .\ *.\ *.* ..\*  . \ \.\.. .\.**..**.    ..\\ .** *.*. .  .  * .\*.. .. * *.. .. . *.*...* ..    .. \.\ ..@.*.**  .. * ...\ *..\.*\*.* *\. .**.\.**** ..*.\.. ...\ *.*.* * \ ...\#
#      #\ *.*  ..*.*\*..\.*.* \ *.\. . .\. ..*\ ... .\. * \\* ..*! *  **** ...\.**. .  . *. .@. \\ * ...* .*.\.\*..*.*\. .. .*\**. . .  * .**..*.**\...*\* ..  .\  . .   .\. * .*. .\.*\   \.*\ \.!* \. * . .*...\..  *  . #
#      #. ..* *  ...*... \*..\..\**@ \..  . @.**  *\.*B.. ..  *...*. ..\*..\*. ...  *.*.**\ .@...\*\ .* . .*..**\ \.*...\.....*.  . .\**.* ... **..*..*..   ...\*.*\.. . *.. *  ...  . *..\... ...*.  \. *.!* ..*.\  *. . .#
#      # . *.*...\* \*\ . *...* *.* *  .\.\. .\\... *.. \ \* . ..*..  ... .*.* *  . \. ***. ** .* .* .@ \ *..\..\..*.  ***. \.\ \ \**.\...*   \... . **\ **W  .\.**\  \**\*\** ..    ** * **.  \\**. ..* ..  ...* !* . *.  #
#       #**.*..!...*....\ . .\. .   .. ...\* ..*. ..**.\. \...\. ..\**.\ * . *...   . .*.... *.*.\.   *.. .\*. * .@ .\*.  ...  *. ..\*. . .*@* !\ .*.* *......\ \.   ...\..*....\ ..\ *\*.*.\.*.\*.*\ ..*\**  . . *\**\....#
#       #*##.\..\**.\ . . .** * \ .... .\** ..*. \ .*\.* \ *. .  . *\. ... .***.  . . *.*.*.** ..*..*    .  *. \ .** *.\\..\   * .. * ...   **..@. ..* \**. .*...\.. .@..\..* *\. \ . .\.. .. .* *\..\ **\.* ..* .@.. **..\#
#        ## #*. \.\.*   . *...*..**.\*. ..**  * ...*  \*\* ** *.    *   ****..\ *\.  \.*.*. **\.  .\@\..*.*.*\\\.*.***.*.*..\* . .* \*\. \.*\.**..* ..!...*.**. . \\\..\ *\**\. .*.  .*\.   * ..**@*\ .. .. * **  **. ... .#
#        #*.* .. \.. \ .. *.\*\. \.*.* \.\.**@*.. *..\.. * ....* 8 \**\ \*. *\ .* .\*. \\.\.\*  ** .*.@ *.* .\..... ..\* \ *.\ *\*\ \.    *.... \ ..\*..* * *.*..*!..*\.**.*\.\*\...\ .*.\ *\@  \.\**.\*\** ***. \.. *\. .*#
############################################################################################################################################################################################################################

Water 8
Flooding 16
Waterproof 12
Razors 47
Growth 7
Trampoline A targets 3
Trampoline C targets 8
Trampoline B targets 7
Trampoline E targets 2
Trampoline D targets 4
Trampoline G targets 5
Trampoline F targets 7
Trampoline I targets 6
Trampoline H targets 7