###############
#*.* ..!\ . . #
#\. *  * ..***#
# . **\.*.\.\*#
# *8.\.*.* * *#
# .*3.*. ...  #
#  .\. *  .  .#
#. ..  *.. .D #
#\ \ \*  * ...#
# .. .. *\*...#
# .*.  \.*.\ .#
#\ .!   .@**  #
#\ .. ..*..B  #
# .\  * .\.\* #
# .*\... * **.#
#*\.* ..** ...#
#\ .....E. \ \#
#   . . . *.*.#
#**..C.\ \....#
#. *\. . .\ . #
# .*... *   * #
#  .. ...  .* #
#***..  .*..\.#
#*.\ \  ..*\ .#
#*.....*..***.#
#* ** ... *...#
#* ....\R . .*#
#\  \.. *  ..*#
# \ \  F. ..**#
#* ..  *  \.\.#
#*  *. \ . .. #
#...\ *..* .**#
# \ .  *\ * \.#
# .    \.*.   #
#\@  **A*.  ..#
#.* *\*\. ...*#
#*\ *. .   **.#
#.*\.!. *   *\#
#\\   ....*\. #
#.***. *..*.  #
#\... .* *.\ *#
#.*    . .\.  #
#  .\**. * . .#
#. \  **\. *. #
#\.*...\ **.\.#
#....... *!\. #
#1 .*.\*\*\ \ #
#*  . . **2  .#
#* . ..***#**\#
#.  .\.*\. #\##
#\   *.. *# # #
# .# ... .#   #
#*@ .*.. #    #
#*#\ .#*#     #
##.* # #      #
# L. .#       #
#  #*#        #
###############

Water 43
Flooding 11
Waterproof 0
Razors 5
Growth 15
Trampoline A targets 8
Trampoline C targets 3
Trampoline B targets 1
Trampoline E targets 2
Trampoline D targets 3
Trampoline F targets 8