##############################################################################################################################################################################
#        #**#.#**##*..* ..**. . **  . ..  \...*....\**.. .. .***....!\   *\\.\. ...    @  .\ .\    ..*. * .. @ \ . \*..  . . \\**.\.  . ..   .\.\ \...   .\ **\..**. *\..\*.*#
#        #\.*.# !\.. .. **.*.*\...\ **\..   \..\  \.\    .*\* .  * .*.\ \*.. \ **..\*.*..  ***. ..  *..\.*  \***  \.\.* ..  *..\.*.*.   *. . ..\ ..  ! * ...*\ .  . ****\** .#
#        #* .. * ....*.*.* ..\  ...  . .  .*.*\ . .\\ \** ... *   .** ..*\ . . .* .   .\ .**\. ..\*. *. *. *.*....!\.*...\\.**..*.\.\@! \  \..\ !*\ *\\.*\ .*.\ . *. * ..*.  #
#       ###.   *  ..* *. .\*\.   * .  ***.** .\* .  ***...\ \ .\  *.\ .* ..\  \.*...\ ***@.* ..* . ..*\*... .. *.. .  \.**\ .\. .\   * *. .  \ **   *\ W\ ..\. .*W\**\*  .*. #
#     ##..* \  .\ .  \.. *..  *\ . *.*...*. .** .   \.\*...*.  ..*.\.*. . \  .*.\*  .*.* ..*  ..  *******.*..*.**. *\.  \.*  .\.*\.* .\. \\ \...\  *.*. . * **  . **\ .\\.***#
#    #.# .* .\.*.. .**.* ..\. *. \*..**.\... .. * .\.\*.\*.\  ** * *. \.*\ .* .  . .\.... \. \.* *.... \.*.... ..  @.*\ ..\\ \....** ...**.  ..*\. .***.\ \ *.  .*.*..\.*\. \#
#    #. *.\ .. *.*..*\..  *.  ...!\.**... ... . *  * *...** . *. .\!. .\.   . ..*  .. .. *\.  **.\..\*.\ \***..  ... *..*\.. ..\. W.\   *.. ........*..\ \  \.... .. ...*. ..#
#    #\*** .  .*.*\ .**..\.*\ ... *..... \*\.*\. \ . ...  *\ \ .* \  .*.@ . .   \..\. *.\**.......***\* * .\*\.\*.\   .\.. .   *  .*!*.  .\.*..* ***. .  ..   .* .*...*.\.. .#
#    ##\#*  **.... *..**  ** .... .  . .. \. *..  ..* \. *. . ...  * ..   .\*.*... .. .\*.  . ***** \*. \**.*.**..   .\  ** *... .. **.. .\.\* ....  *. \ \*.* * *..\*...**  #
# ###*#\..  **.*..@.. \..*****  **. \..*... .\ *\*.\. *..\.\.@*...*.\ .  *.. \*.    ..*.  .. .......* . .*. *\ .\.*!*.*.. .. * ...  *..**.\ *.\ *.   .  . ..\..  .*\.*\..\. .#
##.\ \..\     ...*   ..  *.\.*.  .. .@ .*\.*... .\ * ... * !\..*\.*..  *. *\..**\**\*..  *. \. ..\ *\.   \. . @..** * *.\.. \...\* .\**.. ** .  .* .. *   \...* *  . .** *\ \#
# ##*** .  .*. .\.**\.*..*....*\ .\**  **@**..  * ..@*..*.\ **.* \*    . .*. *  ... *.*\.. *. \* * ..**  .\*  . ..*** **** ..\*\  **...*.\..\*.*.. **** ** .\..\..*   \*\.* .#
# # .# #*\ .\*  .*\!**. . **.*\.  ..\ **.\*.*.\.\ .\\. ....\. .*\*. ..* **@ *.\**\\ .  .  *.. ....\\*\. \*..*   .*.* ***\*   *. . \.  .. .  .\ \.*@*...  .\. ...\ .* \ .* .\ #
##\ *\ ## *  !.* *.**.*  \..... *  .\.**\ . ...**.  *\**. ..*\..\*.  *\.\.*.*..\. * *\ .* *.*. ...  ..* ..  . *\..\\ . *\. ....**.*  .  *  *  *.. .*\ **.**\. . ..*. .*  * . #
#**.# ##*\*\. *.  **.\..** ....\. .. ***.\ * .. .*  **\!*.* .** .. . . .. .\.. ...\.*. *..*\.\**.\*.* .\ \*****...*... ..\.*.\\..\\  **.* \  **..  *...* .. \. *\ \.. .* .*. #
#### # #!...*..* !* *. . *\ * . .. . . ... . \.**. **\*.\.*\*\*.* ** .  ..*@\...\*.*..*. .*\ *.*.**.*.**....*..\  .  * .\  . . **  .*. .*. *.\**  * \*\  .* .\...*. . .*. ..*#
#       #..*.W *. .\.. **\....\.* * * * \   *..* ...*\*\ \* .*\..*.... \ .\ * \... *\\.  .\. .\.  **....\* ***. \ .\.* ***  \.\**.!**\ \. .. . *..\\.**@* .\..*\...** **\..**#
#        ###@ . *  ****.***\.**\*.**  ....\.. .*  \ *.\.*.. **..*.*\*\.   ..*..  * ..  ..* * \.\..*.*\* ..\ .*.\..   *  *. .. .*.\.*.*.. * . \..*\*\ \*.... * .* \*\..\*  . .#
#       ## *\  ... !.*. .***.*\ .\ . *     . .   .\ @...... .\... \..  \  ..   * ***.   *\ .\ *.*\.\*.\.  ..*....***  *    * . .*....**.\.\. ..\.*..  ..*\*.\\\.\ . .  *...\.#
#    ### #.#.. *. . .*.*\...@* *  \* .*.   \.* ....**\..* * .*.*. .*\ ..   **. *..*..*. \*\ .  *\*...\. ..  *...... .*. ***\.*.\. *. ..**\  ...*  .. *. \ .!.*\.*\ .*. \ ..\.#
#   #*.*. \.\.\.\* **..  \ ..@  .*.. *.\*.*.\**!\.*\.. *.*\* **.. ** \*\. .*\. . ..**\  .*.**  .... \.  \ . \.  \. *..*.\@\ .* . .. ..\ ..\**\\. ..  ***  *\ .*.\. *\.*..*.  #
#    ##.\\ .* *  ...\*.\. . *\.. . W*. ..*.\ .. .@.*..**.  . .\*!*.. *...\.  ..*  .**@..*.. @  .  . *.\. .*\.* * * .\ *\*. . *...*\..  *\. *. *\ . *..... .*. .* \.* ..*\*  *#
#    #\ **#*. .\*\. .**..\ .*. ***. \. .*. \ .\..**..***  .\*\   . *** *\..*. .* . .*.**..  .\.**   .\**      .....*.**.\.\.\..*\..  .  .. **...** ** * . .@ .  \.*\   ... W.#
#     #.* *.* . ...\\ *\.. \. ..*.* .   .. .. *! *..*..** ..* ..*.... *..... ..*. ..\**.\.\  ...  *.  .\*.**.   @... ..* .*. *.\    .  .\**.*\* .. ** .  ...\ \ ..*.***.W *\*#
#     #.\##\*\ *\*.* ..*.*\....*..* *.\.*..* .\.. .*.\..\ * .W\..@    *** . \*..    * .. *.. .\.. .* . .. .. \ .\..\ .\.  . *.*.**.. .*  .*..  \ .*!  ...\**...\ ....\.  \.\.#
#      ###..#  . *. *..\ !. !\\   * ..  *  .\**.*\*.\ .  **\*.*.\..   . ....\\* *...   . .*.  . ..... ..  \\ .** *\ *\\.  . . ..\   . ***.* .\\ **.. \ . .*.. \ **.** .* .\.*#
#         ## \ * .*..  ... .\*..  . .*.\. \ .*..*.. .\   .   *...*\. .**.*. **.\...  .\ \... \*\..*.\.  . .*..\ .*@...*. . . . \ . .*.\ * .\......\. .*\.\..\ ....*..**  .***#
#          # ..**..   .   .* .* .  .  \.**.***...* * .***\ .\ @. . * *.. *. .. * .. *  . .   .*.\*..*\.**. \*\ .*.  .... . *\* *\\  . .\*  .*.. .*.* . ... \ *..  * .. ..\.**#
#         #!. \ ! .\ .  . *.* .*  .... *.. \.. \**  **\*.!* . @\*. . ..  .*.*\.*   ..* **.. .\. ..*\.\\..** *.  ....  .*.  .\... .*. **.  \ .  \*... .**.\ *\.*.****. *... . #
#         #* # **. @*.  . \*\* * .** \*..* .@. ..\* \*..\**   . *. ***\  .. .\**. *.** .* . ... ..* . . .\*\.  * .*  ....  .!* . ..\.. .. .*.* \.*.  *.\. .. .\ . .**.\*  .. #
#          #\ \.*   .    ... . .  . . .. *  .\..  .\ *\ . *!\.  .  * **. *  ...**.\ ... .\ ...\*. \.*  * *. *\ . ..\ *. .   \* *.  * ..* .\..\. \.. .\*....*\.\    .. ...* *.#
#         # #***..  *  .*.. .\\..   *.... .   *\\* ... .*\**....** *\..**\**   \\.* .*  *\ . * \  .\*  . ! *... .* **..*  *..  \..*.*\*..* .  *. \*.* . \ ..*\.*. ..!\. . .. #
#         # ..**  **.\.*.\.\  !\.*..\\\. .*. ...*...\ .*.**.\ **.*\.  \..\.*.   * **.\* ...**. .\\   \. .*.\.   .* \.. *  *. * . *.*.**.* **.\\* .\ .\* ..\....\ .\.* . ...*.#
#         #  **.  .*  .** ..\.*\   ** .\ ** . ..*\. *. ..\.. .\.\.*\.* ** .. .  ..\. .! .. \   *.\\.*.*. .\. *.* ...  * * *\ ....*****.. \\.*...... *  .\*..@\ ..*.*. **\.  .#
#        #.* *..\. .\*.*.  * ..  .  . .* .  ..*.\.\*  .\ .\.\  . *.. \ ..*.     ...\*\\  ... .  * * . .*.** *.\* * *. .*! .*. * ..\....*. .\.\.\ *. **  ..*...* \..   *. *.  #
#         #*.\###   ..\..\ *  \ .*...\ . . * *.   *   *..*.  .!  \..*.* *... \\  *. *..\* \. .  **\. *..*.*.***. \\*\ .* \ ..     **  .  .  .*\ \....\*. *\.\ .. .....*..  *.#
#         #** ##..*. * **\ . \   ....*.  *.\.** \.* *.\..\!*.  \   *.\.....\. *  ...\ .. ..\ *. \.*!* . \ ..*.. * ... **.. *..*\.\*.  \   .*.*  ..   *.!...**..  \    .* * ..#
#          #*.\ . *...\..**\..\   *.*. . !.*.\* ...\.\. *.\..* .\.**  \*.  ..*.  .    ..*\..**.. ..*.\.\.\.\..\*.  .  *.*****\.\ \**  .\.\\.* *.*\ .*.!.\ . .\  *  **\..* .  #
#           ##.##\***...\.**\.**..* \ \ * *\*..   ..\ ...**  .\ * \.. . . \*\.\.\.*  . .\* * \  .. \ ...      ..\.*. * ...*. .   .*\.\*.... \*.... ..\**\.@*.. **. \ **\... .#
#             #  #*.*..  .. .  *\.*.*..  \* .*  *\@  *\  \*   ..*\.\\.*  \.. ..\*  ..* *@. .\ \*....*\  \ . *@..  \  .\.**\* *..*..\  ... *\..*\**. \..**..\* .* \.  .**.*. \#
#               #.*.!\*** .  .*.!* .**.\ .. \. \..**  ..\.. .**\*..  *. .\.  *\*  ***.. . .**. *.   . ....**..!**. .\\.** \. . \ ....  *\..* *.*..*. . .. * \. .* ..  .** \  #
#                ##*.#**.* .. .**..\.\ @.\.  . . .*. . ..\\* .\  .\   *.*..* .\.. ...  * .*.\**...* .\ \.... ..\. ..**! . ..\.  *.. * *..*..**..  *...\ * ... \.    *  ... . #
#                  ## ..\*\ .\... \.. \ @... . \**.. .!*.**.  .\  ..*...  *.  ..\ .\*.*. \  *..\..\ ** .@ .**.\ .*..**.\ **@*  .*.*.. * ..* .*.*.. .\.\.*. .* ! \ * .\...*.*\#
#                  #*\ \.\.. . . * \ .  \. *. ..\*.* . . ..\. . *. ...\ .\.*     .. *  .\.*. . **\* ..   *\*.   .* *...* .@*!\* .\..\ .*\.. \  . .*...*.****.  .\* *  . ..\* #
#                 ######..*..\  *. . *  ..  \..*.* .*\..* .\**. . ..\ *     \* .\ *  *. ... . **...    \..@.  .  .\*\ \\  ..\ \*   \*. *..* .\.\. .\*  ...**.*\. \     **..*\#
#                #\*\ #..\.\ **. .. .\ \*  *  !. .*\*.\\ .*..\*\*\..* * .. *  @  .*.**.* **\* ..@\.* .    .\.  *. ..*. *.\.\*   ...\ *.***. *.*.\. *\   .*@\.. ... \.\*.. ***#
#                 ##  \..  *.*\ .*\.\*...*  \.\.*\ ... .*\!.\ ..** \.*. *.@.. \ . . .*.*\..*.  \...*\   * \.\...\.  . *..*\*.\.*\*\*.\ *\..\  !\....*!\  .*.. \. \  *.\*.  *.#
#                 #**.  *  .*. **.. * . .\  **..*...\.. \*\   .\*..\..**..   ... . .  **. ... . *  .. .......*.* . .  .* ..\**** ..\ *... .\* .*****.  \ .!.* \......\ \ .\  #
#                ###.  \@. ....*  *.*  * *...\.*...\.*..\... *. .\..  ..\. .**  \**.\.*.**  .\ !\. . \. **\  . ...**. *\\.\ \.....\ **** *..  .... * ** *.\ . .**.*  *.* **.*#
#               #.... .*.\** . ..\. .* \*@     \.. .\.  .\ .****.!*.\*. .\ ... ..  ..\** .\. *.*....* \.. \.\.* **... \* .   .* \*  .*.*...\.  *\ ..\\. . .*    **  *.*..\.*.#
#                # #****  ***  *.!*. ...\.*....      *.. **.....\*... .. .*** . .*\ **.  \..***\ ..\** . .    .* . *.* .  *! *  *.\...\..* .\**.*. . ...  *\  .  \ .* .*\ ...#
#                #\ *#.\ *..#*** \ \. .   * **.  **.... .*.* *.*..*.*.**.*....  ...**..*.. ..\\. **..@ *. .*\.*.\\*\ . *  *. .\\\ ..** *.*...\*.**\ ..! * .@   .... .\... ..\#
#               #*.. **\*\**  \...*. *     ..** \\. . *.  .*.*.. .* \. !\. \\  . .\***\..    .*. *\ .\*. .*\ .\ * . *. ..*.*.   **\ .. **.. \* \.** .* *.\** *\*\.\  . *. \.*#
#                ##\##.#*..\.  *   *.**. \  \\..*.    * **..*!.\ .. *\\\* *  ****..... .. .**.    *. .\*. . *.. .\...*\.*.*. . *.**\*...*.* *.\.W.. *....*.*..* *. @\* *\*\*.#
#                 #*\ #..##.\* ..  **.!.* .. .. .* . *\  .**. \..**... \*\...***. .*\ .*..\.*..*  \ \. *.*\*. *....  .*** *..*@* *...  .* .*..!.   ** \  ......* ... . ..\..*#
#                  ###. *#.*.. \\.\..  **.     * . \.\.**.\. . *.\\..* ..* .****.*\*.. .*\ \.....* *\  . **.\*.\*  *\ ....** .*...\.*\ ..*... \ *.*. .\ .\...\  * *\..\. ... #
#                     #\##* *....*. .. .* \  *\.**..\   ..**. .*\**.\.\. . @ *.\...  *. .*. ... **.....*.*..\ . .. ..  *  *.* .*. . \ \ *. *\ .\  ..*\*.*. \ !*\.\.**..  .   #
#                      #\\**. *  ***   *. . . **. ...* . \.*\.*.*.*.\ **** *. . *\ * .*. .*** .. **.. @. .       \ .* @*...  . \.. \.. \* .. .\*. \***\.**... . * . **.*.*\* #
#                       ###* * #.*.* \*!.*...  .... *****. ..\...\ *.*..*.   *..\...  \*  . *\** .\. . * .*. . .  \ * .@..W*    .* . \ .*. * \** . .. ***.. \ **. ..*... . \ #
#                          #.#..* .  \ *....\  .*.  *.\W\. ..*  \ *. \ * ** *\..*.. .*... \ ..*..\* **\....! ..*  ......   *  .* . \*.\.@*...... * \ .*\*..  \..** . @** * .\#
#                           ##. #  **#.  .... * .*  *.*. *. *. *..**   * ..*\ *. ..\* *... **\.*\  ....*\**\**\*..*\*\.\ *.*.\\. **..\. .*.   . .*..   .\ .* .* \..*\.   . .*#
#                             #*!  *... .\ \.\** .*** \.  .**!* W*.!. \.. .*..  ...* .*.*\*\  .\..*...\\*.\.\\..* ...* *. *.\. .\** .*.  **....  .\  ..  . . ..*.\ .. . . \ .#
#                              ##**. **....\.*.*\ .**\. .**.... .. .. . .. *.*.**   ... . .*. . **. **\ .*.. *\ * ** *\*\ .**\!\.*. *..*\**R\ . * .  .  .* \.*..*@.   \ . . \#
#                              #....  .* .*  ! *   \..  .\...!\ .!*\.*.*.. .*.\  .**.\.. .@.* ...\  .* *.***.*.\.  .\. \  ..*..*.**.. **.*.*.*.\.  . \**.**.... *  *..  .... #
#                             #*. *  *.!\..*****  *. \ **.*.***\...** *.\!. .*....... **\*..\ ***** ..*\***. ..*.\...* .*\ *. .\.*.*\ *.. !.\..   \**.. ....\   . *\*..*. ..*#
#                              #  .  **.  ..\*. .*.  .. . . .. ..*.*..! .  . ..*  ..  *. ...**\..\*.**\*...\ . ..*.   \.. *\.. . *... ..* * . \\ ..... * *\ *  \ *.\*\ . \.* #
#                               #* \ .\.*.\. .\ *..   ... *!.\ .*. . . ..\.   ... \ *..\.   \.@..*  ..   .\.\....**...\.*..* ..@.**\.. *\ .\W... **.  *..W @\* . .**.* \ .\. #
#                                #.  .*..\.*.**..* ..* *\.* \.  *... *. \.\.* @*  .\..\ .. .....*..\.*\    ...\.\\.* ..\\*\\.  * !*\. \*.* *  .  .\  *.. .    *   ...\ * .. *#
#                                # *.  ** .**\.* * *   \ \.    *\*  .*..*.  .. \* * .\  \ . \ . *..***.\\..*\ *. * .. ... *..* ..  .. **...**. .\. *.. . *...*  .\.\ .*.  \.*#
#                                #  \.*** #..   .\ \*  ..  ..* *\..   *.***  \*W.*\.   ...  ..*.  .***..   .**..*... ..*. * *\*. ....\ .*.*.  * ...*...*. . .\\*..**....\*. .#
#                                # ##..#. ....\*.  .*\*.\\*.** .\ *..*...\*.. .  *   .\ \. ..\. ..\*..\....*.**\** \ *\*... .**\    ***** . .\. . ..*. ..\.  ..!* ..* ...\*.*#
#                               #.\\ .* .*\ **..@.  .... \* .\.*. .*  **\.*. . ..\.   .* *.* .  **  \*. !\ .  \......\ *** ..**@** **\ \* @*\  .@ *.\*.* *.   *\.  \. *\**.* #
#                              #.\. *\.  .....*.*!*\*. ..** *.\\  .. * .*.\***. ..  *\ ...*..   .**  *.. ... ...\.. .  *@.  ..\. *..\\*.\\.. .  .....\*.*.    *** * \....\ **#
#                              # ## \.. *.** *..\ .* .*\.... .  ..*....* *W.\. .     *   ..*\ .* .\ ...   .\ .\\..*... .*. *..**\..\. !.**. .\* \* ..*....*. *.\\ ...*.   **.#
#                              # .*. *  *.** .... *. *\.  *.\ *. \ \. \.\..\*\**\*.* * ***!. .@  *  *\*\ .\.  ..\*.*.. \.\*.*....\  . \***  \.*..@  ... \.\\    .*\.*...* .\*#
#                               ###.*..\  .*.*\ \..* *.  .*. .*. . ..  *.!\*...* .*. **..\.**\.. \ \   . *. . *\...  . .\ . \ . .  * * ... *..\.*\ .* .\.\  *. *... . *\\*...#
#                                 #\   #**\...*...** .  *..* *...\.*\*... .. * .*\..\.**.* **.\...  *@..\..* .. ..  .\..*.....* \. \*.*   **   .\.* * ..* \ . . **.  .*...   #
#                                # **...... *\. ..**\ \ .\*\..@ .  ...***  * .  . \ **.*.....\ .\*  .* .    \  * .@.\. .*\.. . * . .**\.\\*.*\ \.*. !**\*.*. .....*    @*\  .#
#                              #### \. * . \...\..\..*. . * ... *\.  ..**  .*\.  \ *\. ... \ .. ** .  *..*..  . \ *..   W..   *...* ..**... \ ..*.. . * **\ ****.\.\*\....  .#
#                             #*.* * .###.*. .   . ....\\ *  .\ ... **.*..\  * ..* ..  . .\.*.\ .\ \ ..**\.*.   ....*..*\. .. \*\**  \.\ **\..\\\.\\.. ... **.*. .\.\. ..   \#
#                            #\...  * # ##@.\ * \ *......!. **\ \*W . @.  **\...* *  *..*   * ... ..! ..\**.* *\  ..**\..  ....* *.  . .W*@.. ...*. .*. .  *.\** .\  ..   *\.#
#                             ####\ *# #\ . .*.. .**.*\. .* *.* .. .* .....*.\.*....*. ..  *\.   . *\**.**..\.\ *\  . * ...  \ . ..   .* \*..\. \!.. .   . .!.*\ * .* *. .*..#
#                                 #.*#  #*\*  .  *.....   \.*** \.*\*.   . *.      *  *.*...**....*. **....*.\ . . ** . .  *  \ .*.\ * .......**\*.*\  .*  @ .* \. . .@   . \#
#                                  ##  #****\    *.*\ \.  \ .... .*. *\   **..**.* . .\.. **. *.\\.*...*.*.\ ..*\ .*\   \ .* \ . .\...\ \ \ \**\**...\. . . *.. . \. *\ \\  \#
#                                      #\.\#..\! * .***.*   *\**  *.   . .*.*   *\ .\ *. \.\** \  .. @*.*.*.\* .* .*@*     .\..**. . \.......\*.*.  \  *  * \ **!*\*.*.*  .\.#
#                                       #\..* ..\*. .. *....*... *@\ . \@ ... *\* . .*     **\ ..W*  .... .  * **..\ *.  *.  . \. .\ !.*  . . ...  * *.. . ..  .*.*\.!.*\.\* #
#                                      ##.* .**. .\. ..\\....\*. *\. *  *  .\\.*. \ *.  *. \\ ..\  \. ..* *. * ..\..\...** .  .*  .   * . *\*  .\*\\\ .*....\. .*\ \*\*.....\#
#                                     # *......*..    *..    *\  * *.*.. * .*    * .\. *\**.**. ....\ . .*.*.. ... . * .*\*    ***.\ . ..*.*.  ......... **\.*. .. .. *  ..  #
#                                      #*##\#*..* .**\*. .\*\*. *.**** ***.* .\....! . *.\  .. *** \..\ .*\...**\.. \*.  *\... ... *.*\.....\.* .*.  *\* \  *.*.*.... .\ *. *#
#                                      #.# L # .###. .\.\ ..**..*.. \. \..!.. ...*\.*\.* *..**..**\.... ** .***..\ * \ .***  \.*.  .. ..\ \.  *  .*\.** \.. . ...\ .. **** *.#
#                                      #.#  #\*#  # *\* .* \.***.. *  *. ..   *\.***. \* *.\.*. **.. .  .*!*. * .**.. * .\..@.*.\... .* ... . ..   * ..*.\   *** .. \  .\\*..#
#                                       #    ##    #... \. #**   . . ..***..\*..\.* *. **.*. .\ .*.*.*.. \** ..  .**\ * .*  * .  *. \*.\ *. *  . .\* .. .*\ .... *\. *..*.*. #
#                                                 #*.  \ .    *\*..*  .*\ * ..\*.\.*. *...*..... *..... .*** \. \\*..\.  .\ .\ \\.\\.  *.  .*.\.*.*. **...*. ..\.\. .\\\..**\#
#                                                  ## *.*\. .**. *\.\ \* *** . .*  .W* .  .\ \*..*\...*\ .....   \*  .. \ *.**  .. \* *..*\ .**** .. *.  \\*.  *\  .*.. . .. #
#                                                  #\.*#\#  ..**.\..**...* *...*.  **..** .*\*..*.. . .\ . * * *\ * *.*.***....\......*. *.\**..*\\  .. . *..  \ *..  . **.  #
#                                                 ##* .....\.\\* ...W..\.*.  \ \ \ !..  *\.  \...... . ..\..\* *.\*. .. . .**\*.*..\.*..*\**.\. ... ....  . !\\ ..* ..  *.\ *#
#                                                #\.* !\..\!...  *.. *.**.*\.\@.   ***. ... @. *.**\*\  *. ...\*  *. . ... .\..\.. * ..\ .*.*.  *..* *\ . .*.*. **.*.  ..*.*.#
#                                                #.\\*. # . **  **.* .* ***W..\....... * *. . \.  .*.. ...   * .. ...    \. ...*\*.\ .* * ...*.*@ **.\ . *\****.\* .*. .!*.\*#
#                                                 ##*## #   \****. . .W.*.. *. \ \ *\.\..* ..\.*\ .\. . .\.*.. *. ..*....\\**.\*....... *. . . .* .* ..  ***.*.  . .. \*. \.*#
#                                                   ##  ....#....\..   ...**..  .. * *  *. \ * .    \. **  ..\...*\. *. ..\ . ..*.  * \ .\ ..\*!. .* \ \\. * .!*    * .\ .. .#
#                                                     ###**##.#. .*.  .*\.\.\.. *.***. ..  .\..\*\* .*..\ ..      *\.\. **.*..*\.* .\ .  .*....**  *  . \ . *.** .. .\ ..*\ *#
#                                                    #*.#*.\.\  . .. . \*** .. .*\..  \..\* *.\ .. . .* \. . ***. \*\  *\  . *.. .@.. *.. .\   .  .*\  *..\ *\*  \.  *\* * ..#
#                                                     #\ ***. *.. \.  ...\. .  * .*!*\. \ .*\    *.* * .\.\**...* *. *..  *  . \*.. * .\.*...*@... *  \*\\ .\...\****..* . **#
#                                                     #.\**...\*\*. . \ .*  \..\..!\.*.\*.*** .. \.\**...  **...\... **.*.**.* .\*. .    *  **\ .\.    * *\****\**.W*    . .*#
#                                                     #\##\. *.\ **..\ **. ..* . . ..... * .**.**.  ....* .\.... ..  \\ *\*\ ..  .* . **....* .  ** .\.  . ..\.*\.*!..\ * \..#
#                                                      #. ..... !*. . *... * * .\.    \*..  .. .\* \.  ..  . **\  .**.\..*.  . **.*  * !** \.\.* . \. .. .  *.@\* .  .*.*\.*.#
#                                                      #.  \***. .\\.\* .\*.\. *.\*.*.!   .* \.\.. \  .* .\***  \\ * .* .. .*\ *  * \* **. ... *. ..  *@*.*  .\.\*..\ . ..  \#
#                                                       #  ...*# .... .  ..\ ..**.  ** .*.*. .    .. \*.*.***..*. .\ **.. . \ *...... *.*!  .\ ..\.  * . *.**.*\ .* . **.   .#
#                                                       #*\.  #*\.**. . ***\ ..*. ..\* .\ ..*.***.\\.*...*..\* .  \...... \*.!**.\..\....* .\ \\.* *\.\..*\*\*  ..**  .\ . * #
#                                                      #..#\ \.. *\..\ \.**.\. *.  ...  *\\ ..\*.  . . \.*   .\  .. \*\\ ..* ... *  **. *!.  ..\..\..     *..\.   ..  *.**\  #
#                                                      # #* ##\ .*.      . ... \*\.   . \      . \.    . ...*\. *..*..... **\ ** ***.** .*\\ *  .. *   .*\... * .\ \W \\*\.  #
#                                                      #.####   ...\..* \*. .!\....*. *..*. ..** ..\.**  . ..... \*.* .\*... ***.\.*\\. *....  ..  *  .*.    .\   \ *\.\. *.W#
#                                                       #    #*.* ###*. .*.\  . @ ..*\.**.\ \**. . .**.  ... *.. ....\*.... *...* .\**....*  \.*.\..   ** *...* .\..... . *. #
#                                                             #@#.## .\.*.. . *.* .*.....* \  .. . **..**.\* ***\.. **. *.  ...**\...\*.\ .   *... ...\**\.\*\..    ..*.*..*.#
#                                                              # # #*** * \.\.\** ...\. ...* ..*. .**..\. *..\. * *.\.... *.  *\...*\..  \\*\. *\.*..*  *.....*\**    *..  .*#
#                                                                   #..*.\..# *\.   \*   * *..\. \ @\ ** .. .*  ! .. ..\*..  \**  **.. .. .. *.\.\..  *..\...*\**..***  ..\\.#
#                                                                    ##@. *\..    * .*.. *.....\. .\ * ..  .*\ .*\*.*\.*... *.\* *....  *   \...* . \ * .. ...\** \.*  .*  . #
#                                                                     #*# #**. .**** \*  .. * . **...\. \@.*\...!!..*.\. .. .  ..*\  \. .  .. \....*\ . **.*.*... *\  ..\..\*#
#                                                                      # # #**...#*.. \  .* ..\**.\.\ *. .. ..** .  ..@. .. ..    .!*\**  .\.*. \... .. **\. . *\   . .*   ..#
#                                                                          #*# .* *#**. ..*  *  ..*.\ *.*\ **...  **. ..***  .   * \!..! .\**.\**\. .*\***!\  ...  \ .*.  !\.#
#                                                                           #  *.  .# . .....  ...*..**..  *.. ...\ .   ...\.. \\.\..*\ * .*.\.... *\...... *.   .*..\..* .\*#
#                                                                            # \  **  *. #*.*\*. .\.*..\.. . *\ \ *   *.  **\.. .  *\*.*..* ..*** .\.*.. .\  *.*......* .*.**#
#                                                                            #\# .\   \. ..*. ...@ \. * .\ .*..\. \ .* \**\.* \. **.*. *  *...\. !   **\\  . ...*   **..!  .\#
#                                                                             ##.*.*.  #\#\*..  *** *.*\@   @.**.*.* *....  .* **.\.* *.. *\ \*.  .  \..\...\ ... \ .....\\  #
#                                                                               #  # *..  .***  \.\ \.* *\. **!@\.***.*\     *\.*  *...\  ** **.\. \. .\*.\   .** .\*** .* .\#
#                                                                                ## \.. .***\  * * \.\* @. .. ..* **\**. *.\\.\... *. .\ !!.  **   . . . *.**  . . **..*  . .#
#                                                                                 # \..#\*#.. .\W . .\...\.*  .*. .* .\* ***..... .. * @.\..*\  *. .\.. \@**. . ..*....    * #
#                                                                                  ## \ **\...  .\.*  \.  ..*. \*  *\..*...!  . !\   . **.  \.**  \..*.  *..\ **.\..   \  *. #
#                                                                                   #.##.***\.... .*  . ..... *\* .. ..*.**\ .** * .*. .. .. **.*.. .*. .*\  ..*.  *. \.. ..*#
#                                                                                    #  ##* \...* .. . \  .* ...*.  .\. .\.**  **. ...*\   ..\* . *..*.\.**..\..*..**     ..*#
#                                                                                      #. .....\.     ..\**\  * *.*\*.*  . ****.*\ *\ ..@\\*.*.**\....*. ..*..   .**\  *.. \*#
#                                                                                      ## #*\. .*  *... ..!*.*....  .*\ ..*....*.  .*...* .. . \ .\.\ .   .* **  \.**.\.* . \#
#                                                                                     #\ .**### #.##  ..\...***\!*    *.\...\ *. .\***\ .*  . ..\.\ *     .. .* *...**. .. *.#
#                                                                                      ####\.*## ##   *   *@...  *.  .*.  *...* .  ** ...*.* .@ **  ..* **.  \. .* ...  .. ..#
#                                                                                         #..#   #  .*\\.*** .*\ *.*...   \ \ **.. ..\..\.\\ ***..* !\....*.*.*  .\. .**..* \#
#                                                                                          ##     #  ! \ .*\..*. \...\.*.*.* * *..\ \* *..\*.\@\\ . *.  .!.. **.  W ....* \.*#
#                                                                                                 #\.\..**\.*   .**.\. .\*\.\*\..\*. \..   *.*\*. .\** *  . *...*..*. \.* .  #
##############################################################################################################################################################################

Water 0
Flooding 0
Waterproof 7
Razors 8
Growth 46
