####################################################################################################################################################################################################################################################
#          #\.*..\. \.@#  .@ *  .....*.... \ .* .... .*\..@*.  \*\\..\ . *\..     . .\\..**  ..*.**\**\.   \*.*\*. *\ .. ..* .***\. *. *.@\. ** ..* ..\ .\*\. *..@.*....\  *.\.\.  .*\ .   *. ***.****!...*..  .\***.**\ \.\....@ .*****  .\.\. ***#
#         #...*.\.  . .*  *  \..*.\. .\*    \. \ *...\  .....\  *.***** ...  \ .*  .*.\ .*. **\.* * \.* .*\.. *.*\ ..\.    \. . . ..*....*..*...\ .. .....*. .\*\*....*  *.\.\ .*.*   ** !\*\ ..*.. *.. ..*\* *\ *.*... \.**.*.\.* ..  .  ..*  ..\.#
#        # *...*# .*** .  \\.. .!.W.. *.. ..*  * .\. * \.\. .. .... ...*... *.. .  .\*..*... ..\*.* .**. ....* * * *....**\*. ** ..* *\ .***  \  ... *\\. .... . .\ * .  . * **.. .\.. *.  .**. **.*. \\*.* \ \   **.@......*. . . . \..  *\. . \#.#
#      ##*. #*.    .**\  .  ** \**\***\** *.*\. \*...\.* .   *. .\.**\.. .....*\  ** .... . * * .  .\.\ \..  . . . .\ \..*  . . *   .\ .. .*\..**\.. ..  \. ** .   .*\ .  .. ***. *.*  \***  ***\* .  ... . . . **...\ *. . .*.*.***. \..\\. * ...*#
#     #. *.\.... *.*\*! .  **\*..*...\. \.**. *. .*..  . *.\*.\.\*  * \ .  \ *.*   . \*. *.****..  *   \..W*\**\. \ .\.....*.**...** .. . ** *..*\.. .  *. .**.*.* .. .    *.\.\. \..**..* W..***.. . *  \  \.. \..    .* .*\.*****... .W..\\ ***.\#
#      ##\..#*.**.*..   ** ....  .\. . .*..**\..*.   .*\ ..*.\... .*..  .***..*..* ...\ .@..* .*. *\.*\** \* .\**..*   . \*.  *. .\.\.\  ** *.*** .     \*   ...** \*  ..* .   *  .*.*\* .  .\..\\   . *..\@  \.*\\   * \  . .**\.*.*...*.\*  . .\.#
#        ####...  .\. . ..\.*\*.. .\ . *. * ***.**.*\ *\* * . .  *..* ** .*..*W* .\ * ...\    ....**.... ..*...* \ .. *\ .. *...** .  ..*..*. .*.   *  *\.  . *.**  . *..\.\*\*\* *. ... *.* **\.  .*.\.. . . *\\ ** .*.. \.\\.. **  . *****  . * ##
#           ## .    ***  \  * ....\.*. . ** * ..\.\**.. * . .  * .\ \*. \**...*\ .  *. *.. ..**\!.*\*.* .. .  ***..\* .. **. .\ * . *.\\*   . ..*.*.. .. . \*.\*   \\ . . \!\*.**.\. .\* . . *.... ..*.* . .. . ..**.*  . ...  \..*. .*.\*.* *  \..#
#          #  * .  .*..  .\. \  *\  . \  .\*.* .**.\**.  W\*.* .*. .*.\..  .\...\.\.*  .* \..*.  .... **.\ *\.\*..  .\  ...**.. .   .* \. *\ . .      *.. ...* . @ .  *\*. ..*  *.  *.*. * *.*\  . \..**\*.\..*..*\.. ...*.. .*\ \...*..*\.***\\.\\#
#          #\ . .\  *.*.. .\*.. *** *...@\*W.*\.\*\ . . *\.. .\.  \.\  \\ * .*\ *.... *. \.\ *.... .  \* .\ ..***...*..**.\...\.\*@. . .  .\**\ *.*\ .**\ * *. .\.\.... *.\**.\*.\ *..... .. .. *\*\**\.*.\*\** *.  . .**\.. *.*.* ... **  .**.*  .#
#         #.   *\ *.@ **.\*...* *.. *   . \ \.. . .   .. !.!.*  \  .. .. .* ..  \ .*\ .**.\*\\. . * ...\.... ...* \...\..**..*\   \ *. .\@.*@  .\.*.\... . ... \. .\*. ..\ *.\...*.\. *..***   \..\..\\ . .\. \ .\..\ ..\ \ \* . . ..*...**. *.. . #
#          # . \. ... **..*   * ..**..  .\  .\ ..\*.*** ...\ .** ..      *. .*.\..***.*.*.*...W . .** . \ *  .. .\.. \** *.*\ *   . *.*. . ** *..*. *.*\   . *\.* . @ . **..*** .. *.*......... ...*.!. .** \ . .* ** .\*   ... .*.. ... ***...#\  #
#       #  #.#\**\*\**... *\. .**.*. **    .\.    .\..\.. .  *..\*.\..\ *. *.  .  * \.@\.\..  ..\ ..*.... .*  \.***  *\*.* \.*\\  \ \ ... *.\.    *.. *.\..   **. . . \.*.   .*  .*. *\...*\\ * *.*W.** \.. ..*\*. .* . !.\   .*\.. *  .. ..\  .. .#
#      #.## #\*.. .. \ ** .\*.. .\* . *\ \.\..***\* \.   *...   ***.*\*  ....*    * .** .. \ \. .* .\*.\ ... ...**.\ **\ .!..  . ..  .* . . .**  *   ** . .  \. . .   .*    *..*\*!* .*\*  ....\ *.\...  . .\*. *\.*. \ ....   . .*.  .  \*\*  *.. #
#      #*. # **   ..* * ..\ .. . *.  * ...*..\.** *. *...\  .* ..*\.. ** ..\ ..*.\.   .*.*\.. ..\.!\. . ..\..  \.\. \..* * \ .. * \ \*.\*.  *..\ **. .*  .  \.!* \ .@.\*.*. . *\.. .*.**\...* * .* * .  .*.. *\*..\.*. * ** . *\.** \...*.*..* *.\.#
#       #. \ \. ****\.*  *.*\.**.. . .....*   ..**. .\  .**. .  .*\*\.. . \*  . ..*...\****.\.\.... *. \.\** \. \!    .\@..* *\ .\ * .*..\ *. .\**\*. .. *.    . .....*..*   *. .\.**.**.*\* *.\.\**   *\.. ..*. .  .\.*\..   ..*....  .\*\. . . **#
#      ## * .. ...*. \. **\** *.\.\  ..  .\.* *\..* \.*...* *. @*.@.  . *  ***   .\*. **..\*.*. ..*.*. * ..*@  .. \ ..*  .\.*...  ..* *..  . *  ... .  \.**...*.*  *.**...\..*. ** *. *.. **\.* ..\*  **.* *  . !...*  *   * \.*...*. .**.\ .*\* *.#
#     #.. .\ **. .*    *.....  *.\..  . .*  ... \ . ... *    .  *.. .*  \ .***  .   **\ .. .. .  .  .* * ..\.\.**.  * .  *.\\.\.\** \\*.* .. *  ..\. ** \*** \..\. * ....  .\  \*. ..\.\*. \.\. *  .\@\@\ *..!** ....\ \ \. \ \ *.*..  **\.**... .\#
#    #.\   #@*...!\ . .* \ *. ....  \  *  ...*  \*.* * ..*.   \*.\ .\.\.*  ... . *****..  .   .    *.. .****.* *.* *\ **\. * *    . \ *.** **. *.  *...\.... **\* \\***. *\.  ..\  \\*\.*  .  *\   **.. *.\ *...\  ..  .\.\ ..!...\*.* @..\.*.**@\ #
#    # .#**\ *.. \ .* *.*.*... @.\ *  *\..\ ..\.*  ...\.   ....*...  . .  \ \ \... . **.*  .* \. \..    **.. * **..*\*.*. \ .*.*** ..  \.* .**. .  ....\..* ..  .***\...*.** .*** \ *.* .*. *\... ..@*@** .*! .*. * .\.**W..    *...*...\\ * \.\.. #
#   # \ . ***......**. ****\ \   .*..*\. . . .\..* .*  ...\*\*..*\.*   *\*... .*\ \.    . **.*.\\ *.... ...  .*.. \ !.*@*...*.\.\..****. .  *. . .  *. * .*  . .W.\**** * .*.\.*.*. .\. **..\*\.\  **.*\*\..** *  . \.*. ...*.\..\..\ ..\. .*   .@.#
#  ##\*.  .*.\.   *... .......... ..*\.**   . *..\. ...***...    ... *..\... . *.  . .*.**  . .....**\*..\*.* *  . *  *.* *\. *\***.. .     .\.   \ *\*\*\. ..   *... .@*@..**..@.\. * .*.* .*!**  ... .  . .*\..\ .... *.*..*  \ ...  ..* ... * . #
# #\.!\.* *\.* ...\ ...*\  *. \  *  .. *.\.*.\ ...\ *\ *  .\***  .\*\..\.. .*.*.***W *.*.. ***\ ..*..** *   ..* ..*.* . \\. \ .*\.. .... .\.     *.*\*.\  \.*\  . **  *.*.\.\* *\ ***.**...* .*.\..\\ *.. ...*.*... .\..\*..  **\ **. ..\*. *\... .#
# L* *...#\  * \*  .*.\... . @. **\ ...\  *****. . .\..*W*.. ... \**  ..\. .. .....  ... .\.*.   ****....... ..  *.\.   .\**.* **... .\** .\ ***   ...  *. .*...  ..\. ...*  . ..\*.* *. *.\ .. * **\ .. .*!\. *\ . *... *...\.* *.*.\  *.... .. .*#
#  #\. .**.. . ...*.. **.  ..... ....\  ....\*. .\* *\ ....  *\.\..  .! *. *   . *   .**\.*\*. \  ...*.\\.*\ .*...\. ..\*... * .. . . *  **. ..*..* . *\*\*.. @****\. *. ..\*\. . ....*\**\. **** *\.\.*.\. **.\. .   \..\. ****.... *...*  \  #  .#
#  #.## \***..*...\. ...\ . .\  **. \.\.* R  .* ***\**\  * \ .. * @  .*.\*\\ * .*\*\...\..*.\\  .*   *\. *... .  \. **  . \*...\ * *. **@\. \  ....\      *..*.\*\  \ \*.... .** .\ W\*..\*. **..*\. .* ... **** @\   .\*.*.\..** *.* ..**.\... \  #
#   # # . \ * ...\. **..*....*.\.\. . ..* . **.\...\***.. **.*\.. .\. \.*. *.*. *** *\*.*** **\ * .@*.**\ !\ !.\*..\.\* .. ..  ... *..   .*. *\..  . ! .* .. .\* .. ....  * ..*** .\ ....*\.*..* .  . .\. ..*  ..** ..\*.*..\*\.. . .   .* ...  ..\#
#    #. *     .*\.. ...\.  * \ *..\**.\ \ *\*\ *. *. @. .  \.\.. *. .  \. ..*.  ..*\.. .**.\. .\.*...\..  * . *.\*.*   \ ..@\.\\\.  .  ..\*\ .\.*..\.  *. \    *.*  * \. .*\**.... . *.\*... *\.  .@*\** *..*.\...\*    *.. *..* .  ...  * . .\.\ .#
#   ###*. .  ***. \.  *@\.*   *..* *..... .**... \\\ .. *\* \.\  ..*\.\. .. . . \.\.*. \  * *   .. *  ***..* ..  * *\   *\ . \ \ . \ *\. *.\. \.\*.*\ ...  * .  \. .* .\*\*...   . *. *..\ . . . .\..*..*.*\*.**.* . . ....***\.\  \ .* ..*   @. ..#
#  #   ..\ .* .\  ..\..\.  * ... .*.***.  ....  .. .*\. .** *\ .. .*    \ ... .  ..*.* .!.* \ ....**  *. .\..*.. \.* .*... .*   \  ..* *\. . ...\**...*.!!..** ..  ..   . *  ..** * .\** ...\   . ..\..\* .W.... ..\. \   ..****.\  .*. * * \*. *..#
#  #*#\\W* ...\.\* .* .\  ..  ..  ..\..\.   . *. *\.\.. *..  ** . . *..** .*W.*.\  *.* **. .*.*.. .. \. \* \*\ .*.        .  .. . .. . * \.\* . *.. *.*\  *....*\*.. .! ..   .*...*  . \  * .  *\ \* ... *** *.    *  . *\.*\.*.  \...@ * \ . .  .\#
#  #. .\***.\..  .* .   .\ .*...\\.\ ...**** *.**..** *..**  .** . .** ..* . ..*.*.. *.\.. ***.\ *. ...*..* @*.*...*** .***..  \.  *.*..   *.\.  *.* . .*  .*  .. *.. .\.     .* **  .*.* *.\..*. .*.\***.  .     . ..*..  *.\*.* . . . .\..* \. #.#
#  # ...  * . .*.    ..@*.**.\*.*   . *\.**\ W* * \@  .. .\  *\  *....\ ** \. ..  .\..  \  \*.\ ** \. *   . ....\. *..\ ..*.\ .. .   *..*\. *.*  ....*.\ . .. *\ \*.*. *..**..\..**.**.*. *..  \.. * ...   * . **\*. \!.   .  . .\  \.***.*\..#**..#
# #*.\..... \.*.*.\....*..!\.*.**\  . *@. ..  *\.\ .\*\. ..... *.*.\ \**** *\.   . . *. ... .\ *. *. . **\ ...\. ...!..  .\  . *. **\*\ .*....*.* .*\*..\...\*\. .. . *.*.*** *. *.*.*\.\*\*  \* ....*\.* \..*.* ..\... **.  . .     *..* . *   .. #
#  #\*.  . * \*..\ .. *\.  *\...\  .  ...  **\.*.. \****  .*\* .  .  . **. *.\.\ .\**..**\ . . *.   .*\**. .. *   *\..* **  * \ *.\. . \*.\ * .*.**.*. .. .......*\  ..*..***** **..*. **..  *\ *** ..*..\.* .....\* **\..\.. \ *\ . \*\  ...  .. .#
# #\.* *** .  ..! *\\ . .*.\ W*.*..*.  .*.....\* ..@*.* *  .     .. ..\*.. . @.\   \. *..*.\.* .... .*\*\!*.  . .\.*  . . ***. *\* *  \ . .\.*  *\ \  ...  ... @.* .\ .*..\ ...*.  . .... *.*.. .......    *.. .  ..*...\... *.*...  .. \.\. * .*  #
#  #\# .\ ! \**\ *\ *...\* ..   ....  *\** .*. \ .\.W** \\.  *.**.  . .. .*.  ..*@. *. \*.*.\. * ..  \*..\*  .. .. .**** . .  .\ .\   *  ..*\*. .. .*@* \.\* ... *\. .\**\  \ *\ *. .*..*   *  @\.  .   \\... .\ *\.\ \*...\. ...\*. .*..* . .. *.\#
# #\....   *..* .*. **...***.*..\.*\**\.  .\*@. .* \ *..!.\.*** \. \.\ **... . ..**\..*..\..* .!\* .... ... \. .**.....\.    * .  .*\ *    . .**\*  ... *. . .*.*...\ .\.*. \ *   .\.. .. *..**\ @*..* ..  *..\.*\**.*..\...*   . \   . .. *\ .    #
###...**..##.\* \.\.*..*\ \.* *\ *...***  \.. .** *. *. .... ..*\* . ..* .\  ..\.....\. . \ * ! ... .  * ..\.\  .**\**\ *  *.*...*.\ .  \. .  *.*.\  \ *..**\....\  \ .   *...*\.*\ ..\***\**  .\ \* *   * .   .* **...** .\* ..  * \ *\.\*.   .*..#
#..\*\*.*.#. **...   \.*  .*.\*...   ...\.  .**.. .* .\*\* .\..*..\.\. .    .*..\W    ...*  . ..* \  \*..*.  **  *.**. **.. ..*. ..*** *   . \. .... \.. .!.** ...\\..  .*\.\*\* **\  ..** .*  ****. \*\*.\* .\* . **....\. *..* .! ..*  *.\.\*\.  #
####.#* .  **#* *.\* .*\* . .*.\.\.\\.**  *..*. .. . . ....\* *.*... \** .*\ .*\*\*.\*   .\.. *..  *.\..\!.*.\ **\.*..\....*  **\ \.\ *  .\.. **  \*...* * .**** \   * .*.*. .\.....\*...   .... .. . . .....  .* .\ ** .**\!.*.    *..*... *. \*  #
#   # #  .\.\.......*\....*. .......  ...*   ..* *.    ...* * \*\.  \\..*\.. *...*  *. ..*.  .* *\.. .*\. @*   ..* .*\.*\ ***W*\. . .\. *.*  .\.* .\ *..\.. \**.**.* . \. .*!      ** *\* ...\\.   .* .\.*.   . *\*.*\*\ ..*\.** *.\.\\**.  \.\ *  #
#     #*.\   \.*.  .@ ..      \* * .    \*. ..*.\...\. .* . \.*.\*\*.   .. \ *\ ... .**... .\ .. * *. ..* \....* . .**\. . *.\... .*.!@. ** *\*  .\.!\*.. * * ..*. .\.**   !\\  .*.. **  .....\**. \.* *. .  \.*...**... . .  * .*.. \..*\*.    .\ #
#  ###*. *#*.. \ .*\.. \ **.\* . *... ...*. .****\ .. . .  *!*.\...\.\*.*.  \\.\ * . @  *..     *.*\* . .\ .* *.* .\*....*. .*.  . ....*\.\ *.* *    .* . * .  . . \..\ . ..*..  .\. .. \* . **.\. ...  *   ..*.* ... \ **..* ....  *.* .. *.*  .*.#
# # *\ * ..*   .*..*  \  .\\..\....\*\* ..\. *\** **.\.* *   *   ***....\ *\@.\*. .** .*.  *..\.  \.*  ..*.\*.*...... \* .\* .*. *  *.....* .. . *. *\.. *   *.*. @.\*. .* ** .  . *. .@..*  .**.\  \ .**\  ****. \   .**..*\  . *.\ \*\*.  .\!. ..#
# # *.#.*..  .... .#**. .*..  .**\* .. * *  ....*. ! .\* \  \*..\ .* .***. .* . .\.*.**.*.\*\*.\.*.**.. *. * *\* ..  \..  ** . . .\\.\. \  ..  * ... .\....  .*.\ .. ..*... .    *...\*. **.*\*\*..* .\....**\..*...... *!  ..*\ . .* ...\*\**.\   #
##*.## .#\.*.\.  ***\. \ *.*  \ *...   ...* \*  .\  * ...*.\..\* .**.**..* *.  *.**. **\.*\...   .\. .*\.. .\. .. **\  * .**  \. .*  **  \.  .... \ *..\   *.*.*...\* .\ ..........*.*\ \*.@. .*. \*\@. \.\..*... .\.*   . .* . * \**\ \. ..\. . . #
# ## #.#..\.\.@. *..     . *.. **.\ ..**. *.\* **. ..\** \ ..  *  \* .\..*.....\\.  ..*. **\ .  * \ * \*.* ..   ....  .. *.\ .\*.**...\**   ..** .. ..**\ .. .*.\.*...    ..\!.**. .!.. .. .. *.\.*. ...\. \\.\ *.  * .* *..* .*  *.! ..*\**!*   ..#
#   #*  .\.*...*.*.**\*..***.W. .\*.*.\. \** .*\.\. * ..\ .   ..**..* !*..*\..\. \ \.** .*.*\ \@*  \   ...**@ \...  *\.\ .     *...\*.*.\. ....\ *** *...\\ **.**\...\. *.\ *..**** .   \ .  . \*  * ... ....\* .** .. .. .*\.\. ..\ . .. *. *.@\ *#
#    #......* *.** .**.**...\ *\*.**.*.. ......*. . \  .  \.  ....  . \.* \.. \ \. * \.\.. .*\... \.* .*\ \ * .. *.....* ..*\ .\*   ....... . . *.\\  .*    \. \**!*   .*. .... **.! ...*.**. *.*... .*\*..*!.\. ..\* . . ..\ ...** \*\. *   !   .\#
#   #... ***.*..\. *...*.. !. * .*. **\  ****.*... @.  *. ..\.  * .   .!@** .\.   .. . . ..*\** .*.\*  . ..*.\ \** ....\\ *.**.\*..\*....*.  *  ...\ .\. *  .\ ...**.*. . !\*@...*..\.*.\*....... . ....**\ .*.*\. . .. *\.** * ..   ....**.\ .\ .*#
#  #\*** ... ..\ ...* .. \  **.. .*** \ *.*. ..*\.*...*.* *..@\ *\*     ....* \..**.** ... . *****.W\ **..\.*.. *.  *..*\****. ..*\ .  ** \*\.\.\.*\..\ * *  *\***...*.  \...... .*. *\..  . . ..\   \  ..**\* .**\ \* ..*  *\ . *!*.  * \.\  ..**.#
#   ###\.\    \*...*..@  ...\... .\.    .\.   .\...\.*\ \ *.*\**\.\   !\. .\.\ . \. . \! *...... .*\*.*\. \**\ *. .. *\**\\ ...\ .* **.*.  * ..  *** . *.   * .*.**\*.*\* ... ..   . . \. *.*  \* .\.\* .\.*...*....**  .*.*\...*... .  *   \.** * #
#    #.. *  #*.\*  .!\.* . .. \. \**...\ .. .*   \  .\. .\...  .*. \*\ .   * ..  .*   ...*.\.\ .   *  .*\..\. \.*  *.*..**.\. .. ** .. ... \.. *.  \ .*\.      .* *..*. ....** * .*  ! . *...\*.. \... @*. . **.*  \\\   *  \  *.*..  ..\    ..\ .\#
#    ##.*. . \  .**.** ... *..\\...*...*.*** . .*.\!\*\ .  .*!\  * ..*.\** * * . .*\   \ **   .    . ....\*** .*\ *!...\ . .**W..**.**\ \ .*.\.**\ .  *..*.\*\.\.!  *.* *......*  . .\ .*  \..\ *......*.  .\.*.* **.  .\.\. . **..*\*....* * .*.\ #
#   #* ...\ .  .**.*.\.  *\*. . ..... *!**.*.  .\.  *..**.@ . .   .  . *\.@. *.**  .. . .W.   *..!*..*\*. **.\  ...\   ..   .\*\ .. . *\.*!* *..\*. .*.\ ..........*... ..***\.\* !.\*. * ..  ..**\.\ *..\  . .\. \ **.......\ .*\ *.  ** . .\#   *#
#    #. .!*\*. ..* .. .* ..*. .\. *. *.*\. *. .*.*.   \*\.\.*\\.. . .\ * **\ **** ..\*.  \*.! .. \!\.* . ...*.\..\*.. .. .*.  ..... . ** *  ..\..*.**....*. ..* . ..*.. \**..  ... . *  *\ .\  .*.. * .. *..* .\. .\ \  .** . \ .*   * . \*\.* .. .#
#    # # *   . *\.\. * *..\..\... \ *\.\.\ .*...  \  \ *.\.\. .   .  *.\..* .*\*\  . .  *. \.**\ .\.\.\   \.\*. .*\  ...  .\ .\ . \.**.*  \ .\.\*...    .. * @*    *...\..*\*.* . \..\  \.  .\* * . .\  **.\ ...* ......*.. . *. .  .. .  .. . .. ##
#   #@\#.#\.*....*\* *. \ *  \..@\.**  .. * **.!  .....\  *.. .\.*. \.... **.\. *\  \*\\. .\\..** *\.*. ..  *.  .*\ .\\\ \..*..\....\. .**.  .. \ \  .\. * * *.\*  *!...!*\ *.\   ..\ *\..\*..***\    \ *.  @...!  ..**\*.\  \. * . \**\. . .@.\*# #
#    ## ##*##*...\.#\*\*  W**  .****.\..*.... \. . .\  ..*.**\...\  . \..*  .*  .* *.* *.\* *\ .*** *.. ... .\.\*\   *  .......*.. ..*.\ ..\. *\ .. .   @. . ..  .*.*.\...*..*.\\\ *..  ...** .*\..  *.\\   .* \\\.*... . .* ..\. *. .*.*  @\*..#  #
#         # #..**..  . * * *.   \...  \*. .      . .. \... ... .. *.    ..* ..*.*. . .*.. **   **\***  ...\  *\!  ...** .\ ** \.  .\ **.\.* *..*.***..\.... ..  \**  *.* **\ .  *\\*.  **...*. ..W\ .*.*\..  .\.  .  * . . ..   .*\.  * . *\#...@# #
#          #..#* \..** ***.  **. *\.*. .\*\ .\* \ .. * \ * ** .\* .\.* * \*\. **  .\.*....** .**..\*... . ..*.* ..@  ..*....  . \ *....*. *.*. .***.  .*. * ...*..* .\.*\**.. . .. .* ..\.. \. \ \!*..****\  *.**.*  *    ..*\* *\*..*\  .*.*.***# #
#         #\.\#. ####. *\.**. .\*.  *\*  ..  . * . **.*.*. .  . ..  ..**.. .*.\..\ ....  . \    .***  .\**\.. ... .. *\**.*.\* ..\*\*.\..*..\ . *...   .\\..   *\. *.*\.. .. ..   *. .   .  ..\  ! *.**.. . \  . ..  * .*. .  * .*.! !*\..*.#.*.#  #
#          ####   # #...*\.*.*\...*.\.*.\*..** \ *.*.. .***\  *. ..   .\.. ...\ . .*\  @.\.**. ** !..*  *..*\. \ @ * .*\.\.* * *......  \. \. *.*\* \* .*\. . * .* *  *\*.* * ....*  *. .*.**  ****.  *\*\*\ ..** . **. \.  *.. *\  . **.\#.  .**# #
#             #**#  ##\ *!*\ #W *. *  *..* .\.*  ..\....\..   ... * * **\*** **  * *. ...  .\ .\..\... .*..\ ..  \\*\*.. ..**. .** \*..\. ... .*..*....*\**\* .... * .*.*\* *. .\*..**** * \.\.\.. \*\*.\...* .*..* *\.* * .\ **.  \* @* \\\ .#**.##
#              ##  #\*\ *.\.\  .\ ***.   *  ...\.*\  .. ... ..*.**..*  * .* \. \.\.\...\ .    \*.... \. ..* ..\ \. . ..  .. . \...\ !\...*  .**.*.*.\. ..** \* *..*\  ..\ ...  \.*...... .\ \.  .... *\..*\*. *. .\.*.\.*.  . .*. ..  ... ..*.*..*##
#                 #.**. . *  *\*..\* .\*....**   . ..*.. **.  .\*\*.....\*..\ \   . .\.*.. \.. ....*      .   !\. .\ . .  **...** ..** @*\.\ .*.\  *..* .. *.\ *.\.***.   ...*....*    \ * ..! *\.**\   .*.. . .*.! .....\ .*\\..   . .** *.*#*## ##
#                 # #** *.. .\\ *  *.* *. .. **... \ .  . .*  \  .\ *\**.* * .*  *.. ..**\...  \ .**. .*. .. \ * \.**. *\ \.  ..  ..*\* *.\....\..*\..  *  *\..\.. .\.*   \..\.*.*@    .\. ....**.\...\. .. .. \..*  \  *. *.*.* . .*.\.. . .*.# # #
#                  #.**.*\  *#  . .. . . .* ...***.. .  .\ . ...  * .*.*.*..\ .  * .  \**. .   .  *.\.\. **    ...\..*.. *.***  *\ .\.....*.  ..* .***\..* ..  .  \.\*\ * .. .\..*. *    *.*. \ .  \..   .\ **. .\  \.. * ** ..\..\.\..  .*. @#    #
#                  #\#\***. \.\.  \ *\..  ..*. ....*. . \..****   .\ .. **. .    *.  *... . *.*. .** ..  **  *. .\ *\..  \.....*.. \ * *\.*.   \  \  .  .\   * *  .*.. .\*.\..   *.**  \.\ *\\. ..... ** .. *. ** *\ ..  *.. \   .   *!.. ...*#    #
#                   ##.##.#. \.\   .* *..*  \.. . *.....  .. *.*.. *..  ..*\.  .\..  **.*.   \**.*.*  *\ .*\\...*.\.. .. ..*.*\.*\ . * .W.. .!\  ...*.    .*.. .* \. ..   ** *.\ * *.*.*.*..*. \\*\  \* * @ * ... . .* * .\ *.\..* .\..* .** .#    #
#                     # # *..#*.\.* . . .. \..*.\...* .*\.*.**.*\ .*\ ***\.*..\.*..*\*..**  @!..\.**.\*. *\ ...\* .\.\   . *\..\ *. .*\  \.*..*\\*. ***.. *\ .*\*..\   *  \..... .  *.*.*\ **.*  \.\..* *.\.*.\  . . .\* .*\ *.*.  *\ \\######     #
####################################################################################################################################################################################################################################################

Water 0
Flooding 0
Waterproof 4
Razors 32
Growth 24
