#################################################################################
#                 # #                                                           #
#                #. ##                                                          #
#                # .#\#                                                         #
#                # \#.#                                                         #
#    #           #    #                                                         #
## ## #         #. * #                                                          #
#\#\*\##### #  # #\##                                                           #
#* .#\#* ..#.##*#.**#                                                           #
###*.  .*#.\.\ .  .*@###                                                        #
# # \.*#\.*####. #\.***.# ##                              #                     #
#  #  *\# . .   ..* #\...# .#                            L.#                    #
#  #*.##. .#* #\*\. . *  \ . #    #                 #####* *#                   #
# # \ .  * #*\.**.\  ** .... ### # #               #*\**...#                    #
### .***#.\..#. *\.  .* * *.\*. #\ ###              ## *\*.*#                   #
#*#.#*..\*...*# ..*  \. . .\.*# ## \ .#      #    ##   .*#*#                    #
#.#\* *#*  .*. *\ .   *  .*...***#\!*. # #  #\#  # ##*\ .\##                    #
#.*.\..*\ \\   . . *\..   *# ...\....\ .# # #* ##  *.# \*#\.#                   #
#\.\ \***\. .*\ \\ .*\..\ \\..\**.\.. . \**#\*.\ . \. #\ *  #                   #
#**... *.* *\.*.  .*. \*\#!* @ ..\*.\ .#.\..#.\ .* #\.** #\ ##                  #
#**##*..*! \*.. ....  .*\... *..*.\ ***.*. #.*!.*\ * *... *#*.##                #
#.*  \ **. .... .*   . \**..**\ ..  #\. .*..*# #\ ** **  *..* .*# ##            #
# .. . ..*. *    *\ *..... **..    .*.\** . **.*. #. \*#.!\ * *\.#\ # # ##      #
#. .* *\\..*.\*....*.  **\..\ *. **..***. * \.\..   !. .\.* *\\#\.# ##\# *#     #
#\..\ . ** **...\***. * * \ .   . . .....*.#. #\....***  .\**.\ **. #*.\...#    #
#..*  .* @**   \ .*\ *.  *..* *  \..    * .*.*  .* **..*  .  #*.\\.\. . #  #    #
#.\* *.* ... \ \** . *\.\*  .. * .\.* . *..* ... * \.\.@\.  \*\* #*.**# *##  ## #
#  .\* .\.** . ...   ** ..**!.** *.*.. .** \   .**..  **..\.** . ...  .*##.##*\##
#   *\ \....\ ***. .* \ \\.\.\.* .\..   \  .  ***\*.. ** .. ...  . @* .. .. **.\#
#.* ***.. \... *     ..*.*.* ..*\..\.*...*  \!..\*.\. *\\***..\  \# .\\.\.* *#..#
#. *..* \**  .\ \ * .\.**.*\.**.\ *.....*....\..\.* . \ *. *  *.*.@\* .  \. \#  #
#.\.\..*\... .!\..  *. .* ..\..** *\.*.\..*. .... .....*.* \\*..* * *\ *\. .! ..#
#\  .*. . * .  * .@* .*.\  \.. *\ ..  . . . *.\ .\..\**.   *\**...  *...*.  *. .#
#..\**    \.* \. ..\**.*.....\***..**.*. ..\\  * ..* *....  ..*.. \** * . *\.* .#
#. .* .* \.*.*  * .*.*..*\ \ *.***\.*  **. *\*.\. *.*..     .*\**  *\* .. .\..*.#
#*.*.  .\* *.\. * .*.\ 4.. \*\** *  \.* .  .*...* *\. *\\!\*..... .. *  . ... .\#
#.\ .. ...**.. .** *. *  *  .  **......* .\ . .*  *....\.*... * .\   . *.*\ . . #
#    ..  *..  ..*. ...  *..\  ..*. .\*.* *.*.. .\*........ \  .  *\.   .  *\.   #
#\** .!.\.\ . ****\....*... .   ...*.*. \.\**.\   . .  .  \..@\. *. \....* .   *#
#..\.**  .******. .. *..\** *\. .  . \. .*.*..* \.*\   \* .. .*  .. .**\ . **. *#
#* . ..*..*\..*\ .*  .*.... * . .  *\.\.* \***\  \.*   ....\ ..*.  .*.*.   \....#
#.*  .@.**...\** *\ ...\. \.\.*  .  * .. .* ..*. .\.*\.... @   .\*. .\*  .*... .#
#.* .... ** . .\ *. *\.*\ .. ..* . *. ..*\*..!\ .  *.*..**\. .*\ \  @ . ... *.\ #
# *.** **..* .*.\\.\*.* *  ** **..* . *@**.....\..\..*   \ ***..\.\ .  . * .* * #
#.\.**\*..\.\.** **@.\     **.  .*. *.....\ *.\   . **\. ..  .* ..*  .\ ..*. .\ #
#  .\..\.. .*\.*\...  . * .. ..*   ** *\ *.*\.*..@ .\**. .*    ...*...*.  * . ..#
#\ *..*\.* .*** @\ \ * .*.. *.**.  .* \. ..**..\.*.. \.. ..  \ \.*.* *.*\*..  **#
#. .*... *..*.* ....\.. . . .*..\ . **. . ... . .***  . .* .* .\..*..* **.* *\..#
#***..*. ...\.** **...* \**\*. *..**. . \ \* **  *.\ *. *. *****.\... \.\ * \. \#
# \.**!. ..*  **.**\. .  ...\..  .. \.\. *\.\*. *\..W  \** . *..\ .  ..*  \**. .#
# ** *.*.\ ...\. .** .* ** ..*** **\.    .. .. . *..*\  *.. .*.\ \ \  ***\  . ..#
#*. \**.. \.\* ..\*** . *.. ....***.*\ * .   .  *\*\. ...    *... .   .*..**  *.#
#.  .**.\.  ** ***!*.  @. .\...*... . ..* \*  \..*\*\ .*  \  .*.*\*\.*\.. .. *..#
# . *.  . .*.* .\.\..  .* **!  \.*.** **...\*.....  ...\* *..  *.*\.\ .. \ . .\.#
#*.\.\ .\ \... \.*.*!  \* .** * **..* ..@  *\*\ .*!..\. . *..*.\.**... .*.\**.* #
#...*   .. .\*....*.*\  . ..*.....* *.. .*.\*.** .  . .** .*\... ...\* * *..\.*.#
#*.*.  . .*.*.. ... ...*..**.** \.\..\*.\.. .... *.*..\ .*.*   .. .\.* *... **\.#
#. \ *..  .***   *  *. *.  *\.\ .!*.*.**. \. \ \ **. \*  .*..*. .**... . .  . \*#
#*..\*****.   *.**.\.\*..... ..*\.***..*.. .   .\ . *. \*   ...* \  * \*\. .\\*.#
#\  *\.\..*.. . **..**.\ .\. *  .... .*.*!.* ** *...*  ..*  \*\  .\ .* * .@!* ..#
#. .\. * \\.. \. .. *. .*\.. . **  *. . \ .. *. \   .*\ .* ... . **\  **  * .  .#
#\  . *.\ \.\  *.. *.\.*.. *. *.\ ..* \*.*.* * *..*. .. ...\  . *. **.\. *\\* .*#
#.....*.. .\*.*\* . .*.. . .  .* . .. .*...**\ .. \.  \.**.     .  . ..**. . *..#
#. .*\. \* .*\..\  \ ....  .\*.* * ...\*..*.*..\ *.\.*.\!.\\ .\.\\***  *\. \****#
#.. ..  .!. F ... \. \ *. ** . . *.\.  .  **.*\.*.*.\. *.* .* **.\. *.. . ..\..*#
#\.* \ . \*. **   *\ ...   .  * \. \* ..\. **\.*.. ..\...**  \ \ .*\ ..  \.\.*..#
#!\.. ... \ **. \*.. . **. .\.\ .*.*.. *.  .\.\ \*****.*.\. *.\ . ..* * *.*.*...#
#*  . \. *\H*.\ .\..* \  \.*.  .**.****.  ....* .*.*.. .*...**... *  \..*.. . . #
#... \.  . ..*  \.  *   \. *\ **.\.  **. * *.  ***.!... *\\*... .     * **  *. .#
#... .. .*.  . . . . *\. .*\*\*..* **!**.. \  \ *. \ \... .*.  ...*.***\.* ..\  #
#*\   *****..   . \.*  \.** .W.  \*.\ .@.  .  .*..\  *.**.*\. .  * .*...\ ... *\#
#* .***.....*\ .* * .* *\.. *\..* * . **.   .. . .\ .\ *\.. *.   *  .*. ....*\*\#
# ...  .. *@.**.*\* .*\.  . .****!. .\*.\  . .\    * ..***  . \* * ...\* **\...*#
#.\.***.\  .*...!.*\...\. * \.\\. \ . ..\ . *   .* .*\..\ * .....*!*.\.. . *\..*#
#*.**.. .\.....* ...** *.\**\* . .  ****.  .* *..*.*..\ . ..\  * .\.* *.\.\.. *.#
#\ .. \*\*.  ... * \ *\ \.*\ *. *  .. *!..  * . .*\.. *.\ * .  \ \.***..  .\@\. #
#\.. \ *!. *.  **.\.. .\. .  *   *W .*..\\*.*. .*\*  \.*  .\*  .  .*.* .\ ....  #
#.*... * . ..\ * .*.\*\.    *. \.. * ..*   .. . .*.....*..\ .\..\ *\..* *   .\. #
#.. .\ .  *\ *\ \*\* .*  . .\.*\ . *.. * .\.\.... .\   .. *. ..*\*!. ..*...*.   #
#\ .*.\. *.*.. .. ...** *\. .....*... .*  *     **  ..*.. ..**.**..*.  .*..\.* .#
#*\*\..*\**.*\ * *.\***..   ....**\*. *....\*\....  *\..@\.\.*  *  .\ ...  ...  #
#\**\. ...\.. ..**. *..*.  **..\.\*.  **\.....  .*\.**.\* \. *. . .  .. ....   .#
#\ *!*  \ * **.*  ...  ..* \. *.*..\\*.** *.** ...  .\ *.**!\..\ *  *.\* .\..\  #
#.\@* \ .. . * * . 6.\ \..* *\\ . *.....* .*\*\*.* .\*  * .** \\ .   .**. ..\*\.#
# ... *..\ . *.* \\..*\.* . \ .*\..  *!\. ...... *.. ..*\ \  \ .* . * \*.. **.**#
# ** *.. ...\ .\\  *\.* . . .\  * **...*.** \  . *.* ..  . .\* .*\\ .\...   * .*#
#...\..  *\.!\ ..*.*  **. .\*.*.*..\ * .\.\*... \.*!.\.*.  *..***.\*    . .. * .#
#*.\..  .*. .*** **\ .**.*......* \. ..\   .  .\. ..  **  ** .!. *\.\  .  .. .**#
#... \. *..\*.*. ***. *.*..*. *.**. @.* * \  . *. *  * .\*.\*\ \   . *.*.* \ .*\#
#\**.. .. \ .\**@*. * ....\.** . @. *.\.. .  \*\* \   . .**..  *.*\ ..\...*..\\.#
# .. ..*.\. \.\*.  \   . .  \  \ *..\ ..!\ . . *  ..... .... . **.. . . **.@..*.#
#     \..W\  * *.\....   .*\ .  ..\ \. * .  .  *\.  .\* *.\. *  .**.\  * .*\.  *#
#\.....\  .**. .@\ . \.  .*.  \ *\  . .*. @....**.*  . .\ ** . \\**..  .. \.\.. #
# .*\ \ ..*.** .. .. . *..  .*... . ..*.. * \ .*\ ..*\. *...  ....\ @!.* \   **.#
#\*. \.*. \  .. . .*.**\.  * . ..\***.... .**. ****\.!*...   .. ***\.\ ..*  .***#
#\.\.   \.*.*.\.\* \W.**.\**... * ...*\.* *\. . .  .  \.*.\..*\.***..*.*\   .* \#
#* .* ..*. .* .\...  \ . .*.\..\. *.  ..*\\. * .\.  .   *.. ... ... .*\.*. **. .#
#.!.\.* * *\.\ .*   . *\  **... ..*! *... \.....* . . .\*. .*.  *.***..\ . .** .#
#. .\. .*\.**\. . \.* ..*.*.\.   *...*  .**. ..  **. \* .\. *...* .*\ \. **\.\ .#
#!.**...... . ....*.\*.*. \\*\ *\ ..*... \...   * ......\ \..*..*. . \.  *.   *\#
#\  ......\.\ * *.. \.*\ ..\.  .* **\*\. .*... ...   \.\...\..\**....*      \ \ #
#* .  ..  .*  .*.  ..\.*.*  *\ \.*\....* .. . ...B.*    .   *\.*.    *\  .*  .\.#
#. *..*  \* *.\* . .\ .* . ..* .. .\\ **.*. .   *\.. .*\   \*.*.* ...\ *   *..\!#
#.*...\ * * . **.  *.**.. . ....**  ..\*  ..*.*\.\.. **........*....  *\W @\.\  #
#.\ ..*.\.\ *....  ! *\.*\.. .  \* * .\*.*  W....  .*... \.\. .\ *.\ .\   .\.. *#
#..***.**\... *..\ *  . .* .*  *.\ *.. ..   @.*\.*  . .. .*\   .\* \ * .** *\  .#
#*\.***\\ .*\.\.  **\* .\.*\  !.* . . . \W\.. .  * \.   \.*.\..\   ..*  .. . \. #
#.\ *...* ... ****...***  **.\**.*.*.. *. ..!..@.\W. \** *... *    *\.!.\   *...#
#\.** .\. *.\ .*..*.....**.. .\*.* * *   ...\    *  .!.*...**..* .\.*.\*. .*\...#
#. *.* . * *.*.. .. \ ... .**... \*. .  * *.*.** . * ..*. ..*\  \* .*..  . \*.. #
#*..*... .*.*....*.\. *  .\\....\.**\.*\* . *  *.  * \ .. *..**\...\.*.*\   .*@.#
#.\*.*\. *.... . .  ..\**. *\ *.. .*.*!*.   *. \.  *  *..... .... .*..\ . . **.\#
#. . ...**\...* ..\*.*.\.\ .....  ...* \* *.*.   ...*.\.. *.*. ..**...*.  ....**#
#\*\  \**.. .   \.  .* ... . **.. \*.  *  \ . . ... . .  ...... **\  *.**. \ * \#
# .**. .* *\*.*.\. **..*.\ * \.  ... *.\.. * *.*. .* .  \.  .*\* ..  *...\..**\.#
# **..\*\*\..\. **...\*** .\...    ..*..*.\  . ** ..  .\\ \\.*.   ....\.\*  \@*.#
#..*.  .***  .   .....*\ \.** \**.   .\..**.\. . ..*\..  .......\...*.  . .. . \#
#*...   .*\..** *.... \  . \*\...\..**  *..   .*..*.   \.  . \..  * *** *! **\..#
#.\ * .**.**\.. *. .... \*  ..\ \.*..*.\.  . .*.**\.\*  *\...*..  ..   *\\\.*. .#
#**\. \. .*\   .**.** ...\*.. **.**  * **.* \ . .....\. .. .   . \*\ \ .. ** . .#
#*..   . \...\.*\*..\ **.. .\ !*..*  . ..*\. \..*\ *. @....   ..\ .. ..* .\.\.\ #
#.\* \.* .\ *.*\.  .\\ \. **!..*...\.*.  *** ....* **..  ..***\.\* .\ *.* .\ ...#
#  .\D \.  ..\    . .*\ .\.  *.\.   5\.*.*    .@*\ .\. ***. ...**. \*..*! ...*  #
# *. . ..\.\*.\.*.*. .**. * .\\. *...!...* **.E.. .. .*  *  \.\...\.*  **\.*\. .#
#  .  .. *\. .*.. ..\*.@\ . . .** *  .*.. ***.\.*..  . ...\*. .. ** . *..\.*@ ..#
# *....\.. *. *.    .* .*      .\ * ...@***.**  . .. *..*\ . .. *.!. .. \..*.\*.#
#\ * *..*.* . .  .  ..\ * \. ..**. *..\.*.\... * . **\\!.  .  ****.*.\. .\*...  #
#.....*.***.   ...*.   . *.*. .. ..* ..\ @ .*\..\*.\... .\.\ .***\**\*  9..*\ .\#
#\ \ \.*..** * \  **\  .*..*\.*\\  .. **\.\*    .. . \.  .* **\.@ ..... @ ..*.*@#
#\*.  **\.\.*!   .\..\...*..  . **...*. .\. .. **.. \ * *.* \* **\*. .  *\.\..*\#
#.*   \.. ....\.* .\  @\... .\  *..\.. .*.\ *  .*\\..\.*.\* *  *. \....\**@..\. #
# * .  .\..\ .... \*. \ ..*..***. \...* \  .* \ * .\. * \..@*..*.. *\. ..\.  . \#
#... .  \.* .*\ *\\. *.*.* ...** \. *.* .**..\ ...\*. .    *\* ...*.* * ....   .#
#. . \ . *... .....\\\** ... ...   \...*. .\*.**. *\*.*.  *...*\.... .\ .\ *\\ .#
#\.. ..  ..\. . .. .*..\ ** .!.* *\.\ *.*\*.\... @*.\**  *.*.. \* *\\** \... *.\#
#. *\*.*\...  .\.\..\ .*...***.* \ .*\.*\. \  \..* . .\* **.. *. .* *..   W \.*.#
# *\ ...   \*..@*.\.  .. *\...\*\ . .\\. *\.*. . \*.*.*..**!.... ..   ..*.... .\#
#.*. . . \ .. *....!*\..     .* .\. \... ** *. **.. ****..\.\*... *. .***   *.@ #
#..* .  ....  .   .  ** .\ . .. ..* .\**.**..*..*.*.\......  . .\.\ . ** *. *.* #
#\...*.   \\ .*  \ *.. .**\ *.\**\*.*...*\..*.\\...*W\  A .*.  .   \  \ ..*. *.\#
#. *.* .*..*.*. *..\  \\*\.*.  .* . .*\.*.\ .*. .\... . ..**\ * *.* ....* .*.\* #
#\ * *\. .\ *. .\*.. .. * *...\* .*. *..\ .** ** ...  ..\.*. \.\... \.** *.....*#
#...*.*.* \  .  *.\   \.* .*.  ** . ..\..*..\**\    . \\ .  *. .**.!\ .... *** .#
#.  * ...*..*  **.*\.\..\.  .  .*..  *..  . ....*\.* \ ****..\. ..*.. *\    \*\.#
#   *.*. \ .\ ...*** **.* **.*. .  .** ..*.**.  .*.\ ..\.\.\..\  \**\W.  . .  ..#
# **.. .. *\.* *\.\*.@.   .   **!  ... **.*\..G. .*. *  **\.\ \ ..\* .  . \ \. *#
#*.**.*\. ** .\* ..\ .*..\  .**.*   *  * ** *.*.* *.. . .  * .\ *\**.\ *..... ..#
# .*.*. \....*.* * . ..   ..\.\.. .  **\.!\ . . . . . *  .  \ .*.* . ...\...*   #
#    .\ ..\.*....\\  **.*\.   ...\ ..  .  . *. \ .  .\. . . .. . * \* \ *. \.*  #
#..**\.  .\ . *.     ..*  .   *.\ .\. *.*.\.  . \ .\.** \ .\*.. ..* . \ .\ ...* #
# .*.*.  . *\.*\..*. **. \   *..*..*..* . .*****..\*.\\ ..\ . .* .*.*. * *.\....#
#\\W .**.\ . \*. ..*.*....*. ....  .***. .*.* . .\.*\ *..     .*  .*. !\*. .!.\ #
#*@ \\.* .*\*..*\ \*.   * ** . *.* *. .   ...\. *  * \ . ...  .*..\.   .* ** .*.#
#..\ .*..\. . **..\*.\. \ ...** .\ .* .    . . \.\ .*  *.\.!\ ... *...* .  \. *.#
#* .  *..*  . \**. *\ .*..  .\.\* . ...   .*.  . .   * **.*\*..\ *.   .. .*.   *#
#*\...** ...**.*\. . .\.*. \*\\ .* . **. *.!! . *.*.*  .@..\.\   ..** \*  .   *.#
#.*..8.\\   .\  *.\ *..  *.*\ .\..\ * ..*\ *. \ ...* .* .*\ *\ .*.. ...* *  .**.#
#. *\ *  . * . *\\.\.* .*....* .\** . W.***\   *  .*\ .  .*\** . ***  ..*\\.....#
# ..*.*\.\. .\*..\...* *\.. **\\**\. . .\.. \  @ ..\*. ..*..**  *...   *.*** ..*#
# * ..\ *. **..\ .***. .* . .*.@.. \*..\.**\*.\*  .\*. . *. .  !*\*\ ..\ .*.\. *#
#..**\..**  . \. \*.. \.. . \ \... ....** . ...*.*\..*.\..* *.  ***.  ..      * #
#.*** ..*.\*\.! .  *.** ..\ .\..*   ..\..@ ...\. *...*.  *. .\\ ..\@.\.*\*\  .*.#
# .*.\* .*\ .*     . \*. *@.. . *  **\..* . * . . ....\**.*\.......*.*.  *\ ... #
#\\* *. *.\ *.  .\ ...*..\.*\@. ..\...!\.\*\. .*\  *..*\*.\ .\ ..*..***.W...\ *.#
#*\.... .\. .. . *  ... ...* .  .. .*...  . .\* **..** *......\**.. \**  .. ..* #
#\. **\.\     \ ..\.* \.**.* .    . . \  *  .*\ *.\.**..    \*.*\*  .\.*..*.\  .#
# *.... ..\.  ... ....\*.. *\ !\ *..\. . \ .*\ **..*. .    *!* ..* .*\.\..@* .* #
#\ .  .*   *. .\ .. .....* ... ..\  . *.... . ..\.*.*\.\.\!*...* .**\ \..*.*! . #
# ..*  .\**. *.*\ . . !\\. .**  ..\ \ \**  .\*...\..\ . **. * . *.* .* . . .. .*#
#**..\ \*.*\.\..* ***.... ..*.\. **..*..  * *   \!.\*. .*.* * . . . .\* !\.*\.. #
# *\   !.*@..** *!*..\*\.  \*  .\*.. . ..*.**    ...\**.  ..*\*   *.*  *  .  ...#
#** ......\.\..  .\.\....\\..*.\* * .\   .*\. *.*.. ..*\ * .. . \\...\ **\ .!\ .#
#.  *  . .. ....* ...\\.*\ *. *\.\*\.* .* .*  . .*.*  .* ...\**..*...* \\ . \ * #
#* .*\.. \.\ \ *\.   .*..*. * ..\ .!*\ ** *.    . .* .*.  \** .. .   *.\..  .\. #
#.\*.   ..\ \ . .!. ** *.*. . *...  * *\.\. ** !\.*\*  . *.\*. . .*\ .  .*  @*\.#
#.  . *\.   ..*** . ...*.... .  \*  . . ... * * *.. . . .\... ** .\.*  .\..*... #
#\* **.. * .  ....*\  .. .\\ ..*..**.... .*** .*.. . .   * \. * ** ..* ..*\.\ .*#
#...*.* .*. .. ****\\.*\*\*.. \..*. ... **..**.** *\.**.*\..\ . .* * *. *.   .\.#
#.... ..  \..  \*\* .\. \. ...\ **.*!.*.*.\    ..\*..\.*. *.     . ....*.\  * .\#
#\. *. .. \ \. . ... ...  *.. *.**..* *\.\    **\**.....\.*.* \.*   ..*...*...* #
# . * \\  ...\\   .*.   \ .   *\.\.** .  ***.. . ...\   . ..* .\.\ \  ..\ ..\.*\#
# .**\.\.. \..\*\. ... \..*. .*.\***. * ***. .**.  \.\.* \*..\ ..* ...**.  \*\. #
# ..!.*... .. .*.* **. . *..\*\..*.. *.\.\. . ..!*..W* .**. .*\* *.. \.   .....\#
# \.\!**.   .   *. *.\* *\.*.**..    \.W..*  ....*.\.. .\*.  *.. ..*  .  *   \. #
# ...**.*.**. \** .*\ @...*...\ .  . .\***  * \*.....*\   .*...\ \.** .... . * .#
#\   ** .**.  **. 7.. ****.*\*.\.  .. . * ...\!. ... ..\..*.\*  .. .**..  .* .  #
#.\..*.@*\. * ... ... ...\. *.* *  \@  \.. .\*    . *\**.\.  .\\ *\ \.\.  .*\.. #
#..* .\*\   \  .*\ .\*.\.*. **...*.*. .\\\..*.@. ***. *. .\ . .***.***.\.  \ .\.#
#.**\* .. \ \.\ **\ .** \. * .\ .\***\ .** **.\* ..*.** *\ .. ..\*. ...*!. .\.. #
# ...*\ . .* .**..*\..* ..... .  *\.. .*\.*..****** @... .  .*.   . *.*.*  .*.\.#
#\*.*. *** .*\@* **\....*   *   .. .\. **...\.*.*.* .**\* ....*.\.* *\... ..\!*.#
#**.. .. \ *\* *..\ *. \. . . *..\.\*.**... . *.* .\ .\.* ..*\  !\. \.@*. .  *..#
#.   .. \..*.. \  *\**. . W.. **. ... ..*\*.  .!..... . .\* *..\ ... \..\  \.. .#
# . ...\ ....\ .  * ..   *\*. * \.*.*\  ..\*....   **..  \* *... \*\  **..\..*.*#
#\.. \  *.. \  ..\... * .***..\ . ..*.  .**\.\... ..\ ** .. ..\..\*\ *.*\.*\*...#
#.    . \. .\ .. ..  ..  *...***\....R\.*W\*.****\ . .\.  **..*.*** .. *..*....*#
#.  . \. ..\  *\*    .\ \  .*..*.* \*\. .\  \.*. .*.... .** . ****.. .\*\..  * \#
#*\ \....\\*.   .*  .* \..   ..  .* **. *.\ ..* .... \. *.* * **.*.\ \*.* *... .#
#..\. . \..  ... *..\.\... . .  \ *...* . . .*...*.    ....*.*.. .*.\.*..\. *.*\#
#*.*.*.\.*. *\*\ ..*.* . \     \... @. .  *\ *.! ... * \.. ...*\.*.*. \... ...\ #
#\* *.. .* *.@. ***\ . .\..\.  .\   . ... *.\. \..\.*....**. *.!\...*..\.* **  *#
#.. *\\.   .\  \.\..  ..* ..  *\.\.\ .* . *.* *.. * .\\.*.\.***.*.*\..\  .*..\\.#
#\ *...*.*.*. *. .. @ . .* *. .  .\.*\.*..\.\ .*. ! *.! \.**W**..\.    ..**.. !.#
#\ !\\*. ** * .\**\.. ..\..\* .*. **.  ...  *\ *\. *.*\  ..**.W.\. ..\\ ..*   \ #
#  . !* .. ... .. ***..\ !*.*   \@.*  *  *. ..**.  .\...**.** \.*..   *** *.*.*.#
#\  *\\*\.....\\.\...*\.. .  .\.\*\**   *. . * ...  \  \.\.*. ... * **.\\ *..  \#
# **. ..* * ....   *\\* \  *\\ *...!\..* *.** \*. \*... .*... *.* **.*.*. ... ..#
#**\ *\ ...   *\.\.* *\. *** *...C \ \ .*.*.  ****.  . \.\*. .. **. @...*\ ... .#
#* .*\. .\ ..*. .. . .* *...*.*...   . *\*.\ . ..**    ..... \..\*.** \ .*  .\*.#
#.* .*..\  . ..*.**\... **..* .*\..\ . * * \ *  ..* .**. ..   \ \.*** .. . *  .\#
# .. . . .. .  .\.\.*.*.**   \\*\*  . *\*\. .*.*\. *  .  **.*.... .\.\ ..  .\.\\#
#  .\\*\. ..*\.*  ....\\ **\  \ *.\\*.   .**\\.. .@*...  .*\.. .    ****.*.\. ..#
#\.\ .*.\  .\.\*. \.. . .***** \*  \....   .*.**  * \\**. .  .*.\\. **\..*.*. .\#
#    *\ *.\.*\....* *.\ .\.\.*  .  . \ *\\\*....  * ..\* .\. .*. .  *... ***....#
# *.*. . \ *..\ * ..\\..*... @   *\*. *..   .\..*\. .* . *.*\*.\  \ \..*!\\.\\*@#
#\.**.* *\ .... . *.*\...  ... .\. ..**..\   .. .*  \.*\ .\..**  * . ****  . *..#
# * . . . \ . .\* .\** !  \ .*.\* .*\**\ .. . .. .\ .* *.*.*\*. \. *.\.\  *..\  #
#.. *   \.**\...***..\**  * *.. \\ *...**\**@.  . *.** *\. .*. .\ .\.  * \.. \..#
#\* .* . ..*.  *.*.*\.*. ..\\ **....*... ..**.!.*..*..*. .*..   .** .*.  \  .. *#
#.*. *\ ....* !. .**.\*\  ..\ *..* .*\ .. .**\  *. .***.. . .\ .. .\ .*\ . ***..#
#   .!..\  . ...\ ***... ...... *... *.* *.*. **  ... **.*! *** .*  .*.    **..*#
#* * *.  ** \. ** .*..*\.  . . ....\*.*  *. . *.  *. **..**....*\.    * . **.\ .#
#\** .   ... \. .*\.**..*    *.  *. \ *\*\ *  *. .\**. *.\..  ..** \...\  \W. ..#
#\ ...*\* .. . .. * . ....  ..*...\.... *\\. . .*.*.  ..* .* .. *.. *...\.\...*\#
#.\ *.**\.**.*.*\ \ \.  *  **\* .*.*\\ ***..*!**\ ** \.* *\.. *.\ . *..*.**.  **#
#################################################################################

Water 0
Flooding 0
Waterproof 9
Razors 2
Growth 23
Trampoline A targets 9
Trampoline C targets 4
Trampoline B targets 8
Trampoline E targets 5
Trampoline D targets 4
Trampoline G targets 6
Trampoline F targets 7
Trampoline H targets 8