#################
# #*# *** #     #
###. #**.*#     #
# #*.#\* #   #  #
#..*.  .#   #*# #
#\. \.. ## #...##
#.\ .*\*..# L.*.#
#. * #...*# #..##
#***\.*.   #R*.##
#.*..*\* **\ # ##
#..*.. .**..#*# #
#*!.*.\ *. .*.# #
#.\ **.* \\ ##  #
#################

Water 10
Flooding 11
Waterproof 0
Razors 9
Growth 2
