##########################
# ....\.\ *. ........\ . #
#**\ .   ... *\.!* . .***#
#*...***\ .*..* .  !* *.*#
#. **. *. * *\.  *. *. . #
#. .\ ..\*.  * *   .\ \* #
#* ****\..\  . .. \.\..**#
#*  ***. . .*  ..\ \* \.*#
#.\ .\*  *... ....... .  #
#..\ *.\ .   *.\\.  .  ..#
#*. ..* **.* . . .*\..  \#
#**\.. *..* **\\. **...  #
#..** *.. \ *\.. **..*...#
#**...*.\*...@.  \. *.\.\#
#\*\ .*...*\ . \.. .. ** #
#** . \.. . . .  \. .\   #
#..* ** .* *\. .*\. *. .*#
#\** ..  .*.\ . * .*.*   #
#*\.\\*\ . ..\.   * *. .*#
#.  ....*.@\. ...\ .\. \*#
#* .* \.**.  ** ..\. .\* #
#..\**.*.  **\. ... . .. #
#*@ **..\* . *.*...*    .#
#.\.*\.**.   *..  \*  \ .#
# *.*\*.W.\* .. .. .**. .#
# .** .\****  *.**.\*. \ #
#\ .\  *.**\  \.*.  ..*..#
# .** !\**.   .\ .*  ..  #
#* **. .*.*\  *.\ \*. . .#
#*.**.....\*..\  * *  .**#
#**.\.  * .\*.* * \*\\.*\#
#.*.!..*. \.* .\*..*.  .*#
# .*.\*. .*..*.*.\\.   .*#
#\ * \*.\.\ ...\. .. *.\.#
#**!..\... * *.  ..\.....#
# ..   * .\. .*  .\......#
#* . .\..\  \ *.*. * .  \#
#.*   ..     .*.* \.*   .#
#**  .\! * \**.\.. * \* *#
#\*! .*.  . *\  W**.*. *W#
#.* . ***\..\**.*\  *\.\ #
#..  .**.... *! ... .... #
#*\.  .* * \.*    .. .  *#
#.  \  * ...     ..\*. ..#
#  *. . *. **.  \.... \ *#
#.* \* .*. * * ..! ...\ .#
#.. \* .\.@\ . *\     .*.#
# ** .\ * **\  \**.*\..**#
#* . .\. \...*.*..\.. ..*#
#***  ..**.\ **\ ..\ \..*#
#@\. .\***..\**..*\. *\ *#
#\*\....* **..\.*\. . *..#
#..**. **.... .\.* ** @.\#
# *.\.. .*..*!\ ..**. W .#
#.**\ .* .*!.*..\@.. .**.#
#*\.*.** .* .  \*. \.*..*#
#*.**. .\  \   .. .  ..*.#
#.*...\* .* \. *.\* .  . #
# *.   * *.\. ..*.. ..\ \#
#.\. .\.\.!.  . *\*. .*..#
#. .. * *.\ .* .*\.\* \. #
#\  \.. .\ ....*. *.\. ..#
#.. .    **\ .\*. .\\.. .#
# .**. ****. ....\  .\   #
#\ .* . . . ..\.\. \* .. #
#.  .  \ . . \*.\*\.!  *.#
#  . *\..\  ..\ ...\*  . #
#..* ** ***. \.. .\ * .  #
#...* ...\. *.*.*** .   \#
#**.\\.\ **.*@..*\.\ ..\ #
#.\**  ..\.\.. .. . .*.@.#
#. ..\\   *..  .\ **\.*\.#
#\  ***. *\\.**.. .* .@*.#
#...\**\..\ *...* .*. ...#
#* .  .  *......\ ..\\*..#
#*.. . \\*. * \*.\.\..\ .#
#. *\ ..*.  *\ \ ** @   .#
# .\\**.*..  .*.\.*   *..#
# ..*...  *. ...*\    * *#
#\*..\** *.  . *.**. **  #
#\**\.*.*..\*.   \*.**.. #
#*\* ..*. \.*. ..**..    #
#...   \**\...\ @.\\.*..*#
#\*.*  ...***.. .\ .\\  *#
#**.. *   *...**..\****.\#
#* *\ !*. .**\!.*\.****\.#
#. ...\.*.\\...  .*. \..\#
#* ....*.***.*.*. .*\. *.#
#.*... .. \.*@ .* *.. \ *#
#**.\* .... ... .*\..*...#
#*.\ ..  \ \. .\ \. .**.\#
#.\..*  ......  .  \*\...#
#.. *.    * \ W\ . .  @ *#
# .\*. \ ..\.\   ***\..  #
# \.*\.. .\*@! ..\..*** .#
#\.*..\ *\..*  *** *. \  #
#. .\\..**\  \* ..  .\**\#
#    .\\*\!\  \.  * * .\.#
#\ ..*  . *..***.....\***#
#.*.\* .  . \\\ ****\ .**#
#.*..*\  .*\.**. * .\  * #
#.\.@. ***..\*@.\. * *\*\#
#..\.* *.. .*.* * .**..* #
# @ .*\..  ****..  \* .\*#
#* **.*.   ..\.  *..***.*#
#\\*. **\ .\. . \.  .\..*#
# ..  .\.\ ..     \.*.@.!#
#@*.\..\ .*  *.* *\\ *. .#
#.**. \..*.  .* \. *\*  *#
# *\    *. .\\.\***... .*#
#**\..  .\. .  * *. **. *#
#*.** .\.    \* ... * * *#
#* **  .\...   . . * .*..#
#. *.   *.\....\ * .\.*\ #
#\ *.  .*. .\ \. *\*. ...#
# *\*   . *.\\... **\ ...#
#***...** *.*. * .*\*. \ #
#\ .\.*...***. .. *  ...*#
#.\\.*...**.!.*\ . \.**..#
# .\*\.\. ..\ . ..... * *#
#\ ... *\ **  . . \.. *..#
# .    ....\@.\.*. \ \. \#
#.... *  .. ..\* .....*. #
#**. .\**\.   *.  .  ....#
#.. *. *.* \*.. *\.**..\ #
# *.*.  .\*....... .. .* #
#.@ .\.*.... \.*..*.* .\.#
#\*  . .\ \**...*.. . ...#
#.*..\..  .\.*\ *** *\*.*#
#\ *\.*    *.* .\*..\ ***#
#..*.**\.**.*.. .... *@..#
#.*. ****.. *\  *.** ...\#
#*.* . .\.*\.* *\ **   ..#
#\@\ ..  \.\.\*.. ....*\.#
#.  .**.. .**  *\*    * *#
#...\.. *.**\ .\ .*\ *...#
#!..\ *..\..*\ .. .*.*.\.#
#*. *..\.*\\*\ . .  .. **#
#. . * .\. ... . . ****\.#
#\..*..\.\.\ *.\.**.....\#
#**\ .\.!.\...*.\..* . ..#
#.*\.    * ..\ ..  .**\\.#
#\. *. .*.*\  *\ \.**...*#
#*@.* ....*.\* .. \* ..  #
# . .  \...**. \** .   ..#
#*  ** .*. ..\...*..  *. #
#* .*\..*\ *.*.*.*.*.   .#
#@..* ..* \. .*. . ..    #
# *. ** * . .\.\R.\ \  . #
#.* .**\.*\..***.\*.. . .#
#   ... * .\..*!.*.*.. ..#
#*...*.  \\..  **.\.. * \#
#*.*.!*... ..  .\*... *\.#
#  *...  .* \. **.*\  .  #
#.**** .  ..\ **. *.*.*\ #
#\*.*...*.\\ .*.W*.. *.. #
#*.  .***. ..\.* .  *. . #
#**\**.\* .  . **  \..*.*#
#......*\ * *.\.***** *. #
# .  !\... \* *  **.  .  #
#  ****  .* * *  *..*.  .#
#. \*....*...*\.....\**. #
#*..*.. *.\* \*\ \ \ ....#
#\. *\\ . .!  .. \!\. .* #
#.**\. . . . *     * .*..#
#*..@     ..\.\*.. ...* .#
#.\..\  \* * .\. *.\. **\#
# .! *. W.*.\* .\ *  *. .#
#  * ..\.\.... **\***. .*#
#* . . ... ..  *....@.** #
#**... * \. \ *...****.. #
#..\.\!* .. ....*\ .* \ .#
#\. *  .*\.. *\* .*.*.. *#
#  *   . \. *.... ..\.*..#
#\. * *...*..  .*.  .  ..#
# . \ . * \*.\ ** *\***.\#
#\.. .  .*\*.   .\*  ..* #
#*.\. .  . . . *  **.. . #
#******.!\ . \  .**!  .**#
#*.*.. .  **\.   .* *.\*\#
#**..*  ..* .  .  . *. ..#
#.. ***.*\**... * *\..*. #
#* **.*.. *.*\ *...*.\.* #
#* ...\*\ *\**..   .\.!. #
#.\...*\ ..\..    **   ..#
# .*. ..  *.*\. *\. .*\ *#
#  *.....\.\\ * .* *.***.#
#\.\. .. . . . .*..\.... #
#*\* **. .. \..\.\ * * *.#
#...**..  *    * * \ . .\#
#.* .\*  ...\ ..*.  .*\ .#
#\  ***   .  . \.. ....\*#
# .  *W*.\ .....* ..\.*\.#
# . .\** *.. *  *** .**  #
#  .**\*...*..\* .*..*\ .#
# .. . .. *.\..*. *. **. #
#\.  !. ...  \*. \\..*. .#
#.* .*.\ .\.\..*  \.**\.\#
#\..\...\..  \**\\....*..#
#.@@. \..*\ *.\. * \.\.. #
#.\..  * *. . *. * .   \*#
#*. ...  .*  *.....\.* . #
#.*  \\. ....**.** ....* #
#*.  .\ .\ *\*\*.\.. ****#
#\.@*..  \.\... .. *....\#
#..\..\*. .*..*\  * .* \.#
#*..   *  .*\  .  *..*.\.#
#..\ \.\..*... @  *. \**.#
#. *... **. **\.* **\*...#
#...@\* ... .*. .*.*   .\#
#* **.W.... *\.  .   .  .#
#..*.  *. .*..* * ..*.*. #
#. ..\**.\.\...\ .* * .* #
#*\*.@... * . * * * . ..\#
#\ . .* \*.   . ..*\ *\. #
#.....*.... .* *... \. .\#
# \.  *  \. ** \***. ... #
#    ***  \ *....*** *W\*#
# ...\..*\. \  .\..@.....#
#  . *.\.    *\.. @.. * .#
#\*.. *.   . ** .*.   @ .#
#*.!.*. .  ..*.\ \*.**\ .#
#.*. .... * \.**..***..*.#
#\.*** . .**  \ ..  . \. #
#  ..\  \..* *. \ . .. ..#
#..  .*.   \..*\ ..   .. #
#. .* ..*\ .* ..  *.*...*#
#   ..*\* . ..\*.\*\..! .#
#**..*\......@.*  \.*\*.\#
#\** \.*.*...* . *.. *. *#
#@.*.*. ...   .. ..  \ .*#
#**\  * . * *.\* *. \.\ *#
#*.. .. * ..\. \*.*.. .\*#
#.*..! ****. .\.**.**\ .*#
#\* * .** .\ * *..... . .#
#** * ..!  ...\* *   .. .#
#\... *..* \  .. . ..**. #
#. * *   *...*\   \  \**.#
# .. .\.*\*\. *.....*.*\ #
#\.   . .*.  .\ *\\.. *. #
#..** *\ * *\ \ \ \ . .* #
# ....\ ...  \ .*\\  .*\.#
#*@.  * *. *...\.*\.\  ..#
#\. *. . . \.*  **\**\**.#
# . ....\  .* \ ..*.**\**#
#\  *....\. ...W... ..*.*#
#.\.*\ *.   .  ..  ......#
#\ ***\. .**. *  * .    .#
#.\ \... \. .. @ .\ \  **#
#.. .**\ **. . * \.**.\ .#
#\  ...***. \. *  ..*@*W*#
#.\.... ..\    . ** ..* *#
#\ .** \ . *.\. ..*..\..\#
#*\\.* \...*.. .  .. .\.*#
#*...*  \ . ..   . * \..*#
#*.  * **. .* . .\. \ *..#
#....** ..**\.*.   \ *.*.#
#\  W..\\  ..*.*.  . *** #
#. \. *..\.\ *.*   \.\** #
#.\. .. . .\* \.\* .** *\#
#  ...*.\...\ ..*\ \*.** #
#* \*\...!* *.. .*...*.*\#
#*...   *\. * *. .\    . #
#\   **\**\..*** *! * ..*#
# . *..   *.\..*!. *\   .#
#*  ...\.**\ . . \. . .. #
#*\ ** ***\ .   *.  ..*  #
#..\ *.* **  .*...   ..\.#
#. *..\.*\.**\*.\W.  .\..#
#  *\* \.  .\.. .**  *.\.#
# *!\. ..\\ *  * ..**..@ #
#\...\\ *.. . *. .*..* * #
#. **.\ . .\.\** *.\..*\*#
#\.*.  **  . *. \.*   .**#
#. ****** .*  ** ..*.. *\#
# ..*\*.  \.\* .. .*..!.*#
#.*. .\.  .. .. .  .*  ..#
#.* . .  ..* ..**. .\.\ .#
#.\.\.**...* ..*.   .**.*#
# ...*\. .\.* \ .  ...*..#
#\#...#\ . ..*.**... \*!.#
#  \.* #.  . .*.*\#. ... #
#\..\. **  ..* ##..  *.#.#
#. *\*.!. @...\.\ .\....\#
#. ****#\.**\# .***.* .. #
##\##*##. .#*.**.  .#*\..#
#\.# ##.\#*\*....#*  #* *#
#.*.#  #* ##..* .#\#\* *@#
##. .#  ##  ##.##**# .#..#
# ###        # # ## #.####
#             L     # #  #
##########################

Water 150
Flooding 0
Waterproof 7
Razors 41
Growth 33
