#################
#*\..*.  #\##   #
#.**\.  **.# L  #
#****.*\.#.\.#  #
#**.*.*...*\ .# #
#\...*.*. .\.\ ##
#. *.. \...* *# #
#  . . .*...## ##
#.*  \ .. #\. .##
#\.\...* .*. *  #
#\**  ... .\R####
#. * . \.*.#*.# #
#\   \.*.*****# #
# .*\.\ \...##  #
#.#*##*... #    #
#..\ .\. \#     #
##\*\. # #      #
#\.*#. *#       #
##.*##.#        #
#################