#############################################################
#                             #*#\*. # #\*## ....##  #  ###\#
#                            #*.  #..##.. *#\*..*#\###  * ..#
#                          #  # **...** !* . *...* *  .**  ##
#                         # #  #*..* *..***  \ .\\.**.*.* .\#
#                        #.*#  # .#*#.* *.*\. .** ##.\. ** *#
#                        #.# # #\  . ..#..*  \.*  .  .. ..\##
#                        #\.#.#*... .\#*... . *...\.     \ \#
#                        #. #\** * *  ...*  ..\\  .*.*  .*..#
#                        #. *.##\*\* ..  . ***\.*\*. .\  .*.#
#                        #\ . *#  ..!* .**..*. .* ..\ **.\..#
#                       ## .*** \..\ .*  .\*.* * * *.*  .  \#
#                      #..  *..*.#\* * ..\ *   .   . .\*.\ .#
#                     #.#*...*.\. ..\\*. * *\.***  . ..**.* #
#                    #  .*\  .. .\*..*.*\. .*..\. ..   .\.  #
#                   #.\.. *.*...* .\..\ .*. . .*\.* ..  .**\#
#                  ###.\.\ **.*\. ***. \.*. !\ .. . **   .  #
#                 #W.  .. *..  **.... .!\  * .\ . . *\ *.* .#
#                ##*\ .  ..\* .*.!\.  \@... . ..*.. * \ *\..#
#               #** ..*\#* .* * .**.. .**\  \. *.\ .   ... .#
#       #     ### \*.\. .. .* ...\*.*\ \. **\.*\***\*.* .\. #
#      #*#   # .#\ # . .   \ **.\..\\... .\.\  ....*  .**.* #
#     #\.### #\..*.*.*  ..\ \..*.\\\.* *\**** ...@*\ *.*. . #
#      #.. \##..\*..*. ** **.**. \* \.  .......\.. *.*\*  * #
#     ### #. #**.\  *.*\.**.*. . *. *..  . .. . .*.. * \ .. #
#    # ...*# ..\    * . . ....*.\.. ****. . ....\. .\. .....#
#     #.\*\. **. * . **..  *. .    *!*.. ..*\*.\* *\* .\ ..\#
#      #..#* ..  ..* ** \\ *\. *\* ..\  \..**.**.......**.*.#
#      #\.# .* *.\*@ **\. \ *\ ..    *. * **.*.**..  ***...*#
#      # ##\..*.**\* \. .\ *.* *  **. ...\..*.*!.\ *\ *.*...#
#       #  #***  \.*.  .*  * * . . \ ** .. *. * **. . *.*   #
#          #.#*.....  . * .*.\.**. . *.  * *\.W *.  \.. .\ \#
#         #..#*  **.\\..*.*.!  ..*\* .* ** .. ..\.\.  ..   *#
#        #**..**\.. .\*\...*..\*  ..* *\... .\* !  *W.. .. .#
#    #    ##.\**! \.\**  .* .\.**\  .. . * *\\*. *...   .\**#
#  ## ## #. .*..#.....\ .@. *....*\.\*  \* .. *. ....\  . .*#
# #*\.**##\ .*    *.\ *\*. ...*.\. .*. .\W  ...  \. . . \.*\#
#  #*.\# *. **.\  .W \* \* . .. **\  \  . \..**.\.\.\*. ..**#
#   ##*.\\* .*....\. *. . .  *\ . . ....  \ ***.. @...*. .*\#
#   ##.. .   ... .  *    . .**\***\*.** . ...*.*. . *\*.  . #
#  #\..   .* .*. ..\. \.\  .\\ *\. *.*. . \*.... ...@*.*\ .*#
#   ####\.*\.*\\*\\*\\ .*\. *... ...\*\  *   * .. ..\..\*\ .#
#      L  ..*.  .!..*.. . \**.\*...*...*.***....*\ . .  ..*.#
#     #  * .* . **.\*.*. * *  ....**   .  .. ..*. ....\..\.\#
#     #*#.* *.. !.*\.***.. .    *.*.  . .*.*   . **. \*  ..\#
#    #\..\*\.* *\.\ .\..    * * .*. .  ...**\\** ..*\ . . .*#
#   # .**. \ . \. *..*\ .\..\@*.\ \* !\ * \..\    ... *.*  *#
#   #  *..*  .*.* \! .   .* *@* *. *\*** **   . ... . .\*\ .#
#  #\...  *  *.  R \  .!\.. \.\   .\.....*.*  *  \**... ..  #
# #.* ....  .*. * . ...!* \*.... .* ..!.    * *\.\  *. . .*\#
# # * ...  .\.\  \..**\*  ... * ***..\.\.\ *.    \\ \\ *. . #
# #.\#* .  ..\ . . . ...*...* .. .**\..  . \. **..* .*\.*. .#
##*..\.*\ . *\ *     .*  . *.\  .*.\.*.*\. . ... ..   .*.**.#
##\.**@..*... *..\\**..\.*.@.** *.*...*\.\.*\.*.* .\ . . ***#
# #*. *. .\! \\ \  ..@  *.\. ....  *  \..W\*. .*.. ..   .*. #
###* .!\  ..\ ...... ...      *\. *. **\**.    .\ *..  ...  #
#**\.\ !* * **\. . \ . ..   *....\. .* *\* *.  **..     *.  #
##.*#.  #..***...  .....\ .. \ \   **\. *.\.. ..  .*.*.\...\#
## #.\.\ \*...\.. \. \ \.. \ ...  ***.* \\ ..* .. .. . *. .*#
# ## #\*.. ** .*   ...  \.*\ \* .* ....  . *..  .   .   . * #
#   #\. * \.* **..\.\.\ *.*....  \.. .\..* **.\*.   .\**    #
#  #*.\.** *. .*. ..*\*  .**...*...* . .\* ... *..*.  .... *#
#   #*. *.*.*\ \ ! **. .. * .*\*...\ \ \. \.. *** *. * .**..#
#    #\ ...\.. .\*...\  **\.!..*.*. \ .  ..\.\....*  . *.. \#
#   # .**#\  ..**. *..* \. . ***\...* *.****\.** .*\   .\. .#
#    ##\..*.\#....\.\ *     \. ..\ **\..**\ *  *. .\..   ..\#
#    #\.. \\\.\  * .  .. \**.\....  *\. *. .\. .\*****.\.* .#
#     ##.#.  *.. .** ...* *. . * ..\. ..\    ....\**... \...#
#       # \\..* *.*\*..* .*..   ***** .** .\.*\\. .....*\*\.#
#       ##\ .\** *.....*.*..*.*.*\.\.  \.\..**  ..*...*..  .#
#      #\**\  *..\\\.  *\*.\* @ ..  ..* *.* .*.   ..... * . #
#      #*##*... \ \.\ \.*.  ..** .*..   \.*. .\. . *.* .* *.#
#       # #*  ...   . . *.. .*.****\. ... * ...*. .*.\ .* . #
#         #\\* . .\.\ *.. \ .*....\.   . .\ \. .*.\*.   .  .#
#          ##.\   .\  ***** @.. *. \ \.**.*\. *\ \*. \*.  .*#
#           #.*  .. \ .!.\. *. .. .**.*.  \.....*. \ .\.\* *#
#            #.###. .\*.\   *. .   *..*..\....\.*.\. \ *!*.*#
#             #  #\\*\... *.#*\ .*...*!\*.\**. \.*  \.\.*. *#
#############################################################

Water 0
Flooding 0
Waterproof 5
Razors 36
Growth 3
