#################
# \\R *\... ***.#
#\. .** * * ..*.#
#**..**\*\. . \ #
# \..   .......\#
# .\ *.\ .  ..*.#
#.  ..** *\*** *#
# \.\*.* *.*!* *#
#   \* . *\ .. \#
#\*   * ..* .  .#
#.. .\. . .\  * #
#*  *   \. *...\#
#*. ***..*** .. #
#*. .\. *. \. * #
#  . *\.**  ...\#
#*@  . ....*.\ *#
#\. \\. .... .\.#
#.**.\   .*. ...#
#...*.*.  . .   #
##.##\!.\.\.\.\.#
# #\.  !..* * .\#
# #*#.#** ...*L.#
#  ##\#**.  **###
#    # ##\*. .# #
#        #* ##  #
#         #*#   #
#################

Water 23
Flooding 10
Waterproof 9
Razors 8
Growth 39
