######################################################################################################################
#                            #*# ###                                                                                 #
#                            #.##..\# ##                                                                             #
#                           #\.*.#..*#..#                                                                            #
#                            #**#* *##.\ #                                                                           #
#                #          # . *.  .  \  #                                                                          #
#              ##.#          ## .  ##.\ \#                                                                           #
#             #\  #   #        #*...*#*##  ####                                                                      #
# #   ###    #.##*# ##*#      #.7#\ .#*.# #\. \##                                                                    #
##\# #   ## #*\ ...#.**##    # #\ . ** . #..##\#.#                                                                   #
##.# #\.## #\#*.  ...*\ *## # # ..*. .\ \#***..*.#                                                                   #
# *.##**.*\\.*.*.  \.. *\**##\.\**\     ....*   *#                                                                   #
#..*##*.   * .\.\.*.  .*.. .\.*... .\.*. *  #.#*# #                                                                  #
#@...\. .. .* .. .*\ ..\ .......  . .  * *.* ..# # #                                                                 #
#*.\   \   . *  ...*** ** ..\* ...* .\*. .*## \### .##                                                               #
#.\ *. ...  . .  .\**. *\.\. \*.*.**.*..\  *\.## *\ *.#                                                              #
#*.    . *\.*\*.\.**.*...* .**.!*.**\. **. .. @*### ####                                                             #
#*** .\ *.* ... *\*\ .  .\ **  ..**.*...* \. ..## #. *.\#                                                            #
#*.. ..\..\* . ....\ .  *  ...*\*...*.\**.   \ ***\. **##                                                            #
#.* . \ . **  \  ....\...\*\\.*..\. .*..\*.....#!. !.#\ \##                                                          #
#*  @\.  ...*\*  *.\   \. . **.\   .*. \ ...\\ # *.*. . .  #                                                         #
#\..\\ ..* ..*....*..**..\\.*.*  ..*@.. . .  *.#\  *\.#\#\ #                                                         #
#* * .. .. \\. *... **. . .*!*\ ** *\.  * ..\\***\.\.*.@#* #                                                         #
#.\.*..\ *\.*.*  . .** .\  . .  .****\. .****..\..\  *.*!\.#                                                         #
# * ..*.\.. !*.\ .  .. ..\.  ..@ *.\.!.. *.**  **.*# .  ##.#                                                         #
#  * .\*\*.   \ .*.**. * *.**  .*.* .***.*\*.  . *..  #*##*#               #                                         #
#  . \ \*.*.. . .. *** * ..\* \ \*.  ..*\ *.* \.*.... . *#.#              #.#                                        #
#\. \ * ..**\.\ \. \*\.. \ ..\..*. .  ..  \***  *. ..    \.#        #    #.\#                                        #
#* .*\* . ... . . ..*.... .  @ \.\...  . . . .** *** *.\\*\ #    # #*#    #.##                                       #
#. *.*..  \ \ .*..\..\\. .\ *. .\.. . ..*  \\... .\**. . .## #  #*# ..#  #\.@.#                                      #
#\ .*.*\** *** ....***.* *  ..\ ..* .   . *.. *\.*#.\. . \..#\##.. \*\## ###**#                                      #
#** **. ** *..  \ \ .\.* . .**  ...   * ...*  .\ **.  * .#* * .*. *.\ # #.. .*#                                      #
# *\***\ ...\\ .*..\ .\*  . ****.\ . *. *.*.\.... .**\* * \.\ .# .# . #*...*\ #                                      #
#\.*\.*.\ . \*\... .W*.. \. ....\*..*. *\ ..*\.   ..\.*\ *....  .*.. . .  .\ #                                       #
#.\.**.  * . .** . .*.*\..  \..*.* *. ** *  *.  .    .. .\.\ .\.*...  *\*.###                                        #
# @ .. \..*.*  *. . ..\  \.*....*...\*** *\*\ .\* *\***  \.*@**..*\ .*# \ *# #                                       #
#***   !.\.*..\.\ .  \. . *.**.\    *\*.......  .***\.\\..\ . ..... ..\ .#\##*#                                      #
#..  \*.*. \ *.\    *@. **.*..\..  \\ . \ *** \. ..****.. ...* *. *  . !# # #.#                                      #
#\.\..***\*. * . *.\. ..\ .\.\ \.* **.    *.. ..*\*..*.*\  * ... ..* \  *.*  .*#                                     #
#. *.. *.**@. .* \ **.***   **. *....*  * .  .\. *.**    .\.  * *..*. ..* *#. #### #                                 #
#*\.*\ * .**..**!.*...*\.\ *..*     ...\. *.*\*\ . .*.  \ . ..*.   ... ..\!.**\.. #*# ##                             #
#. \.*..\..\ \.* * \*.D* * * .* * \*\. . ...\..*\**.**. ... . *. \**. \* . **\. .* .##*.##                           #
#\*..*.*  ..  .\.*  W.. \. \*. * *.***   .* @... *. .* .**.   *..*.\*. *.\....\.*\ .**\# \##                         #
#*. .* .\  .   . * W\ .*\.\  *\**...*. \ ...\ .....**. .*** \ \ .***.  * . \*.  ..  #. .#.#.#                        #
#.....! *..    ... ... .*   .. \ \. ..  **.\@. .   * .*...*\ .  .*.\ ***.. .* . .\*.*.. \.#..#                       #
#.\.**.\**. *@.*\*. \* **.. .. .  \\.  *.*. .*. .\ ..****.\ \*\* .*...\*..*\**.  *\ .. *... *.###                    #
#   ..\.*****.*..**\.  .* .*.  \.*. . *. \\. .@*. ** .\... ......*. .* .. ..***   * ....*...###\ #                   #
#\  .\..!**  .\. .*  .. *..\\    *\\.. *.*.**  ** \*.!\ .\* .**\*..\  .*.*.* ...\ \.***..\*#.. *####                 #
#* *...**.  .     . .*. \* ... \*. *.*.*. . .  *.*\*** .. **..*.*.*. . * *..  . ...W*\!\  ..** .*.. #                #
#.\\ .\.*..   . . .\ *...\.\* .... ... ..\ ** *..\ *... . *....*.*.\ * ..\*. **..   *   .*.\ . \**.##                #
#**..*..\. .\...   *.... \.. .\ \ .*  !    ** *..\.. **.*.\ \.\\*....\  \* *.***.   *.*@.*...  .** @\#               #
#.\.*...*. **\.\  *..  *..  .* * . .   ..** . .*.\.  .. *  * **\...\**\*.. . *..\  ...*. .**  \*#.#.#                #
#. *. *\.*.*.*. ..*.  .     .***.* \*. \ ..!...*.. ... ..\**......\    . .   . . .  .!.      *..## #                 #
#*\. \. *.\*.  *  .**.....*. \.\*. .*.\\   \  .*.\*...\.\ *.\.*. \* \*. ..*  . .* \ ....** .*.\.L                    #
#.*  .**. *.*  .*\.\. .*\.***. .*\ *...*. \ .**.\. .. **..\. *.* .    \ .     \.\. ..* \.. .*###                     #
#  \ \..\.*\.    . \  *.  ..*  *\*.** \.\ ..**\ . .*. **\ .. * . *.* ...2.. \* *.  *\.    . .##                      #
# *..*. . .  . *\ * . .*\ \\.*.. ..... *.. .\. \  \*.*.\.* \.* .\... * ..  \.*\ .  .   ... ** .#                     #
# .. .\.....   ..  .\* .**.\  ...   * .\  \ *. ..  ..* ** *..\ \.*\ .** ** . ... *  *\   ..\ ##                      #
#\* .\** *. ....*\.\.. * .*..   !.@..       .*** **. !\...* .  ..\. *\\\..  ...\ \  *.  * \  #                       #
#..  .*. \ \.\* .!. . *\....* \*. *. \ *\.\   **. \\* .\ .  .*\  ... * *\   *\ ..\... ..*..*##                       #
#\.* \*  \.. *  .  .@@..\*..\ ..@ *  .\@... ...\**. .   .**\*.*   \** ... \.**..*. ** .\.**.\@##                     #
#. .  \** * .*\.*.... . *. .   .. *\ ..*  ..*....@.\  ..**\.. .\**..\*.\ ..\..* ..\*.. *.* . ..\###                  #
# ** .**\ . ***.**.*... ..\. .\ * . \  *\\*. *..\.\*.@.\...**\* .*. * *  .  **.*.... . ... **.*## .#                 #
# *.\***  .\ *! .. .\ . .  .\ *\*.\...\ . *.**  ..  . \..\\*\   @.. \ * .\* .. *.  \.** * *\. .###\#                 #
#.\*. .  *.  ** \.\  *\...\......* \ **\  . .* **. \* **\.\*.**..*\.\.*. ...\. @. .\ ** ..**.* * . \#                #
#*....*.*\\ *.. . .. ...* \*  *  *..\. *... **\** *... ...* .*\!\.. ...*... .*.\ ... .* *\. . .\..**#                #
#..*\ * ..  ...\ . *\\. .*.. *.. *\.\ \.*.\\.\.**..**.\ \*...*  **..*.\.\ ....\  .. . .*** **.*. ###                 #
#*. ...*......** \.\  *.\.\ *..\  ***.!\*\.*.\ ..  **.. .*..** * .\*...\ \ *\@...\ . ... *.....# .  #                #
#\ .*\ .  .*...*.  \ \*.*.*\. \.  ..**  ... **!. \. . .*\.*.....*.. . .\*.. .!\*\. \.*  . ***.  ...  #               #
# .*..*..\**\.*. . \......  .. \* \*.\. \.*.**\ ..  *.\W .* .**W\..  *  .**..\!*  * \...\ ...*.**.* #                #
#. ** .* ..*.\*  * !\*\* *** @   *. . .  .. .* .* * ** \\... . ..*\.  .\*... ***...\.*  ! *  ..*\.\##                #
#\ ..  .*  *\ . \ . ..** .....\...  ...*.\* *.*.*. ...*..**\. .. .. \  . \.\..*\.*  \.*\**. * **..** #               #
#*** \.*.\.\*  .*\* ...\  ..*\*  .. . .*\ .  **..*  *  !\.   .\\*.*\ ..*\*\..*  **\ \ * ..   ...* *. #               #
#.*.*.*.\..  .\*... \  ..  ....\ ..*. \. *  ..*.*.\**.*.*.. \  .\.\*.*... .*..*.   * \\*. . . . *..*#                #
#\. ... *. *\**.\.  * @*.   *\*.  \   W.*..  ..\**.\*..*.. .*...  .* .\*.\ ..**.  . \. !\*\..**\* \##                #
# * W  .* ..**.\.  .*  \... . \*\.*... ....  \ .* ...  ... .\* *\. *.  ** .   \ \.\.*.\.*.*..** *.\ *# # #           #
#\.\  .*\*. .* *...\. .   . *  \.*** ..  *..*  \.. .. *.**.\ .*.!*\ \ .\\\ *.     ...\..**.  .*...**###\#*#          #
#.  . .. \..  *.   *... *\. .\. *.*.   ...* .*  .\ .. *. .\\ * . . ..\**.* . .. .*.* .* ..   \ *..## \  W #          #
#\.  **...*!\ \*\. \* . . ***    \*. *.    . !\.*....\..  * **\*\. * .** !\*  . \*\*\ @...   .  **.**#.*. #          #
#\  *\*.  .  .......* . *. @***.\ \* .*\ .\ ..*.**.\... .*\ . ..!..*. .\\  \\*\ *..**. \ \. . @. . *.\.. #           #
#** ** ...\ ***\**..\  **@ *.**.   ..\. * .. ..\..* .  .. *\  ...*  ** *.*.  .. .*\.*. W#. .@.*   *\   \#            #
#*.*. .** * .. ..\  ..**.\ .*. ** * * ..*. ....**..  ..***..*.* ......\....*.  .*\. * \. . ..**. \. ..  ##           #
#  .\*.*\ *  .\*.* .\..... **. .\B...\ ...  .. ..W\ *\!*..\.*..**\ *.*... .. * .**  .*.*!.** .. .  \*.**. #          #
#  \ * .  . .*...**\* .\ .*.\ .**  .  .\.* .*..    \. ..*..\*.*\..\......  **..\*. * ..*\..  *** \\.\*.####          #
#.*.** ** **..**..*..*   ..   ..\\.\*\*. *  .   *... ****.\.*.**\   \\    ..*......*  \.\ \.*. @ ..\*.*#\  # #       #
#*\..*.  *@.\..*  ..*   **. .. ...* ...  ..* *  \ \..* ..\*........\ .  *\  .\.. ***.....\\W.. ... \.**\ .*##*#      #
#..\ \.*.... \ . ..\..* .\* \.*. ..\.**   .. ..*.  \..    ..\ ..*  .\ *.* *. ... \*\* ******* .#\... ...\. ..*#      #
# .  *.***..\. .  \*\*. ..*.\..* *.....* ..*.***..\ *\**...***\*.  .*..\. \ .\. * .\....*.\*.** .** . .  .* \#       #
#\ .** .*.*\*   .. . .  . **. .\.... ..**. . **.\.*** .*.**..*..* *\@.  \.***.W\W.\.   C*..  .. *** * .  ..* .#      #
#.**.\* *.... .... ..    .... .* \. .\ .* *..W...\. ...*\ .  .*\. \*..\ ..*\*...  \ . .* *\ **\ .*...*. #.**.#       #
#@*.\ * * ***.**\  \* *. .*. *..\.*\...@...  *\ .** .**... .  *.. \*  .*\\. *. . *.\ .***\*..\..* .\.#*.*.* #        #
#..\* !\.\.**\.**  .\..\  \  . .  *.*..** ..*...\..\**. .. \  .\!...   * *.* .. \*\*   .*.\  ** *@*.... #.##         #
# .  .\**..*. * .!..***\*\\.. *   . .**..***..\ * .  ..*.  ...\.W.  .*\..\.*    . .... * *\.*   *.*. *. *#           #
#.. *\ *W. ...* .  *..\ .* \*\**\.@..*.  \...** *.**.**....*\* .***\\ *   .***.\** . ..* .***\\ *    .. #.###        #
# \*.....*.  \* .\*W    *..\. .* .. *\ \*.\.\ \** .* @.  ... . @.*.. .* \\ **\.  * *   .\ .   !.. ..\  \#\#  #       #
#  *.. *.....\.  ..\*. ..*  \ *.    \ *.* ..* .....*  **..*  ** .. .*.\ ... .\ .**\..**.. **\. \   *.#. . .\..#      #
# @ \ ..\.\.* .**. .* ....  .*\*\....\\.. *. . *.. ..* ....\.*..* * *\.* .. .  *.\ .*!.*...\ \ .** .*..*...#.#       #
#   ..*\. . \.*.\ * .\.\*.*  !\ *\.  .. ..**.. .\ .* *\. * *\*.*.   \*W ..\**..**..\** .\... ..\@\ .* ..*.*.#        #
#\..* ... **. .\**.*\ ! . .\*..\\.  *\.* .\*\. .. *.*.*  * \ !... ..\* \ ..*.*.. ..*.\.*......\ @* . ...# **#        #
# .   .*\ ..\... ..**.\ .. .. *.\*  *.. ...\  \.  .... . .\ ... .. . . . .....**.\ .\. *.  .*  .\.**.   . \ # #      #
#\\*\. *  *.   \.*  ..*.*\  . \  *\\.\. !\ .*  * \ *. * . .* *.. *  .*  .. .....\.... . .\.**  .. .*\.\ .* ..#.#     #
#.* *.\.\...*. ..\ *  ... *!..*. .* \...* \..\ ..*\**..\. ..!\.. .... . \*.\.@*.*. \...\.  .***. .\.. . \    ..\#    #
# !..\ ....\.. ..\... *!*\  *...@*. ..\ \  .\.\*\. \*.. ** .* ..\ *.    .. . ..*.\\.**...  *.\* * . ..* ..*@*  .*#   #
#* \ .*  \...*.*. *\. ...   .\*.....* !\.\*.*\ *.\...*. *.....\ ...  ...\*... *\*  * \...*.. .*\. .  *... ***   .#   #
#\.. ..*.. .  \*. . *..*\ . ..*. ..*....*.. . .*  \. .**! * ***.  @***\*....  * .!\**  ...*.. .. ..*..9 **. \#. #    #
#*.\. ..\ \*\.... \\*******. **.*...  . .. .  .. .. .  . .. *.*\ *.*\.*.*.  .\. .\..*\*.*.\*. ***. .**  ..\ #.. #    #
#* .** *..*... .  ... ...\.* \... !\ . ..**\*\ *.\*..  * * ... ...*.. *\. * ..\.. .*W  *. \.*.\.* .\..\** ..* ##     #
#  .*..\.\.*\ .**..\..*..* .\.  *   * . .. *...\  \ .\** .* *\ *\  .\.  .** .\..\**\ * *** @ ** . \. * *. # . *.#    #
# .\.**.\ \*....\ *..*.* ...** *..*.****  *\\.  *.*.. *\ .. \  . . ..\*....  .**. . **\*.* *\. * .*@ \ . *.\.###     #
#*  .*..... \.. * *\ . .*.\ ...\ ..*...*.*\.*.* . **\.... \* ***. **..**.*.   .**.\. .******  ... ....\. .\ #. #     #
#* * \ .*  ..\.* .*. ..**\  . . *\ * *.* .*..\...*...\... .. * .@.*.*... . ..\..\...* .*\..*. .*.* \ . \ .* . ####   #
# *. ..*. * * *.*..*\  *\*. ..\.. \*.. *!\..  * .**.\*...***.**.   \ *.. \  \ *\ *\*   ..* .\  ...  *...#\  . \. .#  #
#\.*  *.\.* .\*\  \. \. **.***...*!\**...***... * . .\*\. .*... \.   \.  .* * .* *  . ..\*  * .* .\.!* .*  .* .#\#   #
#.    .*.\ .\ ..**.*..***. . .**\.\\ * *..**..* ... . .*.  ..\*... **   .******. \ .*\  \*.. . .**\\.. \ .W*\.\##    #
#.    *\*\.*!\ *...   \**.  . **.* *  *..! \. *.\...\..\ ..**..\** .... ..*..*.\ . *.*. **....\*.  @*.*.\*..#\#      #
#.  ..* *.@..  \* ..\  * \.\.\** .   *.. ...* .\.!  .*\.\ *. \..\.  .. . *.**. * ..\ *** *.\ \*.*\  *..! \*...#      #
#.\.\.* *.*.   ..\ *... *. * . ..\*..*  \.**\. . ...*\..  ..\...*  \ . **.. .\@\.  *.*.. .*\....\.\ .\*\  ..\# #     #
#\.\  * \\  **. !. ..* *.\*.!  ** .*\... *. * *..*\\. !* *******.. . * ..    \*.** .**.. .. .*.*.\  * \.@ *...#\#    #
#* .\..  .\ **\  .\ \..  *.*. .     .\* *..**\* \\*.  .. .! . **.\ *\*   *.*\.. ..  .. \.\   ..  .  \   \*#. \..#    #
#. .**...\  \..\*. *.  W \..  \.*\. *.  .\*. ..@.!... \*.*.....*\ ..\.\. \.\  *..! *\ \.\    *. ** \..*..*\.*#W###   #
#\. .*..\ \.* ..*..* \.!. ...*\ . *..R* *.. . .\*\......\ \ . \*.    .*  . *.* *.\.. \ .**....*..\.\* \ *. **\*..*#  #
#.. \..  *...  .\. *..***. . \*\...*  *   \ ....\..\.** .*.*  ***\..*.  .* \.*..* \...*.\.  * \\...**\.... .  .*\#   #
# .*.. @..\\  . *....*.*.**\  \ *\*. ..\. ..\ ....\@ ..\.. . *.*. *\.* \ .*.\*.\*   .*.... .. ... ...*.!..  *. . ##  #
#* . @*.\.* \.* .@ \ .\*.\. .\ .... .*\ ...\**** *..** ..  .! ...**..*\  *...* \*\  .*** * .\\ \.*\ \*. \ \ .# .## # #
# .\ . \*.\*.W*  *.......*  **. .. .\   \.\...*.*. *.*. * *. . \ ..**.* **. ..  *\.****. .\  .  \..*...  *. *. .## # #
#.*.\ . .......**.   !  .* .* \. ... *  .\ ***...* ...* .\*.. ..\ .\..  * \. \ *\...*.*\.  \.* *.. .  . *.*....*.. # #
#\*     *\..*\ ..  *.\ **. .\.. \*\ \.! ***..*.*.\.*  .**..\.* .*.\@\****. ... ..   .\.   .*.... * *.* *..  .* ..#*###
#*.\   *.*.*  * \ .*\. \..**. .* *  . \.\***\... *\*.*... *.*. *. !.......*   *\ \. . ...\ *\ .!*. . *.*\...*.*.\ ##\#
#. !*\.* ..***\..*\ .  .*\ .. .. *\*. * .*\**  *...*\*..\.*..*...**\..\...*** . .. \. \** .. * \\.. *. . **##  .\  #.#
#\.*\   \*.*.......* ...* \\.\.*.  ...\\ ...* . \ ** ....*   *.\ *...\* * ***\ \... .\ *.* .\*.  ** *. **\..#. **  \.#
#*..*.  ..**  .*. .*.  .*  . . ..  @.* .\ ..*.. .*...*      . *..* . .. * * . *.... ...**. * \..*\. .\ \. .\#.##. ####
#   \ \*...*\ ..**.. *\* . .\ .   \. ** .. .... .\ * .**..*. \*. *\ @*\@...  *.\. .*.. *.\.*\ ..@*  \ *!..\.*   .\#  #
#\.\....*.\.**.\... ....  .\.* . *.\..\**..* *  ..\. ..*. **  \* .@.@...*. **.* *. . 1\.\. *.. *\*.\. .. *@*.*####   #
#.*** *.**  .!... . .* *\**.  . !\. *\.***\.@  *... \ \**.*  \    * !.\.*  .*\\..\.  *...\ .**\...*.\.\..**. #       #
#\*\.\* \.   \* .*.\ ...*\. .**..   ..*.*. \.*.. .\  *\.* * . .\.  .   ** ..\.. . * \. . \  .\ .*.**.  *.*.*#        #
#**!.**  * ..  ... ..* .*\  . \.....\ .. ...\. ..\*. ..**...   .\.*. *.*.\ \  .  ..*.\   *..\* *.\.* .*.\.. ##       #
#..* .*\.***..  * . *.*..*.\.*.\... ..\\.\.\*... ...*. ..*.\  .  ..*\.\.. . .  ...\.**\ * . .*.* *.* *....#\ .#      #
#... \.\   .\..\. @**\.* * *.... * *..*  ....**.  * . \ ..*. .\..*\... \. \ . \\ * *    * **.*\....  .#\  *. *##     #
#\.*. *\\ **  ***\* @..... **\.\.* ** \ .* .\. ***.\.  .. * . * \*.* .\. . . ..*..\. * .* .**.  * .*. *  .  #* \#    #
#.\..\.*.*..* *.\ .   *** \. *.* \..*  **\ .. . .\ . .. . .*. ..*\\.\ .**\.*\!**.. .\..   * . \ #.****.. *..##*#     #
#.  . .* .\ . * .**   .\.**  **** \..  **.\  . \*.. . ..  **.*\ .   ....***.   ..\..*...*..*\...*...***.**\ # #      #
#* \.\ . \  * .  *. *. .**.**..\***.*.....   *.\.. ... *\*..* ..*  *\.\...\   .\*. ..  ..*.. ..\  \*@* .\###         #
#\.. *.\. \.\.*\ *. *\ ***..*.... ...  \    *W* *.\ \....@* . **.**.. *\ *. \*@.*. .\  ****\  *..#..\. ..#           #
#   *\ .\ ..*.***\.   ....  .\.** ..... *.W ..* \..\. \ * *\  ...**.. .*..  ....** * .\..\A. .*....\#.\##            #
#...**..\. ..**... \ \*.\. \*.*.... ..  . \.\.\..*. .   . \.*.\ ***.. * *\    * *  . *! * ..\.\....#.*#              #
#  \*.. . \\ \  .  .\.*\*  .. \ *. \@  .\.*\\.\  .*   * .  *****\..*\ . . . .* *\ . *.. .\ *..*.\.\ ..#              #
#.  ..\*. . * .\*  *... .\  *\..*\*.\ . .*\.* *  ...* . . *..*... .\*.* * \.\. ***...* .*....*.  *\.###              #
#.. . .  .  .\ .. ***...*  . @ \ !.*.* \ ...* ***  *\*\. \...* ...\..\. .*. .\ ...*  .*.* .  .\. ** .* #             #
#.**. . \.\.\.** ..\.. ..\.! .*. .*\..*..\@\*\\... ...\  .   .   \.. .**...  *    *.*\ . \ * .#.*\.*\##              #
#.*  **\..*. ..*  \* \* *** \ .!.**.*\....... ..*. ***...\*..\\.. *   .\..*\*. **. \ ..   *.. .  .\...#              #
#\. . \ \\. *  .  ..* **..  \.**\.\*\...\ \ .. *\* .*.*..*.* *.*. * \... *.*.* *\ *.* \..\ .   ..\ .  *#             #
# \.* .*. **\ *....\. ...  *....*. \** *. .* \***** . . .* **...\\\  **\.**. ..* .*....  .*\... *. *\ #              #
# ..@* .. \.  **   .*\* ..\. .. *\*.*\*\...  *.*\  .  .\* . . *.* **..* .*..  *.\*.*\*  .  .\** ....*#               #
# **. ..**.... *.*\.. .  **  ***...*\  .....\*@..\.*\.  * . .*!.*.. ..**  **\.*..\  *.  . .**..   .  #               #
# *!\. .\*   . .\  *. \* *.\ .** .\..\. \..... \**. **\.*\....* \!.**. .  .\.*\.\ .\*  ** *.. \ .####                #
#..   .  .. ..\. . !.. .*....... .!*. ......   ... \..**. . \ .  ..... \*    . ..  *.\*..*.**  \ #                   #
#. .. * . .   .. *\ . \.***.\*.*\.@ . *..** **. .. \. ... \. .*. *\.   ..* *. \**\*. **\ \#.. * #                    #
#  . .*...*.*\. .  . . *.\** ...  *. .. ***\..... \.*  . .* *\... * .* *..\*.\.\.. ..\.*.  #* ...#                   #
# .   ..\.\. .*.  .\  *. ..\ \ *  \..*** .*.   \\*..\*\..*. .******.**\**.! *    .... . \ .. * \ #                   #
#\  ..*\.\.. *\*.* \.*\* * .\ * \* .*. .\*. \*.  .***..\ . * ..* ...* *** . . .. .  \  . ..* . .*#                   #
# *\*. \***\\.*..  ..*.. . ....  **\ *\.  \  *.\   *. .\\. .\*\! .* .\ **\*.\  ..\!..\.*\\ .\ *.#                    #
#  ..\....\.  .*!  . *.**\. . \. \*.\..* *. *...  *...\  * ..\* **.  .. *.. *\ .\..\ *.*#*.# \.#                     #
#* ..*. . . \*\!\ .... ...\..  ....*..\*.**\\.\ .\*..\ . * \* ..*.\.. **. * *\*******\#.\.*####                      #
#.. .*.\*  *.. . *..W..\*. *.        .\.... . .*.*    * .. .**. . . **.*.*...\.**.*.. ## ..##..#                     #
# \ ..*.\  \ * \ .* .. \*\\\ .*\*.*.\....*\. ! * . * .. \ * ...\\.\*\@*.  ...* .#.\  # # .. *..#                     #
#**..\..*   *.*! *** *. .*\*  .*..\  *.. ...**.*.....*. .\*..* \*..*  * **\*.. *#\  #   ##### * #                    #
#\.* ..**...* . * *...*.. .**  *@ * ..*\ .*... .\* *..* \..*\.   .....**...\ \ *#*#*#        ##*#                    #
#.*\   .** *\.\ \*. \..  * *. **.  *..  ... \.**.\. \\. .*.\.... .*\.*\.   #*#.# # #           #                     #
#\.  **. . .   .. .*.. *..*\\*..W\.W \.*.\ !@...\. * .* **\. \@  .\. .#...  .#.#                                     #
#.**. .*** ..  .*\ *.* .  . .... ***..** .*** .* W*..\*.\.* * .**\\* \.\ .\ .##                                      #
#**.\. *..\. **.**\.\. *  ..* *\ ..** *\. *.*.*..\.**.. *.*\. *...\*   ** ..\#                                       #
#.\.**\.*\*...*\ *. *. *.* \...* **...* \...****   .\*.\*..! \..@ * *..\.\ \.*#                                      #
######################################################################################################################

Water 20
Flooding 8
Waterproof 9
Razors 37
Growth 18
Trampoline A targets 9
Trampoline C targets 7
Trampoline B targets 2
Trampoline D targets 1