######################
#             # ##.# #
#     #      #.#**\.##
#    #\# #   #\ ..**##
#    #. #\###.   #\.\#
#   #**** .*##...\.# #
#    #* * .#* ..!. * #
#    #\#*.#.# ** \ #*#
# L##\##.\ ...***...*#
##**.* .**\ #\.. *.*.#
# ##.. .. .**.* ..**.#
### .**.\  *..*    *.#
#.* . ..**.* \\  ..\ #
# ... .** \.\ * *  ..#
##.. .** @.*..*\. . \#
#**.\ W*.*.* .*..*\@ #
#*.\ *.***.*.*...\ *.#
#*.  . \.\.. .\\.. . #
#! . *..*..\ \.  **  #
#\*\.** *. .\ .\ !\. #
#. .* *\* ... ..**\ .#
#. \*\. ..\*@ . *. . #
#*. \ . ..*... .\.*..#
# \*.@ .*\. *\. . *\.#
# ..\.* * ..  W.\ \*.#
# . ..* *.* \.**\*!\.#
# ... . ..* ..***.*. #
#..*.. .. \ * \....**#
#. \*  *.. ..*  \... #
#\ .  .. *\ *\..\\* *#
#*.\  .*.*\  \.  ..*5#
#*\  .*!**!.   . R\.\#
#\. ..\.\.*..*  .\. .#
#*  *.***...*\*\..\.\#
#\* ..2... .*...  .\ #
#\!.@ A\W.*! *  \  *\#
#\*\*  ....\ .\\\.* *#
#.. . \***.\.\*.D.\\*#
#*.*...*\\\ ***. . .*#
#. **.*....***.. .. \#
# \  .. *  ..*. *.  .#
#.\ . ....**.*. .. ..#
#   .* ..*.. .\. \*.\#
#   ***  **\...* !.*.#
# \....**.\**\*. \ ..#
#*.\* !.. .\. ..* \ .#
#...*\ **. *. *.   * #
#.  ..  .*  \.**.. *\#
#*...* .\ *   ..*\.*.#
#*.*\.. * * * .*.. ..#
#. *.* *\.****\..  .\#
# .. * *.*.. *..*\\  #
#  . .**\.. \.  .* \.#
#...\ *@*\ ..\.  . *.#
#.\.  *.* .*\*  @  ..#
#.. ...\*..\*. **.* .#
# .... *\*\.   \.*.* #
#   \ .*...  .*. \\.\#
# . *. \. ..\**. . \.#
#     *.*\.*..\ *  F*#
#\.\ *..*. *.\.*.\  .#
#. *\..C ..* .\.*. . #
#.*.. ..****.* .*  .9#
#..*.. *..*. .\.... *#
#..*   .@ \..*\*.  \.#
#.*.  *... \ ..... ..#
# . . * .     * **.  #
#   . . \.  * . ****.#
#  \.* ...\\.* **B**\#
#.\.*. .* .... .\ .  #
# \ .    *.*\*  .* . #
#*   *. ....*.. **\*.#
#.   *.**  *** *  ..*#
# . ..\.E\ .*..*\  **#
# .  \*\..  ..*...*..#
#.*...**.*  .*\  *.. #
#* * .\*.. .*.* *.\ *#
#\\..*..\.**.\..*\ .3#
# .....\\.***..\*. ..#
#*. ** *\*..* .*\*. .#
#\.\.. * . **\ **#.\##
#*..\.******. **.. *##
## .  .\!*.\.**..*## #
#*..\. .\.*#\.. ...# #
#.. .** **..#*.. ##  #
# #*....\*.**. \ \ # #
######################

Water 24
Flooding 10
Waterproof 7
Razors 34
Growth 3
Trampoline A targets 5
Trampoline C targets 2
Trampoline B targets 5
Trampoline E targets 3
Trampoline D targets 3
Trampoline F targets 9