############################
#.\.**..*. \*.....  .   ...#
#  ..\. ..*..  .... ... .. #
# .\* *\ ..*.\  \.\.*.  *..#
#.  .\.. *.  *.  . *   .\ *#
#\ .\*. *\\  *\    *.*.   \#
#\. .. .\. * .* ***..* .   #
#**\*.*.  .@* ..\ \ \.\ .\ #
#**. \.    ..\.   . .. *\**#
#!.*\  . . .\ ..*..*   ....#
#..*.. \\ *...  .\\.  *..**#
#* . .*.**** * *. ! * \..\.#
#.\* \.\... \.**.  *\  *\*\#
#*..*.* .\*  *.\. **.* ...*#
#**.. .\..** . .*...**.**  #
#.* \*** ...\*.  .*. . .* .#
# ... *\.   *   \.*..* \*.*#
#.\. .. *.*. \\.. . @ **...#
#* . *...** . ...\ ...\.  *#
#. \.. \.*   *..\   .   ! *#
#R   .\..*..\.*.....   \  .#
#*. .. \.   ... . *..\ .\..#
#.\  .* ....*.*..\ *\  **.\#
# *. *...*.\.*..\ ........*#
# ..@.. .. . .***....\ W...#
#*.* . ......*... \ *..  **#
# *   *  ..\ *.\.. *. ..*..#
#\!*.*.. \* @ ..\...  ..*..#
#  @ *\ *.... \. *\ .. \ ..#
#\*.... .*\. *\*.\. .\ ** \#
#. .\W *\*..*\\..*.\** \.\ #
#.\ .**.\..!.\ . .....  ** #
#*  *.*\***.*.    \. \ .*. #
#.\*\**..\ * * . \.\\!* .\.#
#....  *  .*.. ..  .* .. * #
#. .. \.\  *\.*..  .*\*. *\#
#\* ...\ **. .. . *\.**. **#
#*\ * *  .#* . .\@ *. .#*..#
#.. * !..*.*.   *.  * # # ##
# @**  \\\*. .*.** .*#   # #
#\*.. . .\.    \ # #*##    #
# .  *.*###\.\. ...*#. #   #
#\ *  !**..*..*\!\. ..L    #
#* * \ *\  * *.\ *..# #    #
#..#*..\.  @.***\.*# #     #
#\.#* @.!.\*#*.#....##     #
#. ..*#\..*..*# #*   \#    #
#*#.*#   .\ \.#  ## *#     #
#.  \ *# *### #    #\.#    #
##\.##.*##   #     # \ #   #
# ## #*\#           ##*#   #
#    #\#              #    #
############################

Water 20
Flooding 11
Waterproof 3
Razors 30
Growth 17
