#######################################
#  ##  #    #*  .* .****\. .*.. *.**\ #
# #*.##.#### .  \.*** .**..\. \ *\..  #
#  #.** .@.. .... .\  ..* * *. *\*. . #
# #\ . ***.. * .*  \  * **....*....  .#
#  #  .\** .\ * .\   \. ...\ ..\  * .\#
#  #* \* . . .\ *.. . ** R.***\. .  ..#
# L*..\.@\* .\  \.. . *.\ 8*  ..... \.#
### . **. *.* . .* **\ \  .*.. ..*.   #
#*.. \\...... .\ * ..*..\  . \  \ *  @#
##*. **. .\A\*  **.....**\. *.  .\.\. #
# #**\ *.. \* . ...    *.\ @!.\   **.*#
# #*#.#.. ..* *.*\* . \..  .*\.*.\....#
#  #.\  # .*. *.* . .W..   \.*.* .  ..#
# #...  *\.\..\ * .  . \ . .\....\\.. #
#  #* *.***# .. .  .* *   .* .\  .\   #
# #..#.\.***.! *...\   ..*.*. .* **.  #
#  ##. * *\.**..*. *..*\ . *....... .\#
#   #\.#. . ..*.. *..*. * **. .\ \*\ .#
#    ###\  **.\ \** \... *.\. ** .\.  #
#######################################

Water 0
Flooding 0
Waterproof 14
Razors 27
Growth 26
Trampoline A targets 8