####################################
#   # #                            #
### #.###                          #
#. # .#. #   #         #           #
#!\ *. \ #  #\#    #  #\#          #
#.* . #.. ##**\## #.# #.##         #
#* . \.\...*.. L*#.\# #..*#        #
#...*.  ** .*.**\.*#\## .#         #
#.*@. \ .\ *.@.....#  . *#         #
##...*\...\ . #* ..# .  # #        #
#**  .  * .\ \*@  !#. \ ##\#       #
#\*.\ .. .. \ ..\##.**. .# *##     #
#.\* \.\ *\..*.*..**#.. .\...@#    #
# **\ *   ..\* ..*..... . \### #   #
#\.. . ****\ . .*..*.. ..   ###*#  #
#  . \\ ....**. .* ..\ .. .. *#*#  #
# .\ *.   .**.** .  *****.\.\.#.## #
#..  ..... .\*.@**  . ...\**.   ..##
#* .*#*   \.. .*** .  @ .* *  #* *##
#*  *.@ .  *\* ...   .**\. ...#**# #
# *.*\. *\ ... *.  * ..* .. \.######
#.*.*.* ..! \***  ..*...\  *\.##.*.#
#*. . *    .\ .**\\.... .\. . *.\###
# * ..\*\.   ...\*...@... .. #..* .#
#\.**  ..*\*. \\.*\ ..*.   .  ...* #
#@*.. *\...W .  *.R..\ .. * .. **\.#
#. . *..**. \ \ \! *.@  \ . *  ..*\#
####################################

Water 16
Flooding 17
Waterproof 10
Razors 3
Growth 33
