################
####\L##       #
#.. ..*.#      #
#****#*..##   ##
# \\\..\..\# #*#
# * .\*.#\. ##*#
# .  .*.*\**#\*#
#\  .\  .  ..*\#
#  . . * * *.\*#
# **.. .\*\ *. #
#. \ #  ...\.  #
#@.  * \ \ *\. #
#.*  . ... **..#
# \* ...***. . #
#  .\**  \. \*\#
#\   **.**\.\.\#
# *  *..*\.* .*#
# *  .\*..  **\#
#.\...**.*\ .. #
#\.  ..*.\   \\#
#   .  . ...   #
#. .\ . * \\ ..#
# .  ** .. * .\#
#.   ..*. **. .#
#  ... ..\.   *#
# *\ .\\...\.*.#
#..**  .\ . ..W#
#.* \.   ** .**#
#..*.*.* *.  .*#
# *!\ .* \.. .\#
#....  ...*   *#
#\    . \*\ .*.#
#*  .*....\.\ \#
#* .\W*   ***..#
#*.*\.*\.*.. *.#
#.\..\. \ *.*..#
#.*.* ...\\*.. #
#....\. . @.*.\#
#.* .*    ..*\!#
#\*\.* ...*...\#
#..*....\ . \.*#
#  .@. *. .@.*.#
#\ \.*\.\. *.\.#
# ..\..   \*...#
#.*\ .***\..  .#
#*\.  .*. ..\..#
#.   \ ..\ \ @ #
# \ ...\ ** \.*#
# ..*.*\*..\.R.#
#** ..*.. \.. \#
#..\ *.. .W \  #
#\..\.. ..* \ .#
#  . .** \* . .#
#\**. *\  *    #
#.. .*.\  .\*.*#
#\   ... .**@ .#
#*   \ *\ ...\.#
#\* *. *. * @* #
#  . * ***.*..*#
#\   *. \*.*...#
#  * .* *\   .*#
#\. .**...\ \*.#
#\ ...\. \  ...#
#...\.. \..*.**#
#..* . .*\* .*.#
# \. .\.*.. .. #
#  . * ** **..\#
#..  ...* \ *. #
#   .*\*. .\!\*#
#*\.  \* ..**. #
################

Water 0
Flooding 0
Waterproof 1
Razors 6
Growth 16
