###########################################################################################################################################
#                                                           #.#                                                                           #
#                                                    #      #*#                                                                           #
#                                                   # ##    #.#                                                                           #
#                                                  #..#*####\.#      #      #                                                             #
#                                              #  #. ..* *.\#.# #   #*# #  # #                                                            #
#                                             #*# #\* \###* #*##\####*##*##. #                                                            #
#                              ###      #    #* @###...*.#*...#*.#.\ *## .. .#                                                            #
#                             #\ *#    #*#   ##\##.#*. .\***\* \. *#*\#   # *## #                                                         #
#                             #..#.#   #* ###\ ..#*#  ..#.*#.* .. #.* .\ \. #\.#\##                                                       #
#                             # \ .# ## .*#.** . . ..  *\\. * #*. **\###...#  .*.#.##                                                     #
#                              #\*\.#. # ##\ \  .*  * !.**.**.*.* . .#.* .. ..#\.**#*#       ###                                          #
#                       #  ## ####\## .  \ @..  .. #.\ *.* .*.*. .* *\..*...*\#..\.#.#      #. .#          #    #                         #
#                    ###.##\*# *##.* \.*..\ .@  ....* \* ...@.** *.**  ..**. \* *\#..#     ## ..#         #*#  #.#                        #
#                   # *..##** \*.. . *.#*\.#.\#  .# . ..* . .* .\ *\.\   ..\ #\#.*   .#   #..  *##    #### **##\ .#                       #
#                   #*... #\  .#L*  ..*.*...\   \ *\* *. .*@*\.   *.*.*..  . .\*.** ..\#   #  #\  #  #.**...#### \#    #                  #
#                  ###..  .#* *###.. ...**..**\ .# * ..   .** *\.  *. . \**..\. ..*\ * \#  #*\ @ *## ### . \*D *\. #  #.#                 #
#                 #... *  *\. \#\. \*\***.\.*.   ...\.. @.\...*.. ...*\.....***  ...   #.# #.@\. .**#\ ##* ##* **##   # \#                #
#                 #.*\*\ * **..\.*!.*.\ .*\.* .. . .W.*.* ..\.**.  *\.*\ ** .*. .  .   ..*#\*\.* .*.\** #*\*.\.. \*#### .*#               #
#                 #**.\*\. *\.\.**..\  ..*......*  \ *...*. .**.   .\  *.. .... \ *   . \. .**. ..* ##*. **!*\.\**##  . .#                #
#                 ##**  .*  .\  *. ..W.  ..\*.  \.*.. *.\*...... *\ * *\* \ *   ...   ......*..   *\..*.\.. .@# #.\#@. .# ##              #
#                #..@* \*..*.\*\.* ..* * .* .  .*...  . *. .\\*. \.. \      ..* \.\**..\*\.\. .  ...*#.**.\. ** **. #**##\. #             #
#               #  #*.\ .  .  ..*\  *.\..** *.\ .   \...\. . . *.*\     .\*   .!.\.\ .. ***.#\*.\*\.\ .*\*. \*..#\. .*!*..##              #
#                # **... *.  ..*..@*.*   ..*... .\* . * .  *!\. .** ..\.*.* *.\*. .** \ ..\ *..**.**.. .*... .**** *.#*...\#              #
#                #\ *. \*. *\ *...\\* ...* **** \ . *.******\*.. \ ** . .\.*.\. . **\ .. .. **** ..**..*.* *.\.\. .\\ .  ..##             #
#                #.*W* .*\...*.\....*.*.  ..**  ..  *.\  .\\.*\*\.\..*.\ *.\ .** *.\.**.. \*.*.*. \. * .\.*@  . @* ..\** * * #            #
#                # ..  \* .. .\ \ . *  . .. \ \.*.  *. .\* . .*\. . \ ...... * .\... ....*  \*\ ...*.\ *.#\. * \** .@..\**\*\#            #
#                 # # ***  .  .** \.* *.\ * . . . .\.  ...  \...*.  . \* **..  \ .*.. **  \* .\.\ \..**.  .\..\. \  ..\   *##             #
#                 ##.#.*  .\\.\..\..* ***** *  .*\..*\*.. . ..* \..\   .\ .  \ ..*** *. .*.\    **\ .*....\\ *** .* *\#. .#               #
#               ##\#.\*....*** .#\.. ...*..*. . .* * .*..\  * *\. @*.*\\** . .\.**.. .  **. . **. *.\.  \\  *\...    *.\..#               #
#              #**..*##\ \  ***  *   *\*..*.. .**** .* .\..*\ * .  ..*.. . .@ . \.*..*\ .\   \. \. *    .**! ...*.* . * *#                #
#     #      #  #.#*   *...\.*.* \*.**\.  .\.   .  . *. ..\   . * !\.*\ . \. .  G .\.**  *. *\ .  **.. \  * \\ .\\..**###                 #
#    #.# # ##\#  #.\.  .* . *..  *..\.* @\*.\  .. **.*...   .**@..   ...\.**@ .\ .\ \..  .*.. ... ...**   .\* .\..* \## # #               #
#  ##.\##.#**  ##* *\\ ..**  *. .@. *\.\. *\.** \   . * *...**.\  .  @ \.\.\ \\*..   .* \\.  .**\.\ \.*@\. **.\*.*.*#..**#\#              #
# #*.*  *  #*  .*..***.  \..*.. .*\*!*\  \** .. .. \ . .. .\.*.*.. * *\ * .*.. .*. *.*... . *\**\\ .. \ !.. **.* .\#*  #.#.#              #
# #\.\ ..\*.. . . ....\. ..*.**. *..\...* ..* . *\ ...@  .\.\. .\.!\ ..\. \...*.*. ..\.   .*...*.\*.\.. *..*!. *. \    ..**.#             #
# #.*.  **.** \..**.\   * ....\.*\* ..*. *.... . *.. \ \.*\....\ ... .\ \*.\ ****.\***   \  *\ .*\....\  . \ *...  ..\* @*.* #            #
##.....* .*..# .. **\ .. \.  * *\.*.  .*.\*.\..*...**  .\..\   \.  *\  .*. . .*@.......*.\*** .\* *.. .   \.\*.*.*.* ** **.\#             #
##.*  *\. * .\ .\ \**  ..*.8\\... . *\*.*....   ..**.  **..* .**. * \** \ ..  .\. .*.\**.*..* . . *\. \*  ..\.** .\.**.*.\. .###          #
#* *.\    * \*.**.... **\** *   ** *. .\.  .. *  * .\ .*\.**. .\ . \.*. .***  .\ . .. .***  .     ..\**.. **.*.*  ...   *. .*.\.####      #
#.@...   . .*.*...*\.\ .* B*  . \...  .. .\.\ !\ .* !*.**\ . .**. *...\   .* !\..*\ . *.*.* .*\.\ .\ @  * ***.. \.   *...   # ##**. #     #
#...\...* * .. ..* *   .\ .*. !.  \. *.   ..*.\.*..  ..*...*  ....* . .  .  \..   .. .!\.**\.* \*.*...***.. .*. .\ . ..\** .\* .#*.##     #
#*...* *.*..**   . .   \. ** ..\ *  ..** . .. .* .*. *\. .\..  .. *.   @**.. . ..**.\.\...\ \*\..*\.*..!\.\... \ . .** *. \ ... *.. .##   #
#... ....#*\ \  \..*.\  \ .**.\ **... **\ .* *\...*.\. \ \ \   *\  .\...\.\* .  * *. *.. * ..*. *. .**\!. .*.\..\\ ... * \..\.. . *#*\.#  #
##\. .\   .. ....  .*   .* . ..* .\ * ... .. \ .....*. ..\* .*.  \\  . \.* ..* *...* .  .*  *.*\*. .... *.* *@   \.... .\*.*.  ...*  .#.###
##.*.\ *  *\. *     . .\.\..** @   *\..*** .*  .\....*.**. ..\*\.**..\..* *  . .. \.*. ... \  \...* *...*\*!\. .  \...\ .... .. .\ **\.**.#
## *. .\  ..\.*  \*!      \*\. .\  \ *\.\.. .\. .\.**\ . .** ....\\.  \\. ..\ @\. ..*..*   !\ ....\..*\.* .\..  *..\.... . \..* . \*** .  #
#.\. ** \ . *** \ ..*..*.. .... *  \.\**.    \.. .   .. .**.   .\..*\*.*   \..*. ***. *\  *\*.\. . ..* *..@.**\..\*   \.. \.\ **.*.....C*.#
#..  ..\..* .\.*.\ *..**  *  * *. . .* *  ... .  * .*... ..*\*** *\*.  *.   .\.* *.*. .. *\.*.  . . .  .  *...*.\   *....\ *.***\!\.**. *##
#.\ \  *.***.**\\. .* .** \ \...   ... ..\.*. *\..\  ** **\.* ...**..\ ***..*.*...  !.!**.\ *.\ \ *  * . \..... . \*. .. *.\....* *.*.*. ##
#\.*..**.\.\.*.. ..*  \ ..\ .*  . .. \..*.\. *..\. .*. ..@ ....  .\*.. .\. .!\..\ * . \.\.. ..    **.\**.*. \   \.!\...\..\. .*\**\* . *  #
#\ . ..*.*...* ..  *.  . .**\ \ .   .*  *.  \.\** . .. \.\..   **.. \   **  \.\**.!. ..\. * \*   *.\...* *..W * .W. \\   .!*  *. ... . .  #
#.\ *.*....\.* \.*.*. .  \.* . .....* ...* *..*. ..\.*..*   ..* .*.. *.* W*..\ .*\   **..\*\ * *.* .\ ..... \..*.\ * .. .*.. *\...\.*\  **#
#.* \ .\.\  *...**\ *.. . \* * ..*. .\   .*.*\*    ...* .**\.*   .\. \.\  * \ . \ .\ \**  ..*\ .\*.*  * \\ * .\.\*\*\ *\ . * * E*\*** ...\#
#*..**. .* .. \ .. * ... \ *\*\\..* *.. \ \.*.. ..*\.*\.!\  *.  ...\*** * \ . \\..   ..6    .** *. .. . \*\   .\.. **.*  ***\ . \*... . \.#
#.\.\ \ .* **\...*\.\..\ !  \...  .\\*  .\..\. @.\.*.*. .*  .   * \\*\.*** ..\...*.  * . .\ \.  * \..\ \.  \..\.  .... \ ***** .*.*.*  .. #
#. *  ..*.*\..\  .  **..*\.   . *\ *...  .\. .* \. \..*  ** ***... *..*..  . .* ..*..\*.. ..     \.**\.\..*..*..*.\ .* \**\..*...\*  .* *.#
#\ \**. **.\.. *.  ..* *. .  .\ *..**.*.* . ..*. . . ..\.*. . ..\ \.* ..*  * *\* *. . ....*   .   .*\..*.  . .  ..**..\....*\..*... \.***.#
#.*..! ***.*. *..*  @  ** . *. ..* *. .**\.  .... ..  *  * ..  .. .*  ....* \..\****.* *. . ...*.  *..\* \. . * **.\ * .*.... *.  \\. *...#
#\. \ *\.. *.*.....*.*..*.**\\ \  .\   . *. ..\ ... \ . .*\.\*  \*\..*\..*\*. .*.... \*...\* .\*\ \. ..*\...@.\.. **  *.. * . \  \..\\...\#
#* *.W\.\ ....*\* **  .. *\* *...\  . *\ . \  .*\*\ . \  !...*...\.. .*.. .**..\.. *. \\ \.*... *\.*.*.\.*...*.** \. .*.*\\. *.*. .**..*\ #
#.   ...  *\ *.* \.\.*\.... .** * \*.. ..*..*  ..*.... ....***\*..\.  .\*. *\*.. \\..*. *. .    *\.\.\ *\. \ ..*.\.W..!\* *\.\....*\.W* . #
#..* \*\. * .* .  \ \ .. .\*.\ ..  . **  ** ...*.\ .*\.   ..\.*. .... *..*..* .*.  \... .* .. * *.....**.* ..\ *. *\    . ***.* \..\..**\.#
#* * \  * *   .**.... ....*.*..\.\ . .\..**   .\.\. . ..*\ \ *\..   ..*..* .  *..\ .* *\** *. * . \*.*... .  . * *. .  \*\..\\... \.\.**.\#
# .\.. *.* ..  \.* .**    *. \ . .*. ! \. *\* \  *   .\... *. \*.\. ...\.. ** \. @  .*...* . .. ...\ * *\..*\*.**...  ...*.\.\ .  .!*\**..#
#!*. . . .. .    . !\* ..*.\ \.\ ..*. *. .\  ..\  . .*\!* *.*..* *.\   . .*. .** *   . *.... \* . *!..*\** ..* ..  *\.  \*.* .*. .. .*\* *#
#*.*.\* . . *.. *\ . .\  ..* *  **.\ ..\ ... *.* *.\ \ .. **\  . ..\... * .. \*.\\...... * ** . *.*.*\. .   ...   ..*  . *..\*\.* ..*\.\ .#
#..@*.* * * .  ..\@\.* *.\ .*.. *. @\ \. .  \.*..*.* .\..\ \.*.   .*.*.\. .\....*.*\*\\ *.*.. \*\ ..   **\ .*..*\..* *..\* .*..\.. \****.\#
#\.. \.\. . * * .\.*\* . . ...  ..\*  *. **\ .** @.. *  *. . *. *  .*. .\* *.. *\.\ .  .*..\  .* *\ ... .  .\. .. *.\  . .. \.\..* ..\ *\.#
#. *\. * ...\.* ... *.. *W . \.\ **\*.\  *.. .*. .** \ ..*\ \\ .\ .*.  . ***  . * W\.*  .*   ....*.  *.* *\..  ** ...\*   **.  . * * ***  #
#* .*.*..**...\ \  \\ .\.\\ . *. .... .*\\ ....*  ..  .     *. .   *\\ *  . *.\.. ..*.\ @* \.\   .\  W . .*\*\ **\ \  *\ .\.* .  \..** ...#
#\. * ***..\...*.  **.   . .  ** ** *  .. ..\..*   ***  . .*\ \ \ *.\**.*.   ** \. ... ..*...* \. ..\*\..*... ..\.*. *\...*.*    . \.*  *.#
#. ...**.\*. * .\*.*.  . .*\*.. \*. * .  \.\...*.**\ *\  ***.  *  * ......... .**\ . .*..*.\ .... *. *\.*** ..!* \.  .  .\*. *.\.   ..* * #
#......*..!*\. *  ..*    ***.... *\.!**  . *.. . .. .. .*..!.\ .\\   !*\.*.* .\.**.\ .*.**\ * **  .*\.*\*\*.   .. ..**.   *. \ ***\\  . . #
#. *. .**\ *... W . *\. . .*.\.**. *..*    .. .*. *. .* ..*. \    . * ..******.***.\ .\.\.*** .* .*** ..  * *.\. ...*.\**.* \. \.. ..* .. #
#\*..\ .*... *...*..@.\*\... ...*.*...*..W\*. *.     .*\*\....* \  **.  .***\...*.*.\\.. .. . *.****. ...*.     . *.*\ *\ . .. * .. \*\*. #
#  *.  *. \**!\* @. .\ **. \ .**...   .  **.\** **...*..* *  .. ..* *!\. *. .    .*..* *\@\.* ..**. \   \*. * \..* .....*.**\..\!.. .. \  #
#\.\   .*  @ \*.*..\. *.* ..\*\.*.* *\..*.*\ \.\\*.  ...*.. .  ** ***. .*** \* .* . \..*.*.\.***.\*... *..\**\  **..*.\ \..\. . .**.*.**.\#
#*.*.   .\.. *. .\   ....!* *.  ... \**!.. ... ... ..**.**.   *\**.*..**..**..\ \ *\. \*.\..* .. *. \**.  *..*.*\..**\.*. ...  . .....* *.#
#*  .    !  ...\ *.\. *...\ .*\**\** *\..  .\* \.\.. @. .***.*. *  *\ *..*.\.  ..*\    *..\..*  \. .!..* .**.. **  **.\.   *  .   .**\..*.#
# ..***.**\. *\  * .  \! ***  **.... **.\. *    \ ..**. ..*.** *. .\* *\. . . *\*** .. *.\.. . \.* \**\*\...*\... ...  !\*.\**..\  .\\ . \#
#*..*.. *..\ .  *   \\. ...* \.    . .*\.\ \.\   * .\..  .\.*\... \ * \.*\*.* ..W. * .. ..**. ...*\.*...*.*\\*\.*.\...  ....*\.  .  *.* .\#
#.*..*\ ..\.  .* \ \. .\*   \.* 7\*\  .***..*.....!\*..  *.\. .**  .. .*. .****\  \* *  *. *  . *  ..  ***..*.*.*.**\.. *.*\. . ..  \ . \.#
#. . \.. *\@*....  . * ..\ .\*\.\ ..\.\ * .... .... .... \ *. ..\...* ..*..\* .*. ..*\\..\ .\* ..  .\.*... \ .. .\ .*  *. *.. \...*\ *...\#
#\  .. \   ..3  *....*\ . *.*  *.\*..\. . .\. * \! \.\.\*.*.. \  .* . .\. *.. \* *. *.\ * .*.. .  . ..\**.*. **.  . * *.  ...*... .  .@.  #
#...*.\..*\. **. *\ 2.* .**.\ \ \.* .. \.\ . .. .*    . .. \ *. * .. . .  . .. . * ..\...W*.  \.\.\  *  *....*.  .  .\.* \  .. . .\**\.  .#
#. .. .\*.  . . * .*  ** *.*\@\\ ....  *. .... .*.   .*.**   *\..\.*. .*..\.*.  .\  * . \.* .\.  .***\ *.\.  . .  \.....*..**  *\*. ..\   #
#!   *.!. .\*. \* .\  .  ... ..*  ..**\.. ..    ..  ..*\ . .* .  .* . *..*   * \.*\\\.* ..   *\*...... *.  ..*..     \.*.  *\.... \  .. .*#
#.*.\.\\. *.. *.*\  *   **.\ .\..   **\. ...  *   ..\.! ....\.. .*. * * *@.**\ .\.* .\*..* **\*..\ .* *. *\*\\*\  .. . .*  *.*.*\ .    ...#
#.** .    .*. @\.**.\ ..*.\..*..***\*. ...  .\..  * .  \     .  \*\ *\  *.**..***..\ *...  *..* *@    **.**.!\..  \  .. . \**. .. . .**...#
#....  **. ** .  .***.... .. \  .**.\  .*.. .. *  **. *.* *..*  ..@*.**...*.*  .**... .\  \.. ..\\.\  *.*****. \  *.**..  **.*.* \W.* . *.#
#. \*.**.* ..*  .*\.....\. .*. .  * @*. *\.*..   ..\. . * .  . *.. *\.\A.. .\** .. .**. ...  *\.  .  ..*. ...*..**!*.. . !.* .*\ .  *W .*##
#...**  **. ..\ ...*\  .   *.*\ *\* .*.* @\ .   *. . .*..\.\..**@*** \.* ..* *..\ .....* *.*. . *.**.* ...*. **\**.\.. *.**\  *.. *.**. . #
#. \.\ .* *\ . .. \.*. . * .*.\.**.\ ..**. *.  .\**\.*\*..\ .**.  .\ .\  ..\**\. .  *... * *\*  . *...*. **\ .. \.@@ .\...*.  ..\!\ \.* .\#
#.**** . .\ . ..**.*\.   . \*. *.*.... .  \*...\... \. * \ \ .. **.**..\* . \... ..*\ @.\. \* ...  *** \..\..  \.*\\ ...  .  \ \* . ...   #
# .... @\\..\. * *\. . *.  .*. * ** \. *.*.. . .*  ..*\*   ........*\ \.\*\..**@*....*.* *.**  . * *.\...\* *.\*\.*  *.\*W\  .*\..  . *.* #
#\.\ .\*. . ..*!.* \. .. . ..\.. ..*  **.*\**.  ** .*.**.* ..*\ .*  \ *. .. .!** * ...\.@\ \. .*..**.   . ..*  \ .!*\. **. .*   .*\.. ***\#
#.*\.*. ** \  \. .\. *   *..\*.\.. .\ . ** . .. * *...*.\. ....*. .\**..\\.. *.. . .  ***... ....\.*\  ** *.\ ..*\   ..*.*\..**  ..\*\...*#
#\.**** .. .* .**  .\* . \.**.\*\ .. .  .*  .*\*..\*   \.\*  .*. \ .\.\ \..  **..\. .**..*.. *  *. ..\ *. .**\  ..\*..\..\ . .W*\  .* .\ .#
#  *..*.    ** *\. .*.\**.\\.. . * ..*\*. \  .\. **.\  .\.. .*. .  \.*\* .  .\. ** . ..\ .\\ ..\* ....*1. * .**. \.. *   .. \*\.* .*\..   #
#@\*. .*.\..**..**.\*\.\..* ..**\.*.\.*.. ..*\ . .\* ...**\ \. \  * *. \. . .  .**  *.* .**\*.* ..*..\..  @\.\ *....\****..*....*.*.\..\\*#
#..\ ..* .\ *.*** **.* . \*\..\*... .*. * \ . ..  *.* \ . .    ... *\  *    * .\ .\  .*   .!.\*.  **\*\ .*.* . \...  *..*. *.\*.\ ...  .*##
#\. **.*.. ** . * ..*\   .**. ..* *  *\**. .  . \**.**.@   . ..  . *  .. . *. . **. . . *..*  .**@ .. **\*  *\.* .*\\.* ..\  *.  .  .. ...#
#.* *...*.. .\ ** .\.*.  \** .! .\*\.\.\.* .\.\.\..\..*. . . ...  .. \.@*.!\ . .\... \ .\. .  *..@ .***.*.\ \ *.. ..*     **    .\.*...**.#
#\*\. * **\.  ..*    \   **\*.\  \*.\.. .  *\ *..* .\..* *** .  .@. ..!.\.\.\ W  .. *..@***. *..*.\.\***. *.\\*\..*\. *\. *. . *  \   *** #
# ...\..\.  ** *. *... * \.\.**\*    *.\ . . \. *.  .*\..\.. \.  *\..\ .*    *..* **.**.\..*..**\.*.*.    \  *\.. ***.**   \ *!. *  \.\*. #
#.   .. *\ \*.  *.** ..\ .*.    .. . ** .* *\. ...\ ** *.. *\*   .* . .*. .**.\ * .  .*..\.. \*.. .  **. .  *.*.  .*.. . * . *\. . ..*.\#.#
#*.  *  .* ... \**. \** *..\  \***\.*******. \.\.*  .* \ ..W.*..***. . ..*.\.*W.*.    .  ***.*.**.*   \.. ..*.**.* ..* . *  ..*    ....##*#
# *\.. * \.!\ \!*.@  .  .\ *  ..*.... \.**** *. ..\.   ..! .\ *\**\ .. *.*.**\* \..\ *.. *.\  .. .    . .** ** *..*.\**. *.**\*. * . . *.##
#*...\ .. *..\ .. ...  .. .. * .F.* .*\......... *  *\*\ .\ .\**.* ..\ \.. *\!.  *.*\*\*.....* * \ ..**\.** . \*.*......@*\..*...  \***.# #
#.*.  ..  .@.*\*. \*.*.......*\. ..\.*. ....* .*..\** *\.   \ .*. **.\    .\ \* *. ....**\**@. ..\.. *...\  **!*.*  ***\.\*\ * .\. ***. # #
#\.* .. *\...* ..\..\.\.. *  .**  *.*..** \ . *. .*..*\*\****\.*........\.\*  *.*.\* *..\.*...*.** ..*.......*.**... *.* **... . \ . *.#  #
#  ... ** .\ .. . *.  ***\!@ **.  .\\* !*\*\.\..  \.. *\.*\...\.*...*.    *.* .\.\ .. \ *** \.\...* .**..\. * \. \ ....\\.\@ *\...   . #  #
#*!\. ..*\ . . *\..\ \*\..**  . \ * .. .***.\ ...*...  *.*....*.\   .  .....*.* \..   . ...\ !\ . .  \. \.* . .* \  ..\*.\ . ..\* .**\##  #
#*.**...*..**\*** *... ..*....* . *... .*\.. ..   \. . ..* .* ...\ *\.* .  .\\.*\ \... * *...**\ \..\.*  *@*.  .*. .. .. **. .@ **\.....# #
#..\.  W.\ \*. .**.*... ... ..\.. . * ..\..  \.\.* ***. *. .*..*\.*.\.. * .* . ...    .. .\!.*\* .  .*.. *.\..@*..  \\ *... \..*.* *.*.#  #
#.*.. \..@*.\ * *  *\** ...\**.***..****.   *.. *..*.***. *.*.*.  ..\ .* . .\*.  .*..*  *  ! .*....*\. . ...\.... ..  ***. ...    ....#   #
#*\.* W. R\ *..*.*\...  . ..\** \. *.*.*. . \* *.!.**.*..*.*.**..**. \  * *..  * **. *. **. \.\. \.*..    .. @* \ .. ..* .\*.*.**  . \#   #
#.  .   .*....!\.* \*. ***.  .\ . .. .*....\. .. . .* *.  \*...**..  . *. \ \. *...  ..****  * * ..\ *.   .*..*\ W\...*.  *. . .. . \#    #
# * *\.  .\.**\*......\.\*\.*\*.. .\ \ \   !\**** @ *.\ \ .**\....\*\ *..*\  ....\ .. *....\.*.\ .\ *...\ \.\**  \.  *. .. \*...* *\#     #
###########################################################################################################################################

Water 95
Flooding 12
Waterproof 19
Razors 13
Growth 12
Trampoline A targets 7
Trampoline C targets 8
Trampoline B targets 6
Trampoline E targets 3
Trampoline D targets 1
Trampoline G targets 2
Trampoline F targets 8