############################################
#          #\ # #\#. ...**\ **.*..   *...\.#
#          # .##  \..\.*\*. . *. .. *!\ . *#
#     ##   #  #\# *.  .... ...\ .*..\.* . .#
#    #\ # ##.* .\..*\ .\....  *...*. #\\.**#
# #   #.##\ .. .**#.#*\. .. \.@.*  \ ... ..#
##.####**. #\..*.*\.  .\ .\..\*.*  ..\ .  \#
#\.\ * *\...  .... .\ * .**   ...!.  W..\ .#
####** .. \.@.   **.***.\..\ * .\ R.\. .*. #
#   ####** @.\.**.*\*....\.  .**\.@\ ****. #
#   #. *.  ..*...\.. .*.\ ...\..!.\.\..*...#
#   #.L**...#.*.*.\  .*.*.*\* *. * \.* \**.#
#  #.*##..   \*\.*..*  *@\.*.\**.\..*....* #
#   ##  # .\* *.\. **  *.\.\.*\*.* ... *..*#
#        #*.\ . . \..  .    **.. . \. .. ..#
#        #.*.. .*.. . **.*......\W *.. ..*\#
#        # .@\ .* **\. \..\.. .* . ..\ . **#
#       #*...*.!*\*..\ .  . . . \... ** ...#
#       #\.\\.*..*. .\**.  .. .\. *. ..\***#
#       # #..** .**.*....* \**   *.\ .. .* #
#        # #*..\.\ .. .*.*\! .\ .. *   *.*.#
############################################

Water 19
Flooding 0
Waterproof 18
Razors 44
Growth 34
