############
####..\#   #
#\ .#.**## #
#.*  L.. R##
#\**#.\.*# #
#.#. *###  #
#*.. ..#*###
# . *.*\**\#
#* *.\**#.##
#*\.*.\# # #
#.* #*#    #
###  #     #
#  #\#     #
############