########################################################
## ##.#..*.*.*. *\ \ .. .. *\.*   \** **. ..*.*.... \  #
##.* ..#*. . . **  ...  \*** *\...*\...*.. .**.\*   .\ #
#**#. \*.*..\ . \*\  .\\..  \* . ***.. ***.!\ . .  . .4#
##.*..H.\.. .  ....*.  \  .*\.  .\***.  *.\*.*. . \*  .#
# #* .\*.** . G.\ ..*. \* .. .*.* ...*\ *\ **..*.*  \ .#
# #.** \ **\ E..\*\ *. \..\.*..\ \. .. ..  .*.*...* .!*#
# #\.#   *.*  . .. ....*  .*! \. . .\.*. .\ .**...  *\.#
#  # #**.\.. ..3   .\. B.***.\. \ \ .\*..\.. .. **. \..#
#   ##*..\ * \** .\.* \ *.\.  *.\ ...7  . . . ....*\.* #
#    #.* **\...@  .\   .\*.**\..*.R.*\ .*\*  .. * !.***#
#     ### . . L.@*\.. *.. ... *..*  ..\ **    A*.\...\*#
#        #.D. .*.*\ !.  ..\* *.* .*\*. \  ..   F. \\   #
#         #.* \* *.!\. *.***\*\.* 8..\.  * *... @.. \ .#
#        # .. ... .* .*.C ....***\   .  *@.@. *.\. ..\.#
#         ## \  1\* *   .\.**.* .*. *.  \*.*\**..\ \  .#
########################################################

Water 16
Flooding 10
Waterproof 5
Razors 21
Growth 41
Trampoline A targets 8
Trampoline C targets 3
Trampoline B targets 7
Trampoline E targets 4
Trampoline D targets 4
Trampoline G targets 4
Trampoline F targets 1
Trampoline H targets 1