##############################################################################################################################################################################################################################
#         #.\.... * *\.  ....  . .\.\. . . ... \ .  . *.   *\*  *\!\. ...*\.. * !***. **..*\* .*  *. .*. *   * \.*  .* .**.. \....*.. **.* **\*.*. *.*   ... ...*. . **\ *\. \..\.*..  . *!@ *...\\...\\. . .. .  *\  \ .\ . #
#        # #.*. ..\.*   . *.. . * \ ..  *.*.*..\  \..**.*. ..*.* * .. *\*.*.\. * ...*..*  \ *. ..*.. ** *\.. .\*.. \ . .*\***.. .* \ *\\*.\.** *.**. . ..     * *   . .  \.\*. * ..!\ !\\.\**..*. .** *\ ** *\..  *.. .. * *.#
#       #.\  .. **. ..  .......**.   ...\ *  ...\ * \\.* .*\..*.*\....@.. .  .*..\ .*.    .\. **.... *.\*. .  \*.*   . \. @   .  *. *....  *.*  ...*** .. \*\ .*. \  *.*..  \ \.**. ..  ..***..**\ ..*\.  .*..** *.** . * .  #
#       #   .*.*** .* .. *...*.. \..**.   ..\ \.  .....*   **.*   *\\*. ..\  .*  .*  .\\.* .*!. *. ...\*\ .\\ .* **. * ..\.\*.*.*. *.\****\ .* *.* *!   .**. . ..*..\. .*  *.**.*.. ....\\ \.....* . @@  . .\...  *..** \   .#
#        #..*.\*\*.*\.. *.*\.... *.* .**\.    !*.*\*. \.. .**\.\ ...\.*. .W *.\*.....**  \ .**  .*.\****.   .**\\**. \. ..\**...*. * *..\.. .*\  . . .  **.  . .\..\  .**. .\. \*. .*  *  ..*.. . \. .* *\ *. .* .  ... .. *.#
#       ##\ .*.\..\.*\*\.*.***.* ..*\... **.**W .* ...... @.*\ .*  \. *. ..*.. ..*.*.*.\ *@.*. *..* .***. .  ..\   *\.*.\.*...**..**\.*  ..\ . *\*. ...**.... ..* .**.....!. .\ .\** * *.*\ .\.@.\. *\**\**\ .. \\..\.\.  .. #
#      #. .#*\*\ **. *.. . ...    . .   \.....\* \ .* .. .\\... .*    *.\ *.. .. .**..*.**.\..\*..*   .. *\..*..*\ ....* *    *.  *.... *.   @.*...**\**. \    \\! .    \ *   *\*... . .!\.. . .!** .\* *..**.\ .**. \ \..*.*#
#       ##\ \. * \*.\.***.\**.\*..* * .  \ ..* **.* * ..\ ..  **   ...* . .*. \*\  @...*.*\. \  . ** .\*  *\ \*\.*  .***.*.  \.*.***.\*  ... .\***..*.\  .*...\...*. . *!\ ***. ****. ***.. .* \.. *\*\ *\... *\. **.!* *.\.\#
#        #*..\ ***    .*.*\. \**. . ..\. ...*\...   .  \.\.\ ..*\.*.\...***\ .*.  .\.**\ .. *  .\**. **   \   ....\\*..* *\  \ **....**.\..   \..\* *..*. . \* ..\ ..  \ *..**. ..*...*\* . .**.\ *. **.\.. .\*  .*..\.\*. ..#
#         #*#.\@.  * **...  **. .\. .\ ***..* ..\.   \*.\*\ ** .  .* .  . *   ..*\!*\.\.*\\ .@.. *...*.\**..\* ..\ .*  **.**\!\.*.* \ . .   .   .** ..*\ . \ ..\ .@ . ... .**\\.. !* *.** \ \.* \..** \ .. \*.... ..\.\*\* **#
#        ##*#*..\.\.* !\.  .. *  .\@.  ..*.* \***  .\.\. .. .. \. ..*     .**.....*..** \.* .. *\. ..\ *. * **. . *.. ...*\\ .  *\.\.**..* .*\. \..*****.**..   .*.. \   .*W*.*..\.* .***...*.* .*.*.*.\   .@\\   . .  .*** .#
#       #.#..*  *\. * *..\*  *.*. .W**  ..\ *.\..*.   *.  * \\ .*  ... *.    .\*. .***\ * . * . ..**\*. ..\*\ .* * .\... .\*.\..*  ...*. ***. . .*.\..\..@**..\ .***. .**\. \**..* \. .. \ @..*  ***\.**..*\.*....*.*\.*...  #
#       #.\... \\  .. . ... .*.*.\ **.*  .  * **..  .     ***.. .* \ .\... **\..  *.*. .*\\.. .\.  ****.....  \.. * \....*..\ .*...  .\**.*.. ***\  *\**\*.*..  *@....... * ...\.*. .. .. **. . *.*.. .. .\*.*   .*.   . !   #
#        ###*\ . ..** *...*.. ..\** ..*..\ !\ * ..*...*    .*  \.\.  .* \...*.*\ *\ . *..*! @\*.  ..*.\ . * ..* . .  .****.  \ .. ..  .*.*... **.*  . .. ***.* \.... \ ** .\* ** *\.\  \ .\*.!*.**..\.**.*.**.**. ...    \ . #
#       # .**#.* *.*. .\  .* . ..\!...*. * ** * !... *.\**.*\. .  . . ..* . ...\ *  .\. .\**...*\* .\\  .** . .* * .\. .* . *.. \..*.*..* . . ..** . * * !\. . ..*.\.. .\ ..\ *\!\.*@ . \*.*!\.*.**** ** . .\.**  *. **  ... #
#       L. .# #... * \\* \*..*. *.  .. . .*\.\.*. .*   .W. .  **..\   .*. \.*.  **.. @*\**.**.\.*.*..\    \...!.\* \..  * *. .\*.\*.\ *... !.  . . .\ .. . \ \..*.   .\ . . ....  .** ......*.\*  \.\ .\.  .  .. .\ ..*.\*.\*#
#        #.*.*..*.. *. *!...*\ *..*.**...*.   *.*..*. \\* .\* *.\*    **..   * ..** .\ *..*.. ..*...\..\* *.\... *... .\.\...\*. !\*\*\.\.  **... * .  **.*     .     . *. \  .\ *...      ... *..  \  .*.\.  .****.  \ ***..#
#        #\.*.... *.\*...*. .*.. **\  .\ .\* ..* \.....\.*\  ..\..  .*..*.. ..\ .* *.*.. @.  .  .\...* *.\. . . ..*.\.*.  * *   \..*.\.**  .*.\.*\. @\.*...   *  * **.  *..  .   \ .\..*   *\ ..*  \. . . . . ..*... .. .\.. #
#        #.\*.\..\*.. *. .* ..* *\*.   ** .***.* .\    * .. ..* * .* . .\ \. ..\*.. .. \ \.  ***..  .\.* *\. *.. ....*.  .  .* **. ..  .*...*..\.*\ *.* ** *\..\..*!\..\*\.*   \*   .   ..\.. \.!.\...  *\.*.\ ..*.  *. .* . #
#       ####\. *\W**  **. ..\  *.*......*  .*. \.*    .. . .  *.*.\. .   ..*. .*.*. * ** . \\.\.   ..*\.*.*** *  *.... .* .  .\*\ .. ...*** .... .  \*\ ..\.*. . *.. *\ .*\* * .. *\ . *\  .     \  ..*\W\ *\..*...**.\  *  \#
#      #\*. .. ..*..\..*  \*  \* *** \...\..**   . . . *.*.   *\ \ **\*!. .**\ .\.. . * *.\..\*  .\!  *.\. *\ ..** *\*. *\\.\ .  \  *\* . .*.***\ **\.  *** ...\  * .. ...**.... ..  * ...   ..\*     .* .*. .\. .*.*\   . !.#
#      #.##\**.....* . ** .*  .*  ..\.  \  .  .*  .**. . *. *.\** .**.\.*.*.\.\.   . . .*  . .. .\**. \. .  . .**\  *.... \. . .*.. .\** **  ... .\.  .*. * *   ...** . . \.\  .**\ .  \**.**.! .* *.\ . .. .\.\. \.... ***..#
#       #\## ... ..... .  .\* *.  **.** .*...@ .   ****..W.*... . ...** .*.. .* .. \  .**   *    .\.\ *\ *  *..*... .\\**. .\ **... *.*..**.   *.***\..\ .*..     . .*  . . .\..@\**    .. .  .* .*.! *.   \ . !\*.*.  *\**\*#
#      ##.*.*.*  .\  * * *  ..*  .*  ..  .*. ..* . ....* .. ..   .\ ...\**.* ..  .\*\....*.\ *@  ***  *...*.. .**.**\ ..*. *  .*\*\.**.. ..\ * .\\*. \.\*\\.! *.*  . .* .. *\.* .*\.*** \@**\ *   .....\ ..\   * .*..* \* * \#
#     #.. *.\ *** ***.\*R\**.     *\. ..\..*. **   ..\    W  ..\*. .  . ...\ .\.*. .*...\\  ..*.\*. *\ . .\. * .**.\.* ..\...*\...\. *...  *\ \*.\..\.\ *..\.\.\*   .\.   \*.*\ ..* *\ . \ .**. *.\.*...   .. \ .***.*. . .\.#
#     #.#*.\.@@@.**.. .*. .*\* ..\. .*.\.... *\.*.*  . * *\*\.  ** . .  .. . *. *..\... . .* *.\.\ ..  * \...\ *.* **.   .*. .**. .    . *.*  ..**\. \.**.   .*\**   ..  *..  . ..\ * ..\*\ .*.*\*.*.\..  .\.*.  **** *...\.*#
#   ### \.\*\.\..   *!\*..\.*.**    ....  .*.\*\ ..*.* .*\.. .. .* . *\..\ *  \ \* .** .\***.    .   *\*.. . !.. **.*.*..\ **..*. .*.  *...*.\*\*\.   .*..* . . ..\ \    *.\.\.\ . \. \* *..*.\* . \. *..* .*.. * ..*..*.....#
#### **..  !*  .\**\.*.. @*\*... * \  .\* .... **.  .\  *.*..* \. .. *.*\*..  . **. . ....*.*  \ *. *. . *\  \ *.. @...\..  .!*. .\.* .. **...** . @\ ... .   \ ..* . \  ** .... \*.  ...*  .*..*. .. *.\ .*. .** **.*. ** .\#
#\ *.#\# .*..**.....\.\ .*. \ .     . \**\ . *W.\. \ *** @\. .**..*..* . *. \*.*\   \ @..*  . *.W.\*...\\*.\..\.\.\*\*\ *.* * **\ ... . *\..  *.   .  . .   . . * .** . @\..   \* .  \.\* \ ..**... *.**.  *@* ..**...*.@.  .#
#####\*#. .*...\ ..@*    .*  *.\.\.  **.*. \....*  **...*.\. .\\. .\!.* ..** \*\. .. ..\.\  .*.* *..* .... .**     \  **...*...\. **\. *.. .  . . *   .. .\..\ ..*... . .. ..*\..\  ..\.@ .. *... \*.  * ...\.. .\.* *.*.* . #
#   #.#\#\ . ......\. ..\ ..*.\*. \ \..\...   .\.\.*\*  .*.*.*  .  .\. \  *\..*.*\*.**\ \*..* \ *. . .**.. * \ ..*......   ..* .\.@..* ...* \@.   \ * . \ ..  . ** ..\ .*. .  .*\ *\. .\..!  **\ ...*W ..*.. .\.. .. . .* \  #
#    ##* *\* *.\.*.\.\..*.* * .. .   \ * *.*.\*.\....\*. .*. * *\ .  . .... *.. ..*\*.* .*.. *. . . W .* \. \ .. ***.. * * .**\.. *... .* .**...  \ \. ..* \..**.*\*.   .\\.\*\...\*. \.\. \  .** \.*\  .*.  *  .*\..*.\.\..\#
#  ###*. ..\ . .\..*  **\ * ..\..\@... ..*!*\* \ **\..*\ .. ..*\ **.**  ** *\ .* ...* * *. .**..\ ** **@  ...\.*!.\..**. . *W.* ..*. \..***.*\....\*.. . . \*\. \..\*..\. \* ..  \* *.  ..*...\*** .*..  . .\*!*.*.\.. .\ **.#
# #*\.*  .. . .\.. .  .. \...* . *..\.. *.!*.. .*\.* \  \.*\ *.. .**.. .\.*\. \** * . . .  ..\.**..*  ..  . .. \..   **. **.\..**.. \ *\*.**\ **\ .*   \** *   \*\ ..*.   .. *.\.  .. .* .*\\. \*\.**  .\  *...* .*.*.. . *.*#
#  ####..*  . . ..* .**. ..\*..  .*.. ..\  \**. .*.**.*.  .* *. . *** .\**** ....\.\ * . .*. !.** \   \   *\ \. .  .\.*.  .  . . .  .\ .*...**\.*\   *\.*. . * *.*..*.  *\.. @*  .. ..\*.  *. .. **.*\.\   \.*\. *. ...*...*\#
#   #@. ** *\.**.... ...* . .\.  . . .**.* .***.*  ..*    .*..*****\..\.*...   . .*. .   .\    .\* !.\.*.\.\ . . . .\.\. .  ***.*.  *...**. \. ...  ..**.*\ \* ...**. ..*  .*. .     .*\.\*.**!*@. \.  ..\. *.\*. *   \.*\  \#
#   #.#** .#  \..\ **  * @*.***.**\\ * .*.  ...*... .\..*\ .*\\ .*.  * ..W* \..\ \\ \..*\*. ***\***.*... * *  . *..**\..\.  \*\* .**\ ! .*\\*  *\**.* .. . \ **\ *@  .*\@\ \.. .\.* !\\ * .\*......    *\*..** . *.\ * .*.. .#
#   ###.\ .  @\ \.*..*  .*   \* ..  \.\ .*  *\*.. . ... . . ..\  .*\..   . .***.*..    ... .\....@* ***..\ *   ..*.*.. * ****...\.\. .  **.\.... ....  ..*.A *..**.* .. \*....    .*..\. \.*** *\ .*\  **...\ *.* *...\.... *#
#  #.\#..* \#. \ *   . * *\.\ . *. .. ** *\ \** . * \.\.. .  .*\  **..*\****...*\.**.*.*    .* *  .\.**.*...  .\.\.*\. **.**. .\  . *\. . \*  .\ .\\ .\ *\ .**.\ . .  \..*.....* ...\.  \   *\.\ ...\*. .  \.. \. ** .*  \  .#
#   #.!#\.\*** . . * .\..* \ .  .*!*.  * *. . . ..*.....    *.\ . *.  .  ..\. ..  .*..*..*...* *!.**\.*\.* !....\  . **  .**.* *\ \ \*.... ..**... \ . *.*.*.. *    .*..**\ *\\\..\ .  \.* ... .\.**..**....  .* . *..*.*.* *#
#  #.  #*#*.*. \  .  * *\*..*** \. .\ .\ .\ **...** !** *  ***.*.**.*. . ***   *\*** .*\ .\*....*\*.* ... . ** **\ *\*\  .*..... .\.*..\**....\.  \  . .*.\  **\ * \****.. *.*.* ...*.*.\. .. *  .\\.\ . * W*.\  ...\ \ ...**#
#   ##\....*\.*.  . ..\.* *\***\. .... * .. ... .*.*. * *  .*...  ..*. \ ..  .......\.. .  ..*.... .* . *@... .... . ..  .*\.\.  ...* \. .*\*! .**. .  .*.. *.\  .* .\..\... *.. \ *\**. ...\ . .*\*..*..\\.  .  .. . *\\*...#
#  #\* # #\. .**.**.*. .*!..... * * .  \ ** * *..!...*\ .  **.\...*. * ......*.*\ *\*..  \ .\. *  *\..*..\. * .   .***  **\  *. *\ *...*\ .*.*  *..*..*\. .\*\**. ..   *.* *\..* .\ ...\*.*\*\ \***.*@\ *..\.\.. *  ..*. .** #
#   ## * ! .*. .*.* . .\. .\ \* \ .  . .\**\.\***  * \. *. **..\*..   ..\.\... .* \.\\ .  .   *.. ...\*  **..   *\ *.  .\. \ ** *.\.@ \.**\..**.. \.\...  \.. !\*.\*   . . \*\ ****W.* *.*  ** ....*.*. * *..\***..*  *\ .  .#
#    #*# \**.\ .**   ***.\ ...\ *.* . . ... .. . *.*.. .  **..**** .*...!* ..\..*\ *\.**.\. *..6.*    ..  .\.**.* .**..\ *.W.\..*   *.\*.. *\ . . . ..  ** ..  .*.*... . *...****. *.*.. *\..* \ .**\.  .\\.*..*\.   . .  ..\#
#     # #.\...  ..   *.\\*.\..* *\ .**. * ......\. .  .. *..\**.. **  \  *  *.\ ..\*.\ \** ..**.\. *\  \. *.. .\@ .*.\* ..**.  ..  !.\ *..\*...*\*   .*  ..\\.. ...\.\*\.* \.*\.**\..*!.\**.***. \**  .* *  .**.*.*\*  \ .***#
#      # .. . ...\.**.\*\\ .*.@ .*. \. .\* *..\**  *.\ \*. *.*. .**.* ...*\ *** . *. *  ..**.*.*  *.* \. **. *. \ .. .*.  *!\.**.!  .  .*.  *.*... ****\* ..*....** .... \ .\. .... \. .** *\!*..*.\.. \...* .. .**.*\    .**#
#      # .*  \   ..*\* .@.  \ ***. \.* .*.*..\*.* .* **... *.\. *..** @ \ \**.. ...*. ....W*\.*..\ *.*...\. .*    *\   .*..***\..* !\ .*..  .*....\.\*...**.* * \*\**. . .. * .\  \.\*. *.\.*\. .\\ *.\. .\  *\   .\ .*..**. #
#      #*#** *.* #. .*  * \.\  ***.. *\ . *.*..\**. **.*. .*  *.*.\\*... \...*.\* *...\*\. **..  ..\ .*. * *\.  ***. \..*.\**.\ . \...**.*  \.\. \..* *..* *. .*.* .*..    *. \..*..*.  ** .. .   *. . .\ *. **.*. *.**.\**. #
#       # \...*.\. .\. .... .**\\*\*.\.. \.*.*\.\ *.*.*.** \.\  **..@\.   \.\*..*\..\ .** *\**\ . *.. . \. .    .***\!\ .\.  ...W *  .  ..  . @   *... .  ..* .\ *. .. *. \*.\. ..\ . *\.. **.   *.*...  .*. *.**.\.\.\*.@\  #
#       #\#\ # *.\ **.  ..*\ \.\ .* .\ * .  *.  .**..  \..   *** *..*8 .*. .*......*** \*.. .....**. .*..\   ...\..\ \ .. .. .    * \.* \\  .*. .*. ...\.*. ..*...\* ...*  !. ***. *.*..*...** .*   .* .* *\ ....\*.**.... * #
#       #.... .#\#..\.   .  ..\..\.\** W\.*\.... *..* ..*\  \!. ... **....* !   .**.*.\*\.*  .. ..* \**W*..!.*. **..*.\. *.*.  ...\.. \\.\ * . *..*.*.*@..**\** \*... \ . .* .\... . * ..*! ... .  .*.. .*. .\  ..*\...  \ *.#
#    ###*.\.\.*\ .. \ *\ *.\\  *.! .  .\.\. . .*..\.*   * ..*. * **\..\*  .\* *  *\ ! .\\  *\..!*\\*..\*.*\..**..\..**.. ..** .*.**.\ ..  .*  *  .@\*.*.@ *\*.....* ! .\*\...\.  \. \ **..\...**.\  .*\ ** .\*\.*\..\..     *#
#   #. \* .** *.** *!*.. ...*****\*!*\ * . \..\* *!.*.\...*.....**\@. .... .* .\.   *  .*.*\ ..*.. . *\.\.  *. ..*  .*.. .*.*. . ..*.* ..  ..*.  ...\ .*.. ..*\*.\*\*. .\..\..*   .. .*.\ .  .@.*   ..\..\ ....\..\**.  ** *\#
#    # *..# \ . . .***\\.**\*.**\.* \..\* *..* .**. .!  .\.  *... **. .* . ..\ .* .**.\ . \.  *   .  .. ... *.* ..\..  .\ . .. *.  .  .@\ .**. *\*. **\ ...  . .***.\.  .** *. *\*..  .*. .\  . \...\.. \*\  *\  *  . *... .*#
#   #*..!\.#.#.   \... .\.\ . ..*.. .* *..*  . .*...\.* *   *\*\.\.* \..* .\.  *.\ \   *\*.\ *....\ \\ .**\.*... .* \* .*.* .* ..**.\..@* **...\.......**\ **    *.\. *.*.\.**.\\*\. .\..*..\..*\   . .. ..\ ..\.. \ .**  ***#
#   #* .### ##*. .. .  * ...    *..*\.\..*... *.... .*.\.\* *.*\.* \..\**..\. *\* . *.**\** *. ** . **..* **  *.\ .\..\*\*\.\..  *. * *.! \*. \...*.\..\.  .\.\ *.  \  ..* .\. * .. .\.  ** .  . ..  . . *..*.. *.  .  . *...#
#    ###    #*.\.*.\..*\.. *. ...* \ . .\.*.  \\*  ...**... .\.....*\*.*\\*..*..*.. * \ !*.\.*..\*  *\\  \* \.*B.***.\*..* .*.* ..\ \*.\...\.*.*.\...* \*.* . *....\.**\*.*\ . .*. . ... .**...\.*. ..* \\*. * \.*.\.\ **.*. #
##############################################################################################################################################################################################################################

Water 0
Flooding 0
Waterproof 0
Razors 46
Growth 20
Trampoline A targets 8
Trampoline B targets 6