####################################################################################
#                                                         #          #*##   #####  #
#                                                        # #         #*#.###. *\.# #
#                                                        # ######   #.\.\.*###*.*.##
#                                                        #\#.\\ .# ##\#** #\ .#*.*.#
#                                                        #.#.#\..\#....*.  *\ .. *.#
#                                                     ## #* #..*.*.   .* #* #   *.##
#                                                    #..#!.\#*.*...* . *.*.**\.*.\##
#                                       #            # .. *.  ..\ .#**.*..**.*..*. #
#                                     ##.#   # ##    #\...* \** .\   . *.\.* .  .  #
#                                    #*.\#  # #*.#   # * \.\.*.\\.* .**. .  *   . .#
#             #                      #*\..##.\#\  # # .*.*.. .\..\  .** *.#** .  \ #
#           ##.#       ##          # #*.. ##.# #. ##!. . .\.\* \ ....2. \  .. \..  #
#          #*.\.#     #\*##    #  #.##\*...\...#.##*#\.***W.@. \.. *.\ .  ..*\. @ .#
#         #\...*\# ###.#...#  #.##. ##.... .. # *.#.#**.*..\.* . \...*.\ \ \*. ..* #
#          #\\*.#\#\..*. #**# #\.#*..*..@\  *..** \ #\* * .***\  . .* .*.\* .\\ . .#
#    ##  ###.. #**  *#L. ..# #* #  * *\ .#.* .***\.*.\. *****.. .\ *\*.*..\*   .\. #
##  #  ##**\..#. .. .\ \.. ## **# .. **.\... \#...* .#* ..* .!\\*...*. .*..* ..\ * #
#.###  *.\*..\ *  !**.*.**\#\ .*  ..\.*\. \**\ *. .*  * **..* . ...*..\..  \ *..**.#
# \*.\*..  \ .*. *\.\#....#\.*\*  . ....*..** *...**..  .*  . .. . .*.  *\\7 *. **!#
####..* **..  \.*..** ..\*.# ..*#\ *#* . **#..*.* \.\  \ **. .*.*\*\ .. \.   ..*!*.#
#.. ..\\** ......W . *. !*.\.* *...\ ..#.*..\*\** ..*\\ \!...\.  ..* **...  . \ *. #
#.*. ..* .. .* .\* ***.  .. *\.\*  . .*\ ..* \..*\.\.*  .\..*\****.  .. . .. \... .#
#.    .*..*.*  \\.. . \.**\ . W .   *.**...**.*\*. *\. .   .*.*\..*\ * .*..\ ***\..#
# . \\*..*...\\...\ . . ***. . *.. *.\.*\**#. ***.\..  .** .. .*\ \.\.. ..\.\.*.  .#
#  * .\.* \\ **..* \. .*\#. \..  ...*.....*  *...\.    ..\   **.*\.*...\... **.*. .#
# *\ . .\ \. *\ *\***.**.. \.\\.\*..*  * * \ .\\***\*!*\W .**\.\\ .\  .\*\* .. .\* #
#\ ... *..** *.*.*\ *..* *...   * *\   . *\.\ ..\*    .**. .*\. .\*..\  ..\  * *.\ #
# .\.*...**\ ***.*  **\.\. .  *@.*\ .*   \ ..\ !.**.** .** *.*\ *.* .  * .** . \*.*#
#\**\* \..*.*W\ ..  .\..  *  \.**\* .*   .  ..*......*. \.... .*.*. .**. .\*.**.. *#
#.*..* . ..*. * *\. ..*. *\  ...\... \* *.    .\.*.*.  .* *\. ..\* \ \ \ .*  \. . .#
# *\ ! *.**.* . ..* .\.*.* ..  \  \. .. . \\*. *\*\ *\ *. ..\  .. ....*   *   . .*.#
#.**.*** ....\*  .. \ ..\*\ . ... * ** . ...  .  ...\ \.*.*. *. ... . .\.... . .@\ #
# ...!.\ * ***\.* ...  .*.*..*   ..... @**.* .*.*..* !***...**.. * \ . .  ..\.\*.*.#
#\. .*...\**.* .\ . .\*  @. \.\ .. ** \.\.*. *\ . .\..*.**. ** *.\..  **...*. **..!#
# *.\..\***...\**.\ * *. .* ...\  .\. ...\\. ***\*.\...**...*.*\. . ...*\.... *..  #
# *.*\  * *. .......\\ ....*  \    .**.\.. ..*..*.. *.... ***.* \. \ *** .. **. . .#
#.\ .****\.*.** .. ..\.\\ .* *.    *..\@.* .@*..*** . ..*.*..  !.*.  *.. *.\.\..* .#
# .. .\.  *\ *\*\..... .*\ . .* *\ .....\. . ...*..  \ *.**\*.*.*...**. \\**\ . . .#
#  .  . .\.. * .* \  ....!\*. !\! .\ . * ...* .*..    .*. ..**. .  ..\. ...\.! ..*.#
#\ *  . .*\  . \.\.*. * *..*.\\*\...\...  .***..**. .\ @   .*\.   . ...*..      *.\#
#. **.. ..    .. .. * * *!..**  .\   ** . .....*.... *\. \. . .\*\..* .\   *..  ...#
#\.\.*.  . ...    **\ . * ..** *\*W *.. **\..* *..\  .*  ....\  ..* ***  . .*.***..#
#. * .\.  \ *. \  *\**.... .*.\.*\..*. ..*.\   ....   .   ......** ..**  *\* ..\. *#
# *\.\.  \. * *..*. .@. *.*\**   **.**\.\ *  . .\*B*.\*   *\..\.*.  \*..  ** .\ \..#
#..*.*.\..\ ..*\ .. ****\*..\*   .*..* *..  *.* **\. *.. ..* *. *. @*\*. .*.. . .. #
#\ * . .  **!\..*  *\*.**\**  @\.\*\..   .* ..**..*  *.*.\*. ***... .  .\* .! .. * #
#.*.\ . \****** . . *. \. \. ...**...\..*..* **.. * \.\. ..* *..\* *\W \.* *\   .. #
# .*..  **.. *.    .  \.... ..\\ \*\ .. *\ ....*   *   .*.*\ ..\\ ..**\...\..**  \ #
#   \  @..* .**.*\ *.. . \* * *.*....*. \.** *.\** .   .*. .. .*..**..*   *\*.\ *  #
#\.  *\.*\.   **\*\\   ...**..*@\ *. .*...\**\.* .*  *...  ... ****..\**.\.*. ..* \#
# . *.\\***\.*\*...\ ***. **. \.*.* . .. ......\\..* *\*... ..*....***.. *\ *.*.. .#
#\. \**.**.* *..  .  * .*. \. ..\** .*.  .**    . ..**..\.. **.  *.* ** *** !\..\  #
#\. .....*.. . .. \..\ \....  *  .*. .* . ....*.**.**.   .    . **..  * . W .\ . \.#
#. \ **. .*\*...*  .**   ..\\ . * .\.*.\* **. *    *.... *\. . \..* W* . **.*\.  .\#
#..  . .. .*.. .   .\. .*.*.. ...  * *.** *\ **.**.*\ *\*. .   .   ..* .\*. .* . *.#
#  \.\.*\ . .\.**\*.**.*. *\* .\. *. ..\* .* . **\*.*.. *. ** .*\.   . .*.*\ \. **.#
# *...*.@  . ... .*\*....**.* .. ..     . .. ..*\..*.. \.  .   ..\ \**\ ....*.. .\.#
#**.  \....  .\** *.. . .. ...  ...\* ... .. \.\.*..\.\*       \.*. * ..  \  * ..**#
#**W\\. . .  \....\ . ..\..*. \\ *...  \.\.*  \... \. * ..   . .\.*.*\ ! **.\\   .\#
# .. ..* ..\.. . ...** .**\*.\*..* .*. . ***.\ ..\  ...... . * * .*\...*\..* .  .\.#
#* \.. .\*.  ..... .** ...*\... .\ * .. . ...*\ ..\. ** \*   * .*  ..*\*. \ **  * .#
#** ...\ .**\..  **** \* \\... \.  \..***. .\. *\.  \.. .....   *...   . .. .*. .. #
#\.. *..*.\*@***..\* .  .* \ F... ..* ....  . ***** .\  .**\\ ***\    \.\ ** ...\..#
# .\  * *. ...*.\*.. .** . \** \  .*.*\*\*...... .. .. .\*\. . ..... *.*...\.* .  .#
#\  ..\. ..** .**** .....\.*. .\ . . . *@*..\ \ . ..\.. ..**.  .  ...\**..*  .*. .*#
# . \*.   .*.. .* ..  *.  .. \**\. *. .**.!\*.. . \\..*  .*.\. . *.*\.*\.\.  \.***.#
#. . **..*.*\ \*.* .\\...  .\. ..* *.. ..*... \. *. \*.*.. ..* *.\.**....*... .*...#
#\  ..* **...*....*.\ * .**... ... \ \..**  ..* *.* *. .\\ *...!  *.@** *.*\**\.. \#
#.*\*..  .. \...\*. * ......\\ * \..... \**..**   ..\ .\...*\. ..*...**.\.\.\\ .*.\#
# ! * . . \..*   .*\*..  *\**\.. . . \....*. ..\.  *    .**..* ...*.*.  **.*    * .#
# \ .  ..*......  \ . *. * ..* .*.**.. . *.*..\. \.. ... .. \. @\**\..*  .\. \. .  #
# \. * \ W.\ ..**.**.\.\*** .*.\.  .*  *.\*..**\...  \. * * .  . *..*.*.\\.\   ****#
# . \*.\ .* *.*.. \..\..\.. .*\**  .\.\\.*.\.....  \  *..  *.   \**\..*  . .\ *\**.#
# \ .. .\**\.* \ *.**.    *. ! ...\.****\* **.\ \*...@. \.* . \*..** ** .  .**\...\#
# ..*  .**\ \. .****.\ .\..... .\.*.**..\  .\ *...  ....*\  .\  . ... **\ \.\..  \ #
#...\.**\.. .\.! .\.  \  !\.   \..  *. .*..***.  . * \  .. .\\.* *.. \..*..\ \\  . #
#  ....* *\  .  *  .\.*..   ...**\ .. *\.. \*..  \  *..*\*  ..*\.. . . ..*. *...   #
#\..*\\. *  * ... \ *.. **\ \.*\. * * .*.\..  *  * \.  .*  * *..\ .*\**.   \**\\*. #
#   .* **. ..\ ..\. \..*..   \. * *\* ..  *.*...*\.\ . ....\ .*\ .\.!** * \\!. \ .\#
#\ *..\! *\ .....\  \* .  \\*.*  ..   .  *. * *@.  .**\** *** .  **\...\. . .* ... #
# ....*  ..*   ..  .... . . .    ...\. \*\.\  .. .!*\* .. **..  .*..\ .*\... *\ ***#
#\!*   . *.*.** *\   .* * . \ .* .*   . *  ....*. **.*   .*.  .\... *.\* .* W. ....#
#.\. .*....*  **.*\   *.\..\ ..*\ \ .\  .*  .\***.*.*.*. *.  .\....\.. .  .\ ** * *#
#\ .\*..\  .\ .\ *.\ \. .    *.\.  .\ . *  .  **. *.*..\*\  ..*.. \*. *.*.*  .. \*\#
#*. .\  .\.\. .* .* ..\  \.  ..    ** ...\\. *.**.\ *.* ... *.**.. .\** *.. .**W..!#
#\W.. * * *** .\\*\  .* *.* .    **.  *\.. . . \. \**..... ..*. ..  ***\* \  .... .#
#. \ * \.....* .*\....... *.. * \..* ... \   * . ..*.\*** .\ \....* .\.\. .*.\.  *.#
#.\. .   *\. ***.*.* *\  *.  *  . .*\.**.. .*. \ ..**@ ..  *.    .*..@.*  **. .\   #
#..*   ... \. ....R.\  .\.*..* * . .**..*.**..  .....  . .*.. \*..*..W .\..*.. .*\ #
# **.** . *  .*\.\ ... . ..\***.\* . . .**.  . .*.   .\\   . . *..*   \....\ ***\..#
#.*.. ....* .*  \ \ *\... *....* *. \ *..*.*. . .\ ..  \* *. .* * *.\.  **\ \.\. **#
#\..*\. .\* *. .\.. \*\ .. *..  *.*\ . .*...   *. **. \*. *     *\.. \.*   * .!*.. #
# * @*\......*  .*.*.***..*.*.\*..!**\ .   * \**.\.. *..    ..*!* ..  \.W..*   .\  #
#  .*. .*..\ ...**.. !..\ \ .. ..\ . ... *\.  *. .\  *.\ *. .\. W.**\ @\*\ *.\  *\*#
#* *!   .@..  *...*\***. *.*\.*..... .\. . \ *.\.* . *\.\.*.*. \ * .\ W.*. **......#
#  * *.\.@*. ..  .\ .. .** *. ... **\* \..  ... .. . . \  *.**.* .\* * .* **\.* \ *#
#. . **. *\    .**... \  ...\.\*\*..*  .  *.. . *...*.\   . .**..* .*.  \ ... .@.*\#
#\.\.*. .*.. .. .* * .. .*\ .. ...*\.. ..*.**.  * ***... .*.*.*. . .* .  . ..\..* .#
#   W... \* *.* .!*.\.*  .  ..\ \ ..**  ....*\. .\*..  ** . ..*\      ** *..\   !.@#
#. .  *.\*\ * ... .\ \@ \  ..\    \\.. \  .* *\ *.....**.      .*.*.. .*.. ...\ *..#
#.. . . .\. .\.\  ..\ .\!...* . \ .@.  . .*\.\. .*@...... *.\.*.. .. .. .*..  .*** #
#   * \. *\.\.  *..* ..  ..\.* ..\.. ...  .*\.. !.*    .  . *\.  .   *.\*... * *.* #
# ... ..*.** . .\. *.\ * .***....*.*** *.\ ..\  .**\.**    **   .. *\ .\..\.@*\. \*#
#* \\ .*\ ..\  *....\ ..*\.    ...\..  *  . .*..\  *!..*..   * *\*..** \.*\**\* *.*#
#...  \* * *.\ . *. ... \.\*   .   * . ....**.   \*. . *.\*   .\ ..  *. ** . .** **#
#\.  .. *.\*** \ \ \...\ .  **..*. .\ .** .*.  \*.\.*..  ..  *. .*..\.** .**.\..\..#
#   *...\.*..\ .\*  *\*.. \* \ **.\  \..** .\\....* .\  . . .\ ... \  .\* \..*...* #
#\*\.*..... *.\.... **  \  \..**. ... \  ** *!.  *\.  *\ \* .*..   .*  ..\  .**. .*#
#*.  *.\ * *. ..\ . ...   *...** * \. ..\*. *\ \*.*... \. .. ** *.  \.\  ** * *  . #
#..*.. @ * \.***...*\\ *.\*.*.. .*  . \* ....**  \\*\ *\\**. @ * .*. *. \.*   . .\ #
#\ . . . ..* ...**\ . .\ ....\* *...\..\*\*  .!  .. * .*\*\. . * ... .. ......  \*\#
#..*.\\....*. \ *\**..\ **\.... ..* . * . . . ! * *.@.\**.* . ..\*.\ ..\*.  .....\.#
#\ . *..* ...*.\ *.*\.*\*\ * \C.* .*.*.....*  *.* .**\.\...*.  .  \ .*\** \.**\**.*#
#..\....!. * *.. .*..\.*** ...\*.\ E.** \.!*.*.*.  .. .!.. **\.....*  * .\ \...** .#
#\*..\..**..*.*. \..\ \*. . .\.***\ .. .. \.*. .* * *...   ...   *  \ .* . .. .\*\*#
#**\@*..*.\\* .. .   ...*   * . *.  *\  !...*  ..*\.**** .\. @ ** . . *\ *.**.   @.#
#  .*.....\.*.* \.\  * .*\\.*** *. ** .  .** .****\.*.*\.... . ***\* \. \. .. . . .#
#.\@. \ ..  . .. *.\.\*\.*\* *.*\* .\*.. **...*..\.***  . *.. *.**\..**  .. *  *  .#
# .*... .*\**  \.\* \ . .*\* \**   .*.. ... .   *.  *  .\..*. \ ..*.\.\ . *.* *\.@*#
#*\.  .\ . .. .. ..  . .* ..* .\\ *...\.\.... ..\  \..*  *.. * **..*.. .*..*..*   *#
#* *...@ ..*...* *@\****.. .\.\.*...*\*.*..*        * .\...\.. *\  * *...\  . . ...#
#***. . .*.\ .*. \*. .*     .\*.\** .**.*  . *  * *. *.\*\ .\.\ . *..\* ..**\.*.  *#
#\*. *\*.* .\*. . ***..\@.\.\* . ..*  .   . .* .. *  . ..**\*\ * .\*\*.*.  . .   *.#
# \.\.*.\. **.\*.. *\..*\. .. . .* .  * .\* \.**. **.  *.*  . ... .*\..*...\\  \ .\#
#\. * . . ...\*.\!\ .. *\. * \ ... ...@ \*. .***\*.    \*...  \W...*..** . . ...  .#
# *\.. \* ..    .*..\  ..\. .  W.\.\ ..\..... .  \ ..\ *..\. \.    *.*.. . *\\    *#
#\\..*.... . *.  *  .*  *. .. .    *.*.  .*.  .  .*   . .\.  ..  *. *.\ ***.*. .*.\#
# . \* .**   .* \.*... .*.**.. .\**\**.*... .\.*..** . !\.  ..*.\\.*.\\..\**.*. ..*#
#. . ** \.* ****. ***.*.**.  .. *.*. . ** *. .*. \\.  \ * ** \*  *\ **.*...*.**\.\@#
#*. *.*\.   \.*  *\ . .\.. *!.**...   .\.\*.  .* .  .* .. ..*.*.***. @.\** *\*....*#
#. \* *.*.\  ** *  * .\...... ..  . *.\. ..  . \ *\ .. ***.\  .***\\ *....  *. *. .#
#...* . *\. *.. .  *   *.*  .  .. **.\.\  !.\ . .**..\  *.*@ * ..* . ..\ *  ..*. * #
# \...* ..\. *\*  ***.\*.@ .*..*  .\***.  ..  . ..\. . .*. \ ..*  *  ..**.** !\* . #
#\... . .*..\\*..  *...\.*.* . ..  * *\.*.\ **...  .*..\. ....*.* .*...@ \. \ *\.*\#
#.   .*. .. . .*\\\.\  *\.***\  *. .*\ ** * *  .\*..\ *.* .. * .\  . * .* . .*\ **.#
#\*. ...\ *....\**.  ..* .\..*. .*..* ..\*  *.*... *\****  . ...*  *\.*.*. .  . .* #
#..  ..*\ *** \  . .  ..* .*..  *....* ..... ..  \*....*** *....*  **** . *\ .\ .. #
#\   . *  *  *.\   !*  *** . \* ..*  . . .\\   \*.*.  .**. .....  .\..*  ..*\ \ .  #
#* **\..\.....*. ..*...**.\*    \*.   ..*\.\ *.. .. @*\.\*\ \*.\..  * ***..***.  *.#
#.**.*\ \  .**.\@  .!. .\... *.\. .\*.\..  *.*.**.. ..  *! . ..   *.\ .\**......*. #
#*\... .*....\ ...** *  ..\... . ...\..****...@*..*\* .\***  ..\ . *  . *..*   .. .#
#\* .!* .*\\.   *...\.\. .  **. .\.\ .\.*..\....* *.   ..\..\.\W\ *\*\* .@\..\ **..#
#*.. ** \*  ..\....   .  *  \*  . **\..*.   \* *..\**.. ..  ..*\ .A*.*.*..  *. *  .#
#*.* \  .. .\ .\  *  .   . \...  ... **..*  .. ..... *  **.\. ..* * ** * . \*\.*  *#
#* .   . . \*.. \ ....   .....\\ . * ..*.*   **.\\\ \.\ ..\  \* .*.*.\.\..\. .  \..#
# \ .. *\    \.\ **.. \..*. *..  \.*\ \****. . . .\ .. .*.* **. .**..   ...*\. .. .#
#\. ..\. .\... *..* *. ***** . \..... \.*.\. ***.   *.*    .*\ \ *. .*.*\....**.\ .#
# *\*.  .*** \ .\...@ ....**\\ *..* \ . ...  *..*.* .\.   **\. * *.\ ..\.  .**.. \.#
# \***...*..\..*. .\* *... . .*......**  *. .*.\\ *\.   .  .* *\*@*. *.*  *.. \. .\#
#\. *.*\*.* .\.. .  ... *. .  **\*...*.**..*..* ..\. .   .\ *.\* .**\....**  *.. .*#
#. ..... *. * * .\ *\.*  . *.. ....*.*   *\ .\*....\   ..*.\\. 9\ .  .   .  .\@.. .#
#\  *.\ **.*.\.. * .  *  .\.* .*. *..\* \*.  *..\*.*\..*. **\ *. .* . *\ \  \.** . #
#*.**.*  . .*.*\*@.\ *.**   ** ..* .\.\. ..  .@  *.**  \. .\..\\*.*   ..\.\.. *.   #
#\... *\. .**.. *.. ..\..*...*  *..**.. ***..  **  .\.*. \. .\ *. ..\**..  *\ *.\.*#
#  *  .. * .*.**.. ..*.\ .. !*..\ .*.*\*... ...**.. ... ..*.\.**   \.... \. **.. **#
# .. ..**.***..\*D**.!. *\....  .. . .. . *.  @. .\. *..*\\*. . .**\ *  . \.\.*.**\#
#\.*  \*.. . @*  *.   . . .   ..   *.*.\. * * *.. *\   ..  . \.. ... .*..  .  * ..*#
#* . \*.**\*\.*\...*. . \. *..  *.*\.\ .. ..\.\\. .**  \.\.    . ..\  \*.\.. .\.**\#
#..*  \..* \. ..*. ..*\.*\*** . .*..*   .. *\\***  *\ ....  *\.     *  .. ..\. *..*#
# .. . .*\*.  \ ...*...  *.*\ \ \ .\.  *..\.*.**..  .. ..*\****.*\* *.*  * *.* ..**#
#*\*\\. \.@. .**\. *\.\.***. \ *.* .*.....  ..*.\!..\***.\.*.**.. .\.***.. .... **\#
#.***\.* .. . \*.. \.** .** *. !.\.... \ . .\\*\*.\  .*\* ...  .*.\! ***\    .* ..*#
#\.\.!*\..W*\*.* ... @.\*\.*\ \\ * * **.\*.\.*..@..**\  .\. \ * \ !......*.   .** .#
# **\ ..*. ..* .  \  *! .  *\*   .*..**. ... ..*....... \*. .   .*.*.   \    *...\\#
#.*\* .*\ \* .\ .*. \  *. *....* **\..\.* **  * .  .**\.... \*.. \ .  .**   .@\ *.*#
#*..   * ..*.\.\ ....   * \ \.*..\.*..! \ *  *. .   ..*.\*\ ..  ...*   ...\   .** .#
#. . .    *   ..* .*...*  .\*..\.\*\. .. .\ ..\.\* ** ** **\  **.  . .W *.* *\ \**.#
#  *. ..\ ..*..   ** \ .. ....**.*..  @ ...\ .*.*.\.. * *.\. **\ .\ * .   .\. ..**.#
# ** **. . \.@*.* *...* .*  *. .**  \*.\..  * .  \ \. @... \ @****...  ...!*\.. * .#
# * *..*\..!.** *\*\ *\... .*. .*.\\..* .*  .***.  *\* .\*  .\.**.. *  ** *.*   *\.#
#\\ .*\.! *  .*..... ...*.**** ..**..*..*. \*.*.\.*. *.*.*! \ *. *\**\**.\. .  \.. #
#*.* .  **.  * ... W. .*.**\.\* *..**. .. . . *\*.\    **. \*.*..\*.* \.\    .... *#
#\***.   ..* * *. * \  .****. ....\*\*     . *\*...*.* ..* * ..*\*.  \.... *.  . . #
#  ..\.\*  * . .\ ..... *.*\. .. \. .. .   .. .... .\.*.\*..\  ... .*.     .   ...*#
#..\ ... .\..   *.. ..** .*.. *. *.***...  . *!\..\ ..* .....\*   *\.  *\*  . * *  #
#. ..    . .... .   \ .\  ... . \. ..\.\    ..*.. **\\.\...   *.\* \*\  ** *...**.\#
#* *   .\ * * . \ *..  .    . .\ .\  . ..*.* ...  *.*.*\...*\*.* . .\.* .. .. \*.. #
#\ ...*.. ...\...\.. ..  *\.. ** .\ @** **..\*\.  ***.**\. . . *.* *.*..*.* * \.\* #
#*.* . \  .....* .*..\.**  .* *.  . \*\ ..\... * *...*.* ..\ *  .. \.*... *   .*...#
#*\.. ...*  .**.*\** **.* * **..*  *.\.\*.   \*.\**** *.\. ...**\. * *...\* .*.*\  #
#.   *. \.\   . .*\. \. *.**..  . W.*.*\.\ .**. *\. .....\ .  .\  ..\..!* * *.\*\  #
#**. . ..\  . \  .* *.* *\.\  \*..* * . *. *\..\* ..   . . ..  ***\...\.\ .. ..\ . #
#.*\....  \! *.*.*. \  . ..  .......** .***..\.    ..* . .**!*.*  .*.\...* ..*  \**#
#*.\.*..  .\.\.* . *.\ \ *.***. . . * .***.*\.** \*  *\.. .  .*.. .*\ .**.. \.\....#
#*.....  *\*.* * .... \ .  ..*. . \.** . .. .  ***.\ !. \ \.. .*\.   . .\..  .*\   #
# .*.... ...\**\*\  .*.\ .*  . *.  ..*  * **\*\!**.*...\ .  *\ .. . ..\ . ..*\.  . #
#.  \* \..\* .*.\ *.\.*.   . *...**..*  ...**.*.....* . **. ...\*.*    . **. *\ . *#
# *. . ..* .*..   .*  *.*\. .* .  *\.\ .**\\. ..\   *. *.\..  * *\**..** *.  * . .\#
#!**\ .. ..* *.\.\.. \..\*.* .** **  . *.*..\*. !.\. !*.*** * **.\*.\ . .* *\** \..#
#..\* .\ .\.* ..\.. **.*\.*  *... .  * ...  *.  !..**\* *\......* ** @  *. ....... #
# *. . * *..*... .** *.**.\..\ *. *.\**  . ..   \**.*\*\ . .  *...\* . .      *.* *#
#**\ . .\*.*. .* .\* .*...  *  . .\*..\* . \**.. .*\..* **.......**. . . . \ *  .\.#
#*.* ** \\.\ ..* .*. .\*. ... *    \. *.\**.@\.\**..   *..**\\.\  \..**\ .  ...*...#
#...\* .\..*  *.* .* \*..   * .\*.**.\. W.*.** .\. \. .\ *\..* . ...* **. .  .*.  \#
#   .*  .... ...\ \. \. . . *..  . *..  .*\.*.. *.\.. *. \.*\ *..   .**.*...* .....#
# .  *..  . *.    .*\\\*.*\\* * \ *   *\..  .**.*.\  *.\.  \ \*.   ..*.......\ .  .#
# .  !*\ \  .*.*.\ *..*... . ..\  *..**. \ .\...*...\ *.. ..* * *..\.*  **.\ .. \  #
#..\* **.\.  . *. .\   *..*..*\* ...\*..\.  .\.*. .\  .\..  .\..\*..*..\.\ ..\  \*\#
# \.@\.@\..  .*. ...***\..\ .\ .... *..*.  \.  **\.*. ..\..*\*  ..\  **.\** **\. ..#
#   *.  *.   *.\. \..\*.  *. *...\.* *\ *.* \*** .**.. .*.. ..  * *  ..* .. *. . *.#
#\  .  ..  .*..* ... ..**\*...*.\ *... .\. . ..*.\.**\. . *.*. ..*.* .\*. \W*. **..#
#* **. \  * .!*.  *.. \.\...! *\ . *\.*   .*. . ..\.\.... *\.. \  * \ ** ..**  .. \#
#..\. .*@\*\ *\.  ...\. .. ...*.  \.. .\   .*\*.*.**  . *. * \..\*.. ...*. ..\.    #
#.\* . *.**. * .   *\ \ *   **!*... .*. *\* .*. ..***   *\..* \.*. *\.\ . *  ....\ #
#* .  \.**.    .\ ..\.. *   .*\. *.* \\*!.\ \*    * .  .. *.\.*\.... . . .* .***..*#
#\.*\* .*.  *. * . ... *.***\.W.\. ** ..  .*\  .*.**\    ...   . **. 4* ..*.\.\***.#
#*\*.*..\*...\..\..  *. ...  * \**.!*\ *\*\.*.    ......*\*. W..  .\**..  * . .**. #
#. .*... *  *.*..\* *..  . **  .@* *..***  \  .!* *..   *\\. . .**. ..\.  * \ ** ..#
#.* . \ *.\ .*.   . *..\\  *!\.*.*   ... .**  *..  .  .*.*\*    \.*. \ * .** ...*.\#
#..  ..\*\...*. * .*** *.\**....\.  *\**  .*. ..*.** .  .. .*** . *\@*...   *** **.#
#.* ..**.  * .....***\*\*.. . .* ..*. **.  .\.\ .*\.\**\.....\.   .\\* . \ * .* *..#
# .\ .* \...\*   \*** .** ..*  * **...@ *. . \*   * ..  .. \  **. *  .*. ..*.\ !...#
#  ! *  .\!.** .* \ \  .\.  **..* .\  .\.\..\.\.*\! \*.  **\ ...\ .* .   * ... .\\ #
#\ \.... *. ***.* .\ .\.. ....***. *\ *..* . *....\. \..   *\\*..  .   .....*  .**.#
#**.\.\. .\*. .*\.. . .  .*\.***.  \ .  ..\ ..* .   *... . .**. ..\  .\ .\  .*.*\. #
#..\\ *.. *.\\**..***\\...**  \* ..  ..*..* *   *   .*  \. *.*..\.! \.*..**\*. ..  #
#  .  *.  ..\  *.\. \.    .**.***  \..  .\\.** *  *. *. .. @.*\. *...**..* *.\..* \#
#\ .\ !  \...\ .* \ * .\ .\.\ ..\...* .\*...* \** * ..\ ..@* ..\ \. \**\** .\* *.  #
# . . * ..* . .  \.* *   *..\. \.. ...*.*  *. .... ***    *\\   \.  ..*\*  . .\. ..#
#.**\ . *\. *  ... ..*. ..*.....*    *. \**\\ .**. ...\\.**...     . \..* .**  * \.#
# .. . .*.\.* * *..****\\** .*.*.\\.*.\ ... *  .*\.\. *.. \ ...   .*. . ** .\*.. *.#
# .   .*\  *   *\**.*.*.*...*. .  \*.**.*\ *.**\... ... ...  .* \. * \.  .*..*.\...#
#\  .*     *  .. .  . .*. \..*\*\  ...\ ....\*. .  \\.  *.\  ..***\**.\ .***... .  #
#*\*..*.* *. *.\   . .\.  . .....\.  \ .*  ..***. **.  ......\ ..\.\  .. ..\\\ . *.#
#*\*....**.\ \..   ..\.. *.**\.\ \  . *\* .\**\*. \*...\* \\. \***\**. . ..\.... .\#
#.*. .  ..\* .** *.. *. \  *.* .\.*...!*.  .. * . *.\\ \*.*. * \*..**  .*  ** *\   #
#.. .\. *. \.*...\   \  ..\*\.. *** \  .  .**.. .*\ .*...*.\.* .\****.* .\ .\.**...#
#.* \  *.\.  ..\..*@   .. *...*.**..  .    .... .. **. .*.    .. .  . .***\ *.\.!.\#
# !\ **. .  \**!*.. .\   .*...** .. ..  \* . . .\* .***.. .* \*  *..  ..*.** . *...#
#.*  *. . .. .*.*\.\..  *\.*. .** *.*  *.\. ** . .* ..    *. ..\**  *** *.*    .\. #
#*\.\.. .. .\ .\...**\ .\.**....* .  .*..* .\.\*  *.*. *.*..  ...\ ..* . *\.*... \.#
#   . \.*.. .  .  ... * .* ** . *\ ..\ \.*  .......\.. . \ . \**\.....* *.  .. .*.*#
#*\  **  .\ .* \.  \..* ..\..\W*.*\. ..\*\\   \  *..\.\ ...*. *  \*. .* .* *. **...#
#..\*.**.\** .  . * * . .. *............\*.\  \* .\*.*.\.*.. \.\ .*.*..*.*...\..* *#
# *.**.. .*..  *..*.\ ..\ ...\ !.*\..**\*\ .*. **  * * * . \*.* *\.*..*...*. **\..*#
#\.... *. .**.** *.     .*..\.\*..** .. .. **. ..*.\ .**.W . \...* ..\.*. *@\..**.\#
#** .**. .***.*. \*. \ .\*\*  * .\.*..\!.**\.*.\*.\\ .   *\   *\ . ....* .   *\*\ .#
####################################################################################

Water 172
Flooding 10
Waterproof 19
Razors 16
Growth 47
Trampoline A targets 7
Trampoline C targets 9
Trampoline B targets 4
Trampoline E targets 4
Trampoline D targets 2
Trampoline F targets 9