##################################################
#. .**.. *.    \ *. .\*.*. .*.. * . . * ..## #   #
#\ **\ .*. **  .\. ***...   .\\ . ***.**..\*#.#  #
#*.\*  .*.* **.\  ***\. *\**..\  **..\** **##\#  #
#. * .. . ..**.  .**.*.\.*.\**  **     . .#..*#  #
#.*.*.   ***.. .*  .*.**..... *.\* . * \* *. .#  #
#.*.\*. .  *.. ..\. *\.*.\ *..  *...*..*.*\*  .# #
# **... .**..\ . *\..  .*\.**. *..* ..*.R.\.##\L #
#@.*.\.\*.* ***..**.\\.*.. . .\.\*. *..** .\.\ ###
#*\.....* \ ... .\.\ .\\.. .****..* ..*!*###*#   #
##################################################

Water 2
Flooding 5
Waterproof 9
Razors 14
Growth 39
