##########
##\\##   #
# **#.## #
###*.. .L#
#  # \\.##
# #*\.* .#
#  #*#\R##
##########