#################
#.*..  .\..\.  ##
#..  ...*.  .* ##
# .***.****.\*# #
# . . \..*.L#.# #
#* . .!. *#######
#\ .  \*. \.*. *#
#* \.....  .*  ##
#  **!\ ...\#R# #
#################

Water 1
Flooding 3
Waterproof 0
Razors 9
Growth 29
