#############################
#      #.\*\.. . .*..\!.\#..#
#      #.#\#\. *. **  ..G#* #
#     #\ *.* *    .*..*.*  *#
#     # #*.*\*.  . \ .\**..!#
#######*###  \\ .\* ...*\.**#
#* .@.###*\. *.   .*** ***.\#
##*.*8#\#\  \#* .**.. .. .A #
# #*#\. \.\..\. \ !.*.* . .\#
#  ###\ .#.**.  .  . *..... #
#  #\* *.*\ #  \\ .*\. *\   #
#  #.**\**.5*   **\D. *.1* .#
#   # ...*. .E *.*...\..\. \#
#   # #..F \ **@*. .. * .. .#
#  #\  \ .. .*.*..*.* *\   \#
#  #..\*   . *\.* * .* .*\.\#
#  #. ..\ \ .\W. *. *.. \.. #
# ##*\*\ *..\..\ ..*. .  ..*#
##.##.##\... *.  \.**  .\ \*#
##..****.*#*...  .\.* ..*. .#
# ##\ ** . *.\ . .... .* *.\#
# #.*9#. **\..\R * . .\.@...#
# #. *.\. **   !\\*..*** . .#
#  ##*..# ** * *.\*\  ..  . #
#    ##\.* .\. .. ...\.  .\ #
#     ##*... .. \C \ ... .. #
#    #. .\**..   ..*.B..\ \ #
#     ##*. *.# *\ .. *...\*.#
#      #**#*#..\*.\. .*.!. *#
#       ## ##  6    .*** \.*#
#           #\*W#.*. . \  . #
#            #*   .\\* .\   #
#            #. *..#... .. *#
#            #\ ##L.!  #* **#
#             ##. *..\ \.  \#
#############################

Water 25
Flooding 3
Waterproof 9
Razors 15
Growth 31
Trampoline A targets 1
Trampoline C targets 6
Trampoline B targets 8
Trampoline E targets 9
Trampoline D targets 6
Trampoline G targets 5
Trampoline F targets 1