####################
##*#  #     #      #
#*..## ### # #     #
#*#.\\.. .##.##    #
### * .. * . * #   #
#  *.**\#..* \#    #
#\ ..*..** .####   #
#\ *...  ...* * #  #
#*.*. * \  *.    ###
#**  .\\# ..... ...#
#\.\.*.\R *  *..**##
#....\.#. *...  . *#
#   ..*\ .\....*\*##
#. . .\.*..  . ..*##
# ...  .\ *  *.\...#
#. .* . * * *\.. *.#
#\  ... *.* \. *\*##
#  .* .*...\.. * *L#
#*...\ . *  *.\  .*#
#.**  **\. \*..\ ..#
#...\.**....   . .*#
#\.\ *.** *. ... .*#
#...*\\.*.\* \ ..**#
#  .*..*.  \ .\  *.#
#\...*\. \ .*\ .**.#
# \ \.. \*\.#**..\##
####################