###############################################
#**.** \ ..*..\  \*  . *\ *.\ *.   .. ..* *. .#
#.** **.   \ ..\*...*.*\.*\ . ** ** . . . .*. #
#*..**\*! *.   . \* ... *..\.*..*..*. \ *.\**\#
#** .\.. .*\ *** .*\ *. . .* ..* *.*   *..\..*#
#*.  .*\...*...* \* .\   \**..   *..*\ . .**. #
#\.** \.* ... ..*..\**.\ ...\. *. ***..* .. * #
#. . .. ..*.\ *\....* *\  ..*\... .** . . \. *#
#...@*\ . .** .*.\.***.*. .... . **....\ . *..#
#.\..\...*\..    .\\.*.. *    \   .**@  \\..\ #
#\....  .\. *  \  **\.*. .\.*! .\***..\   ***!#
#\.\.* *\. .  ..   .* .*\  .   .**.. \* * ...*#
#  .*\.... ..  ..   . ..\ * \*. \*\ \\**.@.\ .#
#.*. ..*  ... *... \**  ! .\.*...*  . \  .***.#
#\...*\**   * \.*.\*.\.\.\*\* * .....\**\.* .*#
#  \..\....*\*....*.\ .. .\  *.*  ...**. .. *.#
# *. \.* \ ...*\.\..  *\*  .\* .\..\\\*..*@ .*#
#..*. *.*..  *  !.** *!.. . . *!. \.\**.**@.*.#
#\ *.  .... .\ \* ***.*..     . .*  *.\ ..... #
#. ..\  *\ *.. .* *.\ .  .\. . *...\. . * ..  #
#  \ *.* .\*\  .. *\.*\ .\.** \. .*..  .\  \..#
#. . .\..  .. . .**. . . \.........  ..\** ..\#
#\  \  \*\....   ...\.* . *\*. .\..\*.\ .** \ #
#.*.*\. .* *.\@.\. ..*..!\*.\* *\...**\  .. ..#
# **\ *  \...\* .. ..\.*  *..*  ..*\ .. * . .*#
# .*..* . .\.*.\\  *.. \...\.\. . .* ..   *\\*#
#*.   \ .\ * ..* . .*. .**** .\ *  \ .. *  ..*#
#.\ .*.\*.* .\\..\*..  \ .*..* ** . \*\\ *.  .#
#.\* .  *. . .  * .*\*..\*. .*..*. ... . * .. #
#.* . \*.  ...\*...* *. @* * .  .. * .** ..*\.#
#.*\@.\..\**.*.\  *\ \ *\*..  .*\*.* ** .*....#
#\. .  \....\. ...*.\.**..\  * **  * *. *. ...#
#  ..  .\. !...*\\* .*.*\. * \  *.\!*.. .*  .\#
#. * \.\.  ..**. *.\. *... ..*\ \..**. * .*   #
#**. ...  .  \*\ ... \* *\***.\.  \.*. .*..**.#
#*.  .... *.*..W \  ..\!\*\*\**\..**. ...  ..*#
# *\.*\..\*.\  .\ .**.  .*\ * * *\.. * **.*..@#
#\.* . ...**.\. *. .@\*  .  .\* ***\.. ...*\\*#
#\.. .. ..**.. ..\ ..*...\ ..*  *.!**.  \ *...#
#. .\\ .*.\ ..\.. *\ .. *..*.*. \.....*.! **..#
#**\ *.*\. .*\* \.\**..*\*\.  **\**.\ ... *. *#
#.\. ...*....\.. *...\ \ ..  *.. ....  . .*  .#
#. *..  *. \ *..\* . .   .\   .* .* \*  \\   .#
#\** .**.*\.* * .*\  .@ \*W ** \  . *........ #
#*\. .*. \.....\.. *. ..\.\ .\  **W*.     ... #
#.*\. *\\. ..\..**...\ ..\. ... .* .* ..\  .  #
#\**\.* ..   .\ !**.\@* \. . .  *. . ..  .   .#
# .*.. \.. *.\  *..*...*.*.**.. *.. \* @**....#
#. .*. .*\ ...\*. ** \.* \*.\ .* *.\.* \ *   .#
#*.. *.*W* *...**\ .\.\.\*.*.   .....*\..W *  #
#.**.. .\ **.. .\ .**.. *.**\.\.. .......    .#
#  @\ \. .* \*  *. *. \*. \ ... \\ *..*!** * *#
#\*.*.** .*  .*\@.*.*\.*. ..\.  *.... . .* .*.#
#\.*...* .... ..\ .*... \.. ...\*  .** \   *.*#
#.**\...\.**.***.***\\*\***.\...*.  *.\.\.** *#
#\.*. * \ \   .\. ** *..\*.   *\*  ..*.\.  *.*#
#  !* .*.\.    ! .*  .*..\.\ .*.\ .*\.*..... .#
# .\*\ **..\.. * ..\ \**\*  **.***.....* \.\*\#
#.**.....*  \..*. .. . !.*..\.\*.  .\ . **.*..#
#.*. *. \* ...*. . .\    * * \ * \.\ \ \..**\\#
# .*\.*\.\*. ** .*. .\*\   \  ... ....\** *\*.#
#  .. *  .*.* . \*  * ..** .*\ .. \  .  .\*\.*#
# \@ *\ @ .*\.. * *.*. ***  \... \   . *..*. *#
#...   \.* **.* \ **. .... ..  \*\**.@.*.*. ..#
#....\ .\...**.. . .\@!\. *.***.\. \.*\... **.#
#*.\.*.\.   \**.. .. .  .\ *. ***..\*..\. * .\#
#.*.\@.    \ *...  * .   .   ... .. \  ...*.  #
#\.*..\**.*... *\**.**..* **  \ .*.\. .\ \.   #
#**.\. **.... ** ..**.\*.... . *.**.\**. ..  *#
#**. *@*.  \*   *.**.\!**.*.* .. @\ *.* .  ** #
#*.. .\.\...* \    \...  .!*.\ *\.*\.\.*\.\*..#
#*.  **....* ...  \..*.*.. * * .!*.. * \. *..\#
#!\.\ *..\ .\*  \.*. .**.*.. .  ...\ . .  ....#
#*.\ ...**** . ..*....   *..  .* *. . \*\ * *\#
#*.*.*...*.    *. . \ ..**.\  \  .   *....**\.#
#* A.  .\ . \.* \. ..*  *\ .*....\** .* * *.**#
#.\*.\ . .  .\.....\ . .* \ .*\. ..\*....\... #
#.*.. * *@*..* .  ....\ **  *..\ *\*@    ..*  #
#* * \. *.**  ..  . .   * . \   .*..*.. \ *.*.#
#\.. .\. \.  \******  \.. .\*\  .\ ...*   ..**#
#.   *..   ..\...  .  . *  **  .* \. .**\*..\.#
#*\ \....  ..    .. .. \.....* \.*.*  .****. *#
# *..  **\.*.\.\*\ *\.\.. .. ....*.. .. .**.* #
#*. ..*.. .... .* .\ ...!. . .\*\. @. .. ...@.#
#.   ..   .. \ *  .* ** .* * ..\ \  ....\.*\..#
#****\.*.* *. \* *\\  . \. ..  **.\...\ \.*** #
#\*..*.*..\ .@ ..\  *..  \ . *. \**.*....***.*#
#.*..\*.**.\*. .\  .! **..  . .*... .*.\  .! .#
#\\**  *.***...  . .....\*\.* *. *.\.\..\  ! .#
#. .. ..**.*.\ *!...\\ *..* .. *..*  * .  *. .#
#.. * * . .*  .*.*\.*.**  . *. \*.. .\.  \\...#
#\.\.\.   . \  !** ** . . *..  .. .\.  . \...*#
#**...  *\ *. .*\....*** *@*. * \.*...* .\*. .#
#.. ..**.  ..*.\.\ .\*.  **. .    *..... . *.\#
#.\\*\..\ . .****... .** \*.  * *.\***\. ! *  #
#  *.***.\.  *..... *. .*   *\ *.  **\*.\ \*\ #
#.*.......\ *. ..  ....\*** ..... \..\* * ....#
#. **   * ..**.\.\.  *\*...\ .**.*.\  . ..****#
# *.    .\ ...* * *. * .@\ ...   .. ** *\ . .*#
# **\ *. *.**.. .**\*   .* ..*. .\* ..* ..* ..#
#*...\..\.. ..*\ .* ..** . .*.\.\.*\.\.\*.. **#
#*\.**  **\   ..\ .\ *.*\.@.**.*  \...*.* .. .#
#*. *.*. . \.    .....*. .. *  *.* *\ ...* .. #
#\\*. **. .     * * \* * .. .*.. \ .*  **..\* #
#.  \...\\..\.\ ..\.*\ . * \ *.*  . .  *  \ *.#
#\ *. \ ..**...*@* *.   .. **\ .****      ....#
#.*\.... . . ...\. .. \  ....*..*..*  *. ..*..#
#..  \  *\.. *\\. . .\...\*.*.*..*.. .* . ***.#
#\.\     .  .** \* .**\. .\....\ *\\. .! *\.\.#
# *. \ * **\.**** *** . ..  .. ..\\ *.  .* \ .#
#. \*.. *...*..\\*..  *\ *.   **. * . *.*. .\ #
#***.*\.. *\ **! .  . .  .\*\ .* ..\ . ..  \ *#
#*..* *.* **.. \  *..  .  ***  . *  *.\ **  ..#
#*.. .  * ..\. .*. .***  .....\  *  *.* \*. .\#
#\.*\. .   *.. ..\ ....    \.... *...\. ..** .#
#**\ ** .. .\..\\ ..  .\.**.* *. .  .\..* *. *#
#\.. *\ ..  .  * !.**\   . ...*\. **.. . .\@\ #
#  \... * ** .  \. ....*   .\.. .\ .   \*\...\#
#...*.... *\*..\....\ . ..   \.. .*****.\.8 ..#
#. ***  .*! .  * **. *  \* \ * **.*..... \ . .#
#  .**...\.\*.**..* . . .*.. . *. .\*   .. . \#
# .\ **  **.*\\****  @*\\\. \ . ..*.*  . *.\*.#
#** *...\. .\ \..** ...*.. *.. \  ..\... \ *.*#
#\. .\\ . . \  \..\  . *.\** * . ..\.\ * ..*\.#
# * . ...\. ....! *. *.*. ..\. .!* *   *\..\! #
#  *.\ ****..\  . * *\*.\     . ** *\*\..*... #
#*\.\. .!..  .\ . .\.. *. .  * .\ ... *  . * .#
#.  *.*.\   @... .\    *.* .*..  .\ \*.\*  . \#
#....* ..!!\* *\ \    \. \.* \*.** \*\.* . ..\#
#......*\ . *.W.\  .   . .*\  *  * ... .*.\   #
#* *\\\*...\**.  .\ .* .  *..*.*\.. * \.* .\*.#
#..*  ..*..\ \.*@\ ...  .R. *.* !. ..\..\.\..\#
#*\. *\*..\. *\.  * *.**.\  \ *\..\*\. ** **..#
#\. .\ *.   * ... \ .*.\ **\..  .. *  *.. .\* #
#* **  *.....*.\ \..\\. .\.    . *..    \*.. .#
#* ..*.\  .\ .***. *.\*.... *\\  .. \\ \.@\ \ #
#*.\ *    .*\**..*..*.*\ *.* ..\ .\ ... .* \..#
# ...\. \* ...\ *    .. . .* **.. *.* ** .. **#
# . *** .*.. \ .!* \*. \....\.. .\ . *.....*.*#
#* \....*. ...\.W.**. \.     .. *. \** .  **  #
#. ..***. . ***. \.*  ..\\\ ..\*.*. .. * ..  .#
#\ *\* ..****\!. ..*@\  . ****...*   \*.   ...#
#  ..  *\. *..*\      *.*..*..@*  ***   .   **#
#  .   * **.. .. \. .  .*\    *. .  \\ .. .\..#
# @*.\.\ * .\*\**   \ ***...\* .* \\... \ \. *#
#..\* . .*\.** \ . *\ \**\*.*.. .*.* * .... ..#
#\...*\.*.** .* ** ... .**  .*\    . .\ *.\. .#
#. . . *.*..   *  *.    .. ..*......\.. .  *  #
#.... \  .** * .*..\ *..*.  ... ..*.. .\@.*.*\#
#.* *... *\ .* *...**\..\ .\* .. \. *.**.***\ #
# ..*.\. \ .\*\*.*.*...  . ..\..\. .**. *. \*.#
#.*\.\.* .* .*..*..*. *   * .*. @ .  .* .. ...#
# . **\*\ *\ !....*\*.*\* .. .. ..  **.. *.* .#
#*....*.*..*. \.. *.. ....* \.. .\ W*... . . .#
#  ** \.*\..*. \ .. ..*......* .\***  !\*\   \#
#\ .\.  **\ .*. \. .....*\.\.*  ...\** *.... .#
#  * . **\*\@.***..  \.\.. @.. \!.\ *\\**\  ..#
#...* ..\*.  ..**   .. .  . \. . .. . \.\    .#
#*  * \. .\    .  **.* . \ . . ***..    *..* \#
#..\*    .*.  .* **\ .* *. * *..\**\.* . *.* .#
#  ...*. .W\ . . ......\* .* ....\*  .! *. \. #
# **\..*  \..\.  **\.  .* .. **.\.*   . ..*\ .#
#**. .*  ..* * .\.\. .  ..*. @.\\..     ..\ *.#
# .\. ..\*.. . .*\..* ***\.***!  ...  . .*@...#
#**..\*@W*** * \.....\*.   ... **  *\* *\..  *#
#*\. ***.*.**\ \ ** .**.. * * *.* .*. .....*.*#
#.*...*\ *@...*  \.*  * ..*@*\. *!.* ..* ..* \#
# .**\.*..**..@ \.*.  .* \.. * .\ ..*.*\ * ...#
#\ ..**.. *.*\*..*..*..\... .*.* .*  *......\*#
#.!.\...\.**. ***....*.* ...\..*\*...****.  .*#
#.* .*.\ ***  .*. .\   .*..\.*.@ ..\*.*   \*  #
#**\.* *.\..\   .  *.*\** .\*.  ..\*.*.* *@.  #
#.* *... !* . *.  *.....\\  .*..   .  .**...!*#
# * .\.* *..  *. .!.   * * \ *. *..   \...\.*\#
# ..* ..\.*\  . .. *.*...*\. *!*.  .*.\.\.  ..#
#.  ** ...*.\* .*   *. \ *.  .*.\.\.*.  *  *  #
#. \ . . ..  *. * . *..* .*\   * .. . ..\.* . #
#\  .***.\   ... \. *  \.\..\* . \ .\ * * .** #
#  @\..*... ***. .* \... \   .\\.  ..\.. ...  #
##*..     **\*.  ...   * .\.*\*. .. *   .  ** #
#*.*\.**..\#*.\.\* ** .. *  .*..\ \* .\ .\  .\#
# *..***\.***  .. . .\\...\* . .. .* .*..    *#
#*. .\.  **.*\ \..\.\ ..* *. \**\* !\......*  #
# ..    *. .. .\   *.  . \.  ..\..*.  *** \*. #
# **\*..\#.  .\* . *.    .*. *. \.*..*@..*... #
#..!\.*. ...***\  ** * . ..*\*.\..*\.\. .     #
##   ..*..@  .. ...**..**  .* . .  *  \ .\..  #
##  *\*.*..\.\ *. ..! *...\* * .* ..  .\ \ .. #
## ...#**# . *\....     . *.\*   . *.** *.\*.*#
# *\. **.* #\.. ***..  *.. **\ .. .. #. \ .*.##
#.*#.#*#..\#*#.*..*.*.*.\* *....\.\# #*  \*.\##
##..\ #.  .### *\.*\*** *.\.. \  @!*\@ ** .#.##
##@\#. * ##  #.#.*\* . **\  .\ .**.* # \.* .# #
# ## ##*#    #.#* .#  #...... .\.#. ..##.#*#  #
#      #     #* . * *. .* * \.* # #.**#..##   #
#             # \ L *.#**..*\\.#   #.##\.*#   #
#              ##.#W*# ##. ## *#    #  ###    #
#                # ##    #.# ##               #
###############################################

Water 100
Flooding 8
Waterproof 18
Razors 10
Growth 16
Trampoline A targets 8