##########################
#   #*.\.**.. .*.\***\ .*#
#######..*.... .  ..*.\*\#
#\. \*.. .\* * . *.**... #
### #*  \  .*.\. ****\  *#
#  # #\   *.... *...\  * #
# #.##....*\..**...\. . *#
# #\#.  . .....\.\ \***\ #
# # .#\ ..\ **.*..*..... #
#  #\ *.\.# **.*. .*.\** #
#  #* .. \ .* *. .* .*\\ #
#  #. * ... * .  *.\*..**#
#   ##. *\*..* R * ...*. #
#  #... ....\..*** . *.*.#
# #.**.  \ .  .\.* . *.  #
# #*##..  * .   \**..  \*#
#  #. *.*.\ .\ *.*.\.*. .#
# #\  *\.   \ * . .*\.***#
#  ##.. . .. \* .  .\\..\#
#  # .*.*. .  ..*..* *.\.#
#  #\L\* ** \..**\..**\  #
##########################