########################
#  # .*\..*.*..* ... **#
#  # .* *.... \ * *  ..#
#   # . ..**  .**..\*.*#
#  # ...\*.*.R***. *.**#
# # ... *\..*....\ ....#
###L *..\...*...\.   * #
#\  \*.\.\.\...** . .\ #
#####.*#*\  \  *.***. *#
# #\.*... *.. ... *\.  #
#  ###*#...\*\**..\.*  #
#     #* *...*. ...* .*#
#    #*. #. . #...** . #
#   #*.\*. .\.#*.*.*\**#
########################