############################################################################
# #.###\*.  * . .. \* ..*... ..*\ *.... .  \* .*.* *..* *   *\*\..* ****  *#
# #...# #* .*.**.*........ .**.\*.*\. .\*..*.  \\. ..*.\* \  ...\\*\... \.*#
# #\* ..\.**. .. .\*.. ...**..\ ..**.. *. \*\ .  ...  ...\. .*..** *  \..!.#
# # #.    ..*  **....\ \ \.. \**@\***... ..\. *\   \* .*..\.  ..\*... . \* #
####.#\ !  \.\ *..* **.. !** .  .**. *.\  . .*.. *...**.\ .\**.* *\***   .*#
#.@. *. ** .  \....*...\.  \  .. ..\..*.\ *. **  .* \*....*..  \.\ *..\ \  #
####\.* .. ... \...... . *..\.   *  *  .***.*.B ... ..    . \.  *. *** \.\ #
#   ##\.**.****. .. \ .. . *.*. *.*\. . *......\. . .*\  \\..  *.  ....! . #
#    #.*.*\ .*.\.\  **\ .*\.*.\ . ..\*\\ *! * **.   ...* !..* \..*.\ ... . #
#   # ** ..* \** ....*.. ...* *\*. ...\* . .\ . \..  ...*  .\\.\*...\*. .*.#
#  #**..*\..\. .\ .*.*.. \. ..... ..  .\\.\ .*  *...* .**  ..\ . .\. .*\ \*#
# #.** *.   . \ ..*..*** !  .* .* .. *\..... .  ..* \*\..   . ... . ..*.* !#
# #.# * **\.....\ .*\ .. .**.\*** \ \.*  \*  *... . !..* .**.. . . \ *. * *#
## .... ... *   . ..*  *... .**..* \*\     . .*\.*\***..\* . *   .*...* \..#
# L###.\ .  ** . .  .. \ *\** . *.*.. .\. .....*..*..**\@\  \*\.\ ..\ .*. *#
#  # # * ..4 .\ **.!* ..* .\* *\...\ \.****\ .\* .\.*.*.**\. ...*\ \*. \ *.#
#  #*. **.@. *.\.*.    \ .*.. *.@ .*@.  * ...  .*..\ *.*.. *.  .\*...*..  *#
#  #*  ..**. .   .   \*. \*   ** . ..*... .*..* .*\.* ..*.\*** .. .\*...  *#
#   #.##...\.* .*  .\...*.\** . .*.*.*. * \. \\ .....  \.  *.. \.*\ **.@ ..#
#   #\*..*#. .  \  *\.*\  *.. .R .\... \..  ..\.. *.* \. \ .. .  . * **.\ \#
#   # *\ **.** *....**. . \.*.*\...\  **  ..\ .*  *.* *@.. ..\...**...\*@ .#
#  # *#.  . .\ . **\*.*\ \ *\ ..\  .* *..*.. *\  *\*. .* **. .\ ... **.*. *#
#  #.*\ . .   .*\\.* \\.. \.*.\W ..*. *. .  *.. \. ... * **\ \*.. . .   *\*#
# ##.*.. *..*\.*.*.*. .. * .*.*\**.\* .\\*.*..\ ...\......\*. *.*.* \... *.#
##.. *.\* ..*.. *\ .*...*\..* ....**\.  !.*.*  * .  *....\.* ..\.....*\* ..#
# ##\*   .***..\ . *.  . .\.* *.\ ..** *.*.\  . ... *.* ..** *.*@\.. *.. . #
# #*** .  *\*.\ .\ *.    ***..\.\ 7!\*  \***..  *   *..*.....\ * ...*\*..  #
#  ##\ .**. .\**\....*\*\*.\***. A\ .. ..\** *..*\* * .**\\\\.***\\ \...*\.#
############################################################################

Water 0
Flooding 0
Waterproof 11
Razors 31
Growth 25
Trampoline A targets 4
Trampoline B targets 7