############################################################################
#.. ..\.* \***\ @.*..* \. ... \* *. ...*.     \@ .. *@.*\.. \@   **..\!  .##
#\.\ . . ...\*.   *      *  \*.\..*\!\ .\\.*H\.\    \.* .  ...\ ....* . ####
#  .F\ . ****.\   \ \ .@5. . **...  .* .\.*\ ** .\ *.*\. .\ *..C..\** ...* #
# .  . **\.*4  D  .   .\..\ ...  . *\. \*..* .\.*.\. . .*** \   . .  #* ##L#
#... **....\* ... . *E*..\ **\. .  *. . .* .  .**  ..*.\ \.. . \* . . .* # #
#\.*.*.\ .. . ***.\.*.\.  *.. *      * . *\* *\...*\. .* ..*   .* .*    *# #
#*...*.*\. *.*.*. *\*.*\ .*.*.G.@ .. .. .\.*\.**.\.. *...**B  * . \..#.@. ##
#*\.**.. .....\**  ... ..*  ..*  .  ***.\..*\.*..* *\. ***\* .*. *. \#\.\*##
#R.. ****\ \*\*.*8.***.* .\*.*\ *.\A  *.  * .\...... \.\  .\*.\*#\ 9# # ## #
############################################################################

Water 9
Flooding 8
Waterproof 15
Razors 43
Growth 30
Trampoline A targets 8
Trampoline C targets 9
Trampoline B targets 4
Trampoline E targets 9
Trampoline D targets 9
Trampoline G targets 8
Trampoline F targets 5
Trampoline H targets 4