#################################################################################################################################################################################################################################################
#        #\.*.  * *.\.    \\.***\.*. * \*... *..\.... *\\.*. \ ..\@**.*. ..**  \..*.\**. *.*\*\.\.*\\ ...\* *@.*..**.\. .. * ....*... . * * .\*.\...*\  ...\\.* *.*. *\ *\\ ..\ *.\*\...**..***..* ..  . .\ *..*. *\  *. \*.***. ..*\.\..  \..\*#
#       ## #*\* . .. ...\ .*@..  *.\..**.*\..*\.* .\ .\ **..*.\*\..\  ...  . @*.*. *. .* ...*.*\.*\.   *.. ..\ ..\.\ \ \**.*\ \ .. .\ .*...  ...  * .\**    ..*\. \* .*. .@.. ..\*..* .* .\*..*.\ ...\.\*.* . .. . .*.\.* * .\..** *... . *..\..#
#      #\#....*   .\.* .*** \*.**...* ...*..*...\.\.** *.*\   **..\ .*\ *.*\ ***.\ \ . *..\  . * .*.  .\.\* \*. *. **..*.\.** ..*...  ..      .\  ** *.\...  .... ...\** .@\\.* ... *..\ .\.*\ ..*..\.* .*.  .**..*... .. .. . .*.\.. \  . . . .#
#     ##.@\**\..\.\. .. *.. .** .\ ..\.\ *. .*. * \ .. **    .\ . . *.* \.**.*..... * ...  **  @    \*   ..  \.\. .**\. *.  .   .... .*\ ..\ *   \*. .*   .    *.\.*...*\*. . .  .  ..*** ...\*..* @* *\.\  ****..  * .\*  ..*. . *. \.. * \. ..#
#    #\ *.#!..\ .*\. .. . .  .  \  \ .\.. **..***. *.....\ *  .  .* *\  \.* .*\*.\ \* .*\. . *.**.**...*..* .. *\.\..   .. ...*    \* . *\\  @.  ... ..\*  \. **..*\. \*..@\*.**. @*.. ..***\*\.* . * .. \   .@\ .. \* .\ .\\. .  . ..\W. *..**.#
#     ##.#.  **\ .  .  \   * *.*. \.. .   .* ..\.  . .    \..  *.**\........\...***.! *.\.  ** .***\*. .  \* .*. . .  .*.\ .. . .  .  . ..  *...* .*.  * \*....\. ....... . * .  .\*.* .\* .*.. *\.\. . ... \ .*. . .. * *\..**. * .\\***\...\ .#
#      # ##.  . *\ \ *.. ..\*.\*.  ****\. *\   ..*    . \...** \*.** *.*. \.\  ....* *@ . ..**\\..\*   .**..* . *.. .*\.*  . .   .*\.*\*\  *...**..*. *. . .**.* *..  .\*  \**  *...\.   ..*.\* .*..\* . \W** !\     \..  *\*\.\. .\.@*\.. ..  .#
#     #* .*. **  *  .*\ .* .*.\ *. .....  \.   ..\*\. *. **..** .*.*  \..*. .    @ . .. .  *.\ *. . \ \ .\***** . \ ...\. *.\..\ *\...  **.*...** .\*.. *\.*. *...** .\ .\ ...   ..\.. .   *.**   \...  .\.*  *...*.   .*...   \*\ .\.. .\ ...\ #
#      ##. ..\. \.*@ * *  **.* *\ .*\..*..... ..  .*\..*. .  *.\ ... \.\ *. ...\ .*  \.  *..***...\* *..  *...*\.. *** .*.\*. .!*.\.\..**.***\.*\* .*  .*...\....*@*.. \ * \ \ ...\ *\ .* *  .. **  ...\* ..\.**\. . *.   \...\   . . .  *\\*...#
#       #.\..**.. *.\.....** .**.  \* ..* **.  . . ..*!.!. .*..* @*.....  \..*\ ..*  . .****\ \*\ ..\  .\ .\  *   ..*.. .. **  \...  *\.\ ..*.\...  .. * .   *.\*.. .* .\.... *   .**. \. .  .\.*. . .*..\...\.\. .   .. .***. . *. \... **...*.#
#     ####*\**. **.**. * .. \ * .**.*..\* !* .*** *.  *.    *  . * . *.. *. *\.\* .**  . *.\  ... .* *\..  .*.\** \** .*.*.*.  .\. *\.*..** **** ...*  .  .\\*...** ...*.\ .****\****... ..*  !\. * .*.@*..\..\\ *  \  *. *\. ..**.*   * ..  .*.#
#    #*.\ .. .*..*\.. *....* *....*\.\.*... * .*. *   .. . . *.\\*.  ..\   *\*\ * ..*.  .\\. \.\..\* ...\*   . *. .*.  *\*\.\  !  ...*..\..\.*.\  ***\  *. . ..\... .\****\. .... . \**. *   *.. ...* ...\. \*.* *    *.*   *\.*.. *.. *.*  .** #
#    #\*..\.**\ .*.*\.  .  * .** ..*\*@\* \. \*.. .*\* .\.\*\*  * **   *\ \  \*.**\ . ..* *....\.\*.  *.*..\. .  . .  .\*\*   \*  .\*..\.*. \* .*\.*\.*!*\.   ... . *\.***   .   ..\ **\**  .*  *.  ..*  .*\  \. ..*.** . *.. *. .*.. .*..\  .. #
#     #\##**.\ ..*.**  ..\* *.*..  .* ...!\ . ..   .**....*...\*.*...*..*....*. ..\  .\**\.\.\ **.*\ **** *.  *...**....*@   .*.\... .*.\.\\  . .**...  \  . .** **\.\. .*\ .\\.*\  .*.@ *\\ ... ....*\.. ...\.\..*. \.\ .*..*. *\ . .\..\.\ \*\#
#    ##* *\ \ .*..*   **..*.... *   *. .* *.* ...   !*.* .* ..**..**\.\..    .\ ..  **\.\ *.\ *.*.. ... *.*   \.\ \. ...*\*. ..* .** \ . .. ***  .\*\*..*\*  .* ! .\...  .  ..*\..  *. * . . \.*\**  *.**** .. .\. ***\.\  * *\. .. \. *.* .* **#
#   #**\ . \. \.\  . **@*\...*.....*\..\..\*..   ..*.*\*....*\..  **.**  . .....**  . ..* ....\ . * \.@ .\...**... * \..\ ..\.***WA.. \    \**.   *..* .\.\   .\.  *.*.\ . ....  .  .*\*\..* *...\.\*.*.*.. ..\*******.   ..  * ..\.**@\ **...*\#
#    #*#.\* *\ *.\. ...*\..  \* *.\... .  .* .   **.*. *W ...*. ..\***.*.....** *\ .  * ..* \ * **. ..*.. . .*. ...  \.*\. * .*.. ... ..*\ .\* .\*..  \.*  ***\* **....\.*...***\*.. \*  *\*\.  *...\ \.*\*..\ *.... *.\!..... !  *..*..***...*.#
#    #\*.##\@  \.*.**\ . .  ...\.** .  .  .*  . \ .. . \.. .* . .@**\*..  \...\ .  **\\ *  *.**. .. ***. ..**\. . .\* ... *\\**** .*.*.*\*! . *. .\***.. .*.. .\ ..*.*.*.. .\*\.\.@...\*   *. . .*\.  ...!.*\\.*.!* .**.  . \*.**..**.*.*.. * .\#
#     #.\*# ..\  .\..#.  . .* *.. \ ***..* ....*.**.*****.\ * \* ..* .\ . *. *. . ...* .. .*..*\ .* *.**** .* .  \*... .  .*. .**\ \ .\.. .   .\* ...**. *.**..*\ **.*\*\. . *  ....\ .*.*.*\*.  .. .**.\ @ *.. *...\***.\. \. ... **.. \*.\.*..#
#     #\!.*.**.\ \!  ...* *\..*. . **... .  ..\.\.*\...   . . . ..\  ..\*\.  .\*...\*.\...!**.. .*. .* *\ \ .  .\.. ...  ...*\*.* ..   .  *  . . . *.\*  . ...*. ..*.* .  **..\.\ .  . \*... *\..  .**.*.*** ..... .***. ***\.*   ..\. \ *\.\.\ #
#     #\.\#..*\** *\.** .  * .*** .\. * .**.\ . * *. .* *.. .  .\ .*..\ .*   .*.. . **   * *\. @ . .*.  ...   ..* *.* .\. . \..@\.**.* . \*\.* ***\.* ..* ... *  . .\ ... .....** *\ *  ...* \..  . **..\.  ..  ..*..\..** *... *  .*\..*   .. .#
#      ####   *\.. . ... *...* .*\ *..*.**\.*\. *\*  .W*.***.  ... ... ...\*  *.*\ *...*..*.** .\   \.* ...\   \. .\.*..*!*\...*.* ..*.. .\. . ..*@**\.**\.*.*..    *.*\*\.*\*. \** **. . .\*.\**\....* .**\ *\..*\.. ...* *   \... * * . .*.  \#
#     #*# . ..\. .*.**  .*\. .*.**\....* ..\ ** *\ \.* . .\ ..*     \! . ... \.... . .@** .... ...*.. ..\*\  .. *\ .*..    *.  .*  *\.* ** *. *.  **\.\**.\***\*.**...**.. .\ *\.\.\.@\ ..*. .*..   \..\.**. *\ .\    .  \.\.\..*..\.*\..  .  .*#
#    #\.# .\.  **\.*...   . . .*.  .* \.*@ .*\\ ..\. . .  .. .*..** ..\* .\. .\ .\**. *..*\*.*  .*.\... ! .. *@\. * *...** ..   .* ..\@  ... \* * ... *.** ....  *\  . .*.** .** .\  .*\  .\  \ .*..... *. ..*! .W ***** * .. \ !.\ ..  .\..\\ .#
#     #*.#\ #..\..*.\.*...\ *. ..\***.\ .\ ....***\ \*@    .* . ** .*\ * \.. ...\*.\.   ...\  . .\*..**.. **..... . *.*..\ .**@\ .. *. \ .....*.. .* ..  . \  \ ..@  **  **..  . \ .*\..\.. .* .**.*.*\.. *\.*. . . ...* .. \  *.\..*\*.  .*. ..#
#     #**..#.#*. *..*\*   W.\.  .*.. \ .*@  * ... **.\*.\. **.\ *.*.*. .   ..\...\\.*. **\. .\ \*.. *.*  .\.*.* . .\. ..     ..\  .*  ..* .. \... ..  ..*... .. .\.. ..@.. *\ *.  ....*.   .  .**....  \....  *  **\.. .  *\.!..***\  ...@\.**\ #
#     #*.. *  .!**.***....*   * *.\..  .!**   ..*.\.***.. ...**.** \..\@  \*  . \...\* \..  \ .   *.  .\* * *..   ...** . .*.\.*.\. .  \** \  *.*   .*.\*. *.*. *\** *..*. \! ...*.. *.\  *.... .  ..**\ .*\\ .\*.. .   .**  \..*...   *..\.\.* #
#    #\... . . .**....\*\*.. ...\.* *  **  ..\.\.* ..\.*.    \.\.. \.**\ *.*.**.** \*\.. *  .* .\...\   *\*.*. \** \ *.\.. .\.\*\ .\   ..*\.*.\.!\*\. . .. .  *\*...*\.\..\*..  ...*\   ..* \.\  *......  ! . *..* .\  * ..\..  ..**.. \.\* .\*\#
#     ##...*  .**.*.*. .  *. .  ..*....\ *..\..*\*** \*.\. . \ **. \... .. ..*. .. * . ...*\.*...*.\*. *....\. ...\. . * \* ** *..!  *\.\.** *  . . @ *\*..  .. .*\..* *  .. \  \**.. ... ....* \  .\. *..\.\.....@\. *.** .*.****.** .\... *.*.#
#     #.#.** ** \ .**.. * ..**\** *\\....\*.  .. *..\ \. *.\...*.**. *** .* *.* .\..* .** . *.*  **.*. .\* * * ...\.\.* *. *.****** .* *.\*.\. .\.\ *.. *  *.*@ \.*. \ \ \ .... \.*  .*\... .*\.**.\\. \.\  *.*\  . *** .\.*\..*..*..* ..!\..*\ #
#   ###.\ ... .*.  *.\. .... .*.. .\.*.. *.W \ *...* **.* . * .. .\.\  .\ . *.*  *  ..*\. *\. .  .. .*.*.*. \.\.*..   ...... ..\.** .*\.*@. ***.*   .*\..*...\* . **\* ! *  *.......\** \@\ * ..**\.*\...*...* . *\.*. \ .  .. ..\.\.***\.\.\..\#
#L##   **...*\.**.\*\..*\. .  *. \ .\* *.*\ **.*.  \. !*\!\.\.  .\. .*.*.. ***. .   *.\..!.\** \ .....*..*  . *  *.\.. .*\.**.*.\..!.**.\..*.\* .  * *..* \.\.*.\  \\.\   \**..  . .\.\ \  ..\*\..\ ** ......*.  \   *.. . .  .\\.*.\* . .    ..#
#..*. #** ... \ *..... .. *.\..  . *.\ \  . ***. .   . ...!\.  \ .*..\**.*\ ..\*.*. * .*** **\ \. \ .@*.**\. *.  **.\ *\.*...\*  *!  ...*\....*.*  .... .    ..  \.. .*\   ..*.\*    \\*. \ . . . . ... \**.**  .**.*.\  . .\ ** ..@... *.**\..*#
####.\..#\   * . .\ **\.\@* ..\.  \..*. .\*....  \ *.\ .   . * . ..  .\.*.*..**.*  . .  \\ !... \ .   .\..  *.  . \..  .*\.  .\*.\    *\.  .  . .*. \**  . .. . .**   ..  ***.  * *   .... ..**..\.\  .\ \...*..\.. .\.*..* .. \. \.\ *\...*   .#
#  #. ..*\* ....*\..**.. .\*** **** . *   .*..\**.*.. . * .  .*    *\.. **.. \** \ ....* \* . \\.\ .@. . ..*.@. * *...\.\ .* **\  ..... *..*\...\.* .**.*. \* *..*. *.\ * *\ \...*@.*  *\..\\.   ** .. .  ..\*.* . * **.***. \ ....  **. ...\\ .#
#   #\ ..*.  *. ......\.  *  .*.. \.\....* .\..!*.   .*  \.\  .    .*.* .\ \.*.*  \ .. . .\\. \\ \\ .*....\. \ **..*..** .** .   *\ ..  *.. *  * **.\ \**\....* \.  *.  \ . ..    \.**..*.\ \.* *.\. .\  \** . * \ * ..\.**\  \.* * **.! @.\.. .#
#   # . \...*.**\  \  .. *. .\..**...  .\. \**\**. \. \.\...... . *.. \ ......*  .......\@   *. .. . .*\*\ *\ **..\*\... .  *..*  ...*.*.*  .\\.**.*. ..\.*. \*     .* \     \. ...**.... .*.*. **. . .**. * . * .*.*. .* *  ....*\**. ....@. \.#
#  #.\.\#\.*. *\*!\  ...*.   .\.\. .\  \*   *.*.... ! . * *..   .\ * .   . ***.   \. \\*...*.\*.*.\.*** \  ...*\*\*. .**.*.....*.. .W\.. . \*..  . .  **. *..\!\ ..\ .\**.  .*  .* \. * .. *\.\ \*  .  . .*. * \.\.\.. \. ..  *. ..\.  . \ *. **#
#   #.*#\... .\.. @#***.. .*  . . \. . .\  \ \* \.*!. \.  ..*** *...\.\..\.\..\  **.\...\ ..*....   *\.. . *\.. .*.*\..  \.**\.\**..\*   .**. . .\ *.*..*.....\!.  ..\..\..* *....\.  ...*.**.  \.\*. .*.\   *** .\. . \.*.* **.*.. ** *\.*.. ..#
#   #\# ##.#\ * \  **.** * *\. *. .*.  . *. ....  .   .*\  *\..*.* *.. ** .*  *... .  *  . \. . *\* *..\ . *  ..  .  ....*  . \..*.  * . \. \ ....*..* *..* *..****..*. .**..**. . .\ *\\. *\* ..**\   *.*\ .**... .*. .\...\.\ ..**..*\* \ .\..#
#    #    #. ..  .*\!**....*\ .\**\ *  *\\ \*.\ \* ..*.* \ *. *. ... **..! *. .*\.    *  **  . .*..***\.. ***. * .*. .  **.*  !. .*\.* *\ *! .\.*W\ .*\. **   ...**\ . * **.\.\.\. ..*.  .. *.  **.  ..\\. * \.  * ...\.* *...*. .*.* *.**. . ..#
#        #\  *\ ..#. .* .\ \ . .*. .. .*. .\. ***.  .*\*. ..****   \...**.*\ *..\.* .@  ..\.  . .**\*\   .  .**...\. .*@\ ..  !  .\ \. ..*..\. .*\. ..*.* .\ * \ .\*\ .\.\...  * .*.** .** .   .*.\.*. . .*\ .*\ .\  *  .\   *. *\.*.**..\ *  ..#
#         ###.. \##   *   ..  . . * ..*.  . *. .. .** ..*.\*.*..*\**.\****.*  *  @** . *\*  .. *..  .\.\.  .*..*.*! \* .***. .   .* .\ . ! * *  *..\*\*\.\. .\.    * \ *\.\\ ** **. .*. ..\  *...  .\ .*..*.. *.*\*...   .*! *..\. .**..!*.*\   #
#          #\  .# #  *.*   . .  *\...  \*.*..*  * ....  .  . * *...*.*.\.* . \\ ..\  **\\*\.\.... \.  *.*\  ** *..  .. ..*.\.  .*.* \    **** . \   @  .\*.\. *  .... .**\ \.\.\..*.*.*\ .. ..  ..*\..***.*.* ..** .\.\ ...\ .  .\*..*.\..\. .\\#
#           ##\ \# \W*#\ *.* *\..*..*..*.  .*..\.\..\. .\ *. *\.  .    .*..*. *. .*\*.\ \.W*.\. \ .*\ * .**.*\**.*\ .*. ..\. .*.. . .**@ ...**.. . .  .*..  ....\* .\..*.  ....*.**.* .*\. .\  \*\.. \.***.\** *\* .. *. . . *. . * ..\ *  .\ *\#
#             # # ####..\* #*.*  .*\\*\...  ..   .** *... ** .*! *.   ...**.\..  * .... *\!*.  . \... \ \.\..\.\**. . ***.  *.\*\\.\. .*  !\.*...*.    \.. **\.\..   \\....*.. .\**** .   .\\. .. *..  ....* \*...*.*.\*.. \ *.\*..*.. ... .*\ .#
#            #.\#   #.\.**. ....** *\. \**.. . .\**.\.\. ..  . .\ .*..* \.*. \.\*..*\ \. *..\ . \.\  *..  .* .  . ...*..\  *..\.. \. \*.*\*  \. .. *.*   *..\*. **\.... . ...\  .. ..\\!...* . ***.    \ *.\...* *\ \ *\.  \*.. *. *.. !.. \... #
#             ##    #*#..  *..  .*.\.*.*.**.\*.*. * . ..\\\. *\  \ .\\.\  * *\  . \.** .****!.*** .\..  \..  *.* * \ .*.* **  .* .\...* . . .. .  ..\..*... \* .\..\ *\ .** .... .*\.   .\ .. *.***.**  ..\ .*\.. *. \*.*   \.. .* * ... \.*.@\.#
#                  #\.\* \\\*.\. ! *.. ! **\.* ....\. ..**** *.\  . **\..\..\... !.\.*\* . .  **.* *..*\.*.*\* *\*  .*   ...\*...\ *\...  .   ..** \ \*.*.   .\ * .* .  ...\ **.. .* .   .  \\.  **.*.  \* !*  \   *  *  \  .* **.   *\.\ .*\.*.#
#                  #.*## ....  * \..\.**..\ .*\!* \ ..** ... .\.@..** .\..!. *  * \* **.. .  *.*..\.  \. @ * \ **..  . ..  \ *  \.\\.*.  *      .* ..\.*.*..\  \\.\\**   **. *\*.* **.\.. ** . **.*... \... ..\..... .. !  .** ***.*\!*\! .. ..\#
#                  #*# #*..!\ .. *. .\ \ . **.**.\* .\ .\ \ . * *  \*.  .!.*.. *.*  \.*..\\. *\   .. .....*.\.... * *.  ..    \..  \ *.\\ . ..\ ..     .*\. *.. .\ ***\. .*\.* !*.\*.\.\.  .\***.*\***. ... ..  \ . .. *!..* .**.**.  \.*.. \ @ #
#                  ##*#.*. . ..*.. * .#. . *.*.* *.. ..*  ..  ..*.**\ .. . *\  *..*\...* !\. \\ ...\.** *.\ * \..\.\.*..*. ....*.. .**    *. *..\. \* *.* \*   .\.***. *\.  @.\.* \.* . \ *\  .*\** *. ..\...\*..*\.. .*  \. *..***.**.\.***...*#
#                 #\\ #...*.*  .  .* ... .*\ *.. .*\ **.\. \  \ ...**.  .\*\.*.. .*W.   !. *   ..*\.\.*.*.\. \ .\.*. **.. .*\*... *.*  \ ***.. . ....\*\.. .\.@.**..\..*. ..   .\*. . * .*\ .*\ ... **\*\  !*\.* * \  * ...***...\.*.\ * .*\ * *#
#                  #..# \ .\.\. \**\W.  \ . . . . \ .**.@.... .  .**. .   *.** *. *\ . *R.*\  . *.  .**.. .   * .*  .....\*\**\..**.. *. **. *  .\....* .*@..*..\... \ ..  ..* . .*.  *  ..*..  .\..\.*.. .\..  \   * .\*...* .*\ ..*..  .**..*.#
#                   # .\#  . .\ \*..    .*** *.\ \.\.. .* .\..*. .*  .*!\. *@...  ... \*. ..@.... . ..**.. \  .. *..\ *. ... \  .!\  .** .\**. **  \.... . **..  . \*    .. *.    .  ..  . . .... .. **. @. ....\   ...... .!\. .! ... @ ..  \. #
#                    #*#!****  # .\***..**.. .. ..* \*  .*..* .....  .. ..*... ..   \. *..*\* *.  .. . ..*..\ **\**\.*\. .\*.. ..  \*  ...**. **\**.. **.  .* ** \  . * ...\ . \*.  .\\  *..  \ .. .. .. .. ..   .* *...@ \*.  . . \. .\*\..* * #
#                     #\..\.*#\ *\.  .. *. .. *   .*@..* ..\  *\*. .*   *\.* *  *\  * .. ..\...\..  ***  .*\.\ ..*\*..  . *.\.*  . .!\.\ \.\ ... ** .....\  \ ..\.* . .\**\ .. ...\   *.*..\* .  *\* \\.   ..  ..\ ***.\.. . .. *\ .**.**. . **.#
#                    #\*#....*...*..    .\..     @....  .\*.*\. *   *. . .*. . @..* .  * \. *W*  .* ... \ * .\.\.*.\ .\ .\...  . *\ *.\.  \\* ...*.*\*!* . \ .* .**.**@*....\ .  . \ . **.\..*.**. .  . **\\***   ..\* . *.*. .*.  \*..\.\*.*..*#
#                     #\#...  .*...\  \*  *\  ..\ .  \\.\  *. \.  ... .*  \**\ ..*.*. * * *   . . *\  !     .*..**. *...      *\ .*\. ..\ \**\. \**...*. * * *. *.*  ..!. .  .  \.**. . .****. .....*\ .\.*.*. * . *. *... !.*...*. . .. *.\ .* #
#                     #.**\# . .\* . . *.** **.** !. .\**  . . *  * ..\* .*. *  .*.*\.. * \ * * \ *..   * * .** .    ..*.*...*.. . .\  ***.\*.**..\. ....\ ....\  * \*.@. \*\..\ **....   .\.. .*  .*  .  ...*\.@ * \.\* .** **.\* *... \..W  . #
#                      #* . . . *..\. .. ..\**....*\. .\.\ . \ *\ *. \*.\..*.\.\ . \  *.*.  . ....  ..\ .. *.... . ....*...  .**.   . *... **  \ . .\..\*.*. *\..*...* .   . **. .@\. .\ *\*** .   ..\ **\.. . *.  \.. .  \ ..    *\ *.   \*\. \#
#                      #. .\ \  *..*.** \.  .** .*... \ *.     ...*\ .*\  ..*.*   .. . *.*. * . .*\   . *\\..*  \...*  ..\*..W . *. . .* \**..*   \ * **.*\  \.* . ..*.. *. *.*.\.*. \.*** @***\*\.*. *.\  \ *\..* *\.   *\* .\*.. *....* .\..*.#
#                   ###\.. ....**..*..@** *\* *.\..\ .. ..*\   . .. .\.* * ...* \.**** \*.. .  .*.  ..  .* .*. \.   .\.\.*.\ *.  .\ . ..... ..**@**. \.*.**..*.  * *W**  .   .* .** *. ..  .\.*... *.\*\*  \\. \*. .. *..\ .. ..*.\..*...* ..*.*#
#                  #*.*.  \.  .**..*. .*..\.  .. *\   .\.*.*\*    *..*.\.*  !*\. .\ ..  . *\***... .*\**\** .*.   *. .*. \ \* ..*   \..*\    . *.*\*..\ .*.**   ..*.\ * *\  ...***..\ **. *\\\.\*.. @ ! \ *\*. ...* ..\.\*\..\ \..***.\ .\ . .\.#
#                 # ## ##*    *...*. ... ..  *\. .  .* * *. .\..  *.  . ..   .*\ *..*. *\ *.\*\.\\ \.. \. *\*  \*... ** \ * .*.\.**..* .. * **.. * W. . **\.\   \ *\ *\ .\*...\ ...@*...... .\**.*. *\   .\ ..\ .*. .   .**.  ! * ...*.*.*.*.\ .#
#               ##.#.#\*\** \ .**\.. .  * *...** .\. * . .  *.     .. *. \*. \.  \ .*  .**..\..\.... \.  !.**. .*.. * . ... *\@*.*...\...@* \. . .\\\ * *\.\.. . .*.*\*.\.\   *  ... .*. .*.\.*\ \...*.* *.    .\...\.. * \ \*. \.*\**..*\ \ .  #
#              #!* ..*#.#**   .  *  *. \.*. .\** *.. *  \ ...... .*\\.\...*.. ..*.!W\.\ *. **.\ \.**\*.\..*.. .\*. ...*.*\.*.. .\*.*..* \... \ .*.   .. . \.*. *. * ..*.** . ****. *. . **. ..* \.\  *...... \*..\.\ .* \*@\.. \*.....*@\.*... \#
#               #* .\#* *..   *  *  *.. .*.*. *!*.@! \ ..  ..\  * .*.. ...!  **. *   * .. .*\.  .\..*. ...*.  ... .   ..\.\*  ...\ .  .  .  .. \..*\ . .  ..  **.\.\*. ..*  ....\**\.    *\ .       .*.\..  .*.. *  .\.**...**...\  !\**.\.\  *.#
#            ###\\..\#. ** .*.*. ..\. . **.* . *** ...W   .*.* *\ ...\*...\..\.\ \ .\.* .. \ ...\ .\.  * ...*.. . \   ... .*  . \.  **\.. .\.\ .\ . **.*. * .*...**...\  * .\\.\*...\ .\...**. *. *...**. \\ *.*.!\ ...\  \\...\.* . *.. * .*@..#
#           #.*.* \***. .\ * .\*   *\ ...* !....**. .***....\  \*.* \.. .*\.*.*....**\.\   .** .*.. ** *\. ..*\..\.  .\.*.**  \...\*\..** *. \ \ . ..\*....  ..\.***  *\*..  \. @* \ ..**\ .\.*\  **   *\*.*..***\..  . *..   **.    **\ ..*..* #
#            #.*....**... ...\  .**\.* . . .   .....*.\* *.*!*. *.*   \* . ...... ... .. \* \* .\*\*\ ..**\ ..\*    .  .**\. ..   .**\..\ .*..\ . .*.  .* \   ** ..*.\....* *\  *  .. \.. !\ ...*.\ . ...\ * ...\ *..*  ..*. **.* *  ..  .. ..*\#
#             #** .*##\.  !.*. ..\..* . . .*  . ..\ .  .** .*.  .\ .*... *  \**.  \ *... .* \. .....\.*.* ! **.\**\. * ..\.*.*\ ..  *..*. *.  .. .*\  .... .*...*.\...  \ ..\*.*\...\.*.\  *.*.*.    \ . .\  . \...* . * ..* . **..* *\ \**  *..#
#              #...*##..\.. .\*\ .!*.\. .. ..**....* .*\***.\  .*....\.\*.**.*. ..... * *\. *.\ *. \..**.\. ... ... * ..*. * *  *\  ....*..     * .*.\*\*   **. * .  .\ .!* ..  .**.**.\ .*. ** *. . . \ . ..\*.\ .\  *\..\.     **.*. \*.*\*.*.#
#             # .\.\.##..    .* .  ..\ \*\\.. *\.. ..\.*. **@*  *.*.  ..\*\...  .  ***.*. . \.  \.\.*.\. .*.*.. \.W\\..... \*. .** ..  *.\ *  ..*.!.. ...\ .\.\ .\*...** *\*.  **.. ... *...*.*  *.@...\\ .\\*.. \.   .* .*\**.\.. ..\..\... ..\#
#              #*#.## #\#\#\*..\ \.. ..*.*  \*.  \    ..  . ..*. ..\.  ...  ** .*. .. ..* ... * .\.\  . .*.\.* .  ..  .\...\.** ..\    *\... \ ..*\**\   *. \\.....\*.....**.   ...  ...\***.*. ...*. ..\  *** .   . . . \...*\**\  *.***   .  *#
#               # #   #**#\ #..**   . \. .\..... .*\. ....\. \....  .  ..   .\ ** *\.. . \* \  *  *. *\.\. **\ *. \....   \*....   .\..\!..\ .** . ...\.\ . . \. ..*.\** **. *.\ .\   *.\.\.*     *. .*  *\..***.... . ...*.*. \  . \  \. * \* .#
#                      #*..*    !\   *. . .*.\   \*    \ .  . . ..\ .\. *. \ .*. *....\. **.\ ....\ ....\\.\   \ * *.*. .... *...*    \* .**.\*...... *\.*. **@..\ \.*  \**....* \. *\**. W\.\ ***. \  **    *..   . .*\. .\. *..** .** ..*.\. *#
#                     ###.#\\**. *.. ..*.*\*...  .*.** . ..*  * *\ *\***.. . \.  ...\.* \..   \  \ .**.**.  *\...* * .\ **.*\.*. ..  .* *****..\  ..  . \*.\*. ..*. *  \ ..\ @.     ...\**  *  . .* @. \*\  @.*  .\6*.** .\.\ .. **..  ****.. **#
#                    #\\.*#* \*# ... . ..* .*  \ *....  *...\.* ..** ..\   .*... .* . \ . ..*\ ** *.** ..\...  *.***.. !. ..  **  *.*.!..**\.****\** \     ..W  .   @  ..*** .... .   *...*.@.\ .\. .   **  *.* \ * .\.\\. ***.  \\.\\ \.*..\...#
#                     #.\ *.* \.\ \  \* ** ..  \.* \ *.* *.*.*...  . ..  *   *  **.....  *  \.*..\. *.  .. \. \. *.* \ .*.\*  *.*.. *  @*..**\.*.  *  ...*....*@. *..\.\.* .  . \*  .* .*..* ...\..* \\..\..* * ...**.\..*\  .. \.*.. \...*.... #
#                      ###\#**.*#.   \*. .\ .**  .  .*** ...\*  *\.. *.  *..*.\ *.   \ .\. *..*.. *\  .* \*..*. *.*.*.*****..\. ..**.*.*  \.**\.\. .  * * \  *! ...\* *. *\.\.\.....*.\. .\. .**. .. ..    ***! *!\.\ .  \* .\\.. ..\..  \.  ...#
#                       # *\.##**\*.\..\.   *.. .! *.\.. \.*..\\... .*\.* \.* * .\@.\ ** *... ..\ .* \..  .\*\.*.....*.*.*...@ ....**... *.*\  ..*.*. **. .\*W\ .\ .* .\**.*..\   .\..* \.*\..*... . \. . . .** \\*   *. ...**   .  *  *..****.\#
#                      #.!.#*.##.##..*..*.*.*.\.\****.*. .@   .\\*\.@\   **.. *\.....\.\ .\*  .\* .\  *\. . .* . ... . . .. \.   *\..* . .\..*   \ * ..** *  ..*\.* .  ...... *\*\  .*\..*..\ \\..\*\. .\.\**.*..*.*.\. \. *.. .  ...*...*\.* \.#
#                      # #..##  #*.*\. *..\. *.* ..\....\.\  *. .\. .... *.\*\**\.\..*.. **.\**.*.... . ! .*    ..  *\***\ . *. \. *...* *.*.*..*!..   *..\    ..*. .\  * * . .*\. . **.\ . . .* .** \ . . *\ .\.\*..  .*.\ .  \. ..*.\   ...   #
#                       ##.#    #.\. ***.* *.\!\ ....**.  . ..    *.*\@*... ... *\*. . \ .*...*..\  .     ..* *.*.**.    ..  .*..   .*...***  **.\.**\.\.\.*.! * .*.\*.\  ... \ **.....*.*@\. .***.. .*.. .\. *...@   *@.*.W. .. ..\ \. \ .. .* #
#                         #      ##..#\..\ \**. *.*   ....... \.. !\  ... .* \. \.. \ .   **@ .*\ ***\* .****.\...*.*. .*\.   . .  \\.. \*... \.*.  .** .**..   * .@...*.\  .* *.  *. ..\.....\.....*\..   * .*\  .\*.\. \.*  \  *. **.   ..\..\#
#                                 #**#.\  \.... .\.. * .   .   . *.*. .\\. .  .* **\* .*  *..***.\..@**.\ \..*. \.*\  ....*\.*\  ...\.. ..\.. **. *...* .. * .\ *..\*.  @.\.**... \*.******\ .    \.. .*  *.  *...* * ..\.**...**.      .. .*.. #
#                                # *@*  *\. *.. .* * ...*..*..* .\ . .\ .*   .*. .... .*...\\.*\ .* *.*. .  .\*..*\   *.  \ .** \\ \***.\...\  ** .* ..* \*\. *.. *..*   *...  .\  ....**..  .  *\* * *.  *...*\*.. *\ ..*.** .*  \ **\ . .\. ..#
#                               #* ...\ *.. ..*\*\ * *\. . ** .  \ .\  .*.  * . .\. .  **.*  \* \*!\ \.    .\* ... \.  \.. . ..* . * *.* *. .* *. *\ .\   .*. . \.*  . **\. *   .**    *   \.\  *.... ...\..***   \.. . .. .*\*. .. .* .  \.* ..#
#                                ##*#..*\ .. ..*\..*.. ..*  .\.\  .*.*..*.*... .*. .\*\.*.. \..   \.. *  .@.**  . \ \.*. . .   *. .. .**\*   * \ *\ ***. *. ... .*.\ \..*..\...*..\   \* *\*..\ .*  ... * @ .\.*\..**.* .. *.\**\ ** ..*  .*.\  #
#                                  #\ #\....  *.  .\..*\*.* *.. \.*....*.. @..*.*! .*.* \.. . **\*.*\. .\*...*.\*..\.\**.  \. .* * .*  *    ...@. * *..* ..*.\.* \  ..\..\. *  \..*W.*.\.. .**. *. .. \*... ..\.*\ .**@.   . .*.   *..*.\.*. *\.#
#                                   #*##* \\.... ...  ... . .  ..*\ .*...*\... \. *.....* *.... .*\  \  *\.\ *  .. ....\*.   \.. .\ .  *    .@*..*. * .*.* *\.**  *.  .\ .\ . * .. .\ \*.\. \. .\   !* * .* . .*..*\\ .*.**. .... ..*... . .\**.#
#                                  #*#*# \ ....*\ ... \* ..*   *.***\.. ..\ . ...   .\* .\. .\.. .  ... .    ....*.\.*.... *\!W  .*  . .. *\ ..****..  .  . .\.. *..      *.***. \   * \.\*. . ....**..\* .  .\.\**.*. .**  ..  .\ ..\  \.* ...*#
#                                  #... \#  ..*. * ....\. *.  *.*\ *. *\ \.*    .. \ .\.**\ .. *.*\ *..\\.*.@\*\...\ **.. *..** *\.      .\ .\\.. .*.* **\. .*.*\. *.\  *......*\.*  .*..*.*.@  *\ ..*...\*.\**\.....*  W. .*  .* . *.\ ...**. .#
#                                 # *..\. !\*\. *\ \   **\*.  * .**\...*** @ \..\ . * .. .  \*..**..\ *.\.\ \ *.\ \***\ ***.\*.***\..*\. ..\..*.\**..\...*** .. *\.*...!*...  *.*   * ...*\.\*. \.  .*.\.. ..*... . **. .\.*** \.   . ..**.*** .#
#                                  ##\ * \ ..*.\ .* . *.\ *.. *\. **.*...*.\   \*..\. ..*.  . . *\..* *.**.\. \*   ...* * *  .  ..*...  \ .* *. *..\ . *.. **\. ***..  \  .*. ..\ .*...\  .. . * ...*. ..* .* \. ***....\  \ \..*  *.*\...  *. *#
#                                    #\..\* ..\  * .\* \ *\*** .  .* *. *\  *\. \*\*.\ .. .\ ..\W.. .* ...*W\ *\*.  * . *\.*\  ...\..*.*. ..  \..\W. ... *  .. ....*  *.\  !.... .!**\    *    \.  *.*\ ***.. . *@*. *.. ..    .* ....  \* ..  !#
#                                     # .#.. . * \* .. . \.*.. . ..*\.*.*\ ..*. *\*.....  \*\**. ..\**   .. ...*.   .\  \.*.*.  .!. .**. ....   ..*   *. \\ **\. **  *.   *.. ..*.*..!.*. .*\ *..  \.*.\.**.*. \. .\*. *.**...*. ...  . . .\  .*#
#                                    #*. *\..\ .*.  \ *.*.. * * *   * *.*!*  ** . . .\ .*  ..  .*\  !.*\.. *** *.  \ *.@.\  **...* . .\*..* \ ***!..\\.\ *..** *\ . . . .** **.*..\.\.*.* ...  ** *  .\. .**.*\ *  *. **\ .. \.  .*.\@ ... .* **#
#                                     #. * ** .*..* *  \ .*.*.... .*@.*.**. *.. \.\\. !.*\.. ...*.* *..*** .\...\ . \*..* . ..\  .\  . **.. .\ *.\   .. .\..*. .**  . .. . *\*.. . *. *.W. \. ..**.   ** ... .  *. .*\...... *   .\* .\**** *. .#
#                                    #.*** ..  ..**\...\..  *\ *..   .\**.. .  . . \  ****!\ * ..*.*\  ... ..**   .@. **.  * .. .  .*.* .* .  *\..\  \. \*.\\. .*.\* .     . *@ *  ....*  *.\\  **\ .* .   ...*.\ \ *.* **\ ..\.  .\.*.\. ..**..#
#                                    # * .. .* *...**   !.  .. . *.*  . *.   ***\  . ...... .. *\!*\..**. .*\*  ...\**.. ... .. .\. ... *.*  *\!  *.*!.*.\*....\ \.    ..  .*\.*\* ...*\.***..  .*.. . *\***  **....**.*.* *.*.\..  .**..  \ .* #
#                                   #**..\. .\ .\.\*..     . \* ......***  .****\ * . .\ .** **..\*. \..****..\..   ...\. ..   *..\ *.  .. . * *  \ .*.. . .* *...*.*\.*   ...*.*.\ **. \...*** .. *.  ...\.*\..* *.*...*. .*.\.!\.\*..\   ..\..#
#                                    ###** .  .\..* ..*\.. . .*.  *  **..\.**.*\!... *  .\.* .*!\ . * \\.*.... .. .* .*. \*\  .*. ...*..\....* * ...  * ..... . .* ** .. ..   *\..**W . \.\ \.*.\ ..*\* . . **.\...\*\ .* **.**** \.\.  .   .*. #
#                                      #..* .***. #   \.*.*.. \ * *\ *\ .*  .*.*..\   .  .*\.**. !  .\  *. *.*\ \**\ ... \ .  .\   .**. *\ *.*\**\**. * .  **. \..\.* . .*. . \  *.\*. ...* . ..*.* * .\**    * **.***  .\.. ...* . *   .. . ..*#
#                                       ###\**.... .#.. . .*.. . .\.*. ....  .**\ * *\.  *..**  *  . \. .\.\ \. .*.*. .\@..  ..**\*.\* *.. . \ .* *** *** .*..    **.*.*...*.   ..* ..@**   * ....* . . *.\\***.   **..*.\*. ..*.   . *.*.  .*.*#
#                                         #. \* # .  *..\  ..  \* @*..  *@\. .*..\*\.  * ...*.\ .  . .\*  ..*. ..* *\.\ *\.**. .  ..** .       *... *\\...\.** . ...   ..\*  . ** * .*...@. .  \  \    \..@.*!\*  \\* .***. **..\    \. .*\\. ..#
#                                          #*\**  \.1\ \.* .   *.\.. .*B\.  .*....*...\* .\ .** . * .** .  *\*   \**  . .. ..  .\.\... *\. ..* .* .***..\ .\ ...\ ..*\ ..**.  *.\**. ..\..*. .* .*.\....*.*.**.....W..\. ..\ \* .* .*.  .*  **  #
#                                           ##  ** ..  ... *.**\*\.\   .** *.*!.\...*...*\.   .*.*. ...\*.\..*\*  ...*..*\ *\*  . .. *.*.*** \ \ \..* .*..*. *.** . ..*\ \  @ * ..\  \..* .** *  * . .....\\..   *** \. . .*.*  \*\ *.  .!.**.. #
#                                             ####.# *** .\..\  *.\..\.  **@**\*. *\\* *** .\**. .    ....**\* * ..*... .  *\. **\*. ..  ..!  ....\... .  *\.. *...*  ..*.. . ...   \ *** \.* \.  .\ *.. \.  ...*..\ * .   . .\*.. **\..*  . **\#
#                                               #.. ..*.* *.\. * .#** ....\.\**.\... . .\.   .\.    . .  .. .**..\.\..*  ...*.... \.\ ..* . .***. .\.\.****.\....*\*  * **.* * . \\*. ..* . .  \.... .!    *\..*.\. * .  *. \ . .  *\ ...  \.*..#
#                                              #..*#\*.** ..   .\.**\  ..*...\.. * *.... .  .* *.\.  .**\*..\..\*. @*.. \ ..***..\. \   ..\* ...\   ..****.*. . *.  .*.\. ...*.. *..\** *   ..*.**\*.\.* .\.\. **.\ .*.***.*.  \  ..\*. .\ .*. \#
#                                               #*# ##.#.\* \. .*. ..   *.* **  .....\ ***   *..   . . ****.* ..**  ...*..*\.*  .*\ ..\.**.*  .\* *.\  \*\* \  .. .*.\.*\.. .... ..* .. * ..*..* .**. \* \*. . *  . \.!*..** . * .*\*.. . *.*. .#
#                                               #*#  ### *.   *..\*   . ..*\*\. .  *   .... .\\  \ ..*.W\..@*  ...\.   ....* . * . . .. \*\ . .  .. !   ..* ...\.  ..\ *... .  * ...*.*\. \*.!\* *.  . ...\  *..\. W  .*W*..   .\ .\ .*.  \..*.\#
#                                                #  # ** . *# ..*.* ..*....   \*   **\*.* . \.\\\.* *** * * *.  .   *\ .* **@\. *...\  *...*....*  \.\..\\.  *@.*   ....\ *.\*** .\* .\* .  .  **.    @*\*.**. *. \*...\.** ** .. ...*.. \.. \* #
#                                                   #**#\**.\* .*\* *.*.   . \.*. *.\.  .  ..\  *..* \. . .\*  *  .\. . \\ ..*..* .  .**.\*.  ..\*\  ***... .\*..\ *.\  *\\  * ..*..  ..*\   ..*. .\\*** . *@.\.  \ ..  \. . \..\ *..*\**.  W.. #
#                                                  #**.\ .#\ *..**.*\..* *.  .\*.*...\ *\. *. \ .\@ \.*\*.*!*. .*\ * **..\.\ ..*..... *.\....*.W ..  .\. \ \. ****..* \*\*\ \.  *** . \  \ *\*\.*. *..*\ . .*  . .* .\*. ...*.\ *. \ .* ...*.   #
#################################################################################################################################################################################################################################################

Water 0
Flooding 0
Waterproof 19
Razors 23
Growth 23
Trampoline A targets 1
Trampoline B targets 6