#################################################################################
#.*.\ \.@.* *  .. \.\ .\*...\.\ *.  \*#. \*.  *@ ..\ ...#                       #
#*.\.*...\....* \ ....\...*\.**!. * ..\*..\..\ . . **  .*#                      #
#****\.* .*\**..* *. .. ** * .* .*\* *   \*.\.**!. ..**..*#                     #
#.*. .** \. *.  *...* ..* *.. .\...*. \ *..*. .** .\* .* #                      #
#\.\.\..*.* . .**   ...*.\.*@  **. *.. **.\.*. . *.*.  .\ # ##                  #
# *.*..   *. .* . ** *.  .! .*.*!. ... *..  .*. .. \  . #. #\*#                 #
#\. .\.  *.\... . .\ **\   \.*.  .   .\.\ \..***! ...    * \..#                 #
#\  \. ... .*\  . \.*.\.*. .*.\\ \.  *  .\ . \..*** \*....\. #                  #
#.  . .. .\*\. ** ..* .. .\\\\* .** ..*   .* *. **\ \.. # ..\*#                 #
#*.  . .  .... \.  \  *** *  *.\*..\  ***....*..** ..*\* .L  #                  #
#\. .\.*. .     ..  .\..\*.* ...\ *..*..\*..*.*..\*  **...*...#                 #
# .* .\. ....\.*..\.\ .\...**. . .\ *.\.*.. . ..* *. . *. **##                  #
#\   **..*.  ****       .\ *\..   * **...\.\ \*..\ *\ ..\#\#                    #
#. \\..\ ..\ .\.. * **. .*\** \ .\. ..\. .. * * \.... *\..*###                  #
#.. ..   .**\*.*. * ..\*.. ..*.. .** \  ... .**\   *. \  *\@ *#                 #
#. . \ . \.* ..*.. ..  ..\.  *  * ***   **   .. .\*.. .*.. \ *##                #
#\..*.  *. @ .*.** \* \..... \...*.*..* *\.  ...* @ \. ..  .\.#\#               #
#..**\. ..   \.*\..\* ***..\\ *\.. ..* .. \..\..* \... \ . \.*#*\#              #
#*.*  *\..\* *\**..*.@..\.**...**\. .* ...  \.**... *\.*..\.\. **#              #
#.      ...*.*.. **.\ *..*..\* ... .\.  . .**..\. . .....\*. \ ###              #
#\@..\. *.*.....   \\   ..\*.*. .**.. \ \.*.. ..\. \*.\.*.*...*\# #             #
# .\     .* \.\*.  .\   * \*\.@.**.  *.*.\ * .* .*. .!. \\.  *.  **#            #
# *.\**\.**\. .   \  ..*.*.*.*. **....*.*\. *......*!... \**\.\#** #            #
#*..\.* ... .\.*  . \  . ****. \  **\..\ . *..  \  *.*  . .*...\*.\*#           #
# . ***  .*.**.   \\* **\*.*\*\....**. \\.**.   ..*.** ** .* . .\ ##            #
#*  ..*.! * *.**.*.\* .. . **.. \. .... *.\*.*. .   .*.**.*\..  .\#             #
#\ **.*...\.   \. * .  .\ *.*\. . \.   *\ *** *..*.  ..\.   .  * #              #
#.*... *\ ....   * .\.*  .*..*.\*\.**.. ..*.\..**.*\.*  . .      .#             #
#\. *\ . .**\*. *....\.\ ...*.**.. *..*.\*.*. ..*\*\*  * . . .*. *#             #
#***.!\.   . *..**\*. ... .*.*\.\  . *. ..*\ .**\ . .    . \ .*.* .#            #
#.\.. .\ * ...  .**.** .*.** ....   .!*..*. * .\*. .. . .  .**\.. .\#           #
#\**..\@..  ...\*\..* .*. . ..\   .   \*!..\\ ... ** \  ... **.*#  ##           #
#.... \**\**. \ .*.*..*.  \..\. \** .\.\  .*.  *. . . *...*.**  #* # #          #
#*.\*@ .....*\\ *. !*\ \.@.\.\ . \**\ * .**..  . *. *..** .*...* .. \#          #
#. *\.\.*\.*.**@...\* *.*..  \!\..*@*.. ..\. .. .*\ \.*.W.*.\.\. #.\#           #
# *..\.\ .** ... .\*\ \..   \  . .\** .  . *  .*\.\ ..*  .* * . *@* #           #
#      .*...\* .\.*\. **... .. . .*...  \.\.  .\  *\  \ *.. .  .\ #*\#          #
# ..*  **   ..\ . * . .. ...* . *   *..\. **  .*.*..\.* *..\*\** . .#           #
#*\.*...* .* . *  .\ .* ..*.*   \  *. *.*. . . .\ .! * *..\ ..*. \  \#          #
#\ .\*\..* .* .W...*. *.*@  **.\..*..\.... \**  *.. \.\.*. \ *..*.#*# ##        #
#.\.\ .. *\ .... *... .\*  *\*..  !* *.*.\*..\. \! . . **.. ... .*#*.#. #       #
#.*... \..   *\. ...   *..*.**.  !*W .. *.\. .  .  ..  .. ..\*** \... .#        #
#**  ..    \*\* \.. .*** *. ....\ .  \.\.*.\ *\  .\  *.  .\ .*.*    * #         #
#.*  .  .*.*...   . .* .......  .* . .\. . . . *.   ..*.. .**.*...*..#          #
#.\ .\..\..*.*. .*.*.*\  ..\.*\**..* *.. *\.\  *. ...  \. \. .  \ *.#           #
# *** *. \*. *. *\** \.**\ * *.  *.* \.\..* .\.!..*.. *.. . ** \####            #
#\. . .. * * . \. .* .*.**.  * **...  *.* .  **\*\   @.   *...   ###            #
#*  ....*\  ...*.  .. .W\.**.  ..**  . .... .*\ ...\.  *.\. .*\*.*. #           #
#.\ . .** ** **  .* .* ... .*  . .\ * \ \*.*\* . . . ....* \*... . \##          #
#.*.\  .  .\   ..** .\ *\\ . .@..*  .*W\.\\ **@ *.  ..\.**....# #*..**#         #
#.** *\  .  .\\  ..* ..*....*.\**  ...\. *.*.*\ * ** . *.** \ . ** * \ #        #
#**.   ... ..  \** *...\ * .\..*!.***\W.*\ .*. *W. *\@..  . * * *\.*###  #      #
#.* *** * *... ..*  .\*... *.*** *.. .**.. \.. .\.....\  \* \ *.\.. *.###*##    #
#.*.*.\**.*.*.....  * .**.\*. .\ *....**. *.\  ..*\ *.***.* .*....  @#..#*\ #   #
#\.*** * .*..*  ..  .*.*....\ *.**** ...\ . .    ..**\.\.\*\ \.  . *. * . * *#  #
#* .**.\**.***\..*...  *  *\  **.. R  \.**\  \ \.\ *. ..  . *.. .*\.\ ...*###   #
#. ..** ..\*..  ..   . .* ..**@*.  ..\. .\.**.\. *...** *.* *.* *#.  *..\*\#    #
#.\* . *.\....* \ ...\ ..\. ..**\   .   * .! *.. * . .**#\*   ..  .\**\.*###    #
#\ .*..*   *\ \* **.  *  *\ **.. \ *.*\*\ . .... .  \* * . .*\ *\.*  \#.# # #   #
#\.*.\.\  .  .. **   .*.* \\\* .\. **. *..! \...\ .... . * ..   * *  #.#\#\ #   #
#* .. ...\  \.*.\ .** *\..* **........ *@\.\*\.   *....   *** .**\.. . **..#    #
#*  .@ *   \  .\.\ .\..\  \ *..*******\*\* \*.    ... * \.*..\ **.***.... ..#   #
#*.*\* . ...\.\.\. !  .... .\* . .**.. *...... . **  *.@. *.*. .  ... .\#\.!#   #
#.. *..*.**\****  *\ **..    . *  **. .* \ \ ..\@.*\.....*\.. *. .   .*#####    #
#.\ *.*.*.*\....\\*.... . *..\. .* *....  .**.. . \.**\...  \...\\ **\.*. #     #
# . ..\ .*. *..***\   .\.\   ** .\*.\.\.*. \.*... .... . \..**. *  \. \#.\#     #
#\  \. *.*. *\ ..**\.\\ \*** .. .  \ . **....**. .. .. ... ..*. * * . ..**# #   #
#* * * .*.\... !     ...*... ..\  *\  .***. *.\*.  ..\\**. \.*.*.***\* * ..#\#  #
#* .**. .  \. *.** * .\.* \.\ ..*\..\   .*  .*.* * .*.\\....*.* ...\ . .  . .*###
#.\.*.*.*.* ** ..\ .  ..\..*  *\***\...\\. \*  *..  W\.\ * @. .*\   .\   ...\.\.#
# .* .**...\ \. . ..\...*.*.* . ... . . \..*@...*.\*..\.*. .\.*. ..*.#\ @@\.#####
#\ ..\\..*...\.**.  . .*...* \   \ . .\ !* *\* . .*. \ .**   .*\  \.. ..\# .#   #
# .....@.\ ..\**. **....\.*. ..* . *\.. .. .*. . \*.*.\  * .**.*.!.* ..*.\##    #
# *.\.\.**. * ..**.. .* * *\   .\....* .*.  .*.... *** *.* \... \. #\ \ ##      #
#\..  . *. \*\. ...  *.*.\. .* \ *   \ *..  *  \.\*\.\  .  !..*#.. #  ##        #
#. ...  . ...\  . .*\.. .*.......    ..*.*  ..  @***   \* .\*.   \ \@#          #
#*.\  \*. . *. *. \.*.. \.\ .\ \.\  \. ..* **\...*.*\ \...*.\*..\#.##           #
# . . .. \\.*. *  .* \*..\..  ..**  . *...*.*..*@*..  ..**.. . *#. #            #
#. .*\ \ .*.* *. \ .**.*.!.\.* .!*..*...*\***....*. ** ..**\  .\ #.#            #
#.**.\..\.\ ..\. .\*\..*..\.\..*.W\W.* **.*..*....* .*   ** ..\.# #             #
# .\*. \.*. *\. ** . .*..*... .  * . *..W \.*@**\.*. ****..@\.*#                #
#*. *\.... *\*..*. ** . . .* .\ \ **... * . ..*.  @..!.*\ *# *#                 #
#* .*. *. .**..\.* *..\.* *.\ .*.\*.  . .*  * .. .*.\.**.\.  #                  #
#. ..\ *\*..*.\. \ ... * .*.     .\..*\*.*  *.**  . .*..* * .#                  #
#. *.  . *.*\   *.\..@\*..*\ *...\ *..@**.  * .. .. .\.  .. .#                  #
#* ..\* \.   *\ \*..\**.*\ ... ..    .. ..*\...*. . .*..***.*#                  #
#. ...*. . . *.*.**.***\..\.*  .* ****.. .. *\ ** .* *.#.*\ .##                 #
#\  @  *  ...\*......*. \.. .    *\..*.\.*....   ..*.*. .\#  ..#                #
#.\ \ ..\*\*\. .. \ ****.   .. . .*.\....* \ * *.#.**..*..*\## \#               #
#\.*. *\..**. .\ *..\*.*.\.**\**.**\*... .\ ..\... .#.*. ###  ##                #
#* .. *... .**  ..* \.**...@. \.\****\** *.\ \.*\#\*\ \*#                       #
#*\  *** * \.  .*\.\  ...\. *!\ . ..\.\.    ... *.*.* ##                        #
#  **. \*.\.\ .\*. .   **....\    \ .*\ *  *  \ ..... **#                       #
#. *.  ***.\ *****\ \.*** **\  .. ... ..\. ....***..* @#                        #
#  .   .**.* \. \.*.. .. *.*.   * *  .** .*\ *..*.#\.#\ #                       #
#**. .  .**..*\ * ..\.\... ..*..\ * \...* !**.  \  *@.*#                        #
#...    *..  \*..\* \  .. *. \.\*\.. .**.*\.. .* .\##.\##                       #
#.  . ..* *.\ .  . \..* *..\ . ... .*...\..***.**..\.#.. #                      #
#*.*..  .*. *\* . . .*.* .. ** *\\.*. * #\..**.* \**.####                       #
#*    .  \ .. *. ** . \* \.... *\ .. \#**#\.*#*.. #.. *#                        #
#.. \ \.* ***. \*\.. \*\.*@ ... \*\ . \ .## ##.*..#\.*\#                        #
#.\*  . . \.. *.*.* *.. * .... ..* *.!.  .## #..\.#..##                         #
#* ..*\   \ .*..*. .. . .. \\..*. ..*#.*#\#  # ### ##                           #
#* \ . ***.. * .\. # *.  \. **##\ . .#\*##   #\\#                               #
#*... *.*.##\..  . . \.\ ** .# .* \*# *#      ##                                #
#\* *.!..*\#.**. \.*\.\ \.. * #..\## ##                                         #
#################################################################################

Water 70
Flooding 14
Waterproof 0
Razors 49
Growth 49
