#######################################################################################################################################################################################
# \...*\.\ ..\.. .***...*\****.*... \.*.* .@  .. ...\.\.\  *.* * .\.*\*!. \.  . * \.**.. *\.** .. \. ..*. *\..*\..!.**** .\* ****.. .***. .\.***..*\ .. \ . .     **\**.  #           #
#**. \.\ .   **..\ *\.\** *.\...\*.\.\. . ..\. .\..\  ... *... *.\.*  .\*.  \*..\\  ..\.\...\*..*..\.\ .  . .\  *..\. *.\*   * .   .** @*.*.*.... ..  .\.*.!\.*.......*   ###         #
#\\. ...*.\**..*  ... * **  ..* .. .. . .   ...   \\\* \ ** ** . .*.*.\ ... .. * ***\ @\.\.@.. *.. .... \ .  .\..* .**..   *\. \ ....*.....\. \. \.\  **\.... \.*.*\*\.. .\ *#        #
# .\*. \. *.\.\.***.\*...*..*..   *\.*\   .  \*\ .  .\\..*. * * . \ . . . \.  .* .. ..*.. ..**.. . \*.* .\ .* *.*\\. \*. \...*\ .***... \.  \ * \    ..\ ..* . ..*. **.*.* ##         #
#*. \* . \.\@. \... .. *..*\ ..\....  .*. *.*. . ...**.* *. *..* ...\.. .@.. **..\. .\.*  *.*.  !. .....\.\ \.\ .*.\*\. . \ \........  *  *......*.** \ \.  . *.  * ..\..*#           #
#.  .  *\.\..\*.\..   ***...    * *\. ***..*.. \*.*\\*** .\   *\*.\.*..\*.\ *.* .   .\.**. * *\**. .   ** .*. ***.\.. \.*. \.*..\ .*. *...  *...\. .\\.\.\.  \. **.*   * .\##         #
#.\...\..   * .. . .  *..* .* **... ! *..\\...*\. \. .@... ..\. \.\\*. *..! .* .\!.**. ..* \ . .* \ * *.*. .. \...\ *.. ...  . .\. * \.. ..**\W\.\* * ..***.*** ..*.. . . *.\#        #
#\.  .  \ .*\\ . .. .\ * *\  **\*.**.\.... *\ .** . . .. . .. .*\* *. !\.\.\..\*.. .**.  \ ...\ ....*** . * * ..*  *\ *. *\..  ...*  . *. *.... .* .\ .\ *\..*.*.*. .. \    #         #
#!. . \\.\.*.  \*.\ * \*.*  *** * . **.  .. .\  \ .   .*  \ \* ***. *.*. . **\. . .\.*.*\. .. *.*..****  \\  *.\* .\.\. .\.\!.   *\.. ..  *  .*.\. ... * *\*\.**..\ .*.#.*#\#         #
#****. *    **  *.. . *. . .*...*.  *      .*.* \  ..***. .\*.*..\. .*.*\\.\   \.**. .\ .....*. . \....\...... .* **.. *\  *.*    * *. .\*. *\* .**  . * . *.  !*.* *.*.#\ .###       #
#.   ..*\ **\*\*.   * .\ . *****\ .* **\      . ..* .**. .   .*.* * @....* . *.**..*.\.*  ..\. .*  .\.. *. \. **..\.*!\\* .. .\ .   **.  .. **.  ..    \. \.\**.*. . *. *  . .*#      #
#..\.* \.*... ...\.\...... \ . \! *.*!\ * *....\* .*....*.\.*.*....\ \*\*.* **\ \. . ..    . \\...*\.. *\* .*... \ ..\*.*..***.   \ *\ \....*..***  *  . .* .\ **. . .  . . #*#       #
#. . \. .... \*.. .! *  \ ...*.... *\. ..\.\... .. *. .. \..\...   *..* ..  ..  \ **\.* .*   .  .*  .  ..\!*.\. **.. *.*. *.*.. **.*\.\..*...\*\.**.. .  ... . ..   *.. *..###        #
# \... ..  *\... .*  .***.  \..***\.  \. .\   *. *..*. .  ... .\ .   .\ **.**.  .... .*\*.*.*.*\. .   ....**\** *.**.\...  .. ...\.\ *. * . . .. *..\ \..\**   \.    * .*##.@##       #
#@.* **\...**.  . .\.* \\     *.\\.\ * \ .*..\** . .. *   .*. ****  .*..*\ .\ * . .  \. ..\*\.* .*  *. .*.*\ .*..\..*  .* .\.@ . **. .* W ..\*. ...*.\. .*\....   \*.. ......#.#      #
#*..@..!\W* *\. * .. .*.*.. **...** .. . . ..\.\. *.W*.... .. *..* . .. ..\*.***.\. .  \ \ ..**.   **.  \\@. .** \*.\   \\.  . \ ....  .. .\.. *..*.*. \*. \@***.. .... ** *## #      #
#\. . . .\. ..* . .. .\ *. *\.* *..\  .**\.*\.. \***.* . \ .*. .\. ***    *. *.*.  *\  **.*..*..*.*.!    .*. .. * @\    .* . @.. .    *!.. .\\ .. .*\*\. \ .! *.* \.*\* .. \##.#      #
#* .. * .  .\ . .. *    ..***.  . *. \*.* **\ ..*** ..  *.*.*\.\*  . *  ***. .\*\ \. .*****..!.....**.  * ..*...*\*  *  \\**.. .   . ...\.\.   . .* **..\...*.*\ ..*. ..\  . ...#     #
#\..*.\ * @*. ..\.\*\.. *. .*.* ..* .\**  ....*\.  .  ..  .*\. ..\ * ..\..\.  .. \ **.*...*.* \  \*.*..*\. *..*...\*..*..\. *.**\*.. *\...@*     *\ .. **..  .\ ..\.*\. ...  *##      #
#*...*\.\*.* \* *\ . ...*.*.. ..\...\.\  \*.\\.!**.\*\ * . .*\ * *.*  ..* *\. ...* . .. .\. . . *.*  ****\..\**. ..\* ..\..\...\ *...*. \*.\  *..*\ ..\..* \*.**  .***  ..\..*..#     #
#* .*\.\@. *\..*.. ! *!\.\.* *\     ..!*...*    *. ..* **. *  .* * \.\**.\** .\****.* .....*.. *.*.*...*...  .* .   !\ . .\  .*..\ .. .*\..***  ..@*\ .\ * *.\....\. \# . *\ # *#     #
#*.. . .. *...  *   ..... *.  .....\ . *  *. \......\...   \.. .\. .**.* .*** *W.*...\*. .*\ * .... .*.\\@\.  . .**   .  .  . . \     ....... *.. *. \* .\ *** *  .\.. .*  ... #      #
#.. R\*..\\.\.    **.!\.\..*.\ *.***\.*.*** *. !.\ . . .. \ . .***\ .  ..\..*.\.    ..... ..\.    *  \\ . .*..  *.\ *.\*\ *..\!..* ...\\. *\\..*\.*\. ..\ \...* \  \   *\.. * \#   #  #
#\.*. . ... ...*.*. . . ***. \*.   *  .. .* *.\*. .\.  \...**.\*\*.  .      *     *\  ... .*.  . ..* . \  \.  .\.*. \. \**. * \**. .  *. .. . \\ .\*..!**\.**.. .  **.!\**\\# # ### # #
#. .  * \..*\  ..\*....\\.\** * ... \*.*.\* .  ... ..\ @  \ * *. * \ *@. \ .. *. *..\.\.  . .. \. .****\\*W .\*..*\*... ..  . .  !\ *..*  *.\..  *.*\  **  .* . .\.!.  **.   *.#  .\*##
#.**\.\. . . **\!..! \ ** .....\. ....\.*.  .**\   **.\* *. .*. *\. *.. . . \*.* .\  ...  . \*. * ....**..   .*..* ** .\.\ . . \  ..* .*.\.. ..  ..* .*. *. ...\  \*\. .****\*##\*\## #
#\..   \   *\ \*\@\ ...*.. *  . .   *\    *  *.* . . ....*\.....\.@.* *  !*  ...**. *....  .  ! . *. *.\.. .  !.* .\.*  *. .* \ . \ *.  .*.  \   . .\ .**.. \ ..*..\..\** ..#.#*!*.#  #
#... .... ..* .* *..! ..* *  *.**  \.*.\...\\.* * * *.. *...\* ..\.  .\..\. .   .*  **\*\ .\..*.\  .. *. .\.** * .@.*. \.\... .\.\.***.\ ...\..  *. *\*.  *.\W.***... *...*****\***#  #
# !*.. .  \*** ....\*\... ...* *\.*.\ ...! *!\* *..*.    ..... * \..   * . *..\.*\*.*. .**\..\.\ **. \..** ..**. ..... .\  *  \ . .*\\  *\.\   * .. * .  \..*.*.. . * .\ .*\*.* ..#   #
#*\* ..*  **.@  ** ..* .  .* \**...* *.*.\ \  *\*\ *   \*   ..\* . . .*.. \..  ***... .\.\.*** *.**...... .. *.* \. \*\\*\...  *.. .     . .*  .\.*.*  .    **. ..*. *   ... \. \ *#  #
#. \. *  .\**   **. *.\. .*... .*  * *..\\..*@.\.\.\..*.\..\ *.. .*.\*..*..*.  * .*\@*..**.*.\ ..* * **   *. *. .\  . * ...**\. .****\*.\\*.   *.*. ...\*  \*. . * ..**\\ .*\.  *#.#  #
# ..\.\.**..*. ..  *** **..\*   .. *...!.* ..*\  .... \ *\ *..**.*. ..* .\ *\**..!\ *.  ..**\  **. ...**.@..*\... .   \. ..... .*...... .... * ...*  \**.* . \ ....  ..* . . \.*.* .# #
#*. .  * .. .\*.  .*..\.\*\ . * *.\. \  *. .*. \!  *.\..*  .**. . *.\. * . . ** *. @...  *..  . .\ * *\.*.....**\\\  \.\ .*\** *\ ..\ .\     . .. W\*. *.@ ..\*\..\ ..\. \..\ #\@\ #  #
#...\..   .\.  ..... .. *.*.  \.\.. *** .  \** . *@\ .**..\ ..* *.. .* .. ...*\\..*.\ . * . . *\.\.  ... . .!. *    ..\ * .*.*\  .*.*\.*... \ . .\ * ***..  .. @*. **.* ..\...* \ ..# #
# .** \ ....* \..*  .   .\.*.\. *\..*\*\ .... ..... ****\\ ** .... .*.\ ** . .* . . . \ .**\ *  .. . * *. **..** \*.....*\.. .* \.. * ** *.**.\.  *...*..*.. .\.*. \..*.\ .** *\.#\#  #
#. .... .  \*\.\.*** *  .*.*\...\ \.*. ..    . .\ * ...\ . . \  **\.\.\!*.* *\*\ *\*.....\.*.\\ . .* .**..*.*..*\  *. \. . **.. .\.\. .\. \.. ***.\ \\**.***  ...*\** *    **.. ###   #
#* .\ ... *.**...\.*\ \ .\.**  ..\*W.**  ... \ . \. ***. ..**..\ . .*  *....*.  ..*  *\*   .*    .\\**.*  .*.@ .\.  * . . !... . ...  * *.\.*...***..*.**.** *. \.\...\ .\   *\ ..#   #
#.*\.\ .. *\*.**\* *. *\*  ..   *..  * ..***. \ *. ... \! ....\*  * ***** @.. .*  *.\\**  . \   .. ... . .**.** ....*. . !*  ....  \. ... * \ !\** ! .*** .. ** W ..* . ** ***# \ #   #
# .. ..\* .**..\....\ ..\.. *\  .*\ .*\ .. .\..\...  \ .* . .\..*.\..\.\** .*\ .\ \.*.*.*\ .. *... \.  . ..*. .* .\.\..   *\ \\  *.\   . \.. ......*  .*W.  *.\.*\. .*.*...\**  . \#  #
# *\. * \  .\* .   *  \ .\\ * *\ ..**** *\W*..*    .*.. \. .... . *  . *.*  ..  \ .*\*. ..\ . *.. . \. *  *   . .*.\*  *\.*  *\ *. *.. ....**.. .\.*... .....  \    *.*..W\.**..###   #
#*.**\. * ....\ .\**  .@   .  \ . .** ..   .**. . .**   . * * *.. \   . **\.... ..  **. .. .*.*..*\.*\*.  .*. \.* ** ..*.*..@.. \...    ..\*..  \.   . **.*. *..* ...\ W***\.****.#   #
#..\.  *\* .*\.\** ...**\* ** .*  .!*\*..*\ ...**\ .  .  .\.*.. \..    ..* .*.*. . *.\ *. .*..  . . * \ * .* .. \*.*. \...*...* .*!\   *\** . . ...**  .*..\ .\ \ .*.\* ..**.\..* #   #
#.\.\.  ...\.  ..\**\ *... .* ..... ..* .* \. .*... *. *..*.. . . *.  * ...** . .... *\.*.@*@*. \   .  *.*.*.*\  *.  \.**.*. .. ..  *  .* .  ...**.\ \. \.\  .  ****...\.. ....\ *#   #
# *\ \* *..\ *  ..*...\ \  **  .**.. \. ....* .\.**.W...*..  .  . . W...   *.*.\..* *** . .*!*... ** ..*....*.*  .. *\..*.@** !. \\..*. .. *..**** .**.* .. *\.\...\.\* .\.*.*\ ###   #
#.....\    **.   .*  .**!.\.\* !**.*\.\...\ .  ..\.*  * ....  *  *.  ..\\\** .\** . *\. .\*\..\**  **\\*. *..*..*  . *..***\... ... .  .  *\*. .*. *\*.. ..*..\*. ...*.  @ .*......#  #
#\.* . .   .*    .**\ .*.*. ! .**.*\.  \ . * *..\* *..\\*\ ..\* *\\.***....\*\..* \ *\..* .@.  *. **\.**... .......\.\\..\.  ..\ .\*\**.* *.*. *\...\*. .. ...    . \**.\.  ..# . ..# #
#. .\*.*... .*\  *.**... ..... *. *. .***  .  .*.@.\*..\..  . .  *\\.. .\.**** * .W\..*** \*..\.\  \...*.\...*\.* ** * . .\.\.\*.*.\*\..* .*...   .***.*\ ...*.*\. . ...*  .\#@\*..\.##
#\ * . !...  .  .* *..*.. ..**\.*.\.  ...  .*.\ \. .\  *.*\. .\\ \.\. .*\*!.   .\.\ \ *..\.\. . \ \..\ .* .*\\. . .* \...\* .*.\. *..*  ..** **\*.  .... * .   .  .    .# \ . \*..# ..#
#.*\ . *.\ .  **...\  ..**.*...\.... \* \*.*... ..* . \. ..* \*..*\  *.!.*.  ..**\*.. *.\  **\ . . *....* \* \  *  ..*....\. ..*  .\.\....\.\.\ ..  \\ .@...*..  .* ..\. **..\ *\ *####
# **.. .*. * *.\. \... *\ .*..\.\@.*.  *.*\\ *  .**** \ . ....*  \*. *. \..\..\ . *.. . .  *.  \  . .\..\......\.* \ . \.* *. **\ *   \*!*\..  **\.\*\   *. * .\.*..*.   .  .*. ..#   #
# ....  *. ...*..\  .. .. .\.*.\ ..\  *.*.*. .* ..*.. \.. *.** .. .\ *...* .@ ... .... . * . .\\   .\. \*    .. **. * .* ..** .  \ .**\..*. ** \** ..\..*.  . \*.....***@  ....\.. ## #
#.\ * ..\. \**      \. \* ..\\ ..\.*...\  *\.\.. *..* ...@.*\.@*\.\     *.. *.*.\ *\*.\.\*. . ...*. *.\* .  \....**\... \**..*** .... ..\.. .* ..\. .*\ ... . .*. \*.*\ . .  .*!\L*#\##
# * .**.    ..\*\*. .... * ..*\  .*  *.  *!* .  \. .. *  * **...*. .**. *. .**. ... .*  ... *\*. **..* .*   ..    ** *\**.**\....\* *..\*\.\   \. .. *. *.**.  . . ..*!@.*.  \.\ *\. ##
##*..**. .  .\...*\      ..*  .!\  \..* **\* \  ..*   \*...*   \*.  !*\ \ \ *\   . ...*\ .*.**..\..* .* .*\ * ****\. \.**.* * . *...*.\..  .\ \. *   **.\..    ..\. * *.**..** \# #.*##
#.**\ *.***. *.  .*.\*  . *.***. . .\...*..  .  .*.\\ .\\  .  .\.\. ..  .*\*\ *.\\. .\.**.....\.**..\.  *..  ..\...  .  .*. . .*....  .*.  *.... *\.***\ ... .  *  *... ..*..#.  ..## #
#*#* ..****  ..*@*\! \*.*\* *\\.*.\*. \ **\*.  .\.\..**.\.\. \* *.  \*.***.*.*.\. \ *.*.\ ..\..*..\  .*.. ! \  .*. ..\*  *\**  \ \. *\*\  \.\*..\@.*@..** *.\ **.\..\*.  \.*\.  \##   #
#######################################################################################################################################################################################

Water 2
Flooding 7
Waterproof 1
Razors 39
Growth 29
