###########
#    ##*.*#
#   #.@*###
# ##\ @.# #
## **\..# #
## #.. RL #
##* . .\# #
# #.  *#  #
###.. *#  #
# *. ##   #
###\.#    #
###########

Water 0
Flooding 9
Waterproof 1
Razors 9
Growth 30
