#####################################################################################################################################################################
#* !*. .@..\*.\ .. .*.*  ***..\.  .* \.\..* \  *\.*  . .*. * ..*. ..\*   ***. ** *  \  *.\# ...\.*.*#. .#.#                                                         #
#.  ....*  *\  \. .\**..\.\*.. .*. * * *  .\  ...\*..  *. .*  .@ * .*.# *.. @##*\*\ . \.\.. \..#*  .\*.#. #                                                         #
#\    ..\ ...\*   \*.*  .*\@......\ ...*  **  *  *.. \ .... !* ... *..*#. \# * *..* \  .*  *.  *\ *  \ .*#                                                          #
#*.\. .*.*\* ...*..*..\.**.*..\..  **\*.\ .* ..\..****. *.   .\  .\@\ ..\ \ \#**..*\   .. .**..*\\*.*** .\#                                                         #
#*  . .. ..* \.* *\..\**. .\  .* * *\*\.   .. ****.  *  \..  *  . *.*\.*.**\.*.*. .\  **.*.@.***. .*  .\. #                                                         #
#.. \*\ . *. .\. *.  ...** . *.!*.**. **  *. \..... .. ..  . * *   \..... .\.**.* ... ***\.*.\..@ \  ... ##                                                         #
#\**.*. *...\ * ***..\. **\  *\ .\..* ..\.\  ...* .   *.\. \*.\.\    * \ *\. ...*. **..**.* . \ .   * *.*#.#                                                        #
# ..**.\  .*\. .\...*   *\* ...  *.\*.*.. .. ....*.  ...   .*.\\ .***.*. .*  .. . ..*. *\ *  .*\. .**...\*.#                                                        #
#. .*  .**..\*.  .\ \*.*\*.\ .\  .\\.\..  ..*..  . \.*\  .. .\.*. *   * \** *\\* ...*  . \**\.#..\   ..\##.#                                                        #
#*..*\ *..** !.\. .  .\.\.\ .* .**.\  .\.*. ..*.*. .. *     ..\** . \.* .*. **..\    .  .    *\.*. ***.*** #                                                        #
#\ ... .* .*\.\.   . .*\.  \ ......  .. .@   *... .. *\ .*.* *.*.\*. .\.\* **.. \*****\\* .\ \.... .!..\.##                                                         #
# . ... .  .*.*.*\.\.... \  .. \ .\  * .*.  *.*\\.*  ..    ...* .*.*    .. ...\..*..\ \***\ \.*.  ..\ \.* #                                                         #
#*...  ....*. \**.**\ **\. *.. .**. *\  *\ *!.\.. .  .*\...   .*. ...*\  .\.. . *. *......!**\. *\.*\*# * #                                                         #
#\. .. *  \   .....  * . . * *.*.\ !** ..****.!   .***... . .* .*\  ..* ...\..\.@. *\.\ .\..* \   # .. ###                                                          #
#** ..\. \ .*\.* \  *..*  \\ ... *.*\. **\.\.\. .* ..*. ..*. ****. **.  \ .  *. *  .... \.\ * *.. \**  #                                                            #
#.\. \  .** .. *\ ..\*.\.. .*.\ .. \.*  .  .. \..*. . .\ ***\. ...*..**\....*** *..     \ .*\...\  *\*.\#                                                           #
#\ \ *  .**.*  .** **\.*..\..\.*.\ *.. .*\.\* .\*. .  *\.* \. *. \..\...*\ .*\  \.. . *\.*  .** .\.**.\ #                                                           #
#\  ... *..\. ..*\ .\ **.\   .\**.\*..\. **. \ .\*.   . ..   ... ** *\*.. ..\*\. .\\  ...*..**.*\.*. ..###                                                          #
#***** .. *..   .* .\ *. .\*. .. ...  *.\... .\ . .  * ** .   *. ...* ..\.  *.  . . ...\\*...* .*\*\. *..*#                                                         #
#  ......\.*.. *...\ * *..*\.\* \*\. *.* .*\* *. .*  * **  \  .    *.. **. ...*.* .  *....  ..*  ...#\# #*#      #                                                  #
#...*\...  *. \..  * * * ...\..\ .**.. ..** . \ . .\ * .. ... ..*.* * *..* .* ..\... ..  .    ..**. .\#***#   # #\#                                                 #
# **\.. \*\..*.*\**\..\.\*\.* \*\*.. ... *\ .\. **.  . .. .....\...\.@!* *. *\* .\  *\ @*\..**  ...*\.\*@.#  #.#**.#                                                #
# .  .*\ **.*.*..... *. **  . ...*.\ ...!...... \\\ .\.\  \.\.... *.**.. .  .\  *......  **...\.  ***. W.\####*## *#                                                #
# \ .\ **..\.\ \ \.  .*  *  \ .\*.... .**.. \...... \ .**  \*\...  **. . \ \.. ... . \* \** .\. ..\.. .. \  \.**.*#                                                 #
# *  * . *  *. *..**... .**  .  ..\ . ...  .** !\ .. .  . . .  .  *.... *.. ..\.@.  . ...    . \*. .\\*\.. #  W\##                                                  #
#*.*\ .  .  .  ..... ...\\..\.*.**.** \  \.  * .  \ .\ .* **.*\. ***.**....\ *\****.    .* .\ *..    \*   .  \.**.##  #                                             #
#. .!.*  .  . ..\.  \  . *..  .  *... **\* .*. .  .*\.*..\*.\... .*\ .. .\\.....  * *.*  .    .\. .\.\*\. .. . .*\*.##.#                                            #
#  *\..\..\*  *\\  \  .**.. * *\.* ..***.*\ \*\.\  .  *.\**\. .*\*.  .* ...* ..*\*. . *.* .*. *. ..   .@*   \  .*\.## ..#                                           #
#....\..* ....**   .. *..@. . *.*.\ .. .\.@. . .   .... *\ *. ***.\*..* **.  . .....\ . \....* ..* ...*.*\**.*   ...\ *\##                                          #
#.\   *\*R  .\\****..* **.!.  * **.* .\W...... ... *\* *\. ..*\. \..*..*.  .....* . ..\..\.  ..\***\  . . *#*\ **.  ***.*.#                                         #
#*.@ !*.*.  \ . \.\.*. .\. . .. ..*.\      \** *  *.* *** ..\.@ \.  \.*.\* *.*. .. .    **\ .\..\\* \\..  .*.. \.*\.*....##                                         #
#.*. **..... ....  \.*\.*.\*  *\   *\** .  .*\.**.  \  *. **.*.\. \.... ..\**..**..*\.\\\*****.* .*.. \ \ ..*.* .*.\ .*. *\#                                        #
#.\** .*..*.  *\   . . .\* .  ..\ \..*\ **.. * * . .. ..* *\ *..*@.  ..\ \ .*. *\* * \  .*..*..*\ *. ..  ..\\**  * .. # ..*#                                        #
#\..** \.\\ \ *..\   .\* *...*@*.* *\* .*\.*\. .@ ..   ..*.\..**.*\ . .. ....* .  \*\ * .**\**\* *\ *\.    .*...*\ .. .  *#                                         #
#..* !   . . .* .. . \!*..*\...*.\   .**..\.*  ..  *  \***..*  \ .\  ..  ..  .* **\*.***.** .. *\.**. ..\.\ W\ *** *\. \ #                                          #
#*\.\.*.*\*\.  *\ \..\ *\.\. ...... . *\  *.\... \.*\*.*..*.\ ..\. .*  .*   ... ....\** ..*.   * ..*. ..*..**. ...\.*  *.\#                                         #
#\.. .. @ ...*\*.*. \ .\..\* * \* \* ..*\.* . ...**\*.\.* .. .  .\  .. ...*.. . *\\ *.. . ..  ..\ *..* *** . *.*\*.\**..  \##  #                                    #
#.*.\. .\    .*.\. .  .  .*.\*. *\. ..\*. \..\. \.... . . .\\.* \ . **.\*\. \ ! *\ ..* ..*. *\\**\*. \ .\ *\*.....\**\* **. .##.##                                  #
#.* .   *. .. \. . * .* *.*.*.\.*.*.****   **  . !.\   ...\*. .*..*\*..  **.      * \..*.. \.. .\ * .  \  ..* ... * *.\*#\ *\  *.*#                                 #
# * * ..**. * *  . !\ * .**.....*\*.\.** *. .\.* .\ . \ **\*..*. \   ...**..  \*..  ..  * *\ *. .\.\*.*. \  ...\* ..*\..\.. # *. .#                                 #
#\. *. ..\..\ **\ . *..* .  ***..*.*...\*... * .\**... . ..*..\*. * . ... .  .W...... * * ..* *.\..*.......***\  . .. .\# \.  #*\ ##                                #
#*. \ *  .**.**  *\***. **  \..**. . .  *\**.W..**\\.\  \....* *\. .\.\.\  .\**. .\  *. . *...  *\ \.*. \\  *\.  *.*  \. .. *.** #..#                               #
#\*.\. **\.. .. ....** .*.\*  \ .*.** .**. ..  \.\****.*   .*. .*** . *\*....\**  **\ \\.\ *  @ **\.*..\ .  *.*.**\\\.   .* . ..\... #                              #
#.* **. .** . *\ \ \.\.!* !.\\ .**  .....  *\*  . * \. .  .*\ ****.  *.*..\*.\.*\ \.*\..*.*.\.**.\ *...*..*. *.*.\!!..\* .\*...* **..#                              #
# .  \*  .. ....\ . *. .* .\ \ .** *\ \* \ . .\.!.... .*..*......\. *\ . *...*\..*. *.  *..\ . * .\.**\* ... .   ..*  **. .\* ..\. .#                               #
#  .  ..   .. .  .\*. .*.. .   ...** ...\.*.*..*. .***..\..!. ..\.* \   .. * .\...  ** ..\ ** .\ \* *...  .\ .*...**  \.*.** *.\.. .*#                              #
# \   *.\ \.  .!.  ..*   .\.*\.** .\.....\* ..\*.  .\  *. *  \ .\.** * . . **\.! *.\. ..*..*. \... * .  .\.\  \. *..\* .!*.. .\* \ \#                               #
#\  *\*\*  .*.*@. *  ...* . .**\.\\.  .*.**  . . ....*.   \ **.*.**\ * ..\. .  ..*.*..\..* .\ .  ....* ..***\.. .*\  .   *. .\.. .*#           #                    #
#****  !*  \.\*@.\. \ .*. * *..** . \ \.\. *..... **.    *\\\**. * \ *\ .*\.! .. . **\. .. .*. *.*  .. **..* .\ . *   ... ...* .\ #  #        #.#                   #
#....  *.*.. **\*.\.  ... ..    ...*.....  .*\\.\ .** . ... .*\.  ..  .* *. ** \.*\.\*\. ..\ \..*.    ...*.*.. .  W.  .*.*   .*. *\##\# #     #.#                   #
#.\. \...*.. .\*. ! \*.**.* *..*****.. ..\@.*   *\\.*... * * .* * . *..  .. ..*. !.  ..*     .. . *.. *..\ . ..\.. .*  .\*...\.##.# #.##.#  ##. #                   #
#\.   .*. !\ . ...* .. *  .* *\.....*\    ..*\.*\*.*. *** ..\**.**  *.  \. ..\*.@.\.*..*. .. ...\ ...**. . . . \\.... . \**. *# ### #\.#\###*.#**#                  #
#.*\ ....*  \*.*\.    ..\.\  . * .  \. W* .\. ..*..*.\*\* \   . .   *.\.. *...\*  * **. .* .*..\*. .!\.*. *..*. ..* * \ *\ *.!\#  .#*.*\.# .*. *# #                 #
#. .. .  \!*..*\   .*. .. ** .*. *. .*\ !*\*\ .*.\..**...** . \  * **. *.\.\ *.. .*...   .. *@.*.** ...**.. *\ ...\ ..... *\*  *..*.\*# .*#..  \  #                 #
# \ *  .\ **. ...\     ...\.  .*  \* \.*...*\*\.* .** *\  .\.*\. . \ *\* ** *** .\.\    .*\*.\.* ..  * \**. \*\.. *.\. .*.* .   ..#@..*.*.. * . .\#                 #
#*! ..\..*\. **..\. *** *\...* . * .   *\*@. * ..\ * ******* \...**.. .*..\ .\*\. \** .* . ...   .. .. *.  .. .   . .\ .**. # ... **  . .*.**\.#\.#                 #
#* *\.   ..*.*   ..*\ ..*  .*.. ..\\.*. .\*\.*. ....  \.* .\..*  \.**. . \ .\ ...\ ... \.. *.@. .\..* .*\. \. .   \. ***..**\**  .**.*\ .  \.. **..#                #
#***.\   \**.. *\\  *..*\\  .. ...*. * ...*. ..*\.*. * ..\    .**@  *  .    ..  .   .* .* .\ .     .. .* * .*  \.*\*.....\...*.***!*...\. \ *.*..*.\#               #
#.**. *.  ..* ...  .  \.* *.*. \.*\  ..\*.*@. *.. .\.\ .*. *.\ ...\.. * \.\   .**.. **!. .... .\ *\**\*.... . . .* * ..\.\.\.  \..   *    * ..*..*.##               #
# \. .*\.. .\*   .*.. ....  *. . .\****.. \.\   ..\ ...\.* ..* . *.  \. ..*\*..* .*\. .\   . ...\...\*@ \**. \.\*\.*** \*.**   .*\.* .\....  *   * * #              #
#.. * . ** ..*  .****  .\.... .*. .*\.*...  ..  .. **  \ \.    .*\  .. *. ! *\ .* ....   *. .*...\. .\.**.  *..*   \*.   \.* .*.. \ ** ..*  \.. . \*#               #
# *. .*\... *.** .\.* ..** ...  .*****\ . . *.  *\ .*\ !....*\...*\.* **\. ....*.. .\. . .. .***...*** ..!   **.   *.  **  *\.*.\.  ..\. . \.\.*  #\#               #
#\*\  .*.*.**. . \.*.  \.. . .*.***\...  . \.** . . ..* \*.\* .\...\ \.\ . * \  * \*  .*.  .*!\..\ \.\W\*.. .*\. ..*****.*....*.*..*.**..@  #  \*### #              #
#.. *\**...  . ...\..\. @* ..**\.*. .  .. .. *\.. * .\.. ..\.\.. .\ **\*\* \*.   . .. \ .** @ ..\.\.\ *W..* . @  . \*... \. \ . * .\.  . \#.* . *.\.# #             #
#* \. ...@\ .\  \    . \*.. * .. .**.. .....*.. * ..   *... *  .*  ***.*..\*...   ..***  *.\ ***.  *!**\*\ *...\@**.*\ \ .  ...\  . .\... .*    .*  . .#            #
#.\ .\ .**..  ..  **  *.\*..\*.**..... .\*.*\ .\..** *  .\.\. ... ....*.\.**.... .. !... *\!*.*    . .***\\.\ *\. .** *.*.***   **\.*...  \*\\. *\.\\.*#            #
#\ .. ! ..\**.   ***.**.\.* W...\... *\.*. .\\*.**  **..\ ..   .*  * . \.\.\  \*. *.  . .  .... . *** *.. .  \. **  . .**...\ .*.*...  . ..@ *\#*  . #.#            #
#* \     ..... \....... . . ...*   ..   *  .. .*\.*.\* \  ..@. .*.**  . . . * * \**\*\* .   \..... * **\.***  \* \ ..*\.. .\ ...**\  \ . *\.!***..  \ #.#           #
#.. ...\.  *\. .  . \\*\ . *.**** ..\* .* *\  . .*.. \.*\. \.\   \**  ..   ** *..*..   .\ \*. \.. ....   *.\..* *. . * .  *.  @***. .. ..* . .....\. *  #           #
#\\ *\ *.* .**\  \* .\ *\ \* ..* \*.*\ *..  ..\  \\\*  .\   \.*  .....*.   .*\..\.*.***.*.   *.*  W*... *  .\** \   *.\ .W\ .\*..\  . .**.  *. .  .*   ##           #
#\  .**..*. \* .* *\.. **\@.\.....\.*...* \.* . * . \@. . .... ***..* *.  *..*.\.* \.. .***. . *.* **   .*.\..* .*\....*.... ***.\ *\ *.*..  ..**. \* * .#          #
# .  *..\   *\ **\.. ..*. .*. ..*\*\** *... . ..* .. .*. \  *.* *..*.  ***  ...\....   *W*.*.\.*.. .*.... *.* ...\*\.*... .* ...*  \..\ .!    \ ..*.#@###           #
#\.***.. \* ...  . *.* .\* *    * *\...*.** *.*. \  \..\..\  *. .*\. . *\*.*  .!\  * ..\*. !   .***\ *. \*\.. .* .@*.* *.  @. \.  \..*..\ # *  .\#.#\\  #           #
#...*\. .*..   \. *\ .*..\ .  ..!...** . ...* .**..\. .* .*.\  \.****.*. . * *.*. ..  .... **\. .. *.\*****. .*\*.  .. ..\.\\ .  *  \. \ ** *    # ....*##          #
#*... . \..\  \.. . \.*** \**  **..*.\.   *.*...\..@  .*..* *  *\** * \    . *\. *  .* *..\.** .\.* .....***  *! .   *.  * ...\  .   .... . *\.#. .\ .**\.#         #
#..  .* *.\*.*.*\ *.*...** **. \.. * .    *..\ .@.\.\ ..  *..*. *\*..**..\.*\.  \**.**.\**.*.*  \*.*    * .** .     ..\ **  **. .  *.  .. !.*\.*** **..*\*.#        #
#.*.. . .* * ..*  .\\.  ****** !.\ *\ *.*\.\.*  .    *\*\ .   .\* ..\ .W . *\.*..\**..\*  *. ..*.\ . ..\*.*** ..  ..\. \.*.  .\\ .\*. .\*   ***.*! .*.\  .#         #
#\..   *...*.*.   ...  \.\.*..  .   .*\ .. *.\.** *.  ...*\ *.  .\* *\ .  \**..*\ .\.. .  *\ *...  .. .*\  *.* * *\*\*\. *.  * .*  .   *\ * ..*.. \\.\ . *.## #     #
#. .**.  ...*.\   .\. .*\**..* ..\.  .  \.\*..\.*.  . *\... .. . \ \. . ...*.... ** **  . \  . .* .* . * **. .   \ * \ .\* **.  \.* *. .*..  ..*  .*. . ...  #*#    #
#*\*.\.\  . ......*.*\ ..* *.. *\.\* **\ .... * \. .. \.*...\ \**.  ..\  **..   \\. . \. .*\ \ \. *. .*.....\*.\.\*..*..**.*.. .* .* . *. *\*.*\ .*.*\ . .. . *#    #
#. ... .\ ..  *.\ .***.* \.... .\.*. *..\. .. . .  ... .*. * ..**!\*\\   **  * .*\ *\....\* \.\.**\**   .. .*...\*   *.\.\..  . ..**\. ***. \*.*\ *\..\@\ \*#\.#    #
#. * *  . .* .. *. * * . .\   .*..*\...\!*.*\..  *.. *\.*  .  ......*....*\.\.**.* *. .\..**..\..**@\**\ *.*\.*.*.  ** ..** ...\  ....**  * .. \  \.*. .*#... *.#   #
#\ \.. \*.*@.***.\** \..\ *.... \... \*..*\* . ....\.** . .  *.*\ .\. \ \   .*...\ .. ..*\.*\...\* . ..\ . .  **\*..\   **\.   .\* . *.  ...*\ .*  \..  .*.* ##..#  #
#.\. *.\. . ....\ .\.  @.*.\*\.\.*.\ *\*\. .* . *\   .. *** .* *. ...\.*!  **.  .****   .*..  *\..  .  * .*   \. ** .\.**.... .\.**  .    .*\.*.\ . *.*.*.\...###   #
#\. *   ..**. .\..*\\**.\..... . . ..****\.**  \\ *  *  *\..\..  .* *.\.* ...  .W\..  ..\ .. * ..*\ \ \ \ ..*.. ***.**.*   ..  * .@.   . . *\ \* .*.\*. .  *.#      #
#**** .*  \   \ @ * * !.*\    \   *\**.\  *\....**\ \\...**\ ** \.*\  *****\.. *..\ *.\. .  **.@   *.. . *.\\...*.... *.\ \  .*\\  *.*\ !.*\!. @ \* *.. #\\ *#      #
#\*.**..   **.* \ * . ... .*  . .\* ...*\* **.  \ *..* *\*.  \**.*...*\...\*.\ *   ..   \ **** .* **..\..... ..... *. .  ..\.*..   \.....*.\..***.\*.*.   .*#       #
#*..W.* *..*.*.\.! *\*\...\..  *\*.. *@.*.*!* \..\. *.  ..\  .*.*.*.*.. \ *.. *... . .**! ... ... *\. . * * *.* .\**\ .*@..*.!\@* .... *.\. *..*. .. *. ** #        #
#\. \  \.*..** .\ *... \    ..*\.\ \*.\.. \..  ** *  . . .******. . @**.*. ..*  \  *   \*.\** \ \ .*. **..*.. ..\*.. * .* *.\...\ *.  .** * .\.. \.\*. .. . #       #
# .*..*..****.\.  . \ .. * *..*.* .\.  .....\...*.*..* .\...*. ..   *.**.\. ...**\*.\*\ ..  \\*\ **.*.\!\*.*. *..@\ \.\****..\  .  * .*\.  .\.  ..  . \ .\ ..#      #
#\...\.. . **.*.\*... \* ...\..\   *\   .*\**..*. .. !*.\*\.. *  . ...\.***.   ..*...\**....*...*.... .*. .\*  **\.\.*.!\ \***.* \*..**.. *   .\***    #***##       #
# .\.\*  .*\.\. .* *.\ * \ ...*..@....\. . . *\*.... ..  *.*..\  .  \\...*.  \*\.\!*.*.* * \..\..*.   * \.  **..\*   *\.\  !..... \.*\.  ..*......\*  * **\#        #
#  *@. .  . .*..\..* . * .\   .  \.\.\ .\  ...  ..*\* . ** .\@**.  *. \\.*.\. ... .. \..* *.   .*....\ ..\. \.  W. .\....\   .  \ .*.   ***.* *\ \*\.**\.*.#        #
#. *\*\ . !* ....*\  **.*. . . . \.*...  .*\ ..   . .** \.@ *..   *.\... .\.  . *. * .\*.*   *  .   \ ..   . .\* .\ \\.. *... **.*.**\.** . \\* ..*#. \. \*#        #
#\ !*W.*\....  .\..  .. *.  . ..* .\ .*..*.* * W** . * \  \\**... *\.* * .* *.  .  .\ * .. . **.    ** \  \   ..  \* **.*.*****.***.\*\\. . ..\ .\**.\# #.#         #
#  *..\\.. .\.\   \..\ .\ *.* . ..  \....* .*W\ ....**\.\   .* \ *.*. \** . \  .* .....\* .  \.   \*\.*.\* . ... .. .. ....* ***. .*... *.*... ** !\\ . #####       #
#*\* \*.. \..\. *.@.\ ..\...\ .. * .. .* *. \  . . *...\* .**.  .!   . ......**.\..\ .. *  . **. ..\* \... * ..@*  \** * . **\...*******\ \. .\...*.\ ..\   *#      #
#!. .\**.\..\....\.....* \.\.\  \.*.\. .*.\...\.\. *.*. ****. .  \\*\  . .  \ . .\ *  \.*\.  .** . ! ..\.  **\*...\... . *.*..\ *.   . ..\. *. ..*.  .  .#*..#      #
#\\**\.***\ . .* .\ . *.    .*  .... ..*.* \*** * \ **\\..\*.*.\*.  ** *.  ..... **. ..\*.. .*\.\.  . ..\...\...    .\*. .\..*.*. *! *\ *  * * ... * \*...#.#       #
#*  *@  .. .\..\ ..*\....\** \ **.*\    \*....*.*\  .  . \@.\....@\\ . .* \.. \..\ . *!...**\ ** . . .. .*\ *  ..**.. .\*\ * .  !. \.. ..*** \. \ .* *.*.. .#       #
#* ....  ...* \* \\* **.*..* ***..* .*  ..** .  *.*....\..*.... ..... . \ .  \.. * *    \. . \ . . \.  \ . ..  **.  . ...*..  ...*.....   .*  #\.  *. .* . *#       #
#   .* .  ..*\ ...\.*.   .*....*\ . ...**\.*\*...\. * .**..**...\..\ .  ..   ..\ .*.. *\   \ *. .\.\   *\*. .  **\. .*\**..*** .*.\.*.  . ..*.  .. .\*.\!  #     #  #
#  . ..  . ...*\\*** .*.. .. ..*..*\. *.*@ . *.   .*... * .\  . . \  ... .\.**\.\ \ . .*.* .*\     *..\\ .* *. .  ..\..\.. .*..!.. **.. **. .  .\ \ ..*. \ # #  #.# #
#.  *.*.*  **\.* \*.  *...\* \...**.*\.*..  *.*\  ..\ . .! .* .  .\.\\\\.\.\.*..*.*.\. *.\\ * *\ ... *. .\..\.*.*...     **.***..\ .. .*.*  *\ \ .. \ . @# ##*###. ##
#.. *\. .***.**.*.***\..  .....\ **. ..*.* \.\*.\ .. * . \.*..* *  *\ * \.. *. ..\....\*\  ***.*. *.. *.*  **......* *.\......* ..  *. . *  *  .*. **.***.#\.\. ! *##
#..*..*\  *\*.. ...\ .\.* .* * . ..@** . .\  .**.....*\*  *\*...*..\...    .. .\* *.*** .\ **  .*.\\.*..W\*..  .  .*...**\\.  .*.  \.\*\.** .\\ \*\. ..*\.* ..\*#\. #
# **. W*... .!\ .* .*\* \..... .\ *.\*.\***.  . **  * !......\. *.*..* ****... .\ *...* .*!*.*\**.*..** . .\ .. *\ . .\\.*.  * .*  . ... .\* *\   .\. . * . .\## ####
#*... \.   *** ...  ...\....... .*.\ .\*\ ..\ \...\*.\ .\ @.*..*\*  . ...\*\.  *.* *\ * ***** .*  * \..  ...  *\. ..  ... .**.   \ *\  * \!..*.   .*#   \ .\  #     #
#. ..  .   ..    .   \\.\!\...*\  *. * .** *.\..  . *.\.. \ .....* ..*. .* * .*\*..** . *****..\*.\..*\.. . \...\   *.   * .*. .*....**.**..\... *.*..# .*.#.#      #
#.@**.\.\****    .*.**...\* *.\  *..****.**.... .\@\ * ..* . .**\..\ *. ...*.\*\*\  ..* .*\.*.*...\ !. \.*.*. ..*\  ...\..*\*.*.*\.\... *. *.  *\  ..*   * ##       #
# *..*  *....\  . *  .... * . *. . . * *. ..\ \ .**...\* *. ...*..**\. *.* @\ . *  \... . .\*  .\*..  . .. .*  ...  *\ .* .*.\ *   .  .*.\**   .* * \*.  .#L        #
#\ ** \... *  .. ..   .*\.. ***.\   .*.\ .. *.\  .\ \  \.W\. . .  . .*\.*. ..\\.*\ *. ...*  \..** *\.\.\ .  \ .  ! *\.\\.*....*.**** . . . .\.  .*.\..* \.\.#       #
# *... .\ *...... *. *.*.\ \... * *\.. .*\  \.  **..  ** .*\. .*.*\* .*...**\ . \.\.  * \**  \...*.* .** *. ..**. .@*. *.*\ \ .\.\..*\.   *.*..@.***.\.#*.*#        #
#\.*\.\**.\*   . .\* . .*.* .\* .*..\*  .**\* *\.. ..**.\.*.\... .  . .*\\*....* *** .... @*\*\ .\.\.. *. **  .** .. . *\**.. . ..\.... \ \ .*.*****\. \. .\#       #
#  *\..\.  . . *@.*.* **\*. *...*. ..\ . .\.  ...\.  *    . . *..*.*.\*\**. * .\ ..\\.  \.*...*.*.** .**.**.   **.*@ . \...   \  \.  .\*. .. \ .*.**  ..* ..\##     #
#*.. \ * \\ . ...*...\*.* @ .*.\*.*.  **.* .. . * ....* .\  \.\**..** *. .\..\. .\ ..  .*\.* *.\.*.**...*.. . .\.  . **. ...* ..* .*. .* *.**.. . . \.*  \ .#*.#    #
#.. .. *..\  ! * .    .. .*\ *...*.\\  .** *\*. . \  \\  .*..*\*.  *....  \.  .. \ .\*.\.. \ **    .*.*..*\ .....**  *. .  .*. .\ \.*.\   \.**. *.*..*.\. \  \#     #
#.   .\*** .* *** *..  ... .*\* *..*     ..*!** * ...*.*.\\*\. ... . .\W*..* .    .  **.**\.*** .\.\ .. \. ..*..**..\\  .  *\ *    .\. *... ... .\*..\ \  . . ##    #
#.\.*.  . **. ...\.. . . .*  *..* ..   *. \\\*.*..\\..\..  ** *  ..** .!. **. .*\. *.. @.*. *..*. ** \\* . .\.*.*.\ **\ **... .\**\  . .. * *!\ \ . ***.# . .*\.#   #
#\ \\ \.....***.*.  **.*\\* *....\.. * *.**.*.  .\ \.  . .*.\.\.\* *. *\  .***..*  .   \..*@ ..**\..\ \*\*** ** \. .*.*\..   .* . .....  ...* * !*  @..*.*\.\***#   #
#** \ .\  \..* .\\***\ ..*. *** *.*..*.\ \..* **..\ *    \   *  *. *.    \**.\.\**.\.... \**   ... .*.. * *. .. .*\..*.* *****.  .. ....   ..*\\*\ \.  **.\ . ##    #
#.\\* .. \** .\ **.\***.\** *...*  ..  ...*\* \... **.*\..** ** ..\.\@. .....*  .* ...*...\.\   . ...*\ \ \   *.   *... .  .*** .\*  \* ..*. ...... \* .*\ .\ *#    #
#..*.    . \ * **.**.....\.  .  \ .!* **  \* \**\.* \..*...\*.  \   *\ *.* .\. . ..\  ..\* \ .***.*. *. .  .\...\\ *    .  \.** . *.... *.  ..*. *\**\.*\.\####     #
#*\* .\ .  . ..*.... .\\..\ . \**. \..*\  *\  .*..*\  ** \...  *.*\\**\.\.\.*.  *.** .*\..\...\*.\... * *\* W* . ..* . .* .... .\ ..  *. !****.* .*.. **.\.# ## ##  #
#*.*.*.\    . \. .\.\.. **\  . .. .\\ ..  ... *\***.* *. .*\  *... ** \ *\  ..***... \.!.\..*\. . ..**.\  *  ..*. ..\* .*  *.*\.*\ *. ** ..\*..* *. *\.\  **# .# .# #
#*.\ . . ..\.*..!.*\.**... *.     ** **. \*.  ..**. *.*.*..**.* *. . \.\ \.**\ .\. **   *. .\    \ \ .. . .. *** .  *.\ *. * .....  \* **..* .\.  .** *.  ... \*  # #
#. * *\  ... *. .\. ..* \.. ..*. .** \***...*.  ..  ...*.* .*.. \ .*\.***.** \   .\.. .*\*. \..  .\.\ \.*.. **... ...* .\ *\  \*\*\. *.\.\  . .\.*.*. ..\ *.*.\.##  #
# .. .*.*..* .\.\.* ..\ .. ..W\.. *. .\*\  ..*. .. .* *. .*...**. *.... .\.*...* . .\  ...* .* *..! . \..\*. .\  . \.W* *\*.\* **..  .* .*\*.\ .*.\. ..\* * ..**#   #
#. \. .\*.*\.\ *. \ .  ..   ..* \.*.. *\  \..*\\ ..\.*  \..   .. .......\\.**..  .\...... * .**.\.\*\. .. ..\...   ..**.*.* ..*.\ *   \ \..* .**.\  .  *. ..**  #   #
#...*.     . . .\..*..*  .*\..  .*. ... \ .@ .*...\.\.  * \.*    \.\   \.. .\ \ . .*@  .. ..*. .@  . ..* .....\*. .  .* ...**\ . ..\*..\* .*.\..*...*!..*\.\.*.#    #
#*\..**.* .\.\.   *. *.\.\* *\ \.*  *.\ ..* * ..  *  .. . ..*..... ..\*  **\..*  . **.**.  ...*.. * .*.*. . . *\** .*..!  *........ .  @.  .\!*..*\ .  !\.\.* *#    #
# *  .\ \ . \  .\ \....@\* \. .* ..\* . \.\ *.*.* . \*\.. .....  .   .!..*..\ ***  ...*.. \*\ .   \* ****. \. *.*\  ..*.*. \. .. . \   *\.\*..!..*  *  *. . .\. #   #
#.. ... \.\ .\  .** . .\ ...*  *.*..* \* .*.  .  .*.*. \  .. ... .* *. . . * ..*..\*.  .. .@.   @@.. ... ..*\ . ** .* .  * * \  . ..*\ *  ... ...**...**.\*  .. .#  #
#.    * .  ...\ *. . .\.*.\ .\.. .*.. .**  **. \ ..**.*  ...*... ..*.    * .\* \*.  \.   . .****..*\ ..*  .  . **. .* * *\* *\\. * **  .  *..\.*\.**.\  .@*.. .#*#  #
#.\\.. \ * .* ...*  * ..\** .. * .*..***  .*.  .....*..** . .  . **. *.. . **\  . *.\.. .**   .\ * *\. .    ..*  \. . . !.\ .*. \. .\..*. *..  ....\*.* .\*.. **.#  #
#\*** .\.W*** .!*\.\.. ..*..!.\* @*. ..*  .\. * !*  * \.* . .*   . .  ..\ *. * ...\.    .\.*\.. *...@*  ...**..*.. . . .\ .\\* .**   **. ... *.***..W \... *  *# #  #
#..\.@.  .*.. \ **\\*@.* .\**.* \*.\ . .. ****.\*\ .*..*.\ \.  *  \.\.\.. ..**. \\ * @*.   !@   *..**.\   .\.\ **.  **  . ..*. \*.   *@\ .\..**\*..\.**  \ \\## #   #
# ..\* *\****. **...\\..*. .\.**..  *.\\\  \..  \  ****\.. !\ .\ * *....\   ...* ..\...* * \\. **.\.... *..*..*...*. *.   .  .\ . .\..\.  ...**..  .*.. .!  *  #    #
#. ...  . .. **\*.  *.  .\\..\ . \   ** . *. *  .   ..\. *. *...   \\ @ W!\* .\. * .. ..\.  .. **...*.  \  *  *\*.....  . \ ***\* .. . ..\..  .* *\ **... *\.#@#    #
# ** *.. .** *. .*\.\...*.. \  . .\ .** *\. .\.***.*  \. .\.\* .*. **\. .\  ..\**.. \.*..*. .  ..\.*\  . * .. . ! *. * .\* *  * *.\\.\ ..*   .*.*. ...\ **\   #     #
#**\ *.\. .* !*   * .....   **\.*\!.....* \***\.*.*. \. ** * \  \..*.. . \.\.\ *.. .. ***\*. **  .... .\  *.  .\.*\.** ... .*\**.*. ...***.\. *....  ***  * . #     #
#. *\..\.  *\* \@.. * \ ....... *..\ ***.\*..\.*.. ...\ ..  *  *..*  *\.\ .. *\... \.*\...**..  *.*.. .. .@.  @ **\. ! ..**\.* .@** \. .** *.*.\.!***.*. *.*.\.#    #
#\*. .**.. *\.  * \!\ ..  \ \. *.*   .\\. ....****   ..  .. *\ * ..   ...*\** .*.\....  *.\. **\. .*.*..\ *. **\.\. *.*.*\.. .\...* . *. **. . .\.*...@ .\ .   \#   #
#**. \. \**\* . * .  ..\ * \* ..\..  ...\.* .*  ..     . ...\ * *  \..\. * **. \. *.\. *.....\.\ .**\*.. .*.*.. *..\.\  \.    * ...**\ *.* \**.. \ .* ...*#.**\*\#  #
# .\\.  . . .  .\ \. \.*..*..\ .*.   .\  *..** **   .\ .\. .. *..*\..\.\*\ *\ @..*.**W.. \ *.*\.. *. \.\\.\.* .** ..  \*.*  .*.   .** .\ \.!*.W.  \.* *..*.\#\###   #
#.\ \\ *..*.* .*. .*.*\.  .*.. \. .@ *** \ ...**.! .  \ . * ...  .**..*..  *. *..*.\ .. \ .\.*\* \*  ..*.. .\ \..* .\..**.** *   *. *.* \!*.\**\..\ # . *  **##     #
# .\..*.* ..*. ..\ *  . *..*  *. .*\ .**.*.   .@*\.  * \. *\*.\    !  .\ .*.\.\.*@.\    .  .. .!. *.\  *... ...*.* .\.\.*\.*\\ **\  ...\ .** .*.    . **\.# ..\#    #
#\.** ...*\ .W\ \ .. *  . .* *.\. * \. .\.***  .*.* *\ ...*.*!.. .*\ .  *.... ...@**. .\  *\.* ..*..  .*... ...*..\*.\* \. *. ..* .\.\**.*..\  *.\ .# ..* . #.#     #
#*..@.*. ...\*. .  ....**\*.*..  *. . *..*\..*.* .* . .*\\..** .  .**  ***  ...  .\*... .** \**\*.** *..\. \ ...\ . @* *.. .\  .\  .....*\ *.\*.*..  .. \*. .\#     #
#. \*.***.\  .. \ .\*\.**.*.* ****.***. .  .\.\..\.\ .*.. \.**.  .  .**@...@...    .*.*.*. \.*\..\.\ *.. \ *.\ .\.*  .**. \ * .*..  .* **...\ \...* . . ..\*..*#    #
#...*...!. *..  .*\.. \ * *.***.**.\.. ** .* **. . .\*W.*   ..    .*..*\ *. *..*\.* . *..  .. **\ * *..* ..**.**.** ..***  .  .\ * .*. .* *\\..\ \. \  \* .@###     #
#\. .\*.**\  * \.. \\ .**.*.****.\ *.  ** * *\.... \.* \*\ * ..\ .*! ..*.*!.\ *\**..\ .\ \.**.*.\*\*\. *. *.\ ..\.\\...** .\.*..*  .*\..\*.*. *..\**..  .*\#        #
#####################################################################################################################################################################

Water 0
Flooding 0
Waterproof 9
Razors 31
Growth 13
