#####################################################################################################################################
#.\ ..*\ *..  .*\. .*. ..   ** ....\.\.\* . \\ \. .*.  \.** \* \*     .*\.\.*.*  .. *.**.  ..\. **  .*  .!.*\ \...*** .**#          #
#*\..!.*.**... ...\   .**   \. .**. ..\ * ** .\..*.* *..\.. * * ..  *..*. * * .\  . *\ ..\\.\* \.*\*\.*..*.*.*.*. .#.\...#          #
#*.\  \.*.\*\. *\ *** *. ***.. .@ \ \ .   \.   * . **.. .*.\.\.*.\.*..**.*\*.*\*.\.\. . ..  *.*.*. \ .. *\ .*.\.\ \###\##           #
#.\*\  \ *\.*\.*  .*.  \ . .*.  ..... ..  .*.\..*\.!** ..*. *. . ..**.  **.* *\ ..  . . * * * ..\*....*\**...# \. .*.\.#.#          #
#*...   ..\ .  .. \* *  *   **..   . .\  .. . *.*. *...* . .** *  \*.* ..\*.\ * ... . . . ..*\.\.  .* ...\.*...   .. * ..##         #
#*.*. *\*\   \  *.\.....**.* .. .\   ...** .**.\*..  ..* *....\  . . .\   .. *..\.  *\  *. *.* .** * .. *.*.. .\\.# .\.*\*.#        #
#*.* ..*.**.* *\\. .*\ . *.*.  ....\* \ \..\  . . @\  *.. *\. ...* . .@\.*  *.*.*. *..*.  .*\\.**..\  *.@.. *.\**\  *.. \.#         #
#... *..*\**. .*.\... .  *W. \.\ ..  \...  *\.*  .*..\\.  * ..****.  \..***.  *\** .  ...  . .*\.. * *...\.\.\ * * *..    #         #
#...*..*\. . .@ ..\ \ *  .\ * **. \   .   ...\.*. *\  .\.*..\  *\.* . **W .\. ...@.\.**..\*.\ *. * . * . .*..* . **.  *.\. #        #
#.*\*.   . ...*\.\ .. .   \ . .\.W\.*\   *. .\ .   .  *  \.. .\@\\.\ *.\ **.. *@.. *.*** * .*.. **  *.\.**\*.*   .\  #* .*##        #
#\.**** . \*.*....  .*\ ... .. * *.*.** ..*\*  . . .\*. \  . *  *  !*...  * *  . *\. *.... * . .*\* .**..*****\..*.*.** * ..#       #
# ..... . .. \ *.... .*  .. *\..*.*  **@... *. \ \. .   .  * * .. .*.. .\..**.*****\..@  . .\ *\*** ...*.*...   *  *\*. .*##        #
#..** \.\.  \.... \  **  .**.\.*. \*.**.* ****.... .*.\.\. .\*     .\ ! *.\.\. .*. \.\.\..*\ \. .**\**** .. **\ .\ .. ....#         #
#\\....  * *.  *. *\ *..*.\.* .. . * *.. \.\...  \ .***  .  *.*.*\. ..  .\  . *\. .*  . .\ . . \ .***..\    .\ .\\ .**. .###        #
#*. \ . ** ...... * \*..*.\**\*.  .... **....*.... ...* .\.*.....*\\   . * .  .....*. W. *\ \.**  ...\...*\ ..*\.@. .*\  .*.#       #
#.*.   .*...* .\****..   ..** \*. .* ...!\.\.*. \*  * **.. .. \ .*.\  ..  \. @* ****.. \ ........* ... \.* * ..\ \..*.  \*.**#      #
#...\\ !.\* \ ..\\ .  \.\.*\.  *  ..*.\..  .*\  .!**. ....  .**\*\.. .\.  . . ..*.\ * \***  *  \.*   *\.\. .  . * *..  ****\#       #
#\*.. .*!*. .\..**.  *.* \.*.\   * ...*  .. .....\***. .. \. .....\.!.  .\* .\ . .* .*.. .  . ..  . \ .*** .\.\\.....#\. ###        #
# .\. .*    * .  *. \...*.*  .* *\... .  ..* .. . .   .*. . .. .* *.. \.**  . *   . ...  .  * \. * .!. *.... *** * ....*  #.#       #
#.  ..** .   . **..*.*  ...***..   *   **.\*..*.  . . ***.\  ... ... . **.  *.\*.* ** \.   **..  .\.*\ .\..\.*.* .\ *\.*   .#       #
# .    .\ \  ** **\ . .\* ..*.\  . *..\*.*  *.\ .*@\ ** . .\*\***\*.  *.\..*.@...**.\...   *.*.*.* **!.\* .. *... * ...*. ##        #
#.**.. .  \.** .*\.     * . .*.\*....*...\**.\*  *. ..*\*\*..*...\ *.*\ . *. ...\ ...\.   W\*.. ..*.* * . \...  \\  ..\\*\L#        #
#.\*. . . . *.  .. ...@*.**\.**.*. .\*.  **. *\*..* ..\.*..*.*.\ ..*..   *.. * ..  .\.  .\  ***   *.*\    . .. .!*. ... *.**#       #
#.** *** **\. ** .@\* *  ..**\.*  \. . *... . .. **.*\  . \W\.*. .\...\*.**\ * .*. \ **\ * ***.. *. \. *. .\.*\ **.  *.***.@#       #
# ..\..**\*.  .*. * . . ***..* . *\*\  **\ *..*  ....\..! ... *.*..* . *  .** . ..\ ****\* \\\. .*\.. *.*.. ..*\.\*. .....##        #
#*.* .. ...*\ .\ ...*.\ ...* .\  .!.*\... *.*.. \  * ***  \*!....   \.... ...  . * *...!**...**...\.. **..\     \* \  .\.  #        #
#\..@.*..\..*.  . \ ..  . .. * .*.\ .  ** .  .. .*.*.*.. * . * .\...  . ***. \.  \.\\*. **  . \   ..* .\ . .. *.\   \ ..*.**#       #
# *\. ..* @. \ . \ *\**. .** .. *.. *..*.\.*  .. *   \\*\\.  .. .*.* . . *.  .**. ... \...   \. *\*.*\..\*....* .*.. . *....#       #
#.*.     *. !......*.  * \ .*!  **..*.\.\!. *\.\ * .*.*.. ** .*** .. ..* .   ...  .*.*.*\. *\.* \**\..\*.    *. ... *\. *..  ###    #
#. *\..  *\..\* . ..\ .**. .\.*.... \  * ..**.*\ ..\.*..  .*  ... .\ *\..*.*\.**. .* . ....**\*\.. . **\*.  *.\*   *.*\*..**#\  #   #
#. . .*.** ..*.\.*.*.\*.\ \   . *.  ..\.\  *...  .*.\* .*..\ ... . * ** ..\.. ****.@ \ \*.\.\...  ..  ..*   **!\.. \\.... \.*...*#  #
#  .***.*\ .*.**.. *... \.. **.\.  **.**..*.\ \ * ...*\. *\.*.. .*. *.\   ...*.....*    .\ * .**. ***....  *..*.**\ .\**.!  . . .#  #
#\ ***.\.!\*. *.**.. *.! *....  *.***  \**.   ..** .** .  @*.@  *.*..\....\\. \  ... .*\***.. *  . .**. \* ..  \.  **... .\.** .. # #
#*.\.\..**..    *\.\ .. ** .  *..*.\.*.\..* \.  .. \**  *.*..*.\.*\*  .\*.@*  ** *  ..* .. *. * ....*. . **..**.*.*...*** . \.*  . ##
#*..   \.*.*.** ****   .\\..  \* .*. ..  .*\...* .\..**.\ .\****.!\* *\ .. \\.   . *.*.\*.. . * ....\.\ \ \. .\..!@\* ....@.#* *\\.##
#..  .  *. \.*.\.***\...  . \.\. .\*\.  . W.*.*.*.*. ..*  ..*.  .**\*..*. .     .\.*..*. \.\ *.*  \*..@....R *** . \.     *.*# *.#  #
#\.\**\..\. .. .*.\.\   \*  \* * ..* *\...*. \.*.. ..* . .. .\ ..*..  ** .\*.  .***\  ... .. . *.. \*\.   *\ \.. *  .\  * .\***.##.##
#  .*....\*.!*  . ...    ...*\ * *..**.\  \ ** **.* *..*. ** . \ .***\. \* *\ .*. .. .\* *\ \ . *\...*.  \ *** . ** # ..\ \ .## # # #
#\  *.....*.\.** **.  ...   . ... .\..*.\. **. ..\. . .....*.  ..*.* .\ **.\***\ \ .. ***. ... .\   ..*. . .. *\*.@*...*  .  \*.#   #
#..*.*  . ..  *. ..  . . .   .*  \*.**.\**\...** **  .  .\.\..*.....\  .*. .\\ ...*.. \\.\.*\\   ..  \***.. .*. *. ..\ .*.   ##\#   #
#**. * ..** ... . @ \.. * . * *  *. .. **..\...\.*.*.*\   *.*.* .@ ** \..*    *.*\ .*  .@ *... **\*.\.\**    \\  *   * .   ##  #    #
# *W*\* ....**. .*..\ . . .\.   .. ..  .\* *. \..*..*\   .  .*. ..*..\ .* *. .  ..* *\  .** *  \. **. ...  *..\. ...*. \ ##         #
#\.**.*\..*!*.  *\. .   .. ...    .. .. .. .     .. \*\.\..\.*   .*. .\ . *.*\* .*\\*.\.\*. .*..\   ...*. ..  ..*.. *. .\#          #
#.*\.\.   \.*. .\  . * . *.\   .*\ *..*.\...* * \*. .!..*\ .*. . ** *  .\ .\.  .\.*** . .* .*..  *.  . ..  **..\*W.\*W \ .#         #
#*...*...***.. . .*\..\*\***  * . \.\*\...**.\*  .* *.\.*.\ ...\  ....*  *  * .**\.. \ .*\  .*..*..  *    .*\\.\.  .* \ .#          #
#  * *. **\.**\***\.**\. ..*\.....\**.* \ *..**\  \ W **.\ \* * \ \   *...\\*\***.*\.....  *\****.*.\.  *.  *.*.*\**.\  \.#         #
#####################################################################################################################################

Water 0
Flooding 0
Waterproof 17
Razors 49
Growth 6
