###############################################################################
#     #.*.    . \. .\...  *. *\.W.*..\.\ .\ *..* ** .*...@  .\*. .\*.\ !.*  ..#
#    #**.\*... \ . .**..* . \..\...*.*\. .. *\......**..\** * .**\.*.\**..\  \#
#  ##..  .*.* \  ... * ...*\***.. *\ \. ... ...*\  \ * * ..*.\ . ..*  \\. *\*.#
# #** ** ..\. ...*.....\***\*..\ . .*.* . .*@ .* \\ *..* *..\ \* *.*.**.\..*..#
# #*##.*  ** \ .**. \*.  *. .*..\   ...!  *.\ .*\*   . ....**.... ***.*.....\ #
#  ##* . *. *.  ..\ .\ **... *.. ...\ .\ ..*.   .*.*.\.*.   .. .\*.. \* .***..#
#   ###  . ...\*.\*.*W*.\.* .*\  **.*\ * ..*.  .\  . .\.* .\.. *. *.*. .\..*\.#
#  #..\   .  *... **.......*     ...* .. \.\. \ *.   ** **** \ *  . .**.**\*.\#
#   #R.... .\.*  ..*.*** *\.**. **...  ...\   *.\. \.**\.. ....*.\  *. *.* *  #
#  #\#\. *****   \ . *!* ...* !.*\   .*.\  .*..*.. \*\..\   .*..*..\.* * *... #
#  #*\.\.*.  .* *.*   .**\.\*  *. .  ....@*..  . .* . .* . ***..*. .*. .\!** *#
#  L#.*.******* .@*.\  *.. . \ . . . .\\...\..*    ..  .. *..\. ... \ . .\*. .#
# #*\**... ***\ *.*.* .. ..*\ \*.\.\\ * *   . ..*  *  ...  . @ ...*.. .**.* \.#
## #.*\. \ . ..*..*\.\*. \ ..*.   *.\ . .\\. * !.\.\ .  *  *.*  . \ .*..\ .\ *#
#..**#. . . *.  .*.  **  .* *@.* *.  *\*.. .  ....* . . \ **\..  * .***..\*  \#
##* .##.# .*\  * \.  .\ *\. .* .. * \**.. ....*.   .** **. .  . .\****... .\* #
# ####.*.*..\*..\.@.W*.*.** ***@. . \.*...   *....  *  ..   ..\ \ ..* *\ .\...#
#    # \ *.W.. *...*..\. .* .\**.. \...\.*.\.\** .**\ \*. *\. * \  .* *.   \ *#
#     ## *!\ . .  ... *\. ..  ..***.\*\*\*. .*.\* .*.\..\...   *. .\ ..\.\  . #
#     #*\##.\.. .  ***\.*.\**.*\. *. ...*\ . . *.\..*.....\..\.* ...\\  *.!  .#
#     #. .****..***.W. ....* .... *.**  \*.  .*.\.*..*.**\.. ...  **** ....  .#
#     ##.! .*. .\.\***   .....\.. ...** .\  *.. **\ *. *\.  \ *.**\.**. . *\. #
#    #**..\  \.\.*.\***.\ \*  *. \ **.*. \...*.*\* *  **    ..*...\.. \ *  .  #
###############################################################################

Water 6
Flooding 11
Waterproof 4
Razors 31
Growth 45
