##############
#  #\.*\**\* #
#  #* .*.* ..#
#   #.\ ..\  #
#   #. *.*   #
#  #*  .*. . #
#   #..*\.* \#
#  #. . *#*\ #
#  # ...*.!..#
###. *. ..\.\#
#* . *L....R*#
###*\##  \ @.#
##############

Water 12
Flooding 1
Waterproof 6
Razors 21
Growth 35
