#####################
#.*  ..\.*.. #      #
#\.**..*\R..\.#     #
#. .  ..... *.##    #
#   \\*   ***\..#   #
#\*.. * ..*... #.##L#
#.*.\*.*  *.*  .\\.*#
#. \*.*...\*.   # *##
#.* ..\. **\... ### #
#**** ...**\* \ *#  #
#..\ * .\..* . ..#  #
#\. ..* *.\  * *#   #
# ..\ *.\ .. *##    #
#*.  ..* * .#*.#    #
#.*** .\* ..# #     #
#..**.\... ..\*#    #
#####################