###############################################################
# *\.  \...  * *.\* .** !\.*..*...\.  \.\   . !.. \ ** .**.*. #
#...\ .. *.\.. *.*. * .* *.. \.!\**.\..* ..*.     ....*.*.   .#
#    . *\.*.*..\. ..\.   * @ .\ ... *. * **..**.\ .\. . **.. .#
#\.\ *\.. .\ .....  ***.*\\..*.*\.  *. \..\  ..  ..!\.* ..  *.#
#**...** ..  \D  . \*.. \ .... ..**.* .@.*  *\... ..... ..\ \*#
#.  * .. \*...\ .. .* * . .  \*\.!\.**\..*\**.* \*.A.*. \. .. #
#\**. *\ .*.*******.. .\ *\ ..\   ....*  ..\..*\. .**\**  *\.\#
#.\*\  .*.* !\W*.*\. *...\ .\.! .!. .*..   *.\.*  ... .\ ...*!#
#.*. \. \*..*.. *. *.*\ \.* . *  \ * **  .   ***\\ .. *. .* *\#
#\.  . *.***..*..*.*.*\.. .\  @. ... .... *\ .\ . .*\ . * .. .#
#*  *. *.*** * \***@.  * .\**\.\***\**.\ ...   .* * . ....\..\#
#.*\@... .*. \!.\**.**..\\* .\. ..** \ * *.@*.... .*\*\ .\.. .#
#. *.\..**.  ..\*.. ..    *.*  *G\  \  .\@.\ \  .*   . *\. ** #
# .. * ..* .. .  \* *.  *. .. .. * * *\ \. \.***\.\   **   .!*#
#.*\.*\ \*.*   \.. \* .  .    .\.*.*..*.....*\..  .\. *.\@....#
# *. .....\* **.* \    .*\  .. \ ****.\* *... * * *. *   .\*..#
#\ . .\*.*.. .**.\.\. . *. .\*  *..\. *.\.6.. . *   . \\. *!\*#
# \***.*.*\. **.. .*.. . .\*........**\ *..\ \ .. .**\.\*** ..#
#  .......  \. ..\.*...   ... .\ . ....!. *  ** ..*. .*F...*. #
#\.  . *\.\.. \***...\ .* *\ . *.*.\.* . .* \.. *\*.. ...  ..*#
#.\*\ \.** . *.\.. . **.\ *. .\. ..*  \ ..*.. \.*... ** .**...#
#\. *.  .  . .*.**.  .***    *...*.*\  .* .\  .*. \  *\@* .***#
#*. *. *\.** . \.* \. . .\. .* ..\*.**  \ \*\  .\...  *.*  .*!#
#*\*W.. .... *..\ *. *.**  **.  \.. .\  .*.****   .  ** .*.* *#
#*....\  @\  .*.  *\ *  . *E*  .    **\ .*.\\.* .. ..\*. . **.#
#*.**\.\. .*  .**.**.. . .... \.. . ....\** .*..*..  .*. ..\..#
#* .*@!* .*.. .*.**.  .*\.\*.. . . .\*. ...  * * * .\..\ .\*. #
#* *.* .\.**  *.  .  \  **.. \ **   .. .\..*. \.  \*......*.\.#
#*..*\    * .. *. ....*....*...*\ *. \  *\.* ..* . .\..\\ .* .#
#.*\  *..\.**. ... . ***.. \*.***\*   .\.  .\    .*  ....\ *. #
#.\  \.\.**... .. .. .\ ..\*\...*....* *    . \...*.  *  *\ * #
#\*  . .\*.. .  . ....*..\. **. ** *....**\.. . .. . !*\.\**\ #
# ..*\ . . \  \. * . .**\*  .* .. ...   .\**\.\   *.  * . *.* #
#.\**.\ *. . ... .\  **\..****.\ \ .*. *.....  **.\ .2. *..*. #
#..\    ... .  *.\..**..\**.\. !* ..* .\  .*... *.*. *.*\.*. *#
#.\.\* \. *. .\* *\\.\.  *....       * . **.   \*..\.\\. .* .*#
# *... .\ .*\ *. \ * *. \*.*.* *.. **\ . .\.  * . **\.*..\\*\.#
# \ . \ ...\. .\ . *. ......*.\*. ... ... ..  . \. *.\.\*  . \#
# .... .\  ***. ** * \ ***   \*..*\ . . \. . ..!.!.. .*.*  .@ #
#  *. \    ..  *.  *  \. .  ..*** .\ . .  .**\*\ \*** * * . . #
#\ ** .   \.   *.\.  .  . .\*...*\\.*    ....* .\.*..\..    *W#
#..\. .. \. *   !..*\*.. \.*....   *.* \.*. ... ...* .... *!.*#
#...  . *. ... * .\..\ .\. \*..*\**\*.\  ..* \...  *\  .\  .  #
# * ...*...  \..*\ . . .**  .. **.*  *  .  *.  .*.\@* **. .*.\#
#*  . **.*.   \.* \.*.  .*  *\ ****... . . * *\ ***.**\**.* ..#
#* * \ . *!\. * . ***.** *....\. .*.*. \ . *.*. ..* *!*\* ..  #
#\.W\ !.*\ \.\. . \*. !  ..  \*.   . ...  ..\...@*.  .\.*.* * #
#.     *.. * ..*  .*  .  *.\.*\  \* \...\ *.*.**\*. .*\ ..! .*#
#** . **\ ..\   ... . .....\.\.. ..\.**. .**  ... *..  ..\*...#
#\.**.!*. .  . .!\.      . .* **\ .....*  ..\. .\.\ **. ....**#
#\**  .. *..* ***...\*.*.**.\...  *\ ... . ** .W    \.\..\ \ .#
# ..** * ..*.\*...*\@\**\.. .. .*...*\.   \*.*.*..\ . *..\ ...#
#**B*... *\..**\ ..\*.....  ..*\* .\ *.\ ... *.*.   ...*.... .#
#.\ .. \* \*....*  ** . * .**.....\*\ .* ..*.**.. ..* ..\*\.  #
# ..* . . ..*.*\  .\ *. \. *.**.\. .     \  ....*.\*.\. . .\ .#
#.  * * * *.*.**\*. .*.. * *.\! ..  ***\ \. *. **.* . \. .. ..#
#.. \..\**.*...**. *.. *.* *\**..\  .*....** . .\*.  *** \.. .#
# .....*....\..\.*.*..\.*.\ @*     .\*\*  .. \*\ \  *..* .  . #
#.\*\.  **.  . .*.*..\..\@*.\....*.*..*. ..*\ .*...\.. *\   * #
# . . **\.*..*.*. .*\.   * \ .*  *...*..\ \*  .*.  *  .*.*.*\ #
#. \. *.  ..@....  ..  .*. . *..*..****\@.. .* . \ *  *...... #
#\* .\*. * **.\. .. . . *\*... *\. **.. .*.*\*\*..  \*.*. * .*#
# H..*.**.\* \ *...   * *.. . .*..\..\  \.\.....* ** \ ..*\  .#
#\ .*.*.. .*   \.. *.  \*\*   ..* *\.\   *.. .* .*..*.\ \.*\* #
# \ **.....* * ...\..**.\....**@. ** .  .*\  ..!.*.  \* !*..\ #
#!.\ ...**** * C*.*.... !*  \ \. .*.  .*   .\* *     ... *\*\ #
#. .\\ \... \  ..\..\.** *.@\ ..*.  .  ** .**. . * .\... .*\.\#
#   . . \ .   . ..\. ..  * *  .\.. ..!... \... \.. .**...**  \#
#*.**\ . \* ..\ .  *. \.*.*.. .* 5. ..\ * \*  *.*. . .*. . . .#
#! *.*\\....* **..\.  W\. . .*.. .*.... \....**...*\ ... . .  #
# *.\ .* \. ..\  \**.  .*..\.* *. .\ !\  **.\.**  *. .*....\**#
# #\.. \  . .*\*.*...****@\ ..\.**..!. ..\. . ***..\.\ * *  ..#
# . \  .  . *..  \**\.** . . .@..* * .  *..*.***. \  *. \ .*  #
#* ..  . .* .*.  .\.   ..  *.. .\. . .\.\\ .*..\*. . .. .. * *#
##\ *.. . .. ..   .  .**..\..\ * *..*. *..\...\*...\. \* * \.*#
#. ..  \ *. . ..\.**\.\..*.  * \ .*.. .. .  .\..   . ..***\.*!#
#\.\*  *.. *\.\*. .*\.\\**  .. . *. . .\ ... ..  .* .**.\ *..\#
#..#**** *.. .*.*\* . ..\*. *\*. ..     ....  *  *.  * .  \ \*#
#!* *\#*.**. ..*. *  *.* . . ** ...* .\9.. * .\**  . \ *#   ..#
#####.*\*..  .\..\*\. ... ..\. .. .* \*@.  *  \..  ! .* . .. \#
# L  *#\.* *.**.**.# .*.\#\ *@. .*...*..**..   .\.\.\*. *.  . #
# # *  * #\.\..\ *..\** ..  *.\  *   *.**\*  *\ *\    . ...*.\#
# # *. #*\*#**\. *\..#*.* *8. .\ .** * *.*  *.. ... *. .  .  .#
#  #.#**. .*#*#**..  .\ .\*\  *** * .\ *  *\.*\  *\..*. !* . *#
#   # ##.  .##### *#.\ * ##*..*..**.!*.   .  ...\* .*..##\* .##
#      # #. . *.*\ #     .\. .*.*.*. \\..*..\**... ..*\## ..*.#
#     #\ .*.#####  .#*#  **  . ...\.*  .... #.*. *\..*. *.#* .#
#      ##\*.#  #\\. ## #### *#  #\ .*\.  *  .\.\@.   *. \ ##..#
#        ###   #..\#       #.#.*. * .*  *..*##..\. .\***##  ###
#              #*##        # ##W.\.\ *#   R **#.*#. .* ..#    #
#               #           #.\***#\.#.*  .*.##*.\. \*#.#     #
#                           #*#. .#*..##  ** # #\*  ## #      #
#                            # ##\#* ###*..##   #\##          #
#                                ##.\ .\*.*#     #            #
#                                 #.#######                   #
###############################################################

Water 0
Flooding 0
Waterproof 2
Razors 23
Growth 30
Trampoline A targets 5
Trampoline C targets 6
Trampoline B targets 2
Trampoline E targets 8
Trampoline D targets 9
Trampoline G targets 5
Trampoline F targets 9
Trampoline H targets 6