############################################################################
# #*.\\ \...**. .  *. * **\*\   *.  \ *@\\* . ..* . . ... ....* * * .*# #  #
###** ..*. *.\.*..*. .  .\ *    \.   *.***.\* * .. *.*    *...**.  *.. !*# #
#\.*.*#*    ..\.. \.. .*.W\*.*. ...\**..!....    \ . . . *. \**.** *.\W#*# #
#*..\  *. \* ** ..\     . .!\.\\  . \.@... . ...*..* *   .\...\ \. .*  .####
##. . \.\ . ..\***.**..  .*  ... *\..... . .\.  . .*...*...  *  . *.. .## .#
# .\  .# . ...*W*. \ ...* . * * ..** \*\**\. .\*.** * .... **. . \. #  \.*##
#* .*..***. \*\.. . .* ...* . .. .* .\*. * \ * **..\\*\**.\  .!...\*..*.* ##
#.  .  ..\* ...   * *.\  .. ..*  \.!. *. ...* . **.*.... .!.* * \#...***.# #
# \.. . ..  **. \.*  ....*\  .. .\.   .   \ .\ \ ***.*.\ \... * . #. .#.#  #
#**\#.  .  * *\!. *.*  * .*.** \* .. **.  .\ *  .*.  . . .\.  .*  .** ##   #
#\#  ..  \ .. ..*. *. \**.. .\R\...*..\ \   \..*\*\* .*.*  #***.*\*#*\#    #
#*\   \. . *.*..\.\*!.  *\.   .. *. *\\...\ ..*\..*\!.*.   \.**. .\#*#     #
##. #*..  *.. ..@..* .*..** . *\*. .\ *  . 5 .....* ..*\ # ..... .###      #
#*  .. \**.**\.\****\\.\..*\.W...@ \ \.. * .\  *.*..*.. .  * .....*\ #     #
#\*.. ..*\ .\ \ .\.. A.*... *..... .*. .**\ ..* .*.. *..\.*\  \.*####      #
#** . .*. .. \.*.**\.. *\.*....\ *.***. *   *\.  \    . .*...*\..#         #
#....*.\.\..\* .\.\.** **.** .\..* ** *\.** . \ *B .. .     \....# #       #
#*.  ** **.. \ *. .**. .!..\ . .. ...... .*.  . . ... . \* .*  \*.# #      #
#. \ ..\..   *\*. ** \\    ******\\*.**.*.\*. \   .\  .  . .**\.. ..#      #
# . .  **\ . ..*.W*.\..\*  . **. *.\... .**.*\.\.\ *.   \ .  .#\ *##       #
#  . ..\\.. . * *....***.. .\..*****\\\  **\ ***  * *.!. .. . .C\#         #
#\*  *\  *.\..***.\  .   .\.* *.* *.\ . !..   .*  ..*****\  .\  .#         #
#**#..  .* * **\.. .\.*  \ .........  \. *   *...\ .*\. *  \##. *#         #
#W@*# ..!.#.\.. \  .*\.  ..  .\    * . **.* *\. ..\.. .  .*..*\.\#         #
##*.   \ ..  .*   * .* .\. .\ *.. *. *\.3\. *.\..\***\**  *.*. .#          #
##\# \ . .\*.*.**\*. ***  **... *.** . *.\  .\.\*.\  .\*\.\ \.   #         #
# ##*. *\ *  . #...**.\*.*.\*\*.* **  4.. *.* . \  #. # *\*.#\ \L          #
############################################################################

Water 10
Flooding 15
Waterproof 3
Razors 18
Growth 21
Trampoline A targets 3
Trampoline C targets 5
Trampoline B targets 4