###############################################################################################################################################################################################
#             # *..*.* ..\ *.*.\ ** * .* .   \.. \*\. . . \ *.**.** \ **\ .\.    .*..*\.*.* \. *.     .* \**..  ...   * . * . *.*\  . ..\.! .. * \*.. *\ . . ...   **. \.\ .@.\. .*.   .* ...*#
#           ###*.*@.\*  .* .* ..\*\...*\..  .\\\ .. .\.. *\... *\!*....**..*  \ \ *..*.*.*\*...\ ...*.\@.  .\ * *\.* *..  .@ \**\.*\..** \\. * .*.. * \ ***\.. \. *..\.\.  .... \....\*. * *\.#
#       ####  #.*.. @**   *.\* \.*@\ .  .\.  \.\   **  *. .**\*\...*.*.*.@  *\ \.  \*.\* . ..*. . .\.\.*. \  *. .  *...\*..\* \** *   \*** **..\* *\... .\. *  .\**. * .* .\.\..\\...**.\*\..\#
#      #*. #* *.* \.. *\ ... .\.*.\....\* .. . .\**.\ .*.***...  .*..\ ... \.**   ..*. ...*  * .\....* **.....\*..\. . ..\\ . *. *@\ . .\*  .\ .\\.! *. * ..@*\* *..*\..\ *.\ \  .\..*..*  ***#
#       #.!\* ..\..\\ ** **  \ ...* .  .*  .. ..  .\ .**....* * \ **.!\.\ *... \   *. .\. * *  * \  \..*.* * . **.  *.  ...*.*\ .\*    ***\.\* * .*.\.... \**. * \* .**  .. .\ ..* \*.. ..  *.#
#       #*\*.   * .. \*. ** ****\ . * ..\.\ *..\ \ W .**..*    *  .\.*.... .* . * .** . ...  . .*.*!...\..\. * ... \.\ ..  .   \\ . .\. ..* ....  * .  \.*..\\  ..*\ **..** *\ * * *.. *...\ \#
#      #*#  *.\*. ...... ..\ ..\..  ..\.  . .*   .. *.*..\*.  **    ..** .* .. \.    *\.*\   *\...** . *.** .. .. .\ .*\   *\. \  *. *. . *  . . .*\ \*  *. .*  \ **.* . .* .. \.\..* *.*.*.*.#
#     #.. \.*..*..\.. .. ! .. ** . .. .\ . * * .. . *.. *.* . * .* .....   \. .. .\ .  .  * .*  .*  \  \*.* .. *...*. ..\ .**\* . *\. .... * @ * .. **.\*..\. .*. .\.* *.\!** ...  *..\.*\.. *#
#      #\.# *. . !.\.*. ..W. .**** ** .. ..*\  .\.  * .\* .\. .*\.*.\ .*.**! *.@\ *....*\ \.\.. ..\.**..... .  *\*... .  \.\..*.\ .* .. ** *\@\ ..\*.   .  *   \.. *.*.**. \.  *   ..\*.  **\.#
#      #.*....\* *..*\.\.*  * \***.**...* .**   .*....  * ...* \.  .* *. \@\ \*.  ..   . \ * *.  . \ .. *\  . .*.\ ** *\.. **\ **\  *..**\.    *..\. . .  .**..  .*.....*. *.. .\  * .*...... #
#    ## ..\.\*.* .\.\... .\\ ..*.\.**.\.*.  .*\.**. \  **\*\ .*!..\.\ .  ..\* ..\  *.\   *\..\   .*. .. ..** \ .\ *..** .\ .**.*. ..\..*  \.*\.*  ...\ ... **.. *\. ... .  *    .\.\.   * .. *#
#   #\#. .#\.. \.*\ **...*.. * \.*..\.  .. .\  . \. .* .....  .\*... .  . \*     ...*.  * .*** *.   ..*\....*\*\. *. ..  * .\ *. .****...\. ...\ * \. ****  ..*.\  ..**\  ..* .* . **. * ..*. #
#   #* **..*.. *.*.******* *\..* ..\..  ..   .*\    *\.\*...\. ..*.\\.*.  **...*  *  . *.  .*... .*.\*.\*.\.  * ..\*  . . * *   ! *.\..*..**\ \.\.  .\.\\.. .   . .*.**..*\     ....\ ..\. .*\#
#   #* \#W..*  * * .\..\ .\\*\*\    .** .  @*...*.. *.*.***. . *** .. \!. .. \.\. .... *  .  .*  .\ .\ *\... .*\ .**. .@.. \..*.***** *..* ..\.. .\.*.. *\ .\*.!.  \. .*.. ..\*!. ***..\*.\*.*#
#    ####\     *.\*.* *..\.*\  ..\. .\*\ .*\.*\.. .** . ...\.\*..\  .. .. \\**. . *.\* .* \***.\ *. * .\. .*.. *.*. .\.*\*.*\.*  ..*\..* . \*.* . .   \\\  ...\\..\ ...\ ***  .*.* *\.*. .....#
#     #.\*\ .*.\.*..*.*.*.*..**   *. *.* .* .. \\ \*..\  . .\.****..\ \. ..*.. !\ .. *.    *.....   .    ...  !\*\.*\. * \.. . *. ..*  .  \*\ . \   .\*..*\ *.*.*\.\.\.  *...  ..\.**. . ** .\#
#      ##.#. \.@.\\\...@*.*  ...  .. \!. \. *.  *  *\. *\..***.* .* **..  \.**  .\** . \ \... *.\** \.. .* \. *...*. .*...**  \ . ..**.** .**\*..  \ *.*\.\.\.  ..*. *  *.* *\**\. ..* \ . . *#
#       ##*\.... .\.. \.*..\  .   **... .*...  *    . .*!...*..\...\\.  * .\*\..**..*. .*\. . *..**.*   .*  ...\.*.. *\.  *. ..*W.*..* .*..*.**. .\.*.*\. .\...\ \\..**@**\*. ..  .  * .  .\ .#
#     ##.*# * *  . \.\..*. .. *.   \. . . * \.*\. *.**\*\*.*\.\. ...@*. *  .\* .... ... * * .* .*.. \ .**. *  .\ **....  W\* .**..  ..\***\. ..* *  .*     . .*. .. .\* *\* . .\.\** .\*. ** *#
#    #.  ..\. \  \ *   \*.\ * .*..  \.*.  \*..!....\.\ *..  .  *. *\.!. * .*.. *.. *    . \ *\.\\..* * .....**.**\.. .\. * ....**\ .** .\*! .\..*.*. . \ ****. . \  ...\. * *. .\\* **** \.\ .#
#   #*  \.   \!\*.\ . ..*\  .\*   \  .  *...*... .  .* \.* .\.....* .* \.\***.\..*...\ .. *.\.*  * .\.  ..\*** .\**   .****\. ***. **..  * \.*** \.. * . ..\**  \. . * .***\*....**\*\.\  .*\ #
#   #*.*   ....*. ..  * **..\.\W  ....**.\\.*. .*   *.   .*. *. *\.** \.* *. \ *.\* . . . ..   .**\ *\   \ *..   ..\.  *\*\  .**..... ..\.\.*..\. . **.*..*.\**\**..\*  .....\*\*...!   *..\ *#
#  # ##.. \ .  @*** .* .*\. **\.*.\...**\ ****  .\*\ .... .*.\. ..\*.*!.\ \*...\\*.*.*.** **..* ..*.\....\.*\ * *\\ .*.\.\ \*... ..\ ****.. \.\ ...*.  *\   *...***\*..*.*.\ ..*.*. . * **\ .*#
#### #.#.\  \. ...*. . .  * \*.*\  .\ * ...*... .*\ \* .   *.       ... . ...*\*   .\.\   ..\ .. *... .\ * . @*\ . . . ..* .. \.\ *\.  .@.*.*.  .@....*.. \** *\*. *!.  ** . *.\*\.. *. .*. ..#
#.**\ **\..*.*  .\*.  *  \* ..* * * W.. ..**.*\.\*..... . *. ..*.! .*.*    \. .. \**..** *  *\. *\\*...* .  ..*.   ** .\ \\*.*. .. . .   ***@*.*..* \.\!   *...*!.\.\  ..*. .* .*.\.* \..\ .* #
######. \* *\.. . \.\*.\*.W.*.... .*.. .\*..*.*..@ ..*!\ ..***\. .* *. *... ... *.**** *    ..\*....  *.*.\. .*.*\\...  *..***!\ .. . . *\**!\\..\  ....***......**.*.... . ..@ \* .. ..*..\..#
#   #\*. .\**...  .  . *.\*..\  **.* .. .  ****..\....*.**.*\..*  * . . .  * . .. \..... .   * . **. .  *..\  *.*.**.\*.* ...* .  .**.@ \ *\.*   . * \*..* .\*.\ ***\* \ ..*\.\ *.* *.\*.*. \\#
#    ### *.......*....  * .*  . ..*\ .* *  .. *. * *  . *.*\.\..  ..\ .****..\  \. *\.\\. . ..  ... .. *...*  .*. .**..\..*.\* . * .**.*. .***...  .*.*\. ..*\ ** W..\. *\W.!*  ..\. *\W*\  .\#
#     #\ \* *.. *.\.*. .*. ...\ . .*. *.\ .\... .*\..**\***... ...**. *\ . * *..\ .. .  .\*.*. *\. **\ !*.**...*..\.   ..*.* .\\\* .*\ ...\*\ * .* .**.\ .  .\*\* ... *.. ..* \ . .\...\.*\.\*#
#     # ##.***\ ...*\.\.... .  . \ *  **.   *  * .. . .*. ...\.  \.\* . .*** ****.\ *\.***. ** ... .*. **.\@* .. \. . *.\.. *. .*..*\. .   .* .. .* ..  \.*...\   .*.**. *..\. .* .*.. ....** #
#     #\ ....\. ....\ .*.   * *\.... **.*. .. \. * *\\..  . ..@. .  . \ .*\... ..\  ... \ \.*.. .\..\.*.*.  .*......* ....  .. ... \ ..   \... * *. \* ..\*.*  .  ** . .\.* \. * . *!. *\*.*.\#
#    #*.   *\.*  *..*  . .*\. *... *\..*\* .\*..\*\.*..\ ..* .\*   * *  *.*  ...\ .*. **. ...*.**....*. .  **.\* ...* . ...* .* *. \...   ..\.**!.*. * \.R..*.  . ..\ .. *. . \\.\*\.  *  **  #
#   #*\#..\*..\  ...\ ..*    *.\  ..*.. .  \*\*  . **.\* *\*  \ \ .. .. * ..* .\..  * .. * \.. . *\. ..*.... \.  . \..  .  .. . . . \.. @.*. . \.... . .. .\** *    **\* \.. *... .*   .*.*.. #
#    #. # @....*..  * .\*\!*\***.W.**  .   .**.\. .*. ...**\\\.  *   .*.    *.**  \..  **  ..\.  .*\  .\..  ***. *\.* *. \ .*. *.\**..  *\*.. ..\*\\ .**.  ... ..  .*W*.* \  *\\*   *. ***** \#
#    #.\.*.  *.*   ...   * ......*...\.*  \ *.. ...*   **\..* .  .\ **..*  *. ..  ..*.  .*\    .\.... .\ \....* .\ *.* .   *   ..*\. \... ..@.  .. *. .....*.*\*    ..... **.* **.**. ...\*.. #
#  ###.# ..#*.** *.\*\   \*.\    .  .*.*  . *.   . .. ..\*\..**  ***.*.   *.\** ..  .*   *. **..*.*.  .* .  *\.* .\*\. \ *. *\*\.*.\ .*. *...\  * .\.   \ **\* . ..   *.*\ ..**...\.  \\*..\  #
# #\..\  . **.. ..\... .. ....* .  .**.. .\ ... .   *.\.. *\ \ .*.   \  \ .\.!\*. .*\\.\*  ...!* ***.\\..  *.\*. .**** . .*........*\* ..\... . . .** ... \*.* .  \  *.**...\..*.\  .  \. .  *#
#  ##....*.\* *\ *. \*.*.. *  . . \ ...  *..* . .\ *..* .\. ...\. .    * .* ** \\..*..\*.***    \*...*. *. . \\..* ....\ .\  ..*\* ..   .*\*.  ..* .\\* *  .*. *. . \.***..  * . ** \.... *..\#
#    ## .*... .*  **.**.\.*... . .  \... \.** \* *  ... *.*.. . .  *W*..\ .  .* **.\. ... . .******* ..\.**.*\.\ \ **... . * ... \ ..  .* .* . *..*.*..\.\  *.*.*.*.** .  *. \***.\.*\.\.*.* *#
#   #. \*.  . *.  .*\** .   ****\  .\*.\ . *. !.. \...*.\.* .*\   ..*.**.......*.. .. **. ... .\.\.. \*..* \*\.*\.**\ .* \*\..\.*.\.  * *..*.  .*..\. ..\*****.*.\ *.*..*.*.  ***\. \* ...   *#
#  #\ *.. @ \.*#..*..*.\. \... *... .**..\.*.  * ....\.* .*....\** .* W.* *. *.**. .*\.  .*.    . * ..\ *.....* *\* *. ... . \*...*. \.\*. .*. . . .. *\.\..\. ..****** .\\......\.. *.\. .*..#
#   ##.#..*.#####\.\....* ! ...*.\.  .*....W.*\.*\**. ..\@.*\. ...*\* . .\.\*.**.. *.  . * . *.**.\  *... . ..\.... . @..\  .*..* *\ *.*\\ ..* *.*  ...   ..*\ **\....*! **  ..\. *...*  ...\.#
#     ###\* \.\**.# \.*...\ **.... .*..**. *.*.**..  .  ..**.**\\.\  .  . *..**....*... .*..\\*.*  . ..\. \   *. . ..* ...*. .\ \..* \ .. * \.*.  \ @\@\.* .*.\ ** . **  \@ \*.. ... * **\.*  #
#     #....*   .*\. .#*. **\**.. **.\ .*. \  * ..\ \.* *\.\*...*\  ..* . *.. .*. **.    *  * .*\*.*\  . .....\ * \.*\   *... *. .\W. *.\.*. .\. * ....*.. \*..! ...**\. ..\ ..\* . .\  .  ..\\#
#      ###*# ..*#. \*... \  *. ...\. ...    \.. .. \* ..* .* * .**\ .\.!\**.  .* .*\ .**.* .  . !...... *\.   *@*.\* ..\.* ..\ . . ..**. ... .. .\ . *.. . . . \   ****..\ \*..\ .  .. \* \..*#
#       #.**# \.# *.\\.* . *. ** ***\ *..    .*.***... ... *   \*\    *..*.\... \**.....*  **\** . *.*\.\* *\. ... **\**..*\..** .* . \* * . . \... .***\..   *  . **..\..  *.. \..\  . . ..*.#
#        ###* *\   .  **.\ .* .@ \*.. .\.* .*.*  .*.\..\  *** \ * .\  *.....\W* \..\*.*.*..\... .\ \ .!\ \\..*. .\ .* *...**! .. *.  ...* *     . \*\..*!\\. *. .\ ...@..  .*....*\*.. *.* .*.#
#       #*  . . . *.*\.*\  .**\..!..\*\..* *\**   *.! \.\*........*!.. \ .... * .\* .*..\*.\ .. ..\. *\.*.   **\     .. *\.. \. .** .* .* .. \..  ..*   .*.* @    . \ *   . \* . *... \. *.**.#
#        ###. #\  .*.. \.\....* ..  *.* \*   ...   \*    \*\* ...\.. *\ .** .*.*\ \ .\.. .\* *. \.\* \  **...***\..**.@*..*\*.   \.. .. .*.. .* \. ..\*. * . *.\** .* .\ .*..\**. ** . **.  . #
#        #...*#\.*@.\* \ ..* *.    . \ ..\.*\..   \ . ... ...    .**\\ ....*\. ..... *.*\.*   !\.\*.*  \...\.*..*. .. ..**.  . \* .** ..*  *..\..  .* ..\.\*..\* \... ** .*.\ ..*\..* .\.**. *#
#        #. ###. *\*. .* !.* .. **. ..\ *. \     * .  .!*   \.  * \.*..*..*. .  . ..    .\.\*. .\ ..*.*   .. .. *.. . **.. \.W*...\*.\. ..\*..**** *..\..*...\..*.. . ..  .*.\  *  *  .....  .#
#         ##\#** .\.*...  . * \ \*\* .. .. .   \*. * \ . @*   ....@..* *  \*. .*\ *\.. \...*.\.  \  .\*.  \\.. .\.* . \.*\. **.*\\. .* .  .*  *...** \**..  *.  * \. . .  .*.\..*\..  ........#
#          # . \*\  .\\. .  *   !. .*. .  .   ..*.\* ..*. .  **..*.. ...** .** ..*...*. .!\.\. .. *.. .. *\**.\* .\ *.. *** *... .*.**.\.\*.*... .....\.... ..\  ..*\*\*.*\ *  ...\ *\ ***...\#
#         #* ......\ .!*   \. .*\  ...\ *. **.*\ **..\..   .\**.\ *\ \*...\*.   . *!.* . *.* *\.   *.\..\*.\. *.*\.**.** ** . \*. *  *. \*.... **.*. *..*  \*  .. .. .**@.. \  \* . .  .*..\*.#
#         #.*   #.\...\.. .. *.. ***\ W *  .****.** *.** .\ .\ .!..  ..* .*..\. *.  *..* *  *. *.* .\*.  \*.\   ......*..\..  **  *  . *.. \. * . ** *. ..*.*.. . \.  .*..\   .. ..  \. *.\ **#
#          ##.###**..\ *.   ..*\**..*. .*   *....\ ..\.. .  \.\    \\ ...*\*\.*.*\\*.*.....*.*..*\ .*.\*@ .*.\ .*\*. *.\*.  *. * **\.\*.. . ... \ .* .\* *.*!@. ...* **. ....**\ \.\.*. *.**.*#
#           #\# *..    *. \ .\**.\ \. .....*.*.\... ***..*. ..*..W.  .*   *. ..\ \\.. \*..*..  ....*. *... .*  ...\. * .  .*** *\...\ .* \* *  .. .... .  ....@ ***  ..  ***..  *..   .. *. **#
#            ##.#**   \\.....**. .  **. *.....   . \*. ***\@ *.. * \ .\* @ *.\ !\ . .\.**...\*.*\* .*.. \..*.  .\   *\ ** ..*. .*.*.\.\ ..*.. * .. ..*.** . ... *\*    .*..**\ *.\  *\ \**\\.*#
#            ## *.*\.  *... **@*\ . **.   .\...\\ ...   ... ..* ... .*.* **\ ..  **  . *. ** **\*\\**. ..\ ..*  ... .. .\ \\..\.. .. . ***.\*....\  .. .  *\ ......\ .* *   \. *\*..**  .. .**#
#           #*..  .*.\  \*  \..... *...\.....*\. .  *.\.**\. .*  \.  *..\.  . * \*\. .*.*\**......\  *..\.\  . *. .\.*.  \.* \*..  * . **....      ...*\.*\**\.    .. .\. *.   . *. \. *  . ..#
#            ##.#* ##.  .. \.\ **\*..\\.. .\*.** .\ .\ ....\  W*.*. *.. .** **. ..\. .. .. * ....... .** \*..**.* *   . \ \ * . ..*\.   ...*.\..*! *\ \..**\.\... ..  ** .\.. . ...*.\*.     *#
#              # #*#* .  .  * .. ...   .    .\..*.... .@**.*.*\.*.* .\ .\*.\.\\.\ . .    ...*\. **\  ... ...*\.*\..***\ .*\  * \ \  . ..  \*.. *.*...*..\.*. *.. *.. .. \  . .*\ .\\*.\*\.* *.#
#              #\  .** .*  \**\ ..\ .\. **. \ .** *  *. . *   .  ...*** ....  *** *\ **\!. .**\.\.*  @  . . * \..*   **  *. .*.@..    .. ..**** *. .*..\. .  *.\\..*. **.. ..*.*    .\ *.\. ..#
#               # #\\ *\ .*... !.\  **  *.. ..*.*.\.  *   .\..  *** *.\.*\ \.*.\...*..*. .. ..\  !* ..**.** ...\ *. * . \..**..**....   *.\.\\ .* .*. ..* * ***..   . .*\  \* .\.\**\ \..  .  #
#               # #. L.*    *... ..\*\*\**..* * ..* *\*        \*.* .* \*  .      *.\ \  *.*..\.*.*. .... \ .. **.\* .\  *\ .... * .  **!...  . *. *. ... *.*. . *\.. .* *. .* **....*. *   .\#
#                ##. ##..*#*..#   .\..**  .\..*  .. .  .*.  @**.....   *  .  .\..***** ...*..  ..\*  .. **.* ... \.. *.*..*.. ** .\ *.\\ .* ..** ...*\   .. ..  \.\\ .*...\... **..\.  ...\ . #
#                  #\##\*.#. .***\  \*.* !*\..*\*\.. . *\.   *....*..  .... **  *..\*.*\**.**  *\ *  *..*. *\*.* \* \. . \ .\ ..@ **..!. ...*\.. .**.* ..* *.\  *  . .**!..\   .\    ...\*.. \#
#                   #  #*#*#*\.\\  \ .\ . *...* \. * . .* *\.. \. *\ .*\ *\ .\.*.....\..*\...\..\ .  *...\...\\. ....* .*\.  ...*.\. *.\. \ \.   . *\. ...*.\. \*.***. .*\*.  \  *\ *  * .. \.#
#                       ##*  ...*\*. \.  .\...*.  \.\.. . .*.*..   .  * *\..*  . .\ *. ... **W. ***\ \ *.. *\ . . *. ..   * ..**\.*. ...\ . .\.    ... \\  .* * .*.*.. *.*.**. **..\.. .****..#
#                      #* \. \**.\*. .**...   ..* . ** \  .* *\* *....  ..*** .  \ . .  ** **..*..**\.****. . .*\.. . *.**.\.  \. ***.. \..\.*. \***  *.**. ..@* .  .\..**.\. \..*.*  .**.*.. #
#                      #\##.*#*## *\*.*.*....* \*\ \\* . *\* \ .   .\..** **\.\* . ..* \.. .**  .*..*......   \* .\.\. *....\ *.  *. * . \** .*\ .*.\ \.*.\   . ..\*\**....  *.*\..* *\.* .. \#
#                       # #*. .*. .\. \ .*.\.* .*\ . .\* @ ..   . ..* . . \*. ..*.. \.\.\.\  .* *.....*..\ ..    .  *. @\ \.* \   *\.*   .\..*** *.\*..\*\ *. * *\.  .*.\ \  ... **.*..\.  **.#
#                         #.. **\ .**. . *..    .    .*.*. . .   *.\.   \*. **..\ *.*. .*. ** \ . \ * * . \W\ ..*\..\....\..* ..*.*\\.  .*. . *\  *...*.\. \. ..**\\   \*  ..*.* *. *...*.*.. #
#                       ##\.#*.** \.\\.\.\.  * .* .\   *\.. .\* . *.* .  .**....**.\!....\ *.\.**..*\.*\* \.**** ..* ! .   ..\ *\.*.*.\*..* \ \*  *.\*.\. * .. *..* *\...*. .  * * .*.*.*.\. \#
#                      # ** @* \* **.. . . \*. *.  ..*.. ... ... **.*  . . \*\.\.* \ . \\ .\. *.\. *  **. ...*..*****..*..\ .*\.. . .*..*\*..\.  .\.    \ *\  *..*\.*.   . .  \. *  *\..*\ ...#
#                     #.. *.*\..**** *.. .*..\ .\*  .*\  *..*..*.* *.*.   * ...  *\.\.**.. .****.. .\ ..* .\*  ..\.**   .*  . .***** .***.*\* *\\\  *   . . .\. **... * **\.*  *.. .\ *\*. .\.#
#                    #*** . .W*...*  .....\ .  *   ..*...\*.\*  ***.... .*    ..\ .....**   . .. *.  * . . * .\.\.\**.*...*\* \*.\* *... *.*** .\ . .***\   *..\.*. \.. ..\..* * ***. .. * !\\#
#                   #* ##.*\.... *..*.** * . ..*.  .*.****.\ ...*..*. . W*\ *. *  . .**\..* . . *.* \....*..  .*\W...*   ***. ......**   .* .*\ ***. ..\. *\* .* ...    \\** .....*.\.....  . #
#                   #*.# ##\.*  ..  **.\ \ .\*\*\....\. ... .  \.* ...*\   *. .*  * .\   \  . *..   **. *.\.\. ...\ .  \...* *.\.\ .*..*. ..\. *....  \*. \.. .\ \*. .\\\. **\   \.\**\.\  ..*#
#                    ##   #.#*\.*. *....    ..\. \ . * *\..\*.*... ..    **... *..!**.*...*  **.*\..*..*..* * .  ....\.*   *W\* *.  .\.... \.. ..  * . ***. ..\  ! * * ** *\. \.** ... ... . *#
#                         #*...\ ..*.\.  * .*  ..\*..* \.\ **.\* . .*..\...  . ..*..W*..*\* \ .\          . ..**  ....*....*\ .*\  .**. .\*.. \ ..*.\.* .\ .... \ .*. \*  .*...... . \* \  ...#
#                          #...#. .**... . \..   . . ....*\.\. .  \*\... *.\  .* . .*.\..*.*. .*. .*. \\ *\...* ** ** **.. . *.. .  .  ..\..\....*\* \.*  .* *\*.\\... . ..  ..* .    .  .. ..#
#                           #.\*.  .*.\.. . \*...   \.\    ..**   .*.  \ ..**.* *.....***. \.\.*\*...\..\.*** .@..*\.\.***.*\..\*\... \.*. !.\ * .*. ..\ \***..* *. .. * * .** .***\ . .\  * .#
#                            #*##   . .. . ..... .*.  . .. *\** .*\ .**  *.\.. *.    \*\.\.. * **\.**. \*...\  * .  ...***.** * \  .\  *. .   .. .\. *. *.*.*. .*.** ..\*.\**...!...  * ..*.\*#
#                             ##**.* #\ .*.\*\\*\  \*...   *.*. ..@\  \... ****.*    .  .**.\.\\* . * **.   ..* .\**..*.W. .. .*.** \* .\  *.. .*!*  . *.*... !* * .*   **... *\ .* ... .\..\*#
#                             # .***  * *** . .\. * \ .\.\ ...\.**...*@**.\.\.\* \ .* !\.... \. . *   \.\ @*\ ..*. *. *\.*. ..*.\ \* .   \*.\ .* .*.! .....***..\*   *.  \! * *.. *.  .*\.*.\.#
#                              #.*\   \ *\!*@.. **. .    .*....**.. \..\. ..! ..\ **.   ***. .  W**   ..* ......\. * * ****  \.. . .\ \ *.**.. .\ .****.*  * .  .*@  * \ *! *\.   . \  .. . *.#
#                             #\.#. . . \ . *.\ .. . .*    *.**...\*..* .\.*\.* ....* ..*. ..  .. .. *.*..  \*    .. ..*..*\** **\.*. ..**.***  * *** W  .*\ .\.\*.\.  .\.*\***.    . *  *....#
#                              ##.\*\  *.**.\.* \* .  .  ... ..* \ ...*.*..**.. *\..*   * *W..**. * *.* \. ...*   .\****.\. .\ \ .\.****.\*\**..\....* ..\.******.\*   **.* *.**  .* .\. ..\. #
#                                #.. #\.*. .**\ ..  ** .*. ..**..  @.*\ .\ *..\.\.* ..... !\* .\* . ...  * W  . ** .@ .*\*\.\...* .*.\..**.*.  ...\ \..\ .\.*\.....* . **   \\*.  ..*\*.  \.\ #
#                                #  .  *.#. **..*\ \.\. .* *\...\ .*\*.. *!.W.  .*\. . * . .*****\  .*  *.*.\*  *. *.  . ..   .*. ..* \ \\ .*..*. ...**...** ...* * *\ *..   *.\...***.\ . *.*#
#                                 #. *.#.#\.*\*\\*.  ...*. . .\ . .\.**\ .* .\. *.  .  ** *\* .*. \.\.. .\.  .\\.\\.* .*.  \**... .\ *. .*  ..   . .!. *...\..\\.*.\.. \* .!*\**.  ***.  *..\*#
#                                  ###\*.#*.. #  .**  !*.* *\..* .\.... \*  *!\.*@\ .\ *........* ...*\.*\ ..\.. .. .  ..*.  .*..\*...@  . ..  .*.\ \  !. ... *.*. .  \.\. *. .* *.. \. .\ *.\#
#                                   #*.## #\.#*.  .... .\  \. *..* . .* .*.*. ...\.. .*.  .. . *.\***. ... . . @ *\ \.*! ** **..  *\ .\ .*. .  * . .. .*. .. . ..***.\.... \.. . *.* * \ *.. \#
#                                    #*# ##*.\* .*. *.. **\   .  \..\ .* . .** .\ *  *. *.  *  . ..\...\! ...\.. *..W *  ...\ . \.\\.  * \@.\ .*\**\   .   ..*\ *\...*\*..*.\.* .!*.*. ..     #
#                                     # #* *\.*  .  * \.***\.  .\* \*.*  \....\.\. . ..\**..* **.*\  ..  .\ .. \*.* .\..*\  . *  *.!\.   ........ *. .W*     . \.*.* ...\..***\\ ...*.  *  \**#
#                                        ###\.***.* **. *.\ . .*..*.* .\.*\ . . *.* ... *\*\*\..*** *.** **.\   .*   . **...**...!. .* . . *.**  \*... ..\ *. ..*. .  .** .**!!.  * .  **...\.#
#                                         #..   .*. .*.. .*    .*\.\.*\ *  *.\* . *.    ...*..*...\ . *.\.*  \   *.**\...*..**..**..  . . *...* .\ ..\   .*. .\ W .  \. *.**. *\*\..* .* *\\.\#
#                                        #* .*. *. ..\*  ..\ .. *. *.**.  .. .\*  *  *... *.  ** \. *\ .***** *... ....\*..**** .**\      .....\*  *  * *..\  .**\.  . \.*.*.. .** *. ..\..***#
#                                         ###. *.\  . .    .*** ...! .\.. .\  *. *..  .* *.*** .....!   .\..* ** . .** *\.*\* .\ ..*. *.. .\   ..  ..*. .\ .\ ..\**.  .\ *\ .* . ...\ ..*.***.#
#                                            #\*.. *..*.. .*.**.*.*.*\...  .....\. .  \......***\  .*\\*\.... *. .\*.* *... @ .**. .. \ .**** \.. .  .* **  .  *    ..\. .* *.   \.*.....*.\.*#
#                                             #**\**..*  .*.*.\.* .*. .@*.  * *\. \.*. \.  .\.... .*.  * \  \ **.* . . . .*\.. ..** \..*\*..*\  ..   .\.*.*  ..\  .. .*.. . . .**..* * . .\...#
#                                           ##..*. *#*.\ .* . *\. **   \ \. . . .\.**  \  *.***.\..*\ ... . ..*.** ..  .* .  .\* *.*. \*.*  *.\ *.\.*\ ..*** *.*\..*   ! **\ . .  .. ... ..\.\#
#                                          #*\* \# *.*. !*.@*\. **\ ** .*\ * .**..***\ .\  *..** * ..**!  *  \..\.**\. ..***.. ..\\.   *..* *.*....\..\*..  ..*\ ....  .\. .   ..\.*  . . *.*.#
#                                          #\##\.###*    . \.. \.\ \*..\.. .\.*\**.. ..*...*...\\* \.*.\  \ **.*. \. *...*.. *. * \ \*\. * .* .!.\.  *... .**. \*.\*\.*@ *  *.  ...** . .*.*\ #
#                                           #  # ##*..**.\ . !\. *\*.*. .. \. . ..* *\****\. \* *. .\*.* . \.  ..*  *\*  ..  .... . .. *..* .* .  .  .\ **..\*.!  .*..\..\.**. . \ .. **. *.  #
#                                               #  #. \* **\. ....   .\..  . *.* \..\*\ .\*. .* * . *. \ ! .* .*.\* .** ...... .. **.\.*. .*.   *   .* *\. *.\ . * .* * .**\.\ \* ..  **. .  .#
#                                                 #\ . . *.    .*!\  . *.*..\*.... ....  ...*...\  *. ...**..... . .*..\ \.* *.  .**...\ * *..\ . .\..  *. ..  *..*!...\.****  .. **...* .\.**#
#                                                  #*. . @*  \. . . **\* .\.   .*  \\    \*.*...**\\.  .   ..   . \*.   ..   .*. **.*\.*\ .**..\ . .. .*..\**\* .. \*\!.*.\ ..  .  *.*.. ..\ .#
#                                                 #.  *.   .* . *.\*.**. *\ *\  .*\*    . * . *.. .\****@* .\**\ **..*. .*  *.* . .*.\**\* *...**\  .*..\. ....*\\ **..*..@\**    ..*\*****  *#
#                                                #. #.#* \*\\ ..\***. *\***... *\. . .*\... * * \ . ..* .. ..\ ..\  *.**@.  .*\ * **  *. . \\*... .* .\.. . .*... .***    .*.* * .  .*....\ *.#
#                                                #.* *.. #\...\*.  ..*.  ...* ..**\ .\....*.. ....*  .*... . *\.*   \ .*..*..*\\. ..  \ . ....\***....* *...\..\    *\...**.\*. *    *. \ . . #
#                                                 ####** .  .\ ..\\  ..\    . \*\.  ..\  **. **.* .\ \.  \\ .W  .*....***.*.. * .* \..\ . .\.* .**\* .\*.*@..\.* . .***\ *.. ***. **.. .. * *\#
#                                                     ##...  \   ..* ..*...\@.*. \.**.  ..  *\\ .\ ...***.*.  *....*\..*...\  * \.**.. ...**\.\ ** .\ *..*. ..\.. *\.* . * \..! \  **.**  . .\#
#                                                       # *\* . \\...*...\ ....*....*.*.  ..\ .. .  \...**..* *.   . . *...*.   * ..\.\*.. *.  ..*  .\*\....**\*.\*..\*\.. **\**.**.  .*\\. \.#
#                                                      #*.  * \*. .. ...  * **. .\  ....*.**.**\* .   \...* *..  \. \  . .* *\\.* * *@*.\*.**\.**...*** ..**.*.**...***. ..\....*\** **\*    \#
#                                                     #**.  . W\. . .*\.*  ..    ...** .*\.\ .*.*. *. .  .*..**.*\  . **. .** * \.*...* \..*.***.   .**\. .\ \....*..*.** *..\*\ *. **\ *  . *#
#                                                     #\ #..\@....\.\. ..   ..*  \.\\. .\.\.*..**.*. \ *\*.W ...*.*.*.\ .\ .. *..\**  * .*.*..** *  ....*\.**.. * ....\.. .*.*. \\. .\@.\* .*\#
#                                                      ### ..#. . *...*\*\..*\ \.\.*.\.\***.. *.\...  .. ***\. *...*. *   . *...  \*\ .*.\  *  . ..* \..* *... *..\ \  *\ .    .. .*\ . .. \ .#
#                                                         #* *..*#..  .*..** .\.\* \    *\.. \ \...****  ..* *.*   .\*. *.* **. .* .* *.\** \**..  ...  *.\.!  *\* . . .. ..*. \...   * .*  ..#
#                                                          # . \*.. .*.*.\.\ *.***. *. \*. ...*.\  * ...  \. .\.\*  ..\ \ \\.\*  ....\....* .\.** \ .... ..* \..** ..** .* *..\. .*.*.*...    #
#                                                           #.\ .  @**..*.  .....\. .\....  \.\*\.\\ ..*** .*. \ .* *.\. *   *\ *  *.* . . * . .. . ...... \*.  .\*.*.* \*..  * .*....... *.\.#
#                                                          # ..@ *\** **...\. .  *. ..  *  \ . *.. .*\.... .\*\ .   . @.\. **.  .* \\. ... @ **.\.**..\*  ... *. .***... \..* \  *.\. .\*\* ..#
#                                                         # ..\..\.*\.... \.   .* *  *..!.. .\ . *\ . .. ..*..** .*. *.   \.@  \.!  *!**.    *..*.* *\ . ***.  * ...W ..\   ....\*..\***. \*.*#
#                                                          ##*.*\. ....**...    **..*.*\....\*..*. ..  .* .**\\.  . !* *... ..\. .* *.\****.*\ .. * .... ..** ..  \ \ **. *..\.  .*...*.. ..\ #
#                                                            #...\ \. .**.\. \*. ..\.* *.** .@* @*  * .*.\.*.. \\  .\*****.\* .@ .*\..***.\...* .*@. * *\*.*.\ .\*...\..* ***\..  *.\ ** *.\. #
###############################################################################################################################################################################################

Water 0
Flooding 0
Waterproof 18
Razors 1
Growth 14
