#########################
####  #  #\.*. .. . \.\.#
#...### .A..* .\    \ *\#
#L# #.#  * 4.\..  ..\..!#
## \. *  .. #.  *.    . #
## #.#..  .    *.\*.\   #
# #*\##*.  ..*.*\ .. \ *#
#  ###*.   *\.\  ...  \\#
#   # .*.# . . . .\.\ .\#
#  # \*#\**.*. ..*.\ ..*#
#   ##\.**9 .  ** **\.6.#
#   #\D..@*  .   W***...#
#   # \* *. *CR\*.. *.. #
#  #\..* .\..B.....**.\ #
#########################

Water 10
Flooding 1
Waterproof 2
Razors 30
Growth 23
Trampoline A targets 6
Trampoline C targets 4
Trampoline B targets 9
Trampoline D targets 4