#################################################################
#                   #         ##*#                              #
#                  #*#       #*.*#                              #
#                  #*#  #    #. .*#                             #
#                ##..###\#   # .###                             #
#               #*.  ..#..####  ##.###                          #
#                #  *  *\# .\# .  \#..#    ####                 #
#                 ##. \#.# ## *  .#\.#   ##* \ ## ##            #
#              # ### .  .\  ..**\ ..#   #.\. ###\#..#           #
#             # #***\ *.  ..  ... *#    ##*.*###*\ #            #
#            #** *#.  \*.* *\*..\...####.#@*W\ #\* #            #
#            ####...\ ..   **. *..\# ..... #* .#...*#           #
#           #.##   . . ..\.**.\.  .*  ##\ .\..\.\*\#            #
#          #.. #* .* *#**.*..*    ..* .##\*\  *.*.**L           #
#         ##*#.##\.* ..\...* .  .#*\. *. #*. .\..\ *.#          #
#        #.*.*\..\.\*.* .\** *.*. #..*  *.*....  * @..#         #
#        #\.\.**  \ . ** .*....* @.  . **..*\ .\*..##.#         #
#      ##  #*#\ \.*.... .** * \. \. #*  .. *.* *\\.*.###        #
#     #. *. *##*@ . .\*\.\. . . .** . *. @ .*.**.#.*  *.#  #    #
#    # * #  .*#\.*.\ . .*..  .****.**... **\ ..**...* \#.##*#   #
#     #*...\#\  \* .*. **..* ...\*....*  \. . *.** .\ *  \..### #
#   ##..*  W.**.    * *. .. .* .*.**.\*\... *\.\.\ *.*..*.. *. ##
#  #\ #\**   ** ..*\. ..**. *.   .. **.**.\ *** # *.*.**##\ *# ##
#  # *...*\. ..\ .**. . .*\.** .  * ...** .* .  ... .\\.\#* .#\##
#  # ...##*\\.. ...*  *\... .* \     *  . . .\ ** ** . **\. *.* #
#   #  . .*.    *.\..\..  .*\  . \ .*.\.. . #....\. **\#...*.**##
#   # *..* ..\.   *  . *.  \...*\. . *. .*.\    ..* *. #.*!.\.* #
#  #\..*.*\ *. .\*. .*@*. .. .*\*  **  . .*..\. **.\ \**. . *...#
#   #...  *..*.. .** .\.\. **\. * ..* *. .. *\..*.**\.*\...*.\.\#
#####... \**...*  ...    .. * ....***\. **. .   . .... ..* \.. .#
#.\.   .*.!.     . .\..\. **\. .\*.\\* .*.\.*.\  .\  \  ..* ... #
#***. *\.! \. \***\  .\**. .** .*. ....!*\ \\..* * \.\ .\ *  .\*#
## *. *.....  *.****.  ..* .\.*.. \  .\*.. .W.\. .. .* * .*\  ..#
#\ #..* ..\.   .*.\\!. \.*   **.*  . . .*   .*..\\ **. \ .....*\#
#\ . ...@\*\\ .\\ ..*.\   .**   *\... .  .\ ..!\*.*.*..   .\*..*#
#..\*. . .* \   * ..\. . \\* \....   *.  **  .....**\  . *. . ..#
#   \ **. .\.*. \.\*  . *. .   \.*.. . \... .. \ .\\.*\\ .*\*\..#
#...\*\.  .. \  . .\*    **..*   ..*    *.\\. * .*.....   .*..* #
#.  \*..*.  ..**.\ *!...* .. \  .**. *  *\.*.**\ *.\\..  *\. .*.#
#\.\... .* .. .\.. .\ **..*... ..*.. ..  .**.*.\ \ .**\ \.* . . #
#.  \ . **    \* .*  .* ..\.@* *...   *.. ..* *. ..  * . *. \\* #
# * .\ .. ..* @.  . @  * \..\ \..*\ **.\.*\.   . . ..* \*. .. .\#
#\ . . ***.\... .**..*.  .     .*.\.....*\* .....\**..\.***\ ..*#
#@\\. *..* . ..*\..*.*.\**.* .. \.\.*.\ **.\. *.\.*.. .*.*\* ...#
#*. * . *..* *.*..\. *  . .*.*  .     .\.. *\ **.\*.\**.*. \* .\#
#R. \ * .\..*..*. . *..  .\..\.\*.**.***...\. .. ***\*.. .**.* *#
#\. .*.. * *. \.. .**..!.* *..* .**...\..*  . *\.\...\ *\.**.*\.#
# \*.*\ .\* .\ *\ .\.\.\*. .* .  *. . .** **...\.. *.  *  ...\ *#
#*.\*..  .. .*\...*.*\.\\* ..\.  * .\*. * *.\ *.**  *\ *. *.** .#
#.  .\. . *.\. .\  .*  .. \*. ***  \.\...  **.**. . .  * **.**\\#
#  *\ ** **\.      *..... .\*\....!. .  . \**.\. .\ ...\*\ ..**.#
# \.  . .* *** .* \. *.* ***.    .*   .. ..*\.     *. . W* .\\  #
# .\.*.  *. *.*@* ** ..  *.*\.\****.\*. .*..* \.\.*\ * ..\   .*@#
#\ .... ...\* ... ..*   ** ..\ . **  . . *.\. .  .\.. .\. \* *..#
#*.***. .*.** *.*.***.*\.*   *\*. .\  \. . .\.     .***.* .. .*.#
#*... *..\*.. \!.* .*.   *..*. @ *\  ..*.***  **.*.  .*\.*!* *\*#
#*  ... ...   \.... ..   .. .\ .\..  .\. ..**..*.*.\*\ .*. \...*#
#...\.*\\. .. .*.. . ..\** *. .\. \.\.*..* .   ...  .\ . ..** **#
# ..   *.   *.*..\\  .* .. *.   \@.\.    ..    *. \ .  .* \.\ ..#
#.  **.\.\.*. .\  .. ..*\\*. . *. \.   \. *\*...**..  *.  W *   #
# *.\. *\*.\*.\*@ .*@ \**\\ \* .\. .  *. *.*\  *.\***..*\ \ *\*.#
#################################################################

Water 30
Flooding 4
Waterproof 19
Razors 20
Growth 10
