################################
#     #        #*#\****  * *. .#
#    # #       #.#.#\*.\  *.**.#
#    #.#      #*  \  \. .......#
# ###*.#    # ##. .\. .\. ** . #
##.\***.## #*#.@ .\.*  !...* .*#
# ####* 5.##. . .*.    *  ** *.#
# #.\ **#*#.* ** # A \ *\* .**\#
# #\.#...\.*. #*.   *.! .\  *.*#
#  # .#* *... \.* .\.* *\ ***\.#
# # \..*.* *. ..*  *. \ . * . .#
#  #.\\# .. .  *.*..*.* *..* .\#
# #  . *\.. .\*\   ..\. \\*.   #
#L#.  .**.**...**\ .\ \. *W\. *#
#\\.\ **.*.\. .\ *.*..\. \. . *#
###*#*.... ..*   . .. .**\.\  .#
# #. .\   .*. *   * ... .. .*  #
##...  \ #*\*\.  .. *..*\.*... #
# ###*.  \.***#  \.*...\*\**   #
#  # .\**. *.\. ....\**.**..\. #
# #.\ ....\...R  * \.\..*\  .* #
#  #*\ *..#@ ***.   .**.. . *..#
#  #*.*.  **\..\*   **. * \*...#
#   #\. #.*\* ... \..\*\* .. ..#
#    ##. ..\.!.\....**\#\.  .\ #
#     #.\*# \* *.#.. ..  .. ...#
#      ###*\.  #.\ \ *.*.   **.#
#         ### .\# .**.\.\*.\.*\#
#           #. ## *.* . * .*. *#
#            #*#..*..  #* .#\.##
#             ## .#.. \.\..  .##
#               #..*.\   \@.\# #
#                ###*.# #   #  #
#               #@\.*..   *#   #
#                # #.#.##\ #   #
#                 # ##*# ##    #
################################

Water 0
Flooding 0
Waterproof 10
Razors 43
Growth 47
Trampoline A targets 5