###############################################
#                     # ##  #*#               #
#                    #.#..# # #               #
#                   #\.  ## # *#              #
#                    ##.*.*#  ##     #        #
#                    # ..*\*.*\.## ##.#       #
#                     ##.**.*. \*\# # *# # ## #
#                   ##  * . !. *.  .*\. # #. ##
#                  #**...#.*.\ * \...# * *.*.##
#                   #.#. #...**  .* #.  \*\*# #
#                    # #L. \** \.*. ...7!\..*##
#               ##  ##  #.*. *\ \* *\.*. * .*##
#              #*.##. ###.*.*.. . ..* **. .*.##
#             ##* .#.#\.\.\ *. .*. ** .*  ..*.#
#            # *\ **.* ..   ***\ ..\*  .*. ..\#
#           #..* # .*  #*\   *..\.......*@  *.#
#     #    #\ * \..\ *.*..  \.*\ . * **.*. *\\#
#   ##.#  #  ..\.\#.\* * *.*\ *\*.*@ *.*.\ \. #
#  #*.\#  # \***. .* \****\.\\****\*\ .  .. ..#
####.\**###..**.*  *\..**.*\.\..*\.*. .*\**...#
#.\.\*.**....#  . . *..  ..   .*.. .\ \*....\ #
#..* * ..\#.*.\ \. .. *.    .**\. * *..*\ \ * #
#\..\.\. ...**. . \   *.@.   ... .*.@** *  *\ #
#... **# *.**..  * .**. .\*   \   ..   \. \ ..#
#! ..\**\*\.\... . * . *\*@ * .*. * ....* ..* #
# \.\.#. *\.    .*.*. .\.**F .\.@ .. .***.*...#
##. * *. ....*   . \\..* \.     \  \*..*\.\.  #
#. .. .  *\@..   * .\.   . \ *. *\...** **. **#
# *  !\.* *.   ..*\ . . A.. *\. **.* *  .. *. #
#**.*.!* ...* ******.*  . *.**. ..\* *   *.. *#
#\.\ *\. *\*. .\ .. .\   **!.*. *.***\ .*. ...#
# E** . ... *  . ..    .*.\  .  \*\.* . .\ @\ #
#*\*. \       .  \*...... **.*!\ \*\* \ .\ . *#
#** \.\.\ \* . .**\ .. .@.*.**..\*.*... .. * .#
#..** !..**\ ..\.*.*.*. *.  .\*** .*.\.*.. *. #
#* .*. ....*\..\..*\****** . . ...\..*  . ..**#
#.. .. . . .* ..\...*.*  .  *W \  * .* ... **.#
#***\.* *.... .*..\ .*.W *\ * *.  *\.\.   *  .#
#..\..* *... *.*\ .\     .*.**\* \..*.. * \ .*#
#*** \ ..... * W*. .* *.  .\ ...  ....  *\ .\.#
#\*W   .5\.\.\** *. . .* . @  \..*  .** ...\..#
#.*.*  .   ...**\*. *.\ .  .\. **. * \\!\ . *.#
#.**.*.*..*... * .*\*..* \..*. ..*....  *.*...#
# *.** * \.**.. . .  *..\.  .. \***\.** ..* .*#
#\ . \ ... .....D..\**.\*\**.. \.. B ..*.\.***#
#. *.*. .*\** . . *... .   ** \. .*.\ .. ...**#
#.* **   .. .. ..*.*..*\***..   \* ..\*.*\ ***#
# \.9**\*\. .*   *  *\.**..\.. * .  *..*..  \*#
# .**..*\   W... .  * *\  . *...  \ * .*    * #
# **\ .. . * ..  * .. . .   R ...**.  ... *\..#
# \.* *\.. **\ .\. ** .* !  .\** .*. . * *\**.#
#.. ..  *  .*.\*. **..\.  *.*..**\. .. .\.\***#
# *\* .*. **. . ...*W.*  .\*\..\ .\.* . * ...*#
# .\ ..\ *.  ..\\*\.\\...*.....G   \*  .. .\ .#
#.\.  .\..*  ...\. * .\. . *.. *.     ..\ * . #
# . .*. *.. .  * * .   . .*....\. . * **..*...#
#@\. .  *.  *\ . \  ....*\... .*.*..*.\.* *. *#
#\.   @*.\. . . *.\ ..*.. *  .*.*. @  **...*..#
#\* .\.....\.*\. \. . *. *. . *.\*.* *\\.  ..\#
#. *\!\*.\*. .*.\*** \ *...*.!..*.**. . **\ ..#
#.*\*\.*\.@...* .*!\ .*.**.  .\\ \*. *!*..*  .#
#.**. ..\.**..**** .  \ ...\\  ***.\*. .\ ..**#
#**.*\\.*\.* .. \ ..**.*.*...*.\.*\.* .\*.. ..#
#*. . .**. .**.. . ...*  \. *\  ....*. .***. *#
#\!   ..\ .!\.\.  \...**\.\ *.. .* *..\ ..*. .#
#*.\*. ...... .*.*. . \.\.*. ..... *\  **\.*..#
#.\... **.. \ .!***.\ *. 4..  . \\.\.* ...\..\#
#\.*. .* . ..*\.*.*..**. *\* \ *. *. \.\  * *!#
#.  . * *.* *. .@... \* ....*...*..\   *. * **#
# . *\.. \ .\** .\\. .. * .\..\..*\* .\ *\**.\#
#******. ** *.\ .*. . **. ..*\* . .*  .*\....\#
#...*\*.. . *. **..\** **   ..\**.\... ...\*\*#
#*\.*..\*\.  \... ...*.\ \*  * .*.. @\.!*..*@*#
#. *.@ .*..\.*. *..\ ...*....* ***. **...  .6*#
#\ . *.\ *\.@ . \.\ *. *.*. .* *.*.*.*\...** *#
#*  *..* \.*.. .* . \..***.  . \ . . ..*. \***#
#*\ ..H. ...  \.8   .  .\.*   . . *..  .  * ..#
#*.** * .. .. !     \ .**\. . \. *.*.. .  * *.#
#.* . \...\*. .\.\.... ...*.. *\ .* *    * ..*#
# .  .\ \ .\!\ .. . .\ .*..\..\.*\@\  \...   *#
# W*. \  *\.**\ ****...*\..*. ..*..*.!\** .***#
#\*\*.. ...**C \.... .\.*...**.\ ** **.\* *.* #
###############################################

Water 0
Flooding 0
Waterproof 10
Razors 13
Growth 1
Trampoline A targets 4
Trampoline C targets 8
Trampoline B targets 6
Trampoline E targets 4
Trampoline D targets 9
Trampoline G targets 5
Trampoline F targets 7
Trampoline H targets 7