#################################################
#   ##*...# *. \. .* **...  ...**\... * .\*.*. .#
#  #\ * \  ..*. **..*.\. \    ...* .D*..*.. . . #
#   #*. . . \F*\.* \* . .. \.\*   .***\ .\*.  . #
#  #\.#\*  \.**. . \*... *. \*.    .. * . ***.*\#
###\ .\*.** *.1* ..!.*\. .*A *..*E*\.. .  .\3 \ #
#.**.\#..#*#.@.. ... *\   .  . *B.. **. **\...  #
#####.#\#.\\. *..   .\  \@.\ *  *..* .. \. ..  .#
#    # L#\..\.\*\* **2. 8... .  .... *.@.\ .  .\#
#       #..\ .\*.\ ....   * ....\ C.....\ *..*..#
#       #*.#.!\ *\* . R**4.\..*.\.\ .* .*\.*.. .#
#################################################

Water 1
Flooding 1
Waterproof 5
Razors 26
Growth 26
Trampoline A targets 1
Trampoline C targets 3
Trampoline B targets 2
Trampoline E targets 4
Trampoline D targets 3
Trampoline F targets 8