###############################################################
#. *\*.\..**  \. *.*\ .  ..\.. . \.\ *.*\* * .  \   . ....*\  #
# \...... ....\ .*  *   ** * .*\.*\..@ *.... . ..  .   *\*....#
#* .*\**.\.\.... * *.\. \...* .\.* \\* **..\  . .  .*\...*. ..#
# ..* .\  ...* @*.* .**..\ ..*\   \*..  .*. *  *** .*.  \...! #
#..*. *.**. \. ***.\ \.* .*. * .\.. * \**.  * ...\**. @. *.. \#
#*\.    .. *.* ... .\.*.*..\  *\* \  .*\..\..\ .  ... .. *\*\ #
#\  .. .*... *   *  . \..\  ..@*. ..** .* *.   . *..\.**.. .  #
#@.* *.   * .*\ *.. !**** . .\*.... . ..*  .* **    . *\.*\*..#
#*. .\*\.   *\ \*. \..*\ . *. .\.. *\** ***** .\\ *  W * .*.. #
#\ .\.. * . ....** .. .  * .*..*..\* ..*!*..\** \..\.  *\ .. !#
#**\.\  ... @* .\!**.  *@*..W. .**...*.\ ..*...*.\ .\ ...\** \#
#\ ....* . *. *. .***.**.*.  ..***.*.**\.*\*\**.\ *.\*...... .#
#** \* *.* .* *. **..  . *.*  *.\\ .** . *  .*.\.\*.**..*.\ * #
#**\.*.. .\ .*.. ! *\ .. \\.  *@*    \. .\ \\. .*.*  \  . .\*.#
# .  .\   .. \.  .\ . .. .* ** . . *..*. .\.\.\*  . \. .\ .*\.#
#.*  \ *..*  \ *.  ..  . @ .*. @ **.** \*..*.\....  . . ***...#
#! .  .\*.  .*..* *\*  .\.. ..\***\ ..\ .... **.*** .\.....*.*#
#. \    \   \  ..*....*  . *\  \.*   * * *   \*. .@ * . ***.\ #
# * .  .\\    *..\**\..  \ *. ..\.   . \..*. .* ** .....\... .#
#* \     ..*\.! .*.\ . *.... *.**\ .*    *..**. *. * *. .\ . \#
#...** . \.\***.. *... .\ ..**\.*. *. .\*..\.. .! . ...\...  .#
#.\ *\** .   \ .  ..*\.\........\.\.** *.*.*\ . \. *..* ..*...#
#\ ....* \*.\***... .!. @ .* ....\.  . **.*.**. . .  *.  * .\.#
#...  **\.....*.   ....\.\.*\.\ \ *... . .\** ...\ *\.*...*\. #
#   \* ..*.\*..    *. .*\*\  ... * . . .\ ..   . * ..*.....*..#
#*\ !*.** .*.. . *\.* **....\  .*\.* ** *. \.**. *.\ !\  .* \ #
#. .\... .... *..\ ..  \.* .  . \.*.* *.*  *. . ... * . . ..*.#
#* ..*. . ..\ .*. .\.W.. \  . *.!\.\... ..\! * . *  .\.. *.. *#
#. \....**\ *...*.\.  .*\..   **.. **.. .*** ... . ..@   .  **#
#.. .  .\.\ ..  ..\.. *. .... \. . ......**.*.!* \..*..* .. ..#
#\!.  .**.***  .. *.. *...  \ . * *    . ...\ .\ . .. .. * .. #
#*.\\..* .. .*..  *** ..  *...*\*\* *\*\.***.. . *\... . \. * #
#...**..\   ... \.**.    .**\ .* . \.***\.*.  **.\..\.  \* ..\#
#*\ ....* *...\...** .* . .\.... .**.\. *.. ***.\*.  * .*.\ ..#
#**\.  *\***.  **. * ..\  * .*.*\ .* . .  *.*.*\.. . **.... . #
# ..\. **.     ..  . .*.\**.\... *.. \..\ .!.... @ \ ..*.....\#
#\. .. .... \ \ ... \*..W..*. * ..* **.\ .  .\. ..**   . **...#
#* \  .\.* . *.*...*..\*.*. *.*.*\...* ..    . * \*. . .*.*\*.#
#..\.* . .   **. *. *\.*.*@... .*\ .*. . . ..\** *\\  ....**.\#
# *. .  *.\.\..\*. .*.*. !\.** *. **...*.\.....\*.*. .* .**.\ #
# .** .@. .  @**.\ *..* \... .\*\**\*****.*  **.. **\...**. * #
# *.*   *.\  .*.\ .\.@. .. ..@ **.. .\!** ..\.**.. *.*...!. *\#
# .   * \  . .. . \. *!\..\*....*.\ .*. .* ....* \*\.**  .\*.*#
#.*\* .*.....*\*   \W . . *  ..\.\.**\ . *..*. ..*.**..*..*\ *#
# ..*\ .** .   .  ..  ..*.. *  ... .\.  @** . * ...*.  \.***\\#
# \**. *..*   .\\ \. .*... *\. .* .\** .... .....\..\ \ .. .* #
# ..* .. .. *.*. ...*.. *  . . ..**. \* .\*\..\.*. *.\. *... .#
#**.  . . ..* .* @\.**\ *..   ***...\*\*\ ...\ . \ \.* .*\  ..#
# . * **\ ***  . W*.\.  .   ...*. .\**. *... ......\ .. . .*.*#
#**.**\ . ....   ..*.* * \@ .**..* \ .*  ... .\.** \ .\..* .\.#
#.\.\.   \ .  ..   . ..**.*\@**.. *. ....  .\\..*\ \  *\. *\..#
#.*. \. \. ... ... * . *... \\. .*.*.* .* *..\  .....\\. \. . #
# .*  *..\ . *..*.\**....*.*... \ .**. **.*.\**. \..\. *   .\.#
#.*.\** * \*.*.\.. *.    *.*. *! . .\\  . .*\ .. . *  .*..*..*#
#.* .. ..*. .. **\\  @* **\.*****  *.\*.  .*.* \* *****  *.. .#
#*.  * .\..*****.\ .\.*... *. ....*. ..  .\.**\.* * .\ **.\*\*#
#.\ *\ .. \..* .   * .* * \\. ** *\  \*\**. * * *\* . \..@.\.@#
#\* *@\\ \.*. * .         * \*..\\ .... *\* \.... .\\*.\ *.  .#
#*.\.\.*  \.*..    *... *..\\  * \.  .*  ...\ .* ... \*  . *..#
#*..*.... .  ** * . ...... . \*\* ...*\* .\\.*.\. \.*.\*...*. #
# *.\ .*. *\*.\!.\* * .@\...  .\*.*.*\*..*. . *  *..**.*.* ...#
#\.*. *.!.. *@..  .*.* *. .\.   .*\ ..*....*.  ..*...**.*\.\  #
#. **... \..... **\ ..... \* .. ..**\ *. . *\   *.* \*.\.*   \#
#  .\*\.*. . \. \** * *\.*.* *..**.* .**.  ..  ...**.W\ ..  .*#
#\.\.*...*.*.\   .*.**\*.....*.\ .\.  .*   .   ..!** ..*.   **#
#.*.*.. ..**.\..  \  .**. .R .* *\.\*. .\ .\. @* . \*\***\*.\.#
#*..\ * *\. . * *\. **...*\..\...*. ..  .\..  .. *...**\*. *..#
## *.. .**... .\..\ *. \ .  .. *\* .\*.*\. . *   \*.\*.*. . * #
# ..\* .*. *.  *... *   *  \.   .\ ... **\.*.\.\.\\  *.. ...\ #
#*..\. *.. * . .\ * * \*. ...  * ... .*...  . .. . ..*.\ * * *#
#. * .**\ . *. * .*@.  . \   .\.* **.*.\  @  .\ .\ !\ \  *\.*.#
#.\. *. # .  . *@ .\*\*.\.\.  .*.\..\*..  ..*  \ . \     *. ..#
#*  ... *. ** .\\ . .\.*. .      ..*...@*. ****...*.... *\. ..#
#*\*\\. ***.!#** \ .\\!...   ..\..\....*\*.\.\\ \ .  .* .***.*#
#***. ..**.\.**.\  .      \*.\ .\ **.. \   *   *\*.*. . ..\  .#
#.!. \ \* ... *.\.  **.\ \   * ..\..*.\  .\*..\. **.  \*.*.\. #
#..#. .##*  \ **.. ** * *. . . ... *. *. *..\ .  .\*.. ....* *#
##... # #\   \ .** \\ .\ @\* \.**\.*.. \ \.\. @ * ..\ ..*... .#
# ##*### #*.*.  .@.\.\   *@. ....\*... .\. ** .. .... . .* .  #
#  #\*@.#..## **.#*#* ...\**W.**....\.\* .  .   * ...\. .  *.\#
#   ##.##@*   .**\#\*..  ...  .@\. .  .\ \ *..*. @. \*  ...  *#
#     #  ##\*.*.##.**#\ ..  .* *.\ * . ..... ..  *.. .\ .\ . .#
#          # ###  # ..*\.* .*..* .**.* .\\\... .. #.\ \**#. .\#
#           #     #  ..** # ...\  .**..* ***  \ ..\....**  .\.#
#                 #*\ \#\...#.  .  .*  * \ #..\..#. \* .# .***#
#                  #### .!\. ..##\ ##*..\ . *\..\\ **. \ #*. .#
#                      #*#\#\ # #*.*   \ #\#\##  ..\.\..\##.  #
#                       # #** #  #**#. .\### ##***.. #   \L##.#
#                          ## # #*.@#*\#.#  #  ###### ##\#  #\#
#                           # # #*\*.*# #               #    ##
#                            #  #.\ .#                        #
#                                ###*#                        #
###############################################################

Water 25
Flooding 13
Waterproof 18
Razors 8
Growth 24
