############################################################################################################################################################
#\.*.* ..!..*   .....\ *.\** **.*.... \ *\.\ . \..** \.**.*..*.   * *\ \ *.*.   .. . ..  ** .... *.\*.*....**.\ . *\   *   ..\. *  ....\.\.\..\..\.*..#    #
#* ...  . . * .. ** .*.\** W\*\. **\. . *. .....*.*\*.**** *. . \*.* @.. ...  ! \\.  !!\ \... \* .\. . \ !* .*.\..!. .\.*.* *.\* * * .\..\*....\** .##     #
#\.\*.*...\ *  \ .*.\.\ .\  ..*.*@*  .. ..*@\.... * .....\ .*....* . \*\ *.\* *\...\*. .\  ..*. \*** ....*.....*\*. .. !\.*.   .***.\ ..**\. ..#*..\. #    #
#*\..\.. ...*\*.\ *..*.**.*.** .... \ . \... . .\ ** ..  .*@.....*  ..* *\*.\... * *.  .  !..*\....\ . \.\*\\.  \** .  *... *  . .\. *..*..*.\* **####     #
#.*.  *. .*..W... *.   ..*  .. .  *\*.  ..* ... **.*\* .. .*\ .  *\\. \ *\.\ ..\ .  \ \**... .*  . *.\....\ \ *...**  .* .\   **.*.  .  . \. ....\##       #
#. \ .. .** .*@**...  ..\.\.  ** *.     . ..* .**    .\. .*..* . ...\*. ..* *.\.\*. . .\.* *.W.\.\ *.*\*\ .*. .\.*....*\ ... **  ..** \ .  *\ \..   #      #
#* .* ...* \* . . \ .  **..\.\**\.*\\.* *....\ .* \. \.*.\.  . *.*. *.  * *\ .. **.*. *. .*.\**    *..**..\   **\* . \!.   .***  . *...\ .. .\ .. .L       #
#.*  .   *\ \.**\\ * *....\ ** *.*\* **\* \@.. .    \. ...*. *...\.\..*.\*.  .*\*** *.\** .!  .***.. \   . . *.  ! **.\.* \ * ... \.  .\\    *.**##        #
#\..*\ . \*..!\. .* *..**\  .*... *.*...* .... .\*\.. .* *. . \* .*\*.* ***\.   *..*..\..*. .**....*.. \\.\ ..*.*   *.  .* *\..\  . \\.  .\..*.#\##        #
# .\..   .  .   ..  ** ..*\...  *.  \ * *....* ..*.....***!.*. . *... *..**.*\***   @ * \*.\ .\.. ..  \.\ *\ \.\.\ **.**\.\.* .*.\ \ ***.. .*.**##.#       #
#*  \.*.* .\* \ * *.\.**@..  \*\.*\ \*  \**\.. *   ..*....\.. ..*.. *.\ .*..\..*.... * .. *. * ** !  .* ..\ *.. **..*\ .* . ....*..*...\.. ....*.**#       #
#  ..*.*. \* *!..*.   **...*.*\ **  **\* .   .*.. .\*!@ \ \.\.*** ...\*    ... .  \\.*.. ** \.. .\*. .*..... .  \ .\..\*   .  *..* \ .  .  .. \ . ##       #
#  .**.*.* . . . * \* ...\.  *.*    .\.**    \**.   ........*..*.**\  . .*.*. *. ..**\  *\. ..\ . *\ *\.\ . .* . *   \ .\*\.*\. *..\ *\.*.*.*.\. *#.#      #
#\**\* ...\*  ..   .. *  . * *\*   *.....**.*.**!      *.\...*.*\. . \ * .!.. *\... ....\*.\\.... .\***\ @ . *..*. .\ ..***....\..* ..***.*\.\#. ..*#      #
#*.\....  \...\*..   \.\. .\ . *. ..**   *.***..... . \. .\*.. . .** ..*\.\*.. ....\*\\\*. *\.  .*...\.* . \*.....\@.**. *..\  ***. * ..*..  * .*...\#     #
#...\ **  . ...** * ..\.   .   \@\ *\*\...\***  \    ..*  @.. \  .\.\.***. *.*\***  ...**. . *\  .*.* *. @.  \*.*. *..**.\    .**.***\.*..*...\.... ..#    #
# *   .*\ .   .\.\** . * *.\.** . ...*  . *.\*\*. ..* .* * \ ..**\*.* .*.* ..*. . ..\* ..**\ \W**... .\ !..***@. \.\...*..\. *\*..*\..*.. .\ .\.\*.\*###   #
#.. \ \ .*   . .* *.** ..*\\..* .  *...\  .  \ . *..*\\ \.\.\\.\*   .* . !.\*.  .* *.. * ..*   \@  *. *. .  ... *.\..*  \*\ .. .. .. *.**   @.*\.# #* *\#  #
#* \..  ....!\  ...**\ .\ *  ..*....\.\...*.\.* .\ \.**\.   .. ** . *. . ..    ***!..*.**  *  ... .. *\    . .... .\\.. ..* .! .\  .*.\.. ...** *... \.#   #
#. . *.*.\***.*.   .*. .* .  *..\*.*.  . .* \**.*.....\..*..  *.* * !...  .\  .*.. .*\* *. \.. *.  . ..* .**. .*  *. .*  .. \ *\.. * \.\.* \. . *\.  ...#  #
#.\. .*..  . !\*@ .\....  * *.***.....* * .... ..* *..*.. .\  .\ .. * *. .\ .. .  *\* * * * . \ *..\ . .*\*  \  ..\.  *!. *.*\..@\... .\*  *.   .* .##\.*# #
#** *\.\ .. *........ .* ..*\. .\ ..   *.  . . !*..\***\..  .@*.**...*\.\ *. .\*\   .**.....\ . .. *  . . .\ *. * *  ..* .\. * *! \ .  *. . * \ .*  ##*.#  #
#*. *. \.\. .\**.  .\*. .  .*.  ! .. .\*\ .  *\*.\. *\.@. *.\.**.\*  .\....*.!...****   .***  \ \..*@  .  .  \.\** . .*... \ .\... *..\.. . .\ * .#*# ##   #
#* ..*..  .\. *  * \ .*\ .**.  .  .*. *. * .\..*  ...* *. *.**..*...*.*..*\.   *...\.  * **\* ..*** . *\  *.\.\\..  **... . . .* *.\ . .*\ * * . . .##     #
#...** . *.\*\. .. . ** .**.*.*  ..\ *\.!. * .\..*.\*.\..\.*.. ...\..**..   \**  \.. \*..****.*.*..\* *..\.!... \\....!***. . *. \...*. ... **.\W**. .#    #
#*.. .**\.\ *... *@.\.*.*** *R  *.. \ *. *\.** *..****   * \..\ \. .\*.* .. ..* .* .*.*. *.\. \..*  . . **  ..  . **.**\   *...*\..  .\  \.\..\ * * ##     #
#.  .*.* .*.  ..* . *.*\**\*\.*.  .*.*.*.\.  . .\.....  *.\. \.....  \**.* \.\***. *.    .* ... *...*..\...*\. ** *  * .. \\ *..*..  .  ... ..* .*##       #
#*\*\.*. .* *.**.\..* *...*\*  . ...\*\.  *...\ ..\  \.*. *\ *.*...\*...\.  \.\..*\*\ *. *. .\  .. ..\.* *...  . .. \ *.\.\  .*\.\.@ .\*.*  \\. ..**#      #
#\*.  !\.\......\.. \.**..*..@. ..\*.. \* \**. ....! . *. \*** *  ..\  *. *. .  *\!....\*..\ .\.**  *..*  \. ...\ *  .. .* \\ ..* *.*. . \.   .\.**.#      #
#*.  **. **.  **   *..@..* \..\.** .. @\\...* *... *. \*\..*.\\.  .*\  .*..\*\.  .  .*.*..**. \ *  *.  . ..** .\.*. . \  *  *\ ...\**  *  *\*.\ *..*.#     #
#*. .. *.\.  **.  ...... . .\\. .. * \*****.\!.* .\.* \.* \ .  * * *...*.*  \.\..\ *.*\\ *...*... \* * .\ ..\ * \!.* ..   *\  *. * *. * .   *.. ..  #      #
#* .\ .. *\\.*.. * *\*. *.**. **...  .**\.*.  *\\. .\* ** . . .\.@.. * ..*.*. . \.\. \* *\W*.**\  .\*..\\. . .\. . .  .* *.*  .\  .*\ .\ ..** .    *#      #
#*..*   * .* .*... ** .*. *. *.! .  .....*.* *. **...*\.* . \ *.*. . !.\** . . *  .\\..   \*\..   .. ..*.   ..*.. *. ..  ..  *...\ **\.\\ .* .\** #.#      #
#\ *.* ..\.. . * \*.. .*\ *\...***    *. \ *..\.*.. *...*.\.\ *\.  .\. .  .   * .* .**. . .*.* *.  .* *. ***.*.\ *.*.@ * ..  ..* *\... ..*  .***\ **.#     #
# ..*.  ..\.\. \  ..\. *. * *\..\.\. \..* ..*.* .\*.... .\*..*  \ .*.. \.*...*@\ **  \.  ..*.*\.. \*..   .*@*\ . * \..\.\* .!..\ \..\ \.*. .\ \#.* #*#     #
#  ..  .. . *.\*..*\*. .@*\@* .. \. *.   .\ \.. \ .   \ \@.. ..\.*\ \.\*. .* .. ..***.*.\  @ *....**  ...*  *... ...\.  .. * .\.\  * . .**..\... *\ #   #  #
# \.\. *.  .\ .**..*.. .* *.* * \. *.. ** *..\.  *.   . W  ..@ .* .  . ..*.  .. ** .\.. .\!\ .\.*.. ** *....*\...... . .*  . . .*.*. \. **...  \ .##  ##.# #
# .*. *...* .* *.\ \.**\. . *.*..  .\*..* \* .*..*\..\ ..*. \***.. **   \... **..*\  @. ..*.*. *\ .*.. ..   !**\ . . \* .   *. . .. . . \  \ *  .  *## #\ ##
#\*..*.   *. ..**. *..   *  .**  *. .*. . ..  .*\*.\\.\. .*..\ *\ .*..**  \* \..\.. \.\.*...\ **.***. \\.*\* ...*... ..* \. \. \ \*  .*.   .. *. \\* *\#...#
#*. **   ..\.  !*... . . .\. \....  \\..* .*.... .*.. *. .\** ...    ...**...*.\.**.. *.**\*   . ***..\\ \*\*.  .*\.  *\\.      . .\.*. .\ \*..*. *.\***.\##
#.. ..*.*\*! ..*..*.* **\ . \..\ \ . ..*. *.*  .. * .*...* \* *\ ..*.\..\*\... *\..\.   \. *..\ \*\ ! . * .**..  *. .*.\. ..*.   ..  .** . ...@*##.\ ** ## #
#\    ...*. * \ * ... .. \.\.** *.\. .... * .\.. .\...  *. . \.. * \.* \ *.... . ..   \ W..*.*.     *  ...... .* .**\*..\ . .*  .  ..  . .\ .*##  #  #*#   #
#  . ... . .  ... ... *..\.\**. *\.\ \..*   ** .\ **..  .*.  *\. \  .\.... \*.\...\ * .* \.. .... *.\ **\  \.  ..  . *  *. .**. .\  \.*  * .\   # ###..#   #
#.*\* .**  ....\ .*. .\**.!.... ...@..*..    .. @ ...   *..!\.* *... ...\.\.. *.*.\.. .  . . \ \..* !.W**..  ...  .\. .\*. .\..  .\**  \ * . * \##*.###    #
# ...  .... ...*\*..\*. !*\\*\ .*. *  * . .@*\ .\ *.** ** **. ...  \ ..   * \  ..* *...*.   \.. .*\* *\..** *. .*  . .*.\   \ .** ! \  *.***. *.##..*#     #
#\*  \.  \..*...\.* *\.. \\..   .. .\ * *\.... *. ..\.\..* ..   .  * * * *..\ \.*. .*.**.*. ..\ \.... . ..*    *!*\*\..**..*.\ *..*.\.\*.*\*.\ .. \ #      #
#*. *.. ..*.. \ . * \.*.*.. * \.. \.@\*\*..*.   . .*..*...  *.* *. .\.*. .  .*.*..  \* *\.\ .\*.**... *. *  *.*\ .*.* ..\*.* .*.  .*. ..   .*** \ ...#     #
#*.\. *.. **. ... .\* .*.   .. .**.*\.\.\ ..* .    ..\.*.....\..*@..*  ..*   *.*. .  .    @ ***  ..\\..*..*. .  \\ ** * ..\*. ..* \**.*. .* * . .\. .#     #
#* .  * \ ...**** ..*..\.  .   *.*.*..*.*\...*..\*.   .\.* .\ . .....\ *.\  ...\@**\ **.*.*\*.** .... . \.*\.\. .. .*\.\    .*. .*.**.\..*. .\**. ..#      #
#. ..\. \.*. ..\W !* . .  .*.\.\ .*..*\. *\ *....\ .** .*.  *   *\*\  *..*\ *.\**.\. \.\*.* . *.!\*   *. * .@  \\**.\ *\ .\\* ...* \ \.  \**\ .. ..*#      #
############################################################################################################################################################

Water 0
Flooding 0
Waterproof 14
Razors 11
Growth 13
