#############################################################
# ..\..\..*. .* .  . \@ ***. .\*. **.*..*. ** \. *\ *.*..  *#
#.  ...*\ * .. ..*..*.*  ..\* ..\** \..\. \.@\ .*\.*   * .*\#
#\..\.*\.**.\. **.**. *.\.. \..*.     *.**.!.  .. *. . \..* #
#  .*   *.\.  .\..*\*.. .**  ....\ *. !*.*..*  ..\* . \  *. #
#. ..  .* .\*. *. \*. \* **\.*\\ *.    . .\.. \**\.@.... ...#
# *....*   ****. \ .* .*.\* ... ...*  .\   \* *.\\ * \*..* .#
#\. .\ . . * . . * ***.*\*.\***\\    \**!  .. * *.\  ..\* *\#
#.    .\.\. \  .\ **.\*.*\*.**. * .**  *   .  ..\ *.. \..\*.#
#\..\.   .*\.. !  .\. *.*.. ..\.\\ ... . . **.\  \*.*..  .  #
#. \ *.\. .** .**.. . *\* .  \ **\  ** \ \*.. . *.*..   *.  #
#\*  ..**\  !\*. ..\* \. . .*... *.*..\  .\ .. **..* . *.. \#
#*.\ ***\.    * * . \. \..... *...*\.* .   *. ..\.*.  .\*.  #
#****\.\  *. \..\* .\*\*\. ..... *....*.* \*. . **      \  .#
#*...*.@ ........\   ***.* .\**\  \ .\**. .@..* .\ *  \..\.\#
#\.*  *\. \ ..*  *. *.*. ****\.\ ....  .. ..\*..**. *\.  .  #
#... ***.*.  . .*@  *... ****.** *.\ \@\ .\ ..\* .  .\*\*. .#
#*** .... **..  .**.**.. .* * .*\.\ .*\..*..*  *  \*. . .*..#
#..\.*.* **.*   ...\ .*.*.**..*..** \......*.\*. . \* *.\.  #
#*!* \..* \ .. .\*.*\\...\\ ..* ..  \*  \ *.* .*. . ..\**.. #
#.   ..\.  ..*     \  .\.*. \ \*. ...\ .. ...\ . . . A*.*.\ #
# .\.\  **  . \ .  \ .*        . \..\  .\ ..\. ...\**   .*..#
#\*  *.   !\    ..*.* \. .    *\. .\. *..*. * .   *\....* .\#
# . .\ .  ...   *.\...\..  ***\...   * .F.*.\.  *.. \  *. **#
#   . .. .*\*\ *..  ***\  \. ....**\*.**..*. .  \.   ***.*.*#
#\..*.!  *... *.\* ...*... . . .** .*\**.....*.*. .. ..\*. *#
#. ..***.... **..\\ .*.. \.* *.\..* * ..***....*.. ***. ****#
#   \. * .. !\.  .  \. * ..*.*  .  *.. **.*  ..* ..***.\..\.#
#..*..**\ .\ *   \ ..**.. \.\ ...*...*....*.   .  @.\... * \#
#. *  ..* *.*.\*   *\** \   *.\..** \ ... \*\.\.  ....***.. #
#.\\*.*\ **.*\.\..\.*** .. .\.*\.\\ .    *  .\. **.  *....*.#
#\.** * \**..  *.*  * *  .\ .\....**   *!.\**  *..*\* . ...@#
#.... .\  .  *\**. *.**.\.  . *.  *    .* **. **...*\ \** \ #
#* @.  .*\* *\..*.****..  \.. .* .\. . *...**.. .....  *.*..#
#**.\**.\*. .  \*... .* .\*\*  *.. . \ !\ .\. . *..*\ *. ...#
#..* .\. * \*\.. . .* .** **..\* \.*\....*   **.**..  .@ *  #
#.\*.*..**\.. *.  \**..**.\* ..*\.**  *.\ . .\ . . * .\\\* .#
#..... \.. ...** .... .*\  ..  .\ ...*.**   . * .\* . ..*.. #
#*.. .* \*.*. *\ \..\..  .* ..*\..* .. .\* *. *.  .  \  .\  #
#\ ....\ ...*.... .. \*.. .\*.\@.*.***. *.*..*** \ ..    .\ #
#*...*.* *\.*.. . ***.\!  ..*!.......\.\..**..*\ \ .** \.. .#
#*.**.   ..*  .*.\ ...\ ** \.\ *  ..\. ....!.\.\.  *.* \* **#
#* **\.***\.\  .*..  ..*\. .*.*.*.*. .\*. *\  ...  * * ..**.#
# **. *!..*@*..*.\    \*.\!*.\.*@  .* \.*\.        *.. \ .\*#
# ** .  **.\ ... * .\*.*. .*\. *\ ***    ***.   ..\..\*.\ .\#
#.* **\*.** .... *.\ ! \.. \.* ..  .****\....*\* . *\*...\  #
#\ ..  \***. @.  . .   .\. . .* . .*..\.   **.*. \ .*.\    .#
#...* *.. *.**\..  \.*  *.   \* .*.*...*..* . \.\.\  .  *\ .#
#.* . .*\ ....** * !.*.*.\  .\...*  .. * .\*.   **  .*\\...*#
#  \*  . *..*\...* . . .\ .\.*. ...\****.\ \\. ..* **.  .. .#
#. !  .\..... .  * ..*  .* ....**\ \*... **.*   *.9!.. . *.*#
#...  . ..*.*  \\\ .\ ...*  .*.*.*.*.*. *.. . ... **... .**\#
#    *.*\*\ ..  .! ... .*\ **. !.\..\.**\.** *\. \.* **...*.#
#*  .\ .\  *. \.  . ..*\.*..**.  .*\*.\.*.*..... \.\.*\..*.*#
#*....*\ .**@ ..\.\.* ... .    *\ . *. . ...   .*..\.*.\....#
#*! \***\..**. ..*..*. \ ...  \.* *..* ***\ * \ \*  **  *.*.#
#... \  \ *.@\ ..\. ....\ \* ..\.**  .\*.. .\ ..*.    .! \*\#
#\* *  *.\\..\..\ *..\\.  \**  .\ .\\ ..*..*.\**.* @.*.\  . #
#*\\ ..  * .  \. \ *.. .\  ...*.    *.. . **...\** ...***.. #
#..* \ \ *. \..* \.*\ .  \. ..*\\* !.*..*..*.***.. *.\..   \#
#*..  .*.*\..\  \. !.\ .*  . ..*\.   . *.*\.\\..   *. *\  *.#
#*.*.. \ \**.*   .\  .\*.. .*.\. \.\*  *.. . ..* *\   .. .\ #
#*.\***. .....  \ * ..* * . .  . W..*  *.\***\  *** *.\ \***#
#.**\\.*  .  .\* .\.*...* .  .*  ..  ...**..\  *\..* *  ..\*#
#* ...\\ .. * *..* \..\...\ *...... . .*\ .*..* * .  . *.. *#
#. *...   \   * *  ***.\.\*..\ .  ..* .   .. .*  .. ........#
#**\...\... * \*  \*.*  *.*.\ **.. *. \ *. * .*  \\* * .*.\ #
#.**\\***..\.*.. \..*.  **\ *.*\. .** ... .**   *    \  *.* #
#\* *...**  \.***.*\.. \.***\*.** \.*....  ...*.\ .*   .  . #
#**..  \ * * .\*\* \*    ***.. .*  ...   .   \. *\ \*\*\*.. #
#...\ ..\*\*  .....!*\\\. *  .*  \  *.*.* \ .  \.  .. ... \*#
#.. .* ..* ..* .\.\ *.\. *.   *** *.* *\. *.. ..  **\*.\*..G#
#*   ***\. \..***    ** ... *.*.. . \ .   * \ .@ *...**...*.#
#*..\\.. *.*\ . .   *.*   **  .   ..*.\ .  .*. * ...*\... ..#
# ...* . **.. .   **  . *  * .*..**... . .* . . .. \* *. .* #
#*..*!\\.!. .. \\ .\.*..*\@. ...*.  * ...D..  ..\\*\*.*\ ..\#
#\ .* ...  \**. **.. .*....   . ** .*.\..*.\\..   *.\.*.. \.#
#*\**. .\.**. . . .\\  \\**@**...@ *.... *   ... . ..*****.*#
#\. .\..**..*.  .*\  ***..* ..  *.H .  * *\ *  \ ..*.*\.\* *#
#.\ . **\\.**\..*.* *..\ !.. *.*..**  ..*... .\  *. .\.\...*#
# .*\* \ ...\  @*..\.  .\ \. ...*\@*.. .   .  .* .\\ .*.*.\.#
#*\   .. .*..*..*. .*\.\ *.  .\* .*.*.\.. *.  ..  *..\*.. .*#
#..\ *****...*\ . .*.. ..*.*\  .. *....\@.\*.\   ..*  .  .*.#
#*. \..... . ...\ .. **\  . *\* . \ \..   .**  .  \    . .\.#
# .. .\ .\.\*. ..... .. \*    \. \*\.\!**. ..*.  \ .\ \ \ ..#
#.* \ .**  *...*\    \ ..  *.*..\. .* ..*  . \*\... ... .  .#
#  \ \ .. ......*. ...  ***.***@  \**\.**.\\.\  *. ..*\  \*.#
#...\ **\. . \.\! \* .***\.! *...*..* \**\.** .\..\*... \ *.#
#\. * *. . .\ *. *.*\..*. . **.\ . *.\.*\.*   *. *. .*.\*** #
# .*.*\*.*.*.. *\..\..\.*W.*..*. . .. \  ..\.*.*\..**.. ...*#
#* *.  .\.*\*. *  ***** *. *.. *.* \ ..* \ . * .* ..* \\.*..#
#.*...\.....**.. ..\\.*!..\...   *     . .* \..\.\**.  \..  #
#\.  *\ \. .\. \. *..*.\   .*. . .*.. *.  . . * \.***.* .   #
#* *.*..****  ..* .... .*  ***   ..*..... .. .*  *....*.* ..#
#...   .... .* .. .    .. . .*\.\. **   *.\.  .\* !. **\.\. #
#... * **  \.. *\ \*.  * *\ .  \***.* ... .\   ...\\ \. \ . #
#.\ .. ..\ .\\ \. *.*. . .*.. ...\*\.... ...\..  .  * .. . .#
#.... ..* \ ....   .. ..**\..\ *. .  * *.   .  . .  **  .   #
#\ \   \*.\. ** .  ..*  *..\*. .\. ...\.. ..*..* .\.@\  . .!#
# *  .... .*..\.   * .     *. ..!.\..\.*  . * .* *  **\ \  .#
#\  \..\*  \*.**. *** .  *.. *\. ...*  .* ...... \ \*..\.!* #
#*     .\.\**..\*\..\.*  .. .*  .\... . *.  *  \.W..\ .**.*\#
#!\*\.    *\.* .!\.*..\  .  .* *@. .**\ ..  . .. \\.   \  \*#
#\ **\. ... *\ \. .... .   *\ \..  **...   ..*. *.*  **. \ *#
#.*. *. * ..  \\  \\.\..*. *. .. **.. \ \..\...\  *.* .*  *.#
#****.*  . **..\.   * ..** ..\.* *... .. .  . *   ***. * *. #
#*.*\\..\.  .  ..**\ \ ...\ *.\  * *...*.\  \\. . *...\ .*.\#
#\  ..  .* .*.\ .... ... *.\. .\\**..**  **\..*.. . .\.*.***#
# .  .. * \ * *\*\.*.\.. .*.*.*. .*.\.\ ***..      .\.\....*#
#\.**.. \*..* **.*\. .    .*..\   * . ***..  . *\*  *.* *.  #
#. \.** *** .*.*  . .....\\.***\.*.   . . *\.\..*\ .*..*.  *#
# . ..**.\.* \*\ .  .*. **.**..*... @  .  .***.*.*  .. *.* .#
#\\*.\.*.**  .@!*.*.  .\**.***\.\.**\  *\ *. .  *.*..\.. .. #
#\.*  ...*.**.*.**\ .**.*...*.*\**.  \*.***..*. .\. ...**. .#
#\*    *\*\.. .\... ..**... .\...  .\*.** . **\. ***.\ *.*..#
#..  ..*.. .\ . . *. *.*  @ ......  *\\..\*.\\.**..*. .* .\.#
#\ .@\..\.*..\**..** .* ..\  \ *\ ... . *..*\\*... .*\ .*..*#
#*  ***\..*\.*8.\..\  ** . .. \\.\*...*.**\..\....  .\  *\..#
#.  \*...**.*. * *.   .**.. \*. * ..*\*....*..*\\. ..*.*..* #
#. *.*. *..**.*.\. *\.**.@.*. !\....* . . * \ *.**.* *....\.#
# *  .  \ *\ .*... .\ .. ....  .\ **\ .\. .  *\.**.* .. *\ \#
# *.* .*.*...\*.  .\! *.\  *\ * * ....*. *  * *.\* \\  *\.  #
#*..!.**\.*. \*** .. *6 ..*\.\*... ....  \ *.. **\.. ..  .*\#
#\\  *.. *.*\.* . ..\..  ..*\.\@\ .. ***!. ** * ***  . ...* #
#@. **\*** .. \  ** ** \*\  . *..@  .\..\. ** .\..\  . *. ..#
#\.... ..\ **. .\.\ .. .*  \*\.* . * .     *.. ..\. \ @..*. #
#\*.. .\   .*....*..   *... . \ \..\   *   **\...*. ... ...*#
#!**  **.  ..*\@\. *.. * \ . *...  .\ *... .. * ..*  .\.*.\.#
#... \...\\ *\**. .. \..\  ...\ .\...** ..  ..*..*. *\.*...*#
#. .  * ..\.* **. *\.  . .\. .   @...... *.*\*.*..* * **  ..#
# ***.*.\\*.\*..... \*.* *.... \*.*. ** ..*.*** .\.\.  *. **#
#.... \* .*\ *.  * ..**.*.  .**.**\**. . **.*.* .*\.* *.  .\#
#..\\.*.\...... * ...** .*...\.\.  .*. *.\ .*.  ....*\R.**\.#
#\**. .  *\ \.. !\  ..*.*..\..  \..*  .* ** . .*.*....\*.\* #
#...... !\...\*.  *....\..\.***.. ..  .. ...*..\*..  \.. .. #
#\  *.\  *. . .....*... .  ...*\*\\.\.*   @\.  **. . .    *.#
#.  .*. . .  !.*....**\  . * *.*\.\*. .. \.*..*..  ... *..  #
# *.**.. ....\* *\*.\.*.  .. . \.\..*\**\ . *  *\...\\.. .  #
#\.\..*.*.. *\. \ . . *...    . *..\*.\.*. *. .*. *    .\ * #
#..W*.\. .*\.*. .\*.  . . . ..  ..!.*.... .... .\ * .\.* **\#
# \ .*..\*. *.....**. *.\.** . !\** .**.*.\.*. ..\.*..*\ ..*#
#. *\. . \*\.*\.*.!..*\.**\\.*.B*\* .*.   .*.* .1.*.*.. ...*#
#\   ..\... *\ \.   *..*.****.\...\. ....\\.\*.*. .* ... . .#
#@** @!   \*...   ..*   ....\..*. *** .. * ..\...*..\** .\ .#
#.*\**\. ..\.* * *!\ .*\***\ . .*. ...\\* \.\*.. ...*.@\  ..#
#!\.\. *  *\...\*  . \******. * .* \ *. . .. *.\. ...\*.. **#
#\ .. *.** ***..*  .\*..\*..\*.... .\..\    \ \.*.\.*...\ ..#
#* .  .* * ..\**     ......\.. ***. ..\  . .. *. *. . E *W* #
#\.  ..\  \  7.\..* *\.*.*. \****....**.**..\..\.*\  .\**\*.#
#.. \ *\*.. \  .\ \ . . * ** \. .\.\....*... *\*\*..*. ** \ #
# ...*...\. ......   \*.  .. .\*   ...* .. .\..*   *. *\.* .#
#\*\ \ .  ..\ \   .. .\  ! .  *.  *.*\*. ***..@..**... .*.**#
# . .. \ *. *.\ .** ..**.\@  *\\* .*... *\*\ *. ...\*\  ..*.#
#\. .\. *****\. *.\.. *..*.   .*   \ ..\* *. .*.**\.\.*.* *\#
#. **. ... *.*...\. *\ *..* *. .*\ ..\* ...   ....\**.*\ .. #
# ..!*.*.*..* .   \..*\* ....* **.. * .\ .*.*  . .*..*** .\.#
# @.....*\\*!...\. .. .. *. .* *\.*\\.*.\*.\ *.** **..*.*  .#
# \*\*\**.    \.*  .\  .*\ * ...**!*. **.    .... .\@\..\  .#
#..* .\**.** ...  *. ..*. \.. \..*..* ...*\ .*. \  ..  . .  #
# .\ ***..  .  \ !..*\*.**.* ... .....\*. . .\.*...  * ..\ .#
# *.\.  \ .  \  **.**. * *.*    .* \.\*..\.**  .  \*\*.. .  #
# .** .* . \ . .\*... ..*. *\*\. .. . ..\. *.\.. *.. .\*.  .#
#\ * .*\*....\.*. \ \ *.*\\  .... . .\\ . *.... @. * *..**  #
# **  ..  \.\.*.. . .  *..*.*\. .\ \*.**  .*.* ...\* .\ *\**#
#..**\.*.*.\* .. .   *  **. ..\... ..\. **\* .\. *.. .*.\.*\#
#\ \\ .***.*.   @\ . .*... \. ..  .*   * * . \* **. \*\.  *.#
#  .*\\.*.@.*. .*. *  * *. * *..**.*..\.**.  .\.\\\....** *\#
#  ... *\ *...\ \*\. * *.\*. ***** ...*\*\   .*\.*.\*.W.*\.*#
#.*  \.*\...\**.\* *\.*..!\.\..*.*  .*\.* .*. ! *..*..\ . . #
# *  ..\ *. **. *  ...**.... **\  .\... !...\ ...\.* .*.\ ..#
#. *. * *.....    ...\\*\* . * *  \ \  .  .  *. ..\.  ..  **#
#*..*...  .  @ . .\  \ ...  .\.* **\  .*..*. * \    * .. .\*#
#.@...  . . * .**. \. .*.  . ...*.*.*\.*\\*\ **..*.*.  @\...#
#.*\*  * .\.! .*.\. .. *..*\* .*...\**\*.**....*\.* . . ..*.#
#..  .*..**   . \..  . \ *... .\ ..*\....*\ . ..  \.*.  *\\ #
#*.*  *.... **\* *. **\* ..\.\...\...! *. . . .*\ . . * .\. #
#. .*\. *.\ *.@\ *\ ...\ **...* ** **  .  ..** *.**.**..* ..#
#.  *.* * . @ *.*** * .* .. *C.....*\* .\ *.*. . \..***.. . #
#.  .*...**.  . *.\ *\ .. \ .. *  ....  .\**..*\\.....  *...#
#\ . .!\*****.. !  .....  . \  .\.\\ .* @* \.*\..*..*. .\ .\#
# .** @*. ***** .\*..\.****.*....\ .   \.. ...* .*\* ..  \.*#
#  .. \   \ ...\ **   \ ..*   \* *. ...* .**.\.*****  \...*\#
#.\ ..*.  .* \ . .* * \.    *.* .. *\*..\.\. *\.\\*. .... . #
#\ * \. *  *\.. . .  .\. *\  .* *  * .  .**.**  !... * \ ..\#
# .!\   . ...  * *      .\.* . . \*.*\ *.**\.\..*\. .*.\. \*#
#*  . ..*.. . .**. . *\ *  .. .   .\*... *\.* **.**. * .... #
#.\ \\. \  .\  .* .\. *.** * ...**..***\ \.*. ... .* .\ \*. #
# * *   \. .*\.. *  *   ..  .** ... .*....* * .. \.\* ....*.#
#\...\ ....\.. * \. .    ** * \**@ . *.* *..\.. .. .*.\ *  .#
#*\.*..  . . ... .. .\.* *. ..**.* *\\!*.\ . **** *..  4...*#
#..  \ .\ \   .  ... \.*  .. ... ... .**.****..*..\...  .\..#
# .*. .*.*..  \.  \* ......\*\\ . .. **. *.*.*\**..* \.**.* #
# **  \.\. . ...  ..  .\  . ***.\\\ .*\.* .!\..*\  .\.*.\  .#
#.\..\.\ .... \ * .*.. *.*.**.. ..* *\ .*... \.** .***. *. \#
# .**.***\****..\ *.\ ***...\.\.. * \. .\ .... *.  .\.** \  #
#. *. *... **\ ..*. . *..   *\*\. *  * .*.\. * .  .\ \.. @* #
#.*.. \*\.*... .*...*\# \.. .*.** .\***\*.*..*  * *. **\ .**#
#***  *.*.**\ .*......\.*! .\...\ \ .!.*.  .* . *   *.**..\*#
# .. \..\.... *...*  . \\  \.*.*\\  ..**  *\ .\*.\.*.W\.****#
#. ..*\** \** . .\.   ...*  .  .*. *... *\. *...\ *. \ *\. *#
#  * * . * \.*   *#**. .*.*  ..  \ \ *. **\ .**\  \.   ...* #
#\*....*.. ..*.#***.\.* .\.\ *.**....   ...  .***.  ...  \  #
#. * .\**. ..!.*.*  . * ..\  *\...  \ .  \* *.\*#. ...  ...*#
#\** *..\.*.\.\# #  *\\ .\ .*\...\*   \.*.\.*\. *. .*. .* **#
# **.\.*.  . ..\ # ...*. . .**.\*\* *\. \.. *   .\.*.***\ * #
# .. ! .*. . ..  #. .*\. .**\.**. . .  \ ..\.**  *.* * ....##
#\.\. . .!\**#\ #*# .*.*  *** .*.* ..  . . *\*.*.**....*\\\*#
#.*. \ ..* .*.* #\   .#.***\. \. ..  *\*   *.@*..*. ...!* .##
#.\. .. *\.*# #\#...\* **.*. #   .   .*.. *\ ***##.*\*.\.\ *#
#\*\**.. . \ *. *  . \ ...#\. \\* *\..*  .\.. .. \.*#  * .*##
#.#@*\.\..\# #####*\ ##. ..##\###\.! \**.#.\ **\  ..#. \*** #
#..\*. .* ...*#  #..###\.* # #   #.#\\*. #   *.. .. . .##.*##
#.* \..\. \. *### ###*  ..  #     ## ** ##.. #*## \*.* # *. #
#\.* *.#*  .*.   #   ###* **#       ##.\*\ .\# W.\###.*######
#  *   #.*  **# #       #L*#       #.\ ### #*#*###  #\#     #
#... \\*...#*# #          #        #!#**# # ##\#     #      #
#*   \###\##*.#                     # ##      #             #
##.#*#   #  ##                                              #
#..\#                                                       #
##\**#                                                      #
#..##                                                       #
#*#                                                         #
#############################################################

Water 0
Flooding 0
Waterproof 5
Razors 18
Growth 41
Trampoline A targets 4
Trampoline C targets 6
Trampoline B targets 9
Trampoline E targets 1
Trampoline D targets 1
Trampoline G targets 1
Trampoline F targets 7
Trampoline H targets 8