###########
# . .\*..\#
#.*\. ..  #
#L*  *\ . #
#\\. .*.* #
#*.\.*R #.#
# ..\#\#.*#
#.  .*# ###
#* .*#    #
##*#*#    #
##.##     #
###########

Water 3
Flooding 16
Waterproof 6
Razors 23
Growth 13
