###################################################################
#                                 ## #*#      # L# ###            #
#                                #\ # \#    ##*#*.#. .#           #
#                          #  ###*..#. #   #.*..*  ## .#          #
#                    # #  #\##*\ .*. .\.###\## ..\\ # \.####      #
#                   #*#.###.##.#.\.** *\   .#*\.* ...  .#...#     #
#                  #. **# #.\.. *..\. .##\*\*.#..!...#   . *.## # #
#                   # .. @\ ..\ *   *...* .*..\ *.#\.##\ !#.*\.#.##
#                  #*   \ .*.  ..\.* . *. . .*  .***# ...  *# #\ \#
#               ####. # * ..#*..**\.\\ *  * .. .\  . ..*     # # ##
#              #\.. * .\.. \\*#* . * . \.*\    .* \.**.  ..*.  #\##
#          ### ##*!..\...    .  . **  .** .@**..*.*.*..*. \@\.  * #
#         #...#.# **\* .*. ..  ** \ \***.*..*  ..  .*.*..**  \*.#*#
#        ##.\.*\#***.* ..\* *\ . .... .. \*.. * **. . . \.. . * .\#
#       #\\##.### @.  ..... *... * .. \*. . *!.* *..*.* \*.** .*.*#
#      ###. \.##.**   ..**\\. !* *\!\.\*.\.\. .*\.\.... \.\*.*.. .#
#     #\*#*##\*. ..\*\\ .\...\ .\.. .. !**\. **.    * ...\*. *. *\#
#     #.*..#. ...\.  .  \**  .*..\* .   .\.  .*\\.  .    **\.\ ..*#
#      # .\.@*\\*.* \ .  .. \... .*. **.*.. \ . . .@ \.\ \**  .@@.#
#      # ..* *  . .\ .\  \ .\ *\.* . .... * ...*. *@. *.   \.***..#
#     #.   *#    *..* * .   ***...  *. . *\..*.. .\*. *.. .@*****.#
#    ## .#\!*. *  . W ...\.  .\.*\W\.  . \  .  .\.*.\ \\\* ..*\\..#
#   # .. *#.  .* \  *. . * .. ..    *.*. . *\..*. . .*.. * \ *.\. #
#   # .\ .\  \.*...*.*** .*\ *!.. \\. .*  ..    ..... .  .  *.\.\*#
## ##*##.\ . .*.\  **.*\.\*.*. ..... .\. .\ .\** .*..\..\  .\  *..#
#.#.##*## .\*\..*. .... ..\.  *.\.\.\ * ..   @...*. . . ..\ .  ..*#
#  .* * *.*.*. ... \\ .    .. \*\   \ *    .*.\.* *..\..*.. .\. ..#
#**\.. **..\.@ ** ..* **.\..*\.* ***.* ..*\*@***.. . ..  .  .*. * #
#*.\..\  \.  *..\ .\. \*. ...**...\ ..*....* ..@.. *.*\ *  \..* . #
#* .**. . *  *.*.*. .**.\ *** ...*..*\.\ \ .*\\ .  *.. \....***  .#
#\ ... *\.* **\..  * . \**.. **\..****  .*. *..  * .     **\ *\  .#
#*.***.\. .*.*.  ***..*.*. .  \* *...***\ ! .* * ..  **.\*\.\**\ .#
#. ..\*\   .\...  *.*\. *. *.... * *@... ..\ *. \ .  *.*... . ***\#
#\ .\ .*        \.*\...*   *.. **.... .\.. .\  \\.*  *.*\ \   ...*#
# .  .\. * .\  *. .  *. **.... .   \.\ . *\ *.*.. .\ . \**.\@* .*.#
#.** **\*. .. *\.*.*.....*   * *!  .\* * **.\ ..\  .** .\.***.\ ..#
#\**.\. \.\ .*\ .\ .\*\.\*.\....* *\ *\*\ ...\**..*. *.\ .**. ... #
#*...* .* *. *** * ..* ..*.*. .\ * * *.\ \...*\ * .* *  . ...**  *#
#.. *. ..* .  *. .*.\.*** ***. *\\..\.. *.\ \ ! .  .\** \. .\.*. .#
#*  .   **... * .\.  . .\.. .\*.\ \*.*  **. *.   .  .*.\  **. .*.\#
#.*  .  * **. ...*  . \* ***\\* ..  ...* .*.*\. ***** **\.\.* ....#
#.*  *.\.\.\  \..\ .   * \.\7 @.  ...\..\!\*     *.*.  .!*\.\ \...#
#\. \ \ @  . *.  **.\.   .**\  \ . . ...*..\ *.. .\.*.*.  . *..* *#
#* .. ...   *...*\..   ..*..*\.**... .*. \.. .**.\ .. **  . ...  .#
#. * **\***.\..*..*..    \ ... .@ *  .. .\ *. ..*** .*.*.  F  \*.*#
#\ .   **..*  ..*.*.*\\  . * *...\.*\ * *.*.*  ***\. .**\.**.*..*.#
#*.  .*.*\.    *\.. \ * .**  * ..  ..\. ...*\..* .* ** * ..\*.  *\#
#*.!!...    .\ .*.*\.. . .. *..   .. ... ..*\  . . .. .\*.. . .*.*#
#***. .W\.*...* **\. \.. .\ \**  . ** *.\  \**..  .   \.    *   .*#
#*. .**   *.\**...*\.* .*.   *.  \.*.* ..**\\..*.\* *. .. **.\.. .#
#.....*.*\..\**  ...** * .    \.. .  .\\**\. .\. ***\.. \ .*\.*...#
#\*! .. .\    ...\. *. .*  ..***\\. \  ...* **.  C.*.   *.\. .*.. #
#..* .*** *...*\ ..*!   ..  .*\..\.* ..\ \* *.*\....*.* .*...*.\ .#
#*...***     \. . .... . .   ..*..***.  . . .**...* * . .. *\     #
#\   *.\* .**..*.\\* .  . .\  ..  *\!.*.*.....@.*. .. ..* . \  ..*#
#\ * * **.** .*. . . .*** .. *.\..****. .* @*.. ... . \* ** ....\.#
# \. . \\ *\  ....\ \. ** .. *.*....\* . . ** \  .. . .*..\ *  ..*#
#.  \ *. \*.. * . *\. \*.  **.\.\ * .  . **W\. .**..*. * .  . .\. #
# **...*. . . \..!.*.\.  . .D   .. . ** ..\.  *..\. . . ...    *\*#
#.. .\ . . *. *.  .\  *\. *\ * . *..\\.  . ..\.\.... ...  .* . ***#
#.\*.*W ..\.  .  . *.**.* \  .   .. *.\      *...*  \* *  *.  .\*.#
#..\ **...**.. .   *.*..*... ..*. * .!!\.  .**.\*..* * *. . .   . #
#.  \**\*\.... *\.**   *.*\.. .*. ** \\  .\ .. . .* *. \  \**  .\*#
#.  *. *..\ *.... *\ ..\**..  .**  . ** .  ...*.. * ..!..*.\@.\ *.#
#* .. *..\..**.. . .  ..!**\\* **\*\... .\*  \*\. .   \. \... .. .#
#*.* .*\.* *.*\ .**.\ \ \.. .....\ * *. *.. ..@ .  ..*.*\   .  .**#
#* *. \**.. *..*...*    . !..*  \  . .* .. *   *\* .* *.*..**...*.#
#** . *...\\.* .*. ..*..   \ .. .\*.. . ...*  .. .*\.  .. ..\. ...#
# *.\.*. ... . ..*   **** .  *..\ .*   . . * *\ \ .  \.* .* . . .*#
#*.*  .*\..*..* .\.\... *\\. * .** *  *\\..\*.. ...\   .\.\. .\** #
#\** *\.. .....***\@.*\.. *\\..*.* .*.. .** . . **.. \.*\ * .. .. #
#** .\.   *.\ ..**...***..*. *\***. .\.\*.**.** .. *.. *.** *.\.**#
#*..   \ ..  .. . *@*\.*\ ! *.\.\.\!*.* . .\  .\ **.\*\....\*\*.*.#
#\  ..  . *  *\. *  .. ..*..* .. . .\...*.\ ....**. .   .*.**\**.*#
#. ......\*  .. .. .  * .*  .*\..\  .  ..*W*. .\.\*.  *   ...  *..#
#.@*.\... . .    *    .\.\*.* *\   ...*  . ....*.*.. .. .. ..  .. #
#*.   .\  .    . .  ..\***.*\*. .. \ .\ .*\..*!\ **\. @  \. @. *.\#
#. *\ * \. \...   .  . ..\.*.\ ... .  .\ \.\* **..*** * .W *\*.\ *#
#*.\ ..*.*\*..\  . *\..  *  .**  *.*... .. .\.*.. *\*..... \.... .#
#...* .\*..*  **.\.\.\* .**\...**..** *  \*  \.*  *  *. *. ..  .**#
#..!... *  .  *\**!..*\. ..  *  \  \.\. ..  *.\.. ..\.\*. ** . ...#
#\..*\. * .*.\\.*\*@... ..*\..  ..  *.*\    .*. \. .**..*\*** *\*.#
#. ... \. ***\**..*..  ..*..*.*.*.  . @*. * \.\..*. ...*.*..* ! . #
#*\*  .\* *  . .\...\ *\ .**.*.. ****...*...\.*  * * *.* .. .\   *#
#..\** \.\.*  . ..*......*.*.* \**.*\ *.. . . **.. ..*\*.\. .. \ .#
#\*. * ....\ \..!.*   ... *... ..*.... *\.  *\. *.. . * .. .\. .. #
# \* \.*..*.\. .  *  ..* ..  ..\ . ..\ .\*..*\ .*.\*  .\  **.. \*.#
#\.\*. *\..\  \**\.\\     . .*.... * *\ .* .\ *\. \.***.*!\*   .*.#
#  ** . .  .\**.. .   .  \   ..   .**\  ... \.*.....*..***\...*\.\#
#\*...****.  ..\. * *.*\.  ..  \.**!.*.\.*\*.\@ ..* . ..*..*\ ..\*#
#*.*. \* ..*.  ..\. .*.  .*..*..\..\.*\...*  ..*.   . **. ..**. * #
#.**...*.... **\ * \.* *...... \  * .. .  \ \..**. \ *..*  ...\.*.#
#.*..\.*. *\*\* *\*  *\.**.*.* .. *  .*..* *.\ ..*.. .**.....*.*.\#
#..*..***. *. .\*.. .*  .* .*\.. ..*\.**\. \*.*. \ .\. .. .**.*.**#
#\.. .\  *.* .** **. . ... *....***. .**.*\.\.*...***. \   **. .\.#
#.*  *. . . .\ . *\  **..*.. \ \*.\.*@\* *.. **.*.*.\\ !* *. .\ * #
#** \*\  ... ***..* *... ..**   ** .*. *.**\* !@.*..\.* *\*.      #
#.* **...*. ..*@*\. . \. \ *.*  .. ..\ ...*..    *.\*.**\..  .\ \ #
# * *\*\  \.\.! \...* .  . . . *\.. *.\\* . .\. \ ...  ...***  !.\#
# ..... \@ \.. \ \ *!* .\ . ****.*  .. W     5.. *  \ *   @.@.*\.\#
#\.\. **. *\.\.\..**\.. ..  \..*..  .* ..  * .*. .  **\ **.*.*\. .#
#*. . . **.**. .  . \.\. ..*.*.\. *\ *.* * \ \. \  \*..**\ *. ..  #
#3\**........  \.*\ **  \  .*B..\*. ..\!\. .   ..*   *\*.*\.***\ \#
#\\. .  *.*\..  **.\... \..**.  ..*.\  .*. ..   *! .  ..*. *.\*. .#
#.*  . *W. . \ *..**..* .. *\..*\!. **. \...\\.*E .\ *..*  \..   *#
#\  *\..\@\**.*..\**\ .... **\.  *  *\.. . .* .\..*  .  *!.   . *.#
# ..\. . .*\***..* *   * * .. * ..\.*   .\*..\*. .\\.***.. \  *\**#
#\**....***.*.*.. ..*\.. *  . **...\* *.\.  .** .\ . .\**. ..* .. #
#.** .*..*\..*.. .*.! *. * ..  .*.*.\.* .. **...*...*  .. \*.\.\ .#
#*.*. . *.*  \ * .\.*.. .* \.\** *.* \.  * ..  \..* ... *\...*   *#
#..**.* .\.  . . *  .\   *.*\  \\*.\.* . * \    *  *.\ *\.\.*.\ \.#
#R**..*\ **..** .@. *.  \.\ .*....*.......\..@ .. ..  . ..*.@ *\*\#
# .  ..**. ..*..\..* \....  * .\.*..\\.. *. \. *.*\  * .\ .*...*.@#
# * *...\  .\.** **  . *. *\*\*.  ...\.* *\\*.   .. .. .**\.. ..**#
# . ***.* . ....\***  .*.**  ..* .**  .  .. . .\  \.**  *.\. \ \..#
#\***.*..  **.\* .*.\*..*\ . **..*.\.** .**\ *  ..*     ..\.\*...*#
# !..    . \.\ .*\* .. \*.. *.. *.*...  \.   ... ....\**.* *.** .*#
#\*.\ *\ **.\ . .*\ *.W.\\. *\. .**\.\ \!..*.* ..  \ .***.\.**\\\\#
#*. . \.*.\* *\A*   **\. *  .  .**\6*. .\\.. *..** . ...\......\ .#
#W  *  .. ..*.  . .. *. \*\  \... *.. **. ..*...\. * . .*  ..* * *#
#      \.  !*\. ... ..   .!.**.  \.. .\.. \ * .\.* . . .. .. \..*.#
#.* . *.. \*\ ...  . *  .**.***. .\..  .** .\.   .  *\.. *.  .**.*#
# ..**\ *.    \. .\  . ....!.* *** .*\.* . \..****.\***  .\. ..\..#
#*\ .!* ..  . .*.* \ ....*. **....  !**.* ..\**\. . *.. \@. *.. ..#
#\*  . .\..* * .\. ..@ .* .*\.. .*.  ***   * **..  *\***... .*** .#
#....**  *.@\.  .W* *.. .  *...\*\**...* * .*..* .*.. .. \ **.\\ !#
#.* . .*\ ....**..\ . \ \. .    *... .\* *.  *\*.*.  .*.. .   \* \#
#*. ...\ \* * *. *.**..\.  \ * *..\ \**.*..*\.. *. .**..  ...* .  #
#.\ .**. ...*\ .  \*..  .\. .. *!.. .!   **\  \ . . *.\ .. .*.*.. #
#\*!.*...\*\.@.** . *\..* ***..*.  ..*. **...\.\. ......\.*...*..\#
#*\.\.*\.\..*.\ * ..* .**  .. \... **.W\.\.* *....\..***W\  . .\ .#
#. \..!. * \*.\ .*  . ..*..  \*\ .*. *  .. . *\*\. .\. .. .*.\ \..#
#.. *.*. .\..\.. *\*..\... .* **\ *. .  *\**.\.*. ...  . . ..*.. *#
#..!\. *\....*..  *\*  *\ *.\\*\* .  ....4**  **.*. . .* ..  .\* !#
#\  *  *  !*.. .\**@\ ..* . \*  .   .\*\.  .\ *. *\ .  .. ..\*  ..#
#*...\*...\... **.*.. **.    !. *. .  *  .*.*.. .**\..\**.\...\ ..#
#\.* ..\.\ .9* ! .\.*.*.. !. **.... *.! .*.*.* *  \. .*\  .  .*.* #
#*..  .*..\ .**.  .. .. ......* **\ .*\. !. .. .*.    ..*. .* \.  #
# ..@.\** ..*\..  * ...\..*\.*. .\* .\  .*    *.\. *  ***.... .* .#
#\ *\ .\*. *.*.*.**.* \ \ .\.. . ..***.*\.. \. *..**\.*\.....\...\#
###################################################################

Water 109
Flooding 12
Waterproof 2
Razors 0
Growth 15
Trampoline A targets 7
Trampoline C targets 6
Trampoline B targets 4
Trampoline E targets 9
Trampoline D targets 3
Trampoline F targets 5