######################
# #.\*      .\\.   .\#
#  #B** ** .  #** *.##
#  # .\.*.E\ .\.. .*.#
#  ##.# 4* .* .@* *\ #
###**....\**. **.*\.\#
#\ .D*..\...\ . !.3**#
#.*@ .7 .*... .  @#. #
# # ..*..***\   .    #
## ** \* \C. ** \ . .#
#* . *.*\*..*\.  *  .#
#.  \.!.. \...F..*\.*#
### ... .  . *\  * \.#
#** *** !.   .*\ .*..#
#.#*\A# *.*   .* ....#
# ##.\#.#...  ** **.\#
##  ##\..* #..... **.#
#    #*.\.   R  .**..#
#    #*\# # .* .  .  #
#     #5*.*\ *  *..*.#
#      ######.  * ..\#
#          #*\..*. \*#
#         #*@ *.....##
#         L *#.#..# ##
#          ## ##*#.\##
#              #*### #
######################

Water 22
Flooding 2
Waterproof 9
Razors 9
Growth 38
Trampoline A targets 4
Trampoline C targets 5
Trampoline B targets 7
Trampoline E targets 4
Trampoline D targets 5
Trampoline F targets 3