############
#### . R.*.#
#..** ....\#
#L. *\** . #
############