######################################################################
#                                                                #.###
#                                                               #..* #
#                                                     #         ###*.#
#                                                    #.# ##    #*## *#
#                                                    # ## .#  ##.## \#
#                                                    #  #\ .##** \..*#
#                                                    #.  .# \ *#.*\#.#
#                                           #       ##* #.**..##\.#. #
#                                          #*#     #.##\. ....\  *  *#
#                                          #.#    # *   1  **.*.\..*.#
#                                    ####  #*.### #.# *\*.\. .     *.#
#                    #              # * \##* *.. ## \ .*.*..\ \.\ *\ #
#                   #*#         ####.#..###.*######. .\   .#...*.***.#
#                  #*.#        #\   .  ## ##.#.#...\@ ..*** ..\....*.#
#                   #*\#      #\  *\. R*#\..**.\. .. \*. *.\ . *\*.* #
#                  #*\\.#     #*\ \. ..*   ...\  .*\*\*\\  . * .\.\*\#
#                   #*# \#     ##...\*** #\  ##.\ * .. #*#.* ...*\*. #
#               ## ##.###      #*.\ . * *...*#\.***.   \.. . ..\.. *.#
#            ###..#.\ #     ##  #**..\!.#...**.\*..  .*.*  \  \.\* . #
#           #\ \..#....##  #.*##*..*\ .. .*\.* ...  .**    .*\@*..*..#
#            ####*#* . #*## ..\ .  . .   .\* .*\* .* \.*\@* * *\*\*. #
#             #.. @..*#  #\ L..\\.* .*.\ *.. .*@.*..* .*. ...\\.* .\ #
#              #*..  \..#\ *....\ * \*   \.*. ....****\.. *.   .\.*..#
#             #.**\  ...\**\. .  .* .\..*. . \   ...\. .. .. *.  \ \.#
#              #*. .**   !.*. . .*.\**.\.*  . .!.. ..\ *W  *. .*\ \ *#
#             #.# ...... **...*.*.*.*. .*. . ..\ **.*..*.*.... .*\ ..#
#            #* .*\*\*\* ..*.. \..*** ... \ . !.\*\*... *. *. *... !\#
#          ##\ * ...*....*\.\.*\\**.\ .\* . \**..* ..\.  .\ . .  .\. #
#         #. #\#*.**\*.    .* . \***.*...\ ....  .  *.\.**.. \..* .*.#
#        #. *@ .\ .\*.....  . . .. ****.*.C**.*.*..\...*  . .. \. *. #
#        #.#..  .*.6. *..\*. . ...*..*.\  . *. \   .  .\....*\  *@*..#
#        #..  * .\.  \.*.\...*. ...*\\  .\ ..**\. \.*** .\   . .*. . #
#       #*....\  ..  .... \* .\ .. ***.*..\    .\ .*.*.\....**. .\  *#
#       #*# !#*. .. . .\ .*** **  !! .\**\. **..\ *.*. *. \. . .\.* \#
#       #. *.**.*  ** **  *\..... ..\.  .W*.\.**. * . \. *  .\ *W!...#
#       #\.  .*.*  *.*.*..\..*.. . . .\... \.\.*  .** *  . .\*...!..\#
#      # ##.  \\* * @*.*\ . .* .    * *.* .  .\. . \ *  .. \  *\. * .#
####### ##..\...\.....**\  ..**  ...  ! * .*.  .*. . F\ *. ..\.*.*.* #
#  . .#..#\.#. .*  **.... . **... *\.. ...*.. *.. \..@. .* * .\*\.**\#
# .*.\*\  .\...\** .*. *  \  \   **..\* **.  .... .@ .\ W. .*.* .....#
## .\* ..\  .\.. \.**. .  !... * .   .. \...**\* . *. *  * ..\...*.**#
#** .* *.!\. .\..  ...\ .. **.*\ . . *.\ \ . . * ...\*. \..  *\*.. *.#
#\....*\*..*   .*.  \.*.* ..\.*. . ..\  *\ \**.* @**.  .@   .  *.\...#
##*.\........\ ...* . \..***.*.*.* @** ..* . . *\..\.   . . \ **\.\. #
# .*....**** ...\.*. \. \\*. *..****...  .   ..\*.\.*\.*! .\.\.*.*..@#
#.* .*\ \.* **  **.*\. ..\. *\.*.\.\*\.*\ ***  *.  W..**.. *.... .*  #
#*.. ...*\.  .. ..*..  * * \*  \    .  ** .** ....  . .* .**.. .*..*\#
#.*.  \**.. .    ..* .*.\*  ..\... *..\!*.\...\   .**....*\.\\.*..* .#
#.. .# ... \*.*\.\.\* ..\.\**.**..**.\ .. . \* ....***\....\   .*\* .#
#\..* \.*...* .. .\..*   **.*.\.  *** \  .  .* .*** ...**... . *\ *.*#
#.. \\  ***\. *    * ..\ .\.. *.\*W** ... \ \*   *\ .. .\. *  * .*.\\#
#\* ... .**...\ .\.\* ..\*.*. . .*..*...   .\..*. ..\.\..\**  * *. * #
#**\ .\  . \*\ *.\  !  *.*\..*\. .\..  \ *.. . *.. *.\ . .\..** .*\.@#
#.  \ .\ \ .......** .*.. *.**\*.D   \\! *\. ...* ...\\\.*   ... .*..#
# *.\.*. **.. .\.. *  \*\..*...* *..\  .. .\ .\*.  .... \*.\**.** . \#
# ..* .***\...\.. ..*\..*..  **. ...  . . *.*\ \.\.A.*..*.. .\*... *.#
#\ .. *.....\  *. \*  *\..***\. ..*.\ *.\....  .* \  * .*\*   .*. .. #
#*...**..\ . .*\.*.***. .\ *.*.* *.. . ....\ * .\\..**  ...*@\. ..\  #
#!. *.   ..* .* *.\ ...*   **..* ...  .. !\.*... *** .\.*.   *.  *.  #
#..\.* *. ..\.*..\... \.  ...*\. *\. *......*.* ..\.\.   *.  *\  ...*#
#**  ...*\* ***. * \*\*.*  ..... *\* *\ . . . \.   *.  . **..*. \* \*#
#.* *  ***..\.**.*  *.\ .W.\  .. . \....   *. .*  ..  .\@.\ ...  *\.*#
#.. ***. ..\ * ..  .. . .\.*\  .  . \* .* .* .   ...\ * W*.*..\. .  .#
#. ..* . . . . . *  .*.! *.*.    .\.\.\ . ....***.\.. \ .\. .*. .\ ..#
#****.*. **.  *\ .. .*@*.. ...* * . .**  ** .\ ....*   *.  .\.!*.* .*#
# ..*\\...\*. ....   *.. *.  .**\ .*..\...*  *. .\ .* \ @.5.*.* *.*.*#
#   *..*\...*!\* . **.  .@..  *\..*\ *... .****. * ***E.\ .**.   *...#
# *...\..*\*.. .*\ *.* ***\**. .*   *.. \...\!  **.\. .. ..**.* .. **#
#\ .*..  ....\.**. .***\\.... **\ *.* *. ... ..*...  *.*.. .. \*\ \..#
#  ..*. ..*.* .**.**..**.*\*.\....*..\\ \. ..... . \..*\..* \....*. *#
# **..*.*   \. \*.\.\ ..*\ .\.   .***   . .\..*..  .\\.*.\.**... *.. #
#.*\\.... . .** . .\.** \ . .\.\..* *\ . *\\**\ .**..   *..\.** *\ * #
#\...* .\*.   .. ***.\*.\ * ....   \.*.*.. . * *.*\  .! . ..\*  ..*..#
#\   .**... .. \*.\.  ..  *. ***  \  \* .\  .. @ ..  *\  ..!*.**..** #
# *  *.!.   .* ..****..*\.. *.**... *.\ \ \. * .**   **..* \\ .*.*.. #
#   ..*  .**.*\\** ** ....* .\*..\\ ...* *.  * *.....*\.\..\ \..  . .#
#\***..  ...*. ....***.* \*\..*. . .**.. .\\\*\.  ....\  *.. . !.@. *#
#.*\**\.*.\***.  \\*.*.. .\*...\..*....  *\* B..*.* \.....\. **\* \*.#
#*\*\...*\**. .\.\ \. *.*. *..   *W* **  .** . .*\.\. \.. .*  ...\!\ #
#*.\..\*. .* .\ *!*  .. .\ . . ..**.\.. \.*..  *..\***     *.. \  . .#
#**.**@. .\. **\* .\ *\ *.**..*.**\..**.*****.*.....**  \  *\*     ..#
#*.\ .*!  \* *. ***..**\..\.\*\ !\**.**...\*..  \** *.   .**.*.***  .#
#. **\.*... \.\..*.* **.* .  \.. *.*...    *..**.*. \. \*\** .\ ..*\ #
#\*..* .**\ . . .   .*. **..*.* ..*.*.*.* *.*.*\*  \.*.. .*....*\ \  #
#... .* . . * ** . .\*.*.\* .... .*\.*. .\  .**. .*. \.. .*\  ... ...#
#\ .*\  \\... ** ..   *\.*   *... **..  .*..**.** .**\. .*.*  *\.   .#
# \...** * . .\. \ .*..*.*   .*.\..   .  .*\...\*\... .* .\  .*..    #
# .. ..  .** *  \..\!\ *.**.W...*  *     **. * *. .* \ .  .. .... **.#
#  .    .. .** . ...   . * \  .\*.*..@.* *..* ** @\... *. *.\*\ *...!#
#.\*  ... .*.\ ..*\ . *. .*. \\.*.*...*.*\.*. .. *.. \..*\ ..\* **** #
#..* \ \ ..*\. ***.. ...\..  .. \*. \*...* .* *.\.\  .\.**\.. .*..*. #
#\*\....* *.***... .*. ***.  *.  **.*..\*@**! *\. * **  .\.\\**.. * \#
# *.* \ ...*  ..*..**. ...* ..* \.*.\.\ *. .\ \*.\ ..\*   .*..*. .\  #
# .\..\.  * ..  .. .\..  . \...*.. *.. *....  * .. ** . *.*...**.**! #
#.\*\ .\. .*  *\\.\*\ ..\  .***..  .\  ...\** \\.\** *. . ..@  *W*.\.#
#..**   .....*.**.**..*\ .* ..*.*.. .*\ \  . .* . *.*..*  . .... . .*#
#*..**..** \ . ..\ . *.* ** * \**. *\*. .*\.. \*  *.....  .**.*  .@\*#
######################################################################

Water 89
Flooding 6
Waterproof 13
Razors 17
Growth 42
Trampoline A targets 6
Trampoline C targets 6
Trampoline B targets 1
Trampoline E targets 5
Trampoline D targets 6
Trampoline F targets 5