#########################
#   ##**# #  # ##   #   #
#L #  .. #*###\* ###C#  #
#.## ..\4\..**.# .**.#  #
# .  . *.@ *.*.\ ###\#  #
##\** .\.#R**\ #\ ## #  #
#*@ . * \.*. .\#. .  .# #
#\* ..*H.**..  *\... #  #
#..  ... .**I.\*W#\##   #
# \. ...\ \\ ..*\**.### #
# \. \*.3@*.\. ..**##*.##
#\... *. *.*9\\..\\*.*\##
#.@* *.* * *.**..*  ...*#
#.*\.\ ..* ..\.! D* #.###
# . \.. . .. \\**\*.*#  #
#**\. .  .*..\   **.*#  #
## ... \  *  ....###8\# #
#  G . .*.. \1 \ #\##.# #
#.*.*.  .*  \* .B* .##  #
# .* *\ *!.F.* .*.*#    #
#    .*....  * #..#     #
#\. * *.*..*...##@ #    #
#....E* .*7..#A# ##     #
# .\.. *\.6!**#         #
#*#\.@..*.*#.#          #
## . * \.  .#           #
# ##.*.#..##            #
#   #.*. \#             #
#########################

Water 15
Flooding 3
Waterproof 3
Razors 10
Growth 39
Trampoline A targets 3
Trampoline C targets 4
Trampoline B targets 6
Trampoline E targets 6
Trampoline D targets 7
Trampoline G targets 1
Trampoline F targets 9
Trampoline I targets 8
Trampoline H targets 9