##############################################
#.**... *\ ##...!.***..*** \ #\.. ..#\#      #
#** \ \**!\.\..* .!.**..** **.  **..*..#     #
#*. . ** #*   ** ** . *.*. ...  .**@\ #\##   #
#. .\*... .*\ .\ **. *.*..**.**. ..... *# #  #
#* .* . ** *.\  .* \ .****\*\*\ .*\   .  *\# #
#\  .* .... *. . .  . *.*\.*.**  ..\*   #### #
# \.**\*.\ .*\   .  \ .*.*\..... .*.....# *\##
#..  * * . *.      ... .\....*\.  .***. ..## #
#*!*@.\!\* .    \. ..*\  . .*\...\ .*##\ .#.##
#.*..*. @... .  .**  \.\****\*@ .*.\W\ ** * ##
# *.*  \..  \ \*  * *..*..*.** *\.\. . #.## ##
#*...*..\  .. .... ..**.* .\!. !.*. .\.*.\## #
# \..\*.. .\. *.**.* .* . *.\* .\.  \ *\##   #
#*.   .. *.*.\*..***@*\ . ....\. \  \*. .#   #
#.   . *.......*.*** \ . .     *.  ...* #    #
#.\    . . \*  *..*  . . . .*..\*\.\  . #    #
#*.* @.\**  *.*. **\*\*     .** *.. *.\.*#   #
#!*  .\...**   . \**. *   .*..  * .*.*#*.#   #
#  . \.* .. ..  . .\. *. * ..* .** \\ ...#   #
#\* ..\.@ \.*.* .. . .**    .. **...*\##*.#  #
#  .. . .\ .\\.  ..*. *  .\.*\  . .. ..\#*#  #
#! \*  .  * **  *\ \ \\*.\.\.\.   .*\ *###   #
#*  . **\*.\.*\****  .  * .\ .*.\.*..*.#**#  #
#\ . ..* *\.....\..!* ..**.  ...*...\###.#   #
#.*\ *. @* \   .* . * \ .*** *\.* *\*.##*\#  #
#\* ..*R.\. *.  **..* .*\.*  . \..!..*#*#.#  #
# *..*. **. .....\**. .*.. **.*\*.  #@ .# ####
#\.\ .\..\ . \** \ .*. ...*.** ..@ \*.\  .*.*#
#*. .*  *  ...*\ .**\.@\.\***. .!...*.\. **###
#*.*\*  *.\  .*.  **   *..*.. *   \ *.*.. #  #
#...\ ..*\  *  **.**. .\.\** \ **..*.. \ L#  #
# ...*.\ ..*.  ** .. \ .\  ** .\ *\!\.##\*\# #
#.\. .*. \*\....* .  .*  *.*.\    *  W.**.#  #
#..*  ..*.* \ . *\.\. \\.. ** ...**  \ *\*#  #
#** .\. .*@ . * * *. ..  .. .!..... .. ..#   #
#**.  *.*.. \ ..\.!\  .  \.  . #  ** \..#    #
#...  \* .. .*  .\.* \*.\*\ ....\\.#..\**#   #
#. *.\ . *.. .\.**. \..* ..#*.*  .\.. #*.#   #
#. .##*.\. \* .\**.\ \.#*  ..***\**.\##*#    #
##############################################

Water 40
Flooding 0
Waterproof 15
Razors 18
Growth 25
