#####################################################################################################################################################################################################
#         ##   .. \ * ... *.* .  *  \  \ **. ... *....*\  .*.*\.* *  .....**.*. *. .\.*  \* ..\.\. @.. .   .* *.. !... **. . .. .. **\..\*.  ..*\. . * ..\ *..\ ...*.  *..*.\.  *.  ..\ @ \\\ *.@*.*#
#        #\*.* \ .*.*  * .*.*** \.*.     \**\  ... ** .*** ..  *.   ...*****\.  . . .\ . .. \ \ . \..\ .!.* .*\  . .  *. \  . . **  * .\@ .   \..*  ..* *\.*\ .. .*.* *.\.****.*. .*\ .\.... .\* ..\#
#         ##.##\.\.**... ...* .   . ..** .... ** * .* * ...**.*..\.*\ *.\  .. \@.\.* *.  .    .. !..@*. ..* .*.  *.\*. *\  .\*  .* ..\....  . . .\ . .\ \.*.... .\.*. ... .**.*.\* *  . .\.@  ***.. #
#           ##\. ..!*!.. \\ .  .\  * **. *.\ *.**\..* \.\.*.  ....... ...... ...**\..\ .\.***. \..**..\.\ * *\ .\.\..  .\**..\.  .  *. W   \.*\...*.*\. **..\* .*.\.   .. .....  * .. \**.*.. *\  .\#
#           #\ ...*\......** .\.*  .. . ** W **.\. \..  . ..  .. * .*  ..  .*..*..*\* *. *.  . ** \*. . .  \*...**... \*\**   *.\ * \  .\.*. .*.. ....  .*.*.\  *\*  .  .* \* .  .\  .....\.\*. .  .#
#    ## # ####\... . .\..\*.\*.*. .*.*\ ..*. .*  * ....* ... *@*..\.*.\\ \*\.* *\***  *\.*..* *...!**.\ **... * ..* ..*.* .*\ *  .  .. . .\.  ... .\..* *\. **\ ** .. .*.\  . * \* *.*\.*. \ \.\**. #
#  ##.*# #\ *. .#   .* . .\\...*.\...\  .*.*.*. \.. \.*.  .\..*.*.....*.\. .\..... .. *. .. . *.   *  ..\. .. * * .*..**. *. ..*. *.*..    ..\... . .. ***...\  *..*.  .. !. .  ..***. \\   ..* .. *#
###*..*. .\ .#. ..*.*. *.* .  .\  \ ..*\ *\...   *. .*..**\*. . *.\  .*...\ .\.  *    .   \*\* \*  \***... \  *.. *..*.. **\  *...\. .\ .. \.\ . .  * .. ..*  . **.*.**.    .\* ***\****.\.*...*. .*#
#..\ #.*#  \#*  *#.. . *\*\  ..*..  \\.**. \\ \.\ * *.. .\..*\.  ...\.*\.  .*..\ *..\ \*.* .*.\ . \.\. @\  . *.\\ ..**..*\.*.*\.*  .  ...* .*  *@..*..*...\* ***....*..*.. W  . .*.*\.\..*.* ... * \#
##*  *\***.#.\* .. .* \.. .  \.\**. ..... *.**..*..  **\.\ .*..*.* . *. . *.... *.. .* *      *.*... * .   *\*!!* .  .*.\ .*...*..@.\*. *  *** ...... .*   . *. *  **.*...*..*** * *. \* W..* \ \.\.#
## \ ..#.\   *.   ...\...  .. ....\*...*.*.W.*. *  *..* \.. *  *.. .\. \   .* ***.\ *.\. \\ \\.****.\.**\... * . .\.\*.**....**** *...\.  .*..  .*.\..\**. ..\**!.*\. W*. . *.\.** . .!  @ *\*.\ .* #
##\# .*\ \.  ...\*.  *... .*.\*  .* **.* ** \.*....* *  ..*..*...*  *\*. \.\*...*\.\*.  **\..*...*.. *...  * . *** ..\*.*  \*.\** .. *.* ...  .\. .  ....\*  . \*****  .\ .\* * .*.*   \......*. *. #
# # ... \ *\   !..* .. \ .*\. \*.**..... W**.\.*.. .\*.  .*...  \. \. *   * \  .* \.    *..!.* *...*\.* \\ *....**   ....*..\*.**  **.**. * *.*.\.. *...  . .*..\.*....*    . \. \.\**  \ *\  **\*..#
# #.* .#. . . ..\..  \!.. ** . ..***. \*\ *...*.*.!\..\**\. .  *. ..* \ \*  * **.. .*  .. \.\ *\**.  ....**\...\@.  . . .\  .**..... *..\ . ...   ...\ * @**.\  . . . ..\ *.* .*..  .**  .*.*. **\.\#
##*\..# .  \. *.!.\.. ** ... .*  ..\*\ .*  **..*..!  * . .  * *.*.\ ... .** .! *.* ... .. .. \@ .. .* ..*\  *. *... ..\ **.*\*.\ \.*  *@**... * .\.. * .!..\ * **. *.\\.. ..*.\..\.. ..\. *\*.*.\. *#
# #.  #\ .\**  *.  .... .. .\..* *..\.. .\ .. *...\. .* *. .*..*.\ *  . ..@\ \.. ...*** * *. .\  .\*\.*.... *.*.  \\  ..*. ...\ ..**  .....*.\* \*  *..**.\ . ...*. *  \. .**\.\ *.  *  * **.*.\ *..#
#  #.*   . *...\.\.*\**  ..** * !*.\ ..  *\.\.  **.\*\..... \ .. .*. * \* .*. ..  \\*.@ **. . .*\.....*.*.*  .. \ .*. *\..  \...  *. . ... *. .*..\..**.*...  *.**. ... ** .W *.  .*.\...... .*. .* #
# #\ .\ *# *\.\. \*.  .  \**.**\....  . .*  ...\.   ....* .     ..\  . .*. * ..\.\ .*.* .*  . *.. .  .. *...*\.\.\.  ..*.. !.  * **\ . **. .*....    ***\.. \\.*.*.\..\.*..*..\ \ .....**\ * .\.. *.#
#  ##\*.  .*. *\..** **  .*.*.@. .*. .  \.**. **. .\**  *..**  ...*.\\\.\\**.*\*..\..*.  .. @ * .. .*  .\! ..  .*.\.*\\.. **...* .. *.  *W ..*  ... **.. ...  *. ..*.\.\\  .**.\... *. ...\@ ..\*.. #
#  #* ...\ *.*.\  *. **.  .**.\ . * .  \\..**... .  *..*. . .\  *  . .** ..* *...\..\\ . *\*...@*   .. .*. * .* . **.*. .* *.. .\ .\.\*...\  . *** .@.   .  .\.**  *... *.. ..** .*... . \.**..!. .*#
#  #..\*\....\. ...\..*  \ .. .\  *   ..*  \. ..* ..  ..\*.** ..! \\ \*.* \*\*  ***.* .*\.*.*.\*\** . \.. \.  ..  ***\ \*.. \. ***!  **.*.. * ...\ *..    .  **..* . .*.. . \ .*  .\* . ..*.! .\** .#
#   #.W *  \ **.*   ..*.\. .* *@*   \ W ....*.  *\  .\.. . .. **. . *.*** .\**.* ..\. .*\.. .*.*. .  .\**\.* *@\ *\*\.\ .*  . \...   *.*..* .....*** *\  !*.. ..  ...\.* * .*\ **.\** ..\\.*\ *.** *#
#    #. .\.  *...* \**.  **\..... *..* .  .* \.*. * *..* *.   !*\** * ***\ .*.*.   *  .*. . ** ...\ ...\ .@*..* *. \* .*\.* ..* .. \.  ..* . ...\*\***.\ *@ ..  * . .   .*. ..\*.\.@.  . !.*.\. ..  #
#    ##    . \.**.*.*.  .*.. .. \..\\\* \* .\. ***W.\... \...... .... .!.*\ ..*..\....*.   *.*.  .. *.. . .. *...\\..* . *  * . .  . .*\.* .***. .  ..*  ..\. .*\*.*  * ...  **\  *** ..*.* **  .* .#
#   #. \.*..*.*\**.\  *.   .*  ..\ \*.. .*. *.*. .\.... ..*  !  .*\*.\.\... **.*\. * *..  .  .* .\* ..*.\!..*.  ...* .\. \  * . ..\\  . \*. *  * *.  \. @.\ ***...** .* \*\ *.\   ... *.\ ..*.*.**.*#
#   #    .* . . *!\ *   ...\.  *.* .* .  \* ...*. * .*\.* *.\.*... \.   ** .*\.. . * ** \. .\.  **..  ..  * .    \.\     . .\* *** . .*.. \..*.. \  \*  * .**    .\.\*. ..  R\. *.* *.\!*   .*@*..\.#
#   L ..#\.*\...\*..* *\\  *\  **.\*  \  *.* ..\ .   .  !.\.\.*. @    .\... .*.*.\...*. . .**...\.*!\ .\. .*..  * *..   @ ...!*\.   * *.* .  \.. .*. .***.\.*..*\ ..... @. .\..*.\ \.* ..\ .**\**. *#
#    #\.#* .#..*.***.\ .. *..*..*... .* ....*..W* . *. *\. .\..*..  \..*\ * \..\.**\ . .\\..\ .  .*.. *. \  * .\ * \*.* *. ** *.*.@ *\*.. \* .\. *\.\ *.*\..*\ . ....\ .\. **\ *. .  .* .  *\. .\   #
#    #. *.#*..\ . **. ** .*.  * * ...* *\  \* *    * * *!.*.. *.*..* * .. \..  *     * * **. \ ... *\ ..* **. .. **.*.  .  ***\**.. .*\  *.. \.*..  . *.   \\. .  * .*. ..\.\ .\ .\.* .\. **. .**.  #
#    #*.* #\** ** .*\**\ *.. . \. .\*.\. .**  !\\    \\\ *\*\ \ *\...*.     .@\*.\\..  \ \*  ..\.* \*.\ \ .\.\ !.*.*\.. *.. .\.. ..* **\*.. * \*  \\* ..**!\*.\ \**\** *\.*.....*..*.. * \.\. \*.\.*#
#####################################################################################################################################################################################################

Water 0
Flooding 0
Waterproof 7
Razors 32
Growth 47
