##################################################
#\ *..*..  * .  .\ .  .  \ * ** **.*\.*.. .* *  .#
#. *\ .\\* .*\. * .\  **   .**.    . \   \...\ . #
#  \ . .... .. ..\.* .  \. ...!. .*\  * \!.  *@..#
#.\ . * .   .*  .*\.  **.*   **.  ** *.. .*.\.\\.#
#.\!\*   * *\. \** .. . .. . *.** \* *.* \.*.\*\ #
#\ \*. . ..\  ....\ .   . .. . *.\..**. *.\.\ .. #
#*.  !*.\  *..\..\*.*..* ** .  *** .***\.\ *  \*\#
#* \\*.\*.   **\ * *  !.\*  !\. .!*. .  . \\\*.\.#
#\ .\.*.\ .. .\.\.*\ *   \*.. *.. . \  . ..  .** #
#.\ . * *\* . . * **...\\***. . ..\*..\ .. ...*..#
#  ..\ .*..** **..*\**\... .*..W\\*.A.  .*.*\\*\ #
#.  ... * \.**..\!  .. \ * *.*\ * * ** .\**. .\ .#
#..\  . *\. \.\...\**.*. .R. . .\.. .\. . ...\.*.#
#\\*  . . ** \   . ***. ...\.*.*..  * \ .\ . .  *#
#... \.\.*.... \.   .\*. . .**..**  . .  .. ..*\*#
#*  \..!.* .**\.*!*  ..*..\.\W.\. \*\. .\*. ..***#
# \.. **\. .... .** ..*.**. *.@.    . 4 \.\ **..*#
# .*. .\  ..***.!.*..*..\\.  .*..\. ... *.   .*..#
#\ . \ *  ! . .\. ..**\ .  . @\..! .*..*..\.\...\#
#** ......\ ..  \.. .* .*.   \.\.\. .\*\** \*.  *#
#.*  \* *.. *. .\ .. *  . *** .\   \*   .*\*.\** #
#*..*.....* @\! .\*.*.*. ....*.*.. ...\ ***.  ...#
#. \. * .*\* . \. \ * .. *!\.. .** ***.*\... .*. #
#\* \... ...*. .. \.. .\.  .\ **** @. ..@*.. ***.#
#  ..\* .*.\  \.  .\.\. *.  .**.\.\..   *. \  .* #
#* ...*.*.\...  .\*. * *...   \. **...@\*    *..\#
#*..* ..!.. \.*..*.***  .*..\...\... ..*.    . \ #
#*. ..  ..@..\. \ \..\.. * **    .*. **.*.*\ *\. #
#. .\*\*\.... ... .\ * ....\.  **.  *..*.**.**.*.#
# .\*  * .   *\    ..\.  ...\\.\.. \*  \.\. .\ *.#
#\.. .*.*   *.  \*\ .*  .*.\. .. \ ..*..\ .\**..\#
#.. \.**\.. .*.@ *.. . *. * *.\. ..*\....\ W..*..#
#*..*\.. ..*...... .  ...W\ **\*\  . \\. *.   * *#
#*\.*.  *\...*\  ..*. ..*.\** ***\ *\ . .@ . *. .#
#\   **..  .*.  .*.\. \.\ ... \.\ *\ ... . .** .*#
# \.*\. .**.*.. .   \*   \ *.*B*..*.. .   ...*\.*#
# \.*  *\** .. \\*.*...\...\*.*.   * .  ..  ..*..#
# ....\* *\..* .\ *.\..**.*.*... *\...*. .... ...#
#...*\.. .*\ .\.  ..*. .  ..*.\  *\ \*.\.\ ***.  #
#\.\.. \ ** .*...*.*...*.  .***....\ . ..**.*.. .#
#.*........\*\.* ..*\***\ **.*\*\.\.  **..* * **.#
#\.*\  \.*\  .... *.*..*.*.*\!*..@ .. *..\. **.**#
#*...**.*. . .\....*.. .**.**..  . ..\...*. W**..#
#\* ..*... ..... .\.!*..*. .* \...  \ *..... ! *W#
# *. \...**.. .. ..\ *.*... . .  . *..\.. ..*.*..#
# *. . * \.*.. ...  ..* \*...\.\ ..  *..**.*. . .#
#\.** . . \...  \. ..*.\*.. ...* * .\ ..!*. **.\ #
#  **.*\\. .\.\.****  ..**\.\*\. .W*\. .*.  \.  \#
#. ..\..\   **.*.*.!.\\. .  ..  .\.*  ....    . .#
# .\.**** .@.....  *\... .   * .\. *  \*  . ..*. #
#.. .**..**\.. . . *   **. ..** .. .*....** .....#
#*\. .** \**.*. \  \* @* .* ... *\ **...*..***. .#
#.*\. *. ..* * ..\*. \.. .\**...* ** .\**. ....*.#
#\...  ... .*. \   . .\*..  . * \.\.\.***   *. ..#
#*.\\*    *\.\. ..\...*** . **.\.\ *. *.\..  ..  #
#*  *..* .\. . *\ * ** .. *. . . @\** . * ..*..\\#
#*\ .* .*.** .*.* \..\   .**..\  @..   ..  \.*\  #
#.*....\..*. * ... \*. .  .*...\..\. . \.** *\.3.#
#*.    .\.....   \ .*.**\ ..*..*  .** .. .\\.*.. #
#\..*. .\.. ...\...*. .* **  .\... .\ . .   *.\.\#
# . .\ .*\**  *.\ \ . .*.*\ ..  .*\.\    .. * *..#
#\ .*.**. *...\..\..\ *.\*.**.\  \ .\*. . .** .**#
# . ...\.*.. *..\**..*.**.*...*\.  *@  *\.*...**.#
#\ \!*.*  ....  .\.\*\.\.\.  *...  .\  *  .\*.\* #
#   .*.\*\* *  **!\\*   . .\ *\\. *#*\ *. *.** *.#
#*.\\..*.*. .* .**.* .** \.*...*\.*.**.##\.*.\  .#
#\ . ....*...... .\*\\.*.  ..  * *#.* #*..... \..#
#*\. ***.\**@    **. \*#\* \ ..**... # #.!#.\..\@#
#.*...*\ ..\.* .*.***. *..  **. .\*.*## \##\#* *.#
#..*. .**\ * \  ! **..*.*. ..* . .#.## ###\*#. . #
#  . **.*.\.*.\.*\.\  .\... \.\*... *.#   ##\\*.##
#*  *.\  \ ..*. *\ .. ** \ * . *..*.#.#     ##\ .#
#. * .. .  \ ..\*.#\*.** ..*W .\ .## #        L###
#. \ .\ ..  . .\ .*.\*. .* ....*  .##            #
#.*.*!**.#\ ... . .* .*.**\  \.\\.\# #           #
#.\#\  . \.. ** ..*! \.\ .**.!..* *#.#           #
#    .\ #.*  ..  ..*\.*  .** * *. .  \#          #
#  **\. .**\*\*\..*@..  . ..*...*.* ##           #
#\. .*#\.\ *# ..*.* !*\  .*\... . *#             #
##   # #\# #*.#*. *..**. ...****\.#              #
##*\# #*\#. *.###*\.*\#* .*. \..##               #
# ##   ## ##### #\. .# # .**\#*\#                #
#             # \.** .# #####*.#                 #
#             #. #..##       #*.#                #
#             #\ .##        #\ *#                #
#             #*##           ###                 #
##################################################

Water 0
Flooding 0
Waterproof 12
Razors 14
Growth 42
Trampoline A targets 4
Trampoline B targets 3