############
# #*##     #
# #*..#    #
##*.   L # #
#R.  ...#*##
# \ \#\*#.##
#*..##*.# *#
# . *#*. *\#
# \*...*.\.#
############