###########################
#  # #\.. \ .*..*..  .   *#
# #*#L.....\.....*.  *.  *#
# #.*\ . *.   *.*.   .\. *#
##\.. .. ..#\ . *\.. \*. .#
#** ***   \    *..   .... #
###R.**\ ***\. .\. *.   .*#
##\.\.*\*\.. *\..\ * \* \*#
###########################