##########
#   #\.* #
#  L**..\#
#  #*.\  #
# ##\.**.#
##*\  ...#
#\...  \.#
#*.\*.*.*#
#\ #R.* *#
#**#\#.\*#
##\###.###
# #  #.# #
##########