########
#.. .\ #
#\ .** #
#. ..\\#
#\.* ..#
#.... .#
#.* .*\#
#*. ** #
# * ...#
# **\* #
#  \*  #
# *... #
# .. ..#
#\ .* *#
#.\.**\#
#*..*.##
#.R**..#
# ... \#
# #.#**#
#*#\ **#
#\\##.##
# *L#\.#
###  #*#
########