##################################################
#*R\       .*\ .* .  .\*.*\\ . .**.\.\*\**## .#  #
#*\. . *.   **\*.\*\.\ . .*\ ** **\ .**..\..\#   #
# *. * .\.\*.*.. .* \.* \..**.\*.* ....* *\ ###  #
# **.. *.*.. * .  *. *.*..  ..*.  \. .*  .\. ..# #
#... .\  ...*   .*\.*\..**..*.*** ... *..   ...L##
#\  ...  ** \ \  ..*\ \ *.....**...#\.  . .##..\*#
#.*..\..*\...*. \ .\ *....\  .. ..  *.. . .\ .# ##
#...**. .* . \.. *. ...    ... *  *.*\*  .** .*# #
# *.\***\* \  * \.*\ \..\.**. ...* \.**.  .#\##  #
# . .***..  . ..  . .   \ * *. . * .* ..*\.#.#   #
#*\  \.*\. .\ .*\.*..*\. \.*\*\. .\.* ##. # #    #
#...\\...  . \ .. .**.  *.*.\..  .* . . .#  #    #
#\. \*\\   \ .**. .**.\\..*.  \.. \ \# *\.##.#   #
#....*. *\.. ..* \. .\**  .\  .  ...    ...  #   #
#\*.  .*.\ .  \ \ .....*  ....*.... .*\** *  .#  #
#..  \ .*..   . . ****.**  . \.\ \. *\..*.\ .#   #
#.** \ .***..  * ...... *\\ \*. ....**. . ##\\#  #
#..... ..\ **.\.\ ..\. *...*\ * \ \ .. *\ **\.#  #
# * *\ .\ \..** *.  *\. ..**..*..*... \.  **#*.# #
#.*..**. .*\.  .\.*.. ..*  ..**\..* . .* \*# ##  #
#\*.\...  \.  . .*. .  *. . **... \ .*\..\#      #
#*  **.\*. **\. ..*\ ***    \.. \ .\ **\\ .#     #
##################################################