##########################################
#\.  ** # . *..*. ... \* \*.*\\  .\ .  # #
# \ .*..\\*** ...    \.\. **..\#*   *#.# #
#\ ..*.#.\...\***  . ..\  \..\. . *.*.#*##
#  \ * . .\.  ..*..*  . .\. \.*. .\ . *.##
#**.\*.\  ..\.. *.*.*   \.\.  .   .\.*.*##
#\.* **.   ..** .   *\...  *  * . \..\*\*#
# \..*... ..\.*. ...\. . *.*.*.  .  *\#*.#
#* ***.*.  *   .* * .*.  . \...  ...\.\*.#
#.\..* * . \  . .**. \\ .\. ....  *  .. .#
#..\   .   .*.**\ .\. .....**. \.. *\*. .#
#\..\... \.\.\.   *.. \*\ .*\  .* *. * . #
#. .\ ..* \ *  ...* .\* \.  .. *** . . .\#
# . . \..\.\. . .\. . . .. *. \.*. *   \*#
# * . .  .\  ** .*.\  *  \.*.\.  .\*.\.#*#
# *\...*..**.\.\  **.*.\\.*  *  *\ \..\*.#
#\** ...  .. *. *... ..*...\.*\.. *.*\#.\#
#...*.***.\* ..\* .\ *..  .\.\ *  *\. * ##
#*...* ..   .* *..*. \*\ . . *.*\#*  .## #
#\ . * .. .\*... \.....  **\*\.*##*   ## #
#... .*\...*... \.* *\  .... ..\*. #.##.##
#  * ...* .* . .\ .*.*.  ..\  *....\**#\##
# **\.\ *  \.  . * .*.\.. \*\..#*\ #*.. *#
# .*... .*.  .*. .. . *.  .. .*R..*## \###
#..\..\.... **.* .* \ . **.**..\*  *.##  #
#\ .* . \.**.\ ....*...\*\ .** *\. * #   #
#. ..\. .\..  .\  **. **...*\* \* .\ *#  #
#.\  **\ ...\*\. *\.  \**  ... .# * *.#  #
#  * *..* .*.**\\.. .* ....#\** \. *..#  #
#** \*.*..   .  .  ...*.**.*#..  * ##*#  #
#.* .* .***.\\  *  *. \\....*** *\  #\.# #
# . .* *..\  *. . ..*. ..*\ .. \##\ *##  #
#.*.*\    ** \.\. .*. \. * *\#*.##.\#    #
#. *\. *.\..  \ * .* ..*.\ .# ##  ##     #
#  \ *.. ..  ..... .**** . ###           #
# * .. .\*. * .\. *.*\... \.\.#          #
# *\*\ ..  *\.\.*\.\  **.*.\*#           #
# . *    .*  *.  ..*..\ ..*.#            #
#\..#\..\\.\*\\\# .\*\*. #.*\#           #
# *  . * *. *.\ *. *.....*# #            #
# . \#\*\.  \*  . ... **...\#            #
#. ..*.\... .  ..   *..\\..#             #
#\ .#.*  . * .. \ \ *.....\#             #
##*#.  .*...     \.\ .*..##              #
# # ## ** ..\.* .# *..* #                #
#     #\#\  .* \\. .##*\.#               #
#      ##*  *#*..**# #\*#                #
#      #.. \.#\.\*#   #.#                #
#     #\.###\. .\#     #                 #
#      ## #\ ## *###                     #
#          L# #\. .\#                    #
#              ##.##                     #
#               # #                      #
##########################################