#############################################
#   #***.#. ..\ .\...\.*\. *. ... .\. \..\  #
#  # .*..\ ....\ ... .\.* *.\.  . **\\.  .* #
# # *#..* ** *.\*.    .* *****\  \ *. .*\ ..#
##.*...*..*\ \**.  ..\\* ...* ** ... ** *.. #
####\.\  *\...\ .\..\. *.. .. .** .\\.. \ . #
#..*.*. \  \ \..**.**. ...*  **..** ..\ . * #
##\#*.**..* *. *..\*... *...\.*\..**. .*. .*#
# # ##.*L.......*\*.. **...*. *. ...* ....*\#
#   ## ...*.  . .*\* ... \\*. \   . \   . *.#
#  #\. .* ..*.**...\ .*\\.\.\ . \  .* .**  *#
#  # #.\.\. .**\ \*..\... *  .. ..**..\.*.\*#
# #* .#**  *. \.*..**..\  *  * *\ ... .\ \ *#
# #\ \ *\* .*\...  ..\.*.R *** ...*.\\ ..  .#
#  #**.... *** **  *** *\ ..*\\* *.*. .*.*. #
#   ###\.*..*.***\*.*\ \ .. .*.\ *\. *...*.\#
#############################################