######################################
#   ##* ..  .. . .***\ . ..  . * .  *#
#  #.*. .\.. \ .\..\*.      ***.\.  \#
# #. ..\... . *..  **\.  ..* ..\  \  #
# #.\#\.*#.  \.*\* ...\  .\.  ...*...#
# #\## *....\ * .*...*.  . ..** \..\ #
#  # \*..*.\ .\ .*\ . . *.  \* \ \*..#
#  #L#*. *** *\.*. .**\.\* \ *\  .*\ #
# #.#R# \*.*..*..\..*..  . ....\**..*#
# #\# .\..*. \.*.* **\  \*.*** .\ ..*#
# #.  *.\.***  \ . .....*..*.\ *  ..*#
##.*  .** .\.\* *.  * * .... ..... .*#
##. ** .. .* .. **  ..\ .\  .\ \ . . #
#.*\...\.\.*.  *.\  .\*.\ . . .*..* .#
###.*.   ..** .\* . *.* .\*. \\..\\..#
# #***.\  *\. * \\. ... . ** . . .  *#
# #..# .*\.   \ **  *\..\ .. *.* . ..#
##. .#   ****...**\* .**... .*..\*\*\#
######################################