#####
# # #
# #*#
# #*#
##\*#
#**L#
#..*#
#\ *#
#.*.#
#..\#
#.. #
# . #
#*\.#
#*.*#
#.*.#
# .*#
#..*#
#\ .#
#*.*#
#\*.#
#..\#
#*\.#
#..*#
# \.#
#*.*#
# R\#
#.  #
#\..#
#. \#
#. .#
#   #
#..*#
#.\ #
# . #
#. *#
#*\ #
#\..#
#.\*#
#\.\#
#.. #
#* .#
#*  #
#..\#
#.\\#
#*..#
#.*.#
# **#
#.*.#
#\.*#
#. .#
# ..#
#* *#
#####