#################
#   #\ *.   ..# #
#####*#*.*\.\L# #
#*\ ## # . *\. ##
##... #. . ..####
# ##R\  \ .\* \*#
# #.*. \. *....\#
# #... #.*.. \###
##\*\ \  .*\*  *#
#################