###########################
#                     #*# #
#                   ## \# #
#           # ##   #*  .# #
#          #\#  ## #*. \# #
#          #*.* **# ..*#  #
#    #  ### ##* *.#\*.# # #
#  ##\## **##L..#\ .\*. .##
###....\     ... .  ..\ # #
#\#..*\..*..  *  \*.* **\##
# . *. *..   **. .\\* ..  #
# .*#* .\..* \....***\\.\\#
#... * *....\. ** ...*. ..#
# .. . .. .*  *..* *****..#
# . .\. **.. .\*.....*\...#
# . **\ .\. .\..  \*\ .   #
#* ... . ***  . *  .*.\ \.#
#\. .  * .****\*\  ..** \ #
#.   ....  ..*.\* .\ .\* .#
#   ** \... . .*\.\  . *  #
#\. *...**. **. .*.\ \..  #
#.*\**.*....\*** .\*.\   .#
#\. .* *..\ ***\ . \\. ...#
#. .\.\..\ .**.\.\...*..\.#
#  \  . ***  . .   R \\.*.#
#.*..*.\  \..   .*\*...*..#
#.\.... \..*  .... .* **..#
#.*\*\*.  *\*.. .  \. ... #
#.\. ....*.\* ..  *.* *\*.#
#.      *..*.* \ .  .\*...#
#*   . ..*.*.   .  .  *.\ #
#\\  \.  ... **   ... .  .#
#.\ .  .* \* .*..\*  \.   #
#.\\.***.\ .... . *.\ \ . #
#..  .*..**  .\*  .\ \.*..#
#.. .. . .  * *\.*\.  *. .#
#... *\ \*.*......* \.* .\#
#\ **.\ .. . . .*. ..\.. .#
#**..... . .\. ..  .. \**\#
#. .. .   . .... *.*.\..\.#
#\* * .*    **.*.**\ .    #
#\..   .. .**.\....** .\*.#
# \.*. \ . .\*.*.. .... * #
#... .   .. .*\.. .*   **\#
# .. \..*.**.*.*\ *..  .**#
#\** ***.****\.\*.   *.. .#
#\.\.**. .*\ .. . ** .*\. #
#\. .*\  *.*\** \*.*.   \ #
#*.. . .*... ....*.*..\  .#
#\ . \ .   .**.**.\...  .*#
#*\ .** \* ... \..***\ .  #
# .... .*..  .*.. .** ....#
#\.\.*...\* \  \ \..  **..#
###########################