######################
#   #\. #* . ..\ . * #
#    ##. . . *    * *#
#    ##   . ..  \.. *#
#  ##.  * R      .  .#
# #..... .***\*.   ..#
# ##\  *\.\.  . .\*  #
##*\*   *..* .\.\..  #
# ###..  \.\ . \..  *#
# #.#   .. .*. . *  .#
##.*......  * ..  .. #
#*.*.**** . .*... \..#
##\ ..\.. .  **. *..*#
##  *.....  *\\..* *\#
# #..*.\* #..    ....#
#  # *****.\. * . \ *#
# #.\..#*.  \*.\ #\*.#
#  ###. .  \ .* . ...#
#    #..\. ..\* *#\ .#
#     #**... #. #.  ##
#     #*. .  ### #.*.#
#      ## *.L     #.\#
#      # \#*#     #\*#
#       #\ #       ###
#       #.#          #
######################