##########################################################
#  . ***..\*   . **. .   . .    .. \\****\.. *  R  .. ...#
#*\\ ...  .\ ...*** \...\  *. * ** ......\ \*.*\.\*\.. \L#
#\ .\**\.\.*.\.**.*\.*.\ ...* ..**.\ * ..*..* * \ *.* *# #
##########################################################