##############################
#*#                          #
#**#    ###                  #
# #   ##\.*#                 #
#*.# #.##*#                  #
#.*###.# .#                  #
##\ \#*#..##                 #
#*..*#  \...##               #
#***. *\... #*#              #
#\ .* ..**\ ...#             #
#*\ .*#\*\     #             #
#.*.***\.. # \\ #            #
#*\\....\ \.*# ###           #
#..\ ... ..*.*.**.### ##     #
#. *. .* * *..  ..#*.#*.#    #
#.*\  *\..\. . # . .* \##    #
#**. ...*\* . .*# # * .  #   #
#  *..\  .* *\*#  . .  #*.#  #
# .**** *\**.. **\\#\ . ***###
#.***** .*. \*.*.* . ...... *#
#*....*\ \      .* ..**  #\  #
#.* . ***.\.....\. *  * **. *#
#\.  .\.\. *.***...\#*. \  .*#
#*\. *.* ***.\.  .*.* ...#L ##
#..\*.*...*.. * ... *..\ #*###
# * \.\.\*.*\ .. * ..*...*.* #
# .\\.  *.\*......\ ..*. *...#
# \ \*.*.*\**\* .*. *  ..\##.#
#   .\.* ...**.\..**.*...* **#
#..*.. .** ..*  .* \  *. \#.*#
# \.*..**.* .*.\** .\ . .....#
# . . ***.\.** .* . \. *. . ##
#   * \.*.**\*  .. \. **.\ . #
# *....*.....\.\*\*  ...  ...#
#.. *  ...* * \.*..\** *..***#
#\. ....*.. *.***. .*..\. #.*#
#..  .\** \.*\ ..\ ..*  *.  .#
#.*\*  *. * .*   *\R.*...* \*#
# .*. ..... .*. \ \  \\ \\.###
#* .. * *\.. . \.. \ .* ..  ##
#. **.. .\* .\.*\ . .\.#..####
# \.**..\ .\.... \.*  \* . .*#
#\  ..*.. * \ ** .#.\### ..#\#
#. . \.. *. ...\#* *  \*\*.###
#  .*.*. \..*.\.  ..\#.# #.# #
#..*... *  .*.#**\#\.#*\##.*##
#..*\.\..** \# ### ## ###\.# #
#.\..*#*\*.  *#          #\.##
#*   # #** .##            ## #
# \* # #.#..* #              #
##############################