#######################################################
# .\..* .  *  * . *.. ...* .\...*  . * . \**..    ...*#
#.  * .. . *\.. *...*\ * * . *  . ... **\.*.*.  * * \*#
# *\*\   \ ...\*.*\*  .\.. .*\*  . *\ \... ** *..\*.\.#
#  #.*.   \ .* . . .* .\.. \.*.\.*\.\..  R .*.\   *  \#
#  .\**. *\. .  ..  ..*  ..  ....\ .\*  \** ..  ..* ..#
#\** ....\.\   *.*.***.*. .  * . *.\...* \. \.** *. .##
#..\.\.  ..**. *  .\.*\.*\*  . ** ..  ..**. ..*\ . . *#
#.\*** . *..*...\*\.*..*.*.**  .     \ ..* * *..*.   .#
# ..\....\ *.\ \ *.\.\ * . . ** .  ** . \. *\ . **. **#
# ... * .  .*\*. .\.   \\. . *. **\..*.\..\* * *......#
#.*  .\ .  .**.. *. *. \*\ *\....\  .\.*  .\*  ***. . #
#**.... .  . \.\ .*..\\.*.....* .** * .*****..*.*.** \#
#*#*. * *  ...*..\...  .* . . *. .. *\ .\..\ \  ***.*\#
#\ \\ \... ...\. . .\ *\.\ .\  ..\.*\ *.. .**..  .*.**#
#  .. ... . **..*\.*.*.... . . .** . .*. ..\*  \ \.. \#
# .....** . *..*.**.\..* *.** .\.*. *..  \...* .\*.  .#
# .. \.*.. *..* *. . *.\.. *.\  ..***.\  . .**\.*.* .*#
#\.**.*. \ \. ..*. ** *...  ..* .* .\*.*.*.\* \*. .* *#
#.......* .\ *..*\... **\ ..\ . .\ .*. .  .\*\.*  \.**#
#.  \.  .\.\. .\ .*\* .    ...*\\..\\ .*\.. *..\.*...*#
#   *\ *. \. *..\.*..\ * . *\.\. .\. .*. **\... ..\. .#
#.. *\...*.**.\***.. . **\. .*  ..  ***  ... ..*\.... #
#* .* \  . . .*.**    *.\*   *.* . . .*.\**  *\.*\ . *#
#\  *.****\* .. ...\.* *..  **.\   ***..*.\ *.*    *.*#
#..\***..\..* \  .. ..\*..*.\*\ **\* \.*.***.*\.\.\.*.#
# * \*    .\. . \.*. **.*..\ \. \.*  * * . ..\* * .\..#
#\.  .    \ . ...**\***\* ** .\  *\  .* * *.*\.  . \. #
#*.  \. ...*..   .\ .\\..*....*..*.* ..*.\.   .**\.  \#
#\ .\.\. \**\ **.  .\..*..*\*.*\... \*  \* ..  *.*.\*.#
#. ..  .  ...... ....*\ .  . ..... . *\ * \ \ *.\  .\.#
#.  * .  * .. \.* .  *     .  . ..  ..  *\.*\.*.....*\#
#..*.\ ...\ * .\. *.   *   *.   *. \.. ..*   **\.. .\*#
#.....**\. .  . *...\  *....* \  *.* \..*\\.. *.*..\  #
#*.  *. #  \*.\ . .*\*...**.. **.*.\. *.\ ... .. . #.*#
#*.* \..#.\*.....   *\....  ***.\ \*.*..   ..\.   .\*.#
#*##\  .\...*\  ... * .  . .\*.** .  . \ .**....**.*.*#
## #*. *..**.*.*  * .\.*\...** \\     .. \.\*\ *..*. .#
#   ###.**. **.. \  *.*. \ .\. .... ...* .****.\ .*. .#
#      ##.\  ..*...\. .  * ...  * * ..\ *...*.*..\ .* #
#    ##**.  .. . ***\.*.    .*. *.\* *...* *.*.\\ . . #
#   #...*\ \.   *.*.*\..*\. .\*.\   ..*. . . .*..\\. ##
#   ###*.*..***. *#..**\*  .  ..***. .*........*. *   #
#  #.#\ ..##\....*\.*....    **.*.\.* .. *. \.. .*. \ #
#  #   #*.#\ #  .#..*.  ....*\.\. ...* .\.**..# .**.###
#  #.###*.#\  .  \ ...#*. *.*. ..* .\. .\.\*\\*. .\*\##
#   # #. #....*. #\*  ..* .#.\ **#\* **\ *\...\ \  .# #
#     #*.# ##L \.*. *. *. ...#.\..\..** **  **. *#*#  #
#      ## #   #..   .####### ..#.  .  . **.\*.*##\#   #
#             ##.## .#    #.\\  ##.##.**#*.*\ *.. #   #
#            #*.\#*\*#     ##\ #  #. ..\ .\ .** .\#   #
#             ### ###       #*.# ##*..##.*\.**\*.#    #
#                            ## #\.* *.#\. #.*#.*.#   #
#                                #\## ##* \*. . ###   #
#                                # .*.\ .#.#\*. *.*#  #
#                                #.####  #\*#.#####   #
#                                 #   # \##.*\#       #
#                                      ##  ##*#       #
#######################################################