#######################
#    # .#\#\.... .* ..#
#     #.... *# ..**R .#
#     #* # ..\*  .. *.#
###### . . .. ..*..\.*#
#*. *\ .***.L*  ..\. .#
#####. \...\*..  *\ .\#
#   #\ .*. *.*\ *\*.. #
#  # .  *\....\ ..*.*\#
# #.##*..  *....  .**.#
# #   \ *\ . ..\   .* #
# # .#. ... *. . .....#
##\\**.#\*. ..  . *\..#
# #.\# **.\...*\..***.#
#######################