##############
#.    *.  .. #
#\.\. ..\.  ##
##..   .* L ##
#\.*...\. .\.#
#.. *  #.*.# #
#\. .\.#..   #
#.*   *.\. *##
# **  ..#..# #
#*\.\#*#R.## #
#\#\*##*# ..##
# .   ..#### #
#\. *. #*#   #
#* \*  .*#   #
#. .. #\#    #
## .**##     #
# #**.#      #
# #.##       #
##############