#########
#..* . \#
# *.#*\.#
#.#\...*#
#*.. ..*#
#..\* **#
#****\\.#
#.\.\ *.#
#\* * * #
# ..***.#
#  .....#
# ..*   #
#. .* . #
#*.  \. #
#. . .\ #
#\*\  #\#
#\* *\. #
#.\..  *#
#**.\. .#
#\\  \  #
#  .\ ..#
#\*.*.. #
#..*.. .#
# ..    #
#\\...**#
# ***...#
#\.**  .#
# **.\ .#
# ......#
# \\.\*.#
#. **. *#
#.**\ ..#
# *\.. .#
#\  .*  #
#  .\ . #
#.  .  \#
#..\ . .#
#*.*\.. #
#R***.  #
# *.* \.#
#\  .   #
##\ * **#
#*. . .\#
#.*\ \. #
#.**# . #
#\*\# ..#
# ..#####
#. #    #
#.#     #
# #     #
#.L     #
#########