#######
#L ..##
##*  *#
## .. #
# **###
# \.###
#R#** #
###\.\#
#  ##*#
#######