##################################
#                   #\#          #
#                   # #   ##     #
#           ###### #.* # # *#    #
#          #\*\*. #.*.*#L# ##    #
#        ##\ . #\*##. *.\ ..*#   #
#       #\.* .\ .# . \**.. .\#   #
#        #.*\  . .\.\ .** . \.#  #
#    #   #.. . *.\. *...\**. \# ##
#   #.###*\  . *. \*\ .***.*...#*#
#   # ** #  .. .*  *.\* ..*  \ ..#
#  #* .*. .* .*\*\ #*. \ \  ... .#
# #..  # * .  .. *.*\*.   \.*\ \ #
##   .*\ *\.*. .*. . .   \*..   .#
## *.  .  **.. . \*\   \\*.*.* \.#
# ..*.\ *  .\. .* *  .*\ . *...  #
#\  #.*.*. ...    .\.\ . .*\ * *.#
## \ .* .. . \. \.*.*.. *.. ****.#
# # \*..#. *..\ .\...\ ..\* ....*#
# # .. . *   \ . .*. *.  ..   . .#
##.  *\ .  .. *\ \.  .\ .*\.**** #
#*\#.*.\ * **..**\* .*..   *..\*\#
####\ .  .**. .  *.**..\..... ** #
# #* ..*..\.\..*    .\.   *.  *.\#
##**  \.\*****.. * . . .*\.  . * #
#*#...  ..*. \  .. **.   *\.....*#
#..\..    *  ... * \.\ . ..*  .  #
##    *. \..  *\*. . **\.  .\ ..\#
# ###.*.  .*\ * *\ \*..*... *\** #
##.#  .. * ..\* *\ .\..\ *\..* .\#
##*** *  ..\* *.  \.  .\*\* ..\.*#
#.\ * #*   .....*  .*  *...  ...*#
##  .\\* .* \ *.   ..... \.  .\..#
#*\.. .* .\.. **\* .\   ..*\\..* #
##..#. *.  .. * *. .*.\*.\. . *. #
# #\#* ...***\.. *. .. .\ ***.  \#
##  #..  *.\*.*  . .*\ R  .\*.** #
# ### \ **\ \ \.. *\.\*.*\\ *.*.*#
##################################