########
# L###.#
##.. #.#
#.\.#  #
#  ..\*#
#*\. ..#
#.#* . #
#...  .#
#.* \#.#
#\.\..*#
# .   \#
#*.  \ #
#**..\.#
# . .. #
#\ **  #
# ... .#
#   *\ #
#.. .. #
#. ... #
#*** *\#
#. *..\#
#  **..#
#..*...#
#. .**.#
#* ... #
#.  R. #
#\ . ..#
#   * *#
# . * .#
#.* \  #
#\.  . #
#. .***#
#.. \.*#
#**\.\.#
#. ... #
#.\\.\.#
# .. * #
#. .\.*#
# *.*..#
#\... .#
#.\. *.#
#.*...*#
#*.\.*\#
#\ ..\*#
#*.. .*#
#*.*\* #
#...*. #
#\...* #
#.  ..\#
#...* .#
#.**\.\#
#\.\ . #
#.\... #
#  .\ \#
########