##################
#  #\. . *. *.. *#
#  #* .. **\**.\.#
#   #LR#\.\...\* #
#   #\*  ..* . . #
#  #.\*.\...   \*#
#   ###*...**..*.#
###### ..***. .*.#
#\ * \*.*.**\. .*#
##################