#######################
#.# *##\*\  .#. ##..# #
#\  .###..\\#\  # .#  #
#*. **  .. ...*.****# #
# \ \.\ .  . ...**\#  #
# .\*\** *. .* .*##   #
#\\ . ** ...\\. *##L  #
# #. .\......**. * \# #
# *     .. \*... *##  #
# ..* .* ..\ #* .#    #
#\  .\*.   ..*** *#   #
#. *\.. ..** .#  #*#  #
#\.. *\  ***  .\.. #  #
# *.\.....\  \\.#*##  #
#\.*.* \......*.*.**# #
#. \....  .  \..* .#  #
#. .*.  \*. \ *.. ##  #
#..*  \*...      *. # #
#\.   ...\.  .** #\\# #
##* . \  . **\..  **.##
# . .\ .. \*..\..\.## #
# .*\. *. . .\*\.##.# #
#  ..  *.. *. *.***  ##
#.*..  ***.\*\*..\.#\##
#...*.. . . .*** #..###
###\.\ \* ..*.*\    ..#
###.*...\  *R..# *\*.##
#.*.  .**\*  .\...#.# #
###   \#\ ... \*## #  #
#######################