###############################################
#               #*#              #       ###  #
#               #*.#            #.#     #  *# #
#              # ..*#           #. #   #. ..# #
#               #\. #       ## #*\..####.*.* ##
#              #.**.#      #* #.* ###.* ..*#\.#
#       #       #\...##   #    ..*## . #.. ..\#
#      #\#     L.#.\#.*# ##.*.. ..   \ .  \.\*#
#     #. #    #*. .#* .##*###  ..*** .....*.*\#
#    #..\*## #..#....\###.#*\ * .... *  .*..\.#
#     #\.#* ##\ ##* .*....*\##.   . \.. .\*...#
#    # . . .#   .\#*\. #\ *.*# #\.\ .*. .**\ .#
#  ## * ....##\*\* *  *.**... \.. . . *.\...\ #
# #*####. *\*#.*. .. *. . . * .*. ....\  . * .#
# #\.\\......* .\..\..\.*   ..\.**** \..\ .*..#
#  #..***. *..\ *.* \   . .*\.\*. ..\... * *. #
#  #.#* .. . *.\.*\   .* *. .  .**  **...* .* #
#  #.##\* * ...  .   .\*\.* \.\. *.\. *\ ..*. #
#  #.**.* .\ .  *.**.* . *.*. *.*\. **. . \. *#
## #....  \...\ ..***.\.\....**\.\ *\.*.  . \.#
#\# #*  \..  . **\..\  *.   \ ..*.  *. .\*\*.*#
#. #*..\. *.*...**. ..\ ...* \ \ *\.*. .*.*...#
# ..*#\  .\. ** \*. \ . .  ..**.*\ *.\** *\.*\#
#*.*. .\  .\.\.*. *\..*  * *..\..  .\  **. .\*#
##.* . .*   \ .*..*\ ...\. .\  **.. ......  \.#
#..*.  \*.*. **\..\ .***   * \.*.. ... *  \\..#
#.\.. . .**  ..*\*.*\. ..*.\ ....\..  *.\ ... #
#.\ ...  ..**\** ....*\ \* .** ***  . ***. \ *#
## \ *** *  \.*.R.. .....\ \*.  .  ...\..* \\*#
##....*  *.\  .\.*.* . . ...** **\ *\.*\.. . .#
#..*\ .  ** ...... *.  *  .*\.. \*. ..\..\\\  #
#...*. . ..**\**..\ .  \*\.*. ** ..* \.\.*\..*#
#*\ . *. .\  *.  .*\*   *.. *.*..* ...*. ..\ \#
#... .*. ..* . ..\*..\*....*\ . .. *.*.* \. ..#
#.\    . \.***..  .**  ...*..*.*   .   .  .* *#
#  ***...\**.. ...... .   .  *.. \*  ..\ * \*.#
#  ... .**.*\*\. * .\.\ *\ \\ .**.\...***.  ..#
# * .\. . . ..*...*\.**....    .\... *. **.** #
#...\..  * **.*\..*. \... .*.\. \* .** *....\.#
# .  \\  .* **.*.*.\   .\...  \* .\ *. *  ***\#
#**..*.. ...\\ ..\ . *.. **    .   *** ** \.*\#
#** .\* \**..  * . *\   ..  ....  **.*..*   .*#
#. .  .\. .  .\.   . *\*\  . .. \\ ..*.**. **.#
# . *. *.\ \  . **    . .*   *.* ..\..**..*\.\#
#..  *..\  .*. ..*  \...\ .. .*.. .*  \.  \   #
# .. *.\.***...\ .\..\* .  * *.  *.. *  *\.. *#
#..*..   *..     .. \..\* ..*. .***\*..*.\   *#
#\\.... *\ *.****  .. .*. *. *..\*.*\\...*....#
#  \..  \* *.\.*.** .\ .\* *..*  . .. . .** . #
#\ #.\ *#* *.* .\.\.*..*.\*\\ *\..*\ . \*\.\**#
###############################################