################################################
#            #...*.*  *. *\. * **\.L.*  *#   .##
#             #* *.*\.\. *..*\ *.*\...*... \. .#
#       #      # .*# \...*....\.*\ \ ....*  *. #
#     ##.#      #* #.**\*.**\*...  .\*  .*.. *.#
#    #**.\###  # .**\*  . *. .* **\. .  .\ . * #
#     ##**.. #  #\.* ..**\ #.*\ **.\. .  **. ..#
#    ##.. .* .##.*\..* *.*.. *. .. \ * \\* * .*#
#  ##*    . . #**..\.\ . . ..\* .\.. *..** . ..#
# #.*...* ...#\ . .. *.*... *  ..**  .....\. .\#
#  ##  *.** * * .\.\ * \** \*\.\*.*.. *.\**\.\.#
# ## .. *. .##\.\*\  ...*.\.*\*\.\.  \.  \.*.. #
##*** # .  .R #  \* * \ \*.*...*\..** . ....\ *#
#*.###  * *\.\* .*. . . .\*.\\*.   .  *\. ... .#
###  #\##..*  *.\.. ..* \.. ..*.**.*..\.\*\. * #
#    #.#.*    .\. \.... .. .  \****. *. .. ..*\#
#     # . . * . .\ ..\... **** *. \. *\.\. *...#
#     #*..  \ ..* . \ \ *.*.*.\..\. \....\ .**\#
#      #. \*. ..*.    .......* .*.  ... ** ... #
#     ##*..\*\ \.*. *.\  \. .. ... .    *. .\..#
#    #.  **...*. .* .  * .**   *  .* *. * .   .#
#   #*\.\*.*..*\ *. .***\ *\.* .*\.. \.\*... *.#
#   #*...*\* . \..\...*.*...***\..**    *.*.\* #
#  #\..\ .\ * *.. .*\.**..\ *..*\.*\ .\** *. . #
################################################