############
#. *\* ***.#
#\..*  \. \#
#***. ** ..#
#*... \. ..#
#.* * .. ..#
# .....* *\#
#. *   *.. #
#  \ ****. #
#.  .**.. .#
#*   .*  . #
#. *.*.\*\.#
#\*.**   . #
#.*\*\.*. .#
#*.*\.. .\.#
#. \ .**  *#
#... *** *.#
#\ .** \ ..#
#..*\. \ ..#
# *  .\.. .#
#\.*\ ***. #
#. *. .*\ *#
#\.\*.*.* *#
# .*.\.*. .#
#\..\... .*#
#.*\ .***\ #
# ..*\*    #
# \\.\. \.*#
# \**.. .\.#
# ...\\..* #
#......... #
#. *. ....\#
#* \ ..**. #
#..\ ..*.*.#
#\\..\#. R.#
# ..*. ..  #
#.* .  *  *#
# .. ***.\.#
# \ ..*  ..#
#\..\ .. * #
#**  \.  ###
#.\.\ .* \ #
#  * .....##
##*. *#*#L #
# ##. #*#  #
# #\* ##   #
#  ##.#    #
#   #*#    #
############