###########################
# ##.**. *\  R..\.* ** .. #
##\*#.\.\. \*\  *......\ .#
### .* \\*....*..\. **. \.#
#\\ \.*...*  .\ . . **   \#
#### *.L.*#\*..*\..***. \.#
###########################