###############################################
# \.\.....*.\ *.*.*. .\.\**.\.\ * \ *R*#      #
#*.    ** \  .. ...\ *  *...*\ \    \.\.##    #
#. .* ..\*..\*. \  *\....\  ..* ****. .*#.##  #
#.. ... ..*  *.\. *\. \*\ **  .**.\* *..  .*# #
#.**..*\  .\*...*\...\...\.. .\ *\.. .\#** \# #
#\..  .  .\. \. . * .\ *.....*.*.. *\....## # #
#. \*..\ ..* .. .* ... .    #.... ..#* \. #####
#.*.\..  * *. **.**\* \. . ** . .\. .##*..  ..#
#..*.*  *...*\.. *\.  . .*.\*  . *..*# ..##**##
# \. .\ .** ..*.\\.\ ....*..  * *.#L...*#  ## #
#.  *. **\..* **....*\. .\ ...* * . . ##      #
#*  .** .  \*\*.  *...\*...  *. \ *.#.#       #
#*  ..\ . \....*. ... \.\  . . *.*.**.#       #
#.**..  \.. *. .* *.\ .*.\*.  * . *\..#       #
# .. *. ..\ .. \*..   .. ... *. . \*..*#      #
# \* *. *\ \.\... *.  .*. .    * \ \ *#       #
#  .*\.*..** ..\. .* .   \  ** *. *.*####     #
##...*\.   ..****  ...*  ....\*\*. #\.*\.#    #
#\ **..  *  **..\.\ .\.    \\ * ... * *##     #
#.##\.....\..   *.... .\.. *. \ *\*.*##       #
## ..  **  * ...\..*.\ .   *..  ....\#        #
#  \  ... ..\ .. *.* * *..#\   *. ###         #
##..\* *..  .\*. ..*\.  # #.# .\.###          #
##.*  ## ...*#.*\.... \.#*\*.. #.\ *#         #
# ##**## .*.\# ..*.  .#*#\*#.\..\###          #
#   #.*.\*#\*.* *# #\**.##*###\##             #
#    #.**.## \### ##*#. \ #   #               #
#     #**#  ##      ## * #                    #
#      #*#            ###                     #
###############################################