##########
#** ##   #
#..*..#L##
#R\. .. .#
##########