######
##.# #
##.L #
#..###
#.* .#
#\.. #
#.*. #
#*.**#
#\.. #
# *..#
#   *#
#***.#
#\** #
#. . #
#*. \#
#* *\#
#* ..#
#. . #
#.   #
#.\\.#
#\*..#
#*.. #
#\ *.#
#*.* #
#*.\*#
#....#
#. .\#
#\ .*#
#   .#
# .  #
#.\ \#
#....#
#.\  #
# .R\#
#\.\.#
#*\ .#
#.  \#
# .**#
#\.. #
#  **#
# \..#
# ..*#
#.**.#
#*\..#
######