#####################
#..\ *.*. .\.  ...\ #
##  .# . *.*. .**\*.#
##.**.*. .R*......#\#
# #.  .\.. .*.\* ...#
#  # *..\  ..*.  .\.#
#  #\.  .\**..*..* *#
#  L**.... * .* .*\.#
#   #.. .*.   \.*. .#
#   # .* *    ..*   #
#  ###\. \* ...**\ *#
# #*\** ..*.  ..*   #
#  # .*.# *.* .#.\  #
#   #* # #. ..\*...*#
#    ##   #*.* #\*.\#
#          #*#.\#*.##
#           # ## #*##
#####################