##########
# #      #
# ##   L #
#   ###*##
#\ #\*# ##
# #.   R.#
# ..##\###
#* *#*.\.#
#.\* #*.\#
#\*...\ *#
#..\...#*#
##########