####################################
#*.*L #.  .\*\ .\.***.*.\ .*****\ *#
###*.*.*..    *   .**  *.*.*.*... .#
# ##  \.  \. .*.\ \.*   ..*. \**. \#
##*\. .\ *..**..  * . .\.  .\.*.* .#
# ##\ *.*\. . \.\ *... .. * ****\ .#
#   # ..**..\.*\.....\  **\ \.\..*.#
#  #\\..*...**\   .\ * ...* .*   .*#
#   #.*#  . *..* **. \  * * *.  ...#
#    #\.\\ *.**..\.  ..*\.. ** \  \#
#     ##*#  ..*  ......\  *..R...  #
#       # #\.\.*\ .\ .\***\.\.*. \.#
####################################