#####
#. \#
#  .#
#...#
#. *#
#. *#
#\ .#
#...#
# *.#
#*..#
#*\ #
#** #
#**R#
#**\#
#**.#
#*. #
#*  #
#.\.#
#\\*#
# .##
#.\ #
# ..#
# *.#
#L.##
#####