##################
#***.  . ..\.*#  #
#.  \.* ..  .#   #
#..\  *.   ...####
#*.\\ .  **...#..#
#*R *\ . .....* ##
#*.*. *..  *\ .# #
#** *\*\* *\ # L #
##################