#####################
# #.\R*.\. .  * ..# #
##. *..* .\  \. .#  #
#.#*.*.*  .**..**\###
#. .*. **  .\ \...**#
# . *..**.*\  \..####
##*..*.\.\**.\ .\.# #
##..*# ..*.... *.\# #
#L ###* .\.**\ *\#  #
#####################