########################################
#                       #*#            #
#                       #\.#           #
#                   # ###.##        #  #
# ##               #\#.\#\.*###  ###.# #
##\ ###            #.*.*\**\ .*##\**.*##
# .. \*#        ## #...#..\***.# ###\*.#
#*#  .*#       #  #     #\..  ###  #. ##
#.  . *#      #*. *      . . *\* ##\. *#
##....#       #\ *. *. .  .. *.#.\. .#\#
#.\* \.## ###  ##. \.   .* .\..... .*.*#
# *. *#..#**.##* * .* *..*.\\....*. . *#
# .**  *##.# . .   **.\ *. *.   \.    *#
#*\.* #*.. \  .*\  .\.*.**..\.  .  *. .#
#. *.*..*\.*.   . .*. .*.*  .   *..  ..#
#\..*.*\.  .* .*\ *. .*.... * ..*.\  *\#
#.*\ .*.*..*.*..*.. . \   . .* \ \. .* #
#*.. .. .\.*... . \.* . .* ...*.. . .. #
#.*.. *\** .L\. .. \. *.**\.**.   \* . #
#\*\ \.*. * .*   ..*  **\** .*.. ..*  .#
#.**...***.....*.* ....*. . ...\ .  \..#
#\..*. \  ..** .\.. .\ .*\* \ ..  .**.*#
#* ..**....\*.  *.\ . . .*. .. ..**...*#
#.\\**  .  .*.*  \*\*.\.*.\.  *\ \  \..#
#  *.*\  **.**.  .* * .*. .\\ *.*.*.. .#
#* . \  *\ .*.\.  ......\. . .. **.*\. #
#. . .... . * .    .\** ..***..*..\ . \#
#*  .*\ **  .. . .**... *.... .* ...* *#
#.*.*.*  *.  **.\**. . **  .\. . \*\  .#
# . . *\...\....*\...  *\*..\ .. ***  .#
#.*  . .  *.\ \ .. *\\*..*. * . *.\\  *#
#.* \  *... ......\...\ \.*.\*\* *..  .#
# .\..* ...\ .**. * **.\. ...**  ..*\  #
#..** ..\. *....\ .*  *. * . ..   .. .*#
# \ *..* .*\\**. ...\*.\...*   \.\** .*#
#\..**...\. ....\..* . ..*\.*. ....\ *\#
#*   *.*\.  *.*..\..  *\.* .. ..\ *. .*#
#. \  *. *\.*\*.\  \ * . *. . . **. . .#
# * *..\*..\. .R.**\.. ...\.*\\*.. \.  #
#\..\. ..**.   .*..\..\.**. * *...  * *#
#*  .\ ....\  . .\*.   *..\ .*\.**.....#
#.  .** \. **\**.   .* *  **  .  *\.*. #
#\.*..* *....\ *\..  . *\..*........ . #
#*    ... **. * .. *\ \...\..*..\\ .  .#
#* *.\\. *\*  **.**\ *. ...\**  ..   ..#
#*\ ...*.\.    . .\..\*... *..  \ . * .#
#..* . . . * .\* ..*.**\...\  *****..*.#
# .**\\.* .. **.  *\\.* \  . ..*.**... #
#.*.*. *\\.  *.* ... \.  . .\ .**.*.  *#
# . .*\  .. .\..  ..\**  *.*. ...** .**#
#*\ *. .    *\  *..  ....\.. \..  * ..*#
#*. .\* * *.. \*.   . .\ *.... ..*.  *.#
#**.. * .*\*\..*\ ...*. *** *.\ *.*\*.*#
########################################