##############################################################################
#.\....*  . ......\.....*..  *.\   \*.\ ..\.* .\...  *\.. .\..*.....**.##    #
#..  .*\ *  .  \.\ *.   *\ . . . * ..   .  *\  .***...* .\*. .*\ . ... .\#   #
#. \.*\.*. ..\*\ . .*\.*..  ..\.\  ..  **.\\.\ ***. \*..  \.***.  *..\..#    #
#\\..*...  .*.\**\. .*. .*\\**. *..  *\\..* *. *.  ..**  **. *.  *\ .. .\### #
#.. .....  ..* ***\........*.*  .**\* . *..*** ..**.*\. \**. .  *\.. *..##\.##
#*\ * **.\   .   .*    * ..*.\ ***. .*  .*.. *..\..*.  .  ***....*  *\. .  * #
#.\ .\*..*..*   \\.  . .. ..*.****  **\.**  .\..   *\ .***. . * .. .*.*.  #\##
#..*\ *\.. ...\*   .*..*... .\..*. .***.\.. ...**. .*.  ** *** *.   ..**\\## #
# ..*.*  *. \*.*\.  .\  \ *.\* .. * .\.. *\ . .** ...** \.\.. .\. *.*.\ #.#  #
#  ..*. .*.. ** .*\.  .**.*  ....*... .* . ...\.. .*\... .*.*\\   .   *\.#   #
#. ...  *.* \.. \*. .. .\*.\ ** \.  * *.. .\ **   .*. \ .* *....\# \..##*#   #
#** \.\ \..  .**.. \*\ .*....*.. . .*..*\  *.*\ ..*.*\.* . *.*   ...##. .#   #
#.\..** . ..* ....*.. .*\.     . *.* .** ..\.. .....** * .  * *. \ .. .# L   #
#** *.\** *\ * \  . ..*\. .\ \ * .**\ .*  .     ..\\.**..\. * .**.*...* ##   #
#****.\*. \..*\ .. *\ *.**\. ..*. ...*    . \*\ *.. *.\..*.*.  .**   \..* #  #
#*.*.** \ . .\ . **\.\*\ .  . .. \ . .  *.* . * *...*.. .. .\**.\   .\####   #
# \.. \* ** *  \ \..\....*\  *\* . *   ..*.\  **.   *.* *  ***.* *.. \#      #
#\.\.\ **\.*\.\.\ .*   ..* ..\  * .   \ . * *..\.. .*** ..*\.\ . \#\ #       #
#\ . * . ****.\*** * R.... .* *\..* . .\.**..  .  .*.. .. \.* ..  . #        #
#* . *. *\..*\*.. .... * .  .*.   .\..* . **..\.\ **\  *. **. .. \ .*#       #
#*\.. *..* ...*... ... ..\ .*\**.... \    *.*\*..* * *****...  .*..*#        #
#.* . \ \.*. **..*.\*.  ..**.*   \..** \*.\*.*\.\\ \*.*..\... *..*\#         #
##############################################################################