######
# . .#
#\ . #
#.  .#
# ** #
#.\\ #
#* \.#
#  .*#
#.*.*#
# ***#
# \*\#
#*.. #
#* . #
#\. .#
# ..\#
#\  *#
#   .#
#*. *#
#.* \#
#* \ #
#*. *#
#* R.#
#. * #
#* .*#
#\* .#
#...*#
#.\* #
#\.*.#
# \..#
#.* *#
#* *.#
#*.. #
#.*\*#
#* ..#
#\ *\#
#*.\.#
#. . #
# *  #
#. *\#
#.\..#
# .. #
#    #
#\ *.#
#.\..#
#* ..#
#..  #
#*\ .#
#.\ *#
#..\ #
#   .#
#  . #
#.* .#
# *. #
#.*.*#
#...\#
#\.**#
#**\*#
#.** #
#\*. #
# ..\#
#\...#
#* \.#
#*...#
#\   #
# .* #
#. . #
#   .#
#\* .#
#..*.#
#.\. #
#. ..#
# .**#
###L.#
######