###########################################################################
#           #**.\ .*. \.\*...\..\* . ..*.. ..***  .. \. * .\*\**.* . .*  \#
#      ##  #\**..  .* .* .\ .... . *\. *..\.*\ \ * . .  ..\   *... \ .*.. #
#    ## .##\*.*  .  .  .. .*\. *\ ..  .. .*.\..*..  . .  .  . *.** .     .#
#   #\## ##*. .*** .\ ***\ *  ** ..\.* .. .*. *. \.*  * *. .  \  ...*...  #
#   #\* .#**\  ..* ..\..* ..\ *. *  \. * \ \* **\...* . ..*\*\.*.... **   #
#    #..**.  \  .\  ..\*. ..  .  *\ .  \* *.. . **\\.*.\\.\\*.*.  *\ .. .*#
#    #\...  .** ..\*....*. .\* .\*...* . .*... *..***...*  . .....\  \....#
#    #.*. .\..    .. .. . .\ .. *...*.*\ .  .. ..*.\ .\ .*..* ** *.*..*  *#
#     #* .** *. . *\** *  ..*\...* ..\ \..  ** \ *\.  . *..\.\*.......* *.#
#     ## . .... * *....\.\. **. ***\   ....\.... . \ *. .....\..*.   .. **#
#    #\ \*# . ..   . * .\***. .. .\. **..\ **\  .\*....  * .*.\*..\ ** .*\#
#####\. #*\ . *. . *     ....*.\..   * * *.\  . ...  *    ....\... \*\ *. #
#**\.*. .   . .  \.  .****.\ *\ * . *  ..**  *. *.\* *  ..*.  *   .. *..**#
####\#.. \* ..*.\ \ .....\* \. \\  .  .  *.\..\..... .\**..** ..*.*\*..***#
#   #****.. \... .  .*  \*. .* ...\ *.\... *  * ****.* .\**. . *...*.\\.\.#
#    #\.*.  .\ *   * \.\ .. \..  ..\*...\.*....*   ... *..**\ ....  .*. ..#
#    #* \... .**\ ..\  .. .. .*.** ..  \\.. **.... \** \ ..*.  *... .** ..#
#     #  . * *\..  * .*\...*\.. *.. \.*..\  \..  .*..\ .. .\**..... **.  *#
#      #  ..\   \ **. **.. ..*.*..*\. .* *.**\* *..*.  .*\**\.... ...*\*..#
#      ##\*.  ..  *.  .*\*  \ *.** ..* ..\ **..*\...  ..*.. ..*.    .\* ..#
#   # # \ ..  * *..\ .\. \*.* .*\.\ *.. .*\.*\.......***...\  *.*\ \ ...* #
#  #\##..*.\ ... ...* \.* \.. .*** ... \.........\...\.*..\*  *    . ** **#
# #* ...\.*...\# .\..*\*.   .. *.** .*  .. *.  ..**\**.*.**\.\*\*..*\.*...#
##.** * * *.#..***....*.\ ** \ . .*  . . \* \***.*\.\ *. *.. *.\ .\ **.*..#
##\#\*#*##\.#...*..  *.\*. **\..\*.\* .  \\ .\.\.\*   .*..**. *..*  .\.*. #
# # #.##  #. .* ..* #*  *.*.\*\... .**.*..*\ *\ ..*. \*.\ \.\*..*** \ ....#
#    #    #. .* *# .\.\*.\***.  *.**.*.. \. *.   .\. .* . ..*..\. **\   ..#
#          #*.. .*. .*** *.*\ ***.*. .**\ *\**..*.  ..**\* ..  ** .*** \\*#
#          #*.*  * *. .\  *\ ...\ .* *... *. . .. \.*.*. *   ... .\**. ...#
#           #..*\L.\ **\\.... .... . *.  .\** ..\..*..*.*\*.\\.*\.*. *..**#
#            ##.. *.\*... .*\.*..  \   .. *\ \\ ***.. . \.*.   .. .\...  .#
#            #* *.## ..** .\  . ..*.** *  **.  ..\.* ..\..\  .*  . \..\. *#
#             ###.# \*..\.* .****...\*..\ ..R..* *\.\ ..     ...\ .....***#
#               #\###...*..\***\**\... .\.*\. ..**.**..*.    *.\ .*\. \.  #
#                #  #.\*.\ *..\.\.. ..\ .*\*  * .\.*.  *** *\. . * *..\..\#
#                    ##.* .\... *   . .  .*  **.\...*.*. ...  *\ .*. *. \ #
#                      #\* .#. ...*.*\*....   .   *\*\.*.  \.... *\**.*  *#
#                       ## #*. \**\***\* **\ ...\.** *\**... *\ .\***\.\*.#
###########################################################################