##########
#*.  . ..#
#* .  *  #
#\ \*..\ #
#..R*.   #
#   . .* #
#.\ .*.*.#
#.. .\.\.#
#\*    . #
#..  * **#
#\ *. \.*#
# ..\ . .#
# *\.\.. #
#** .**.\#
# . .\.*\#
#.  *...*#
#. .. *\.#
# . .  .*#
#.*  ..*.#
#\.*. \.\#
#. * *#\ #
# \\ ## .#
#L#*\ ####
#  ##.\# #
#   # #  #
##########