#####
##\##
#L..#
#\R*#
#.#.#
#  .#
#\.\#
#.  #
#\. #
# . #
#.\ #
#####