########################################################
##* \.   .. \*\  .** \  .\.*.\ . .  .. .. \.  . *... .\#
#...**  .  *...   .*\..*\..*.  \.  ***..*..\ \ **\**\. #
#\*.\ \ *.*.* .  ..**\ *. . .. .. **.\ **.**..*.....*  #
#*#\ .. . **.\   ...\.    **..    . .*..**\.\..  .  *. #
#..* .   *.*. . ..\\*..  .***\.**.\... *...*.*.  .*.\. #
# *. *  .. ***\..  .\ \ . .. *..**.* \ .** ***. *\..** #
# *\ . ... *.** .*  .      *..* ..... * .....* *\.*\** #
#.*.*.. .* .\.*.\. . .\**..* *. . *.*.\ * ..*. .* ...  #
# *...* *.. .\..     *.*..*.*. .  . .*  *. *.  .. . \..#
#* *.\**. ..  \ . ..***.. .\ . *.**. .  *  * \... *  * #
#. ** ..\. *.*. * .   ..* . .  .*..\ .. *.\* .*. .\ *. #
#.\\  ...*.*\.\ .\.*    .  .\. *.* .  .\ .**...***.\.* #
#   .\**\. .* *   *.   \* \**  ...*  \.... .  ... . ...#
#.*.  ...  **\\....*\ .. *. *.*.. *\*. .\  \***\..  . .#
# **\  .  \*. . \.\...*.**.*. *.* .*..\.. *.*.***  ...\#
# \ .*. ...\.. .. ..*\* .\*\* **\. .*.*....*.*...   .  #
#**\ **.  * \... ..*.**. ..*..\* ..\. \ *. . .  *\** . #
#**.... .  \..*.*\.. .*** .\...*\ .*. \ ..\ . .......\ #
#* *. * \\ *** ** * *  .*  ... ... .. ..* *.\.*\....\..#
#.*....  * . .*.\ . . ..* ..* .    . .  . .. *. *. .*\ #
#\ \ ....*.\.. .....  **......  \.\.\  . *.\ . .*\ ..  #
#\...\ \ *.\*\.\ *. \ ...  * **..\. . * *.*.*\  .***\ .#
#  ..* ...\...*....*.* \*.**\.....  .\..***\**  \*****.#
#\*\..\*. *\* ... **\.. ..*\ \    . **\ *.* .***.* ...*#
#.*   .. .. \  \* ..***..\.. *....* *\.\.** ...\*.   ..#
#... .*. ...* *.* \\.\.. * *\..  ***. .  *...\.*.\ \.*\#
#.* . . ..**\ *.\*. . *. *..* *\*\... \ .*....\.* ****.#
# . .. *\..*\.*** .*..\ \...\*...** ...* \.. * ..... ..#
#  ..\\.\..\*.\..*\.* . .*\ * ..\\...*\  .\  .  \.**..\#
#...*. * *   .. .*. . * * * .\ .... *..  **.\ .  .\\.*.#
#* .\. \.. ..*\.\\. *.\ . *\.. **.\  *   .\  . . . \...#
#\***  ..\... *.*.*..\ *\   .\ . \.\.*\*\.  .** .*.. \.#
# .\.   ** *. *.* ..\  *. *\**  *.* *..**  *.....**\...#
#.*.*...*. \. . .... * ** ***  ......**.* \.**   .. .. #
# . .    \\ .*.**\*\..* ...\.* \  \ .*.*.*. .. . **   .#
#.***\..*. .*.. . .\. *\**\. . **\ *.. . *.. \ \ .\.  .#
#. ***\... .* \\\.  . * ..  .  .. \.\.\ ...\***.. *. . #
#..* \.. ...\ .  .\. .\*\. .**. .*.  ***.*\.. .*\  *\.*#
#..\  *. *  .*.. .  . .\.*.* *. ** \.*\. .   .   . ..**#
#. *  \*\..*... \... .. *\...**\.***\ ***\. . \* .*. * #
#\ ** .. \*. .\ ..* . *.*.**\* . \*.* *.*** . ..\ \.*  #
#\**.\. *..   ..* \*  \*... * \   *\...* **\\..*. * \ *#
#. .** ...\.\.\*.*\\**..\*..  .\\ **. **.* ..*... .. .*#
#..\...   .\.\. *.*\ *. *.*..**.. ..**\. \. ..*.\**.\ *#
#*\. . \* \ *. ....*.\..\..   **\.* ........ .. .*.....#
#** \....\ .* ** \ ** * ..\    . *.  **\...  *\.*#*.. .#
#*.* **   ......  .. *\  *.* * \ **  *** *  \. ***\*\. #
#... .. \...*   .*.\..  \.* *\.. ***.* .* **.\ . ..* * #
#.\R \*  ** . \. *.*..* .\*\. \*....*.  * \.\.\.   . .\#
# ** ...\  . .. *.    . \*** \ ..*.  *\.. .* \  .*\ \**#
# \     . **.*. \ ..* *\..*.*\\\.**. *. * .*.\*  ..\..*#
#.#  ..\* \ *\....* *..*  . .\.\...***. ....\*.    . \.#
#.. ..  *\ ...*  .**.  ***..\..*..*.\. \.*.  .  ..* *. #
#.\**. \.. .*....*... .*.*... ...*.... .\.***\*. # .*  #
##*.\ #.   ... \. \ **  .*.\ .**..\.. \ ..*\..**#..\*\*#
##\  ..  . . *\.....  .\.*.  .\\.** *\.\\......  *\#.*##
# ## .* #.\.  *.\*\. *.*...  *.. .*\*.  . **  .\.# ....#
#  #\# *.*\.  * .*\  ..* .....\ . . . .**\**\   *.*.. *#
# #\# *..\ **.*...* ..**..* .    ..\.\ ..* * .\ .*.*\###
# #..\..#*\*.*.\ ..* .*. \.  \ . ** ..  .\ \  \*\#.\#  #
#  ### \\* #..**\* \\ *. ...* .\  . *.  *.\...#.##  #  #
#     ##.* .#....*# *. ..\**.\. **  ** *.# *  .#  ##   #
#    #.*#.**\.*.*..#*..*.....\. L ... \*.\ .#  #       #
#     #\  *..*... .... . .*#*. *... \.**.\..###        #
#    #...**.#*..*\..#\.\ #***.*# \.*. .\.. .###        #
#     # \#. ##. \*#\  **..*.\#*.#*#.# *.*#.. .*#       #
#      ##. # #.*#\..###***##* \ .# ## .*..*##*\#       #
#        ##  # *#*#\##*\.#  # **.###\. *.## #*#        #
#             ###..  #*\#    #####...#..#    #         #
#                #### ##          ###\* #              #
#                                   #*##               #
########################################################