##################################################################
# ***  .* * .*\. *.\ ..\ ** .  .  .\.* .  \ *\ **..... . # ## L  #
#.... .... ** **.. . * * ..**      . ........**  ***...* \...#\# #
#.*\   \*..  .. . .\**\*... .\*..* \ ** .. \*..  \.**\  .\.*## \##
#\*.\.*. .\ .\.. * .**.** .*....   ...  \.... *   . *# .   .*.*# #
#.\.  . \*\ **\\ .\\. *..\ .  .\.*.*\.. .*.*\ . *..\   *. *.*..# #
#.. * .*..  .  \.  *.  . .*   ** .**.**\ \..... .*.* \R  .***\ *##
#  \  ..   *  *..\..\ \   . \... * .**.   **.* \.. \.  ..*.\. # ##
#**.*\.*..\.**.. .*. ..*.....    .. .*.\*. .**\.   .  . ..*  ### #
# .*  ...\.**.*.* .. .\... . ** *.. \. *.  **\.\* . . .*. #*..\ ##
#\ . *. * **. .....  \  \\\. ... .. ...* \.***\ \   ...* . .#.#\ #
# . .*.*. .**  * \ .\..  * * ..  *\.*. ..*. \.. ..\.\ * **.*.# ###
# * . *.\ **.  .*.... . *... *\. ..\*.*\.* ..\\ .*  ..* #\.*.#   #
# .\ .. .* . \ ....\\  ..*\ .. * .  ..*.*  .\*.  . *  .*.*.. \#  #
#*..* .. .....\ . .*.* \*. ..  .   * ***.   .* ** .. \...  #.#   #
#\  *  \ .\*.  .  *. \ . .... **  \. . ..*..\.*..\.* .\ . # #    #
#... .\*.\..\* \.. .\ \.*... *\.  . ..*\.. .**. \.*\  .\#.#      #
# *.....*.. *.*\.*\* **\. .\ *  . .  .  ....*\ . *. .*.. *.#     #
#*..... .   . **.*.. .\.\. . .* \   .  *\. .. .*.*\  \ *###      #
#\  \ * ..*.** ..\.\ \*   *  \. .\*\  .\*** .*..*. \..**.\#      #
#.... .. .  *. ******.*.  *  . .\.     *\\ *.* ***.  \.#.###     #
# .. .\*.*.\  .*.**\*.\. *. **\*..\* *\\.* \ *\..** *\ # .\.#    #
##################################################################