################################################
#  .. ...\..*.*. .*  .... ***\.\*.*.. ** .. \ \#
#**\\  .\.. \ *. .. ..*   .  .* .*..*  .\..*  *#
#*.**  ..   .*.** *. *. .. \  ..  .  *\. .*.  *#
#\.**.**.. * \*.* *.  *\\     ... ..* *   \*.*.#
#**.. .*\  .. .. .  . . .\....\ ** ..    *.* ..#
#* ** .*.*.****   *...  \. *\\**.\ *\*\ ..\\ ..#
#.. \. ***.... .  *.*\. .....*\*  ....*..\ ..\*#
#* \.  ..*.. ** .\  .    .\..*.* \  \ ....\*.\ #
#. .** * . * .**\ *.   *.*\    ... .\ *.*....*.#
#   .* .\*  .  * .\\..\. .* *  *...**..*.**. ..#
# *.\ . .. \*..* . ...... . .  *.. ..   \.. . *#
#\ *.\.**\. **\* * \  .\.. \\. . * .* \*.  ..\.#
# ** *..*..*  *    ..\**... **\*.\****  **.  *.#
# \.**  \*...\. * .*\.*. \*\\   \*. . .***. *  #
#*.*\. *.. *.    ...**\...**\ *\.*. .\ . .\*...#
#\.*.  .   .    \\*..**   .* *\.*.*\  * ...  .*#
#..*.\ .*  *. * ... \*. *..* **\.*.. ..  . .\**#
# *.* ..*\ \*.. . .....\. ..\..\ .       * .*\.#
# . * *  .. .\ \  \    *.\*\.\... .. .  .**\.* #
#.*..*.** ..*\ . *. *\.* .R.**...\**\* . ***\..#
#*.  *. . \**. **\. .  \.\.\ *.\****   \  .. . #
# *\.\.\ \*. * \*.*...* ..*. **.*.*\***  .\..\*#
#\* .. . ...\.\*.**  .. . **...*. \ *.\ * . .*\#
#.. *...\ . .\ .. .*  . . *  *\.\ ...\  . *  **#
#.*.\   . .**.\ .*.* *  **. ...  .  *\..*\.\ ..#
#.**.\*.*\ .*. * .*\..\...**\.\. .  .*  .***. \#
#* *  .\.* .***.\..*\. *  . . .. .\  ....\.\ \.#
#. \***.*. .** ..\..   .\ .**. \\. .*...  **..*#
#  ...**\*\ ***...\\*  **  *..\.... **  ...\*\*#
#  *. .**.  *.* *. \*  .\ .*\\* .. .\...\\  .**#
#.\..*\\  .**\  ......\.**.** *....  ..* .*..**#
# .* .*..\\.\. .\ \ **.... *.\**\  . *.* \\ ..*#
#. *. *... **..*   .** \   .. ..\*. *. **  .   #
#*..\..**.\..\ \  \.**  \ ... \. .. .*.*. .  * #
#*.*.  .\..\ ..  *..\..* . ** ..\ \* *. .\*. . #
#* .*\*\. **.**  *. ....\   .\..\...*. ..... *\#
#*.**.\   . .*... .\ \   ...   .  .\**. .    *.#
#*...... \.*.**\ . *. ..**\.\.*.*... .* ..\ *..#
#..**.\.*. * \.*\. .* ...\*\.*.. .\. .. *\ ...\#
#\.*. **. .***..    .\ ** \. ....  *\.. *..*  *#
# \.\*.\.* *.*..*..\  .*.*..    .\..\.. * *.\ .#
# . *...\*.*\ ***. .\*\*.* .* . .* \  . ... *. #
#\.**.   \ *.....**  ***.. .*.. . . ..\. *.*...#
#....\.*  \*  ....\..* *\.  .\ .\ .\ .\.* .  ..#
#*.* . .....\  .\.    .. **.. . ***.* . *\** . #
#... **\. \***.**    * ...**\...**\ \   \.*. **#
#** \..  . . * \.* \*.  \ * .\#*...  ** .\ ..*\#
#*.   .*\ *.*\*  . .\.\.*.. .#\.*\  *\.\\. ..\*#
#.*.. \*. *.*.\ *.\..* \.*#.# # **\* \. .\.*\ .#
#\..#..**.*\.. \..*.  ...### #\..* # . ...#\. *#
# * .  \ .. .**..... *..*. .##*\.#\.\. **. \ .*#
#\.\ . .*\.*\ .   ..##*#\ ## #\** ###**. .** #.#
#....**.\.#....   . \.*   #   #.. *# #   **#*#*#
#.*..**    \.***.* * *.###    ##**#  #.# ## # ##
#\*#\#* **\#\ *  #*. #\#     #***#    # #      #
### #\..*.*   \..*\. #.#      ##.#             #
#  #\..L**.\..####  .##         #              #
#   ##*####.\ *  ## *#                         #
#   #**# #\*  ###  ##                          #
#   # #   ###..#                               #
#    #      #*#                                #
################################################