#############################################
# #*.  *\ \.\.*. \   ..... . * *.....* *\.. #
#  #\  ...#****\ . ** \ .*\ \... ... * . . .#
# # .  * . *. .* \R\*.  ****. *. *.. . \.*\*#
#  ##* .\  * *.\.  .\\.**\.*....\\*  ..  \ .#
### ##L*.....**.***.. *.* *\  *   * \*\...\*#
# *#\ .#\*\.\*....**\ .\\** ..* .*. .*. .. *#
##..* \ .\.  \\  .  *\ *. .*\\..\   \**\\ *.#
#############################################