#################################################################
#       ##.. *.  *  ..\\*. .  *  . ...** ***  .\. * .###\  #    #
#      #.#.\.*.\.  *.\ \.\ \ .. **.*\....... \ *R*. *. *..*#    #
#      #*..* ..\*.\.* \ \..*.*...  *..    \  ..  \ \. .#.*# #   #
#      # \ .  .*.*..... *  .\* .   .\...\*. \..\* \  .#.\*\ #   #
#     #  #...\ ..*\*.\ ..\...*  .*\ **....  *  ***.\* \ ** \.#  #
#   ##*\ \  .\   *... *\ **.\*.*.. ... ...\ . ..***   *\.**..## #
#  #\ .... **   *..**..*.*.*  *.. *... \**.*  * .. *\. ..**. **##
#  #*# . \ *  *...\.*..\ .*. .\.**.... .\.*. ...** ....  \.*### #
#  # ..* #.*  .\.\*  *\*.\.***...... **\*..*.\  *\   #. ...*.*\##
# # L*\. #.. *.*\**...*.. .*.*.  .*.*\ .*. *..** \.. *   #.\#.# #
##*#### ..\ \*...\....*..\\*\* ....*.*.*  .. .\.  *. *.. *. ##  #
# .#\ *.# ... .*. * \. .. *\.. **. ***\* **.*. ..... *..\*. *## #
#.*.* ** .#\.*   ..\.\. .\\. \..* .. . .  .\***  .*..*.  .\ ..*##
#*. \....** .. \...\*..\ .* \   ... ..\\ .  .*.. *   .*  * \  ..#
#\.#*## *\***.\...**.\  \* ..** * *. ***  *\  **.*# .   *. \\####
# # ##*\ .\.*\ . *.\.  * .\.* .\. ..*.*.   .. .. .* \.. *  ..*# #
##    #.# . **  *\  ..*.*.. .**\*\*....*.*..*\\  *. * ..*\##.#  #
#     #.*.*...  .  . *.. .*. *. ..\.\  .**  **\ .. \*** . .#**# #
#      ##\*\. . *..\   \. ..*\*. ** *\.  .*\.**.*..  ..\..\.##  #
#     #*\*  *  \*   .***.***\.***.\ ***  * *. *...\.** *  ##    #
#      ##****..*  **. \.*.\...\.\. .\... \ .*....*. \ .  #      #
#       ##*\.* * .**   \... * * . .  ..  .\...*. \ *.   #       #
#      #\\.\*.\. . ...\.\\  .\.\. . . .**...*.\ *. ***##        #
#       # .##* .\ .\... ***. .**  .  \ ..   . .  ..*.*#         #
#        #\ \*\#.  *\..*.*..* .*.* .*.. *..** \ \\ *.##         #
#         #. .*.**.*.*\.**\ *...\.. .*  *\***..******..#        #
#          #*\  \.\*\ **.. *\ **. *\*\... *.\*   *\..*#         #
#################################################################