###############################################################################
#***\ **. ....* * ..\.\ .**.   \ .*\*..\.****\**.. . .. *..#                  #
#.. *.*..\ ***.  *...   *\*\***..*\*.  * *..\ *..\  *. *.##                   #
#. \..**.*.\*  \  **  *. .*\.\ .*******. *\ .*.   ..*. .#*#L                  #
#.      *  ...\ ...*\ \*.. ...*...\.\. \.. \.* .* .  ....*..#                 #
# .*..... **  *.**.  ... \.*.\   . \.* .  *..\ .. \.\  * .# .## ##            #
#.*  . \ *.. .**.\. .*.\...\ **.  ..*.*** \ ..**  . .*\.     #*#*.#           #
#.. .  ..* . .  *  . *. .*.. .*.*.* .\\\*...  ..\*\.*  *\ * ...\\#\#          #
#*\. *\* *. .  *.  . .* ..**\*.*\... .* ** ..\..**  . ** * * \ #.# *##        #
#\ ..**...\.*..  \. ..  *\** ...* *.*.*...    * .. ** .. *. . * .. . .# ###   #
#.* ..\*.\ . . ... .* ..*..**.\.. *. *.\.*  *... .*..\.. **..\.  *\.  ##.* #  #
#\. *  * **.. . \ . .\ ...*\... \.\*\..\... *.**... .  * ..*.*\ ..#  ##*#..#  #
#..\..**.*.* . . .*... \**. . *\.*.\..***. *..**  \    .\***\..*** .. #.*#\## #
#\*...*\.*\ *.\**\.*.*\..*  ..\.    ....*. .   ...  *.*\. .\.   .\. \   *. .*##
# .*..*. *    .** \..* * .  ...\ ... ...... ..*\...\... \  * .*..*\. ...\  \.*#
#....\.*.\  **\*.  * .  . . ..**..*.  *.* * * \ ...* *.* \..*.*\*.\ ** *.. .\##
#..  .*...\ ***** ... ...  \ *. \ . .*. .....  .*** . . *   * .*. .\.*\.*#**# #
#.* \ .**. .... \\*. .  .*.  *\* .. ..  * . * .....  . .*   .\. *.\\.*.*.##.# #
#*.....*..**\ *.**.**. **. * * ...\. \\*. \.. . **  . **. *.*.  ***  .\\.#...##
#.*\* ..* .** .. . *.. ..*..  **  .\...   .***..\. . *..*\...\ *.*. ..\## ### #
# .  ..  . *..* * .\..  .    *** . ..\   \ ....*.   ...  . .**..*  ..\*#      #
#\\. \ ** *.  *.\ .  ..\.\ \ .... * .*.*..\    . . * . * * \.. .*. .*.#       #
#     .. .*.**.\.  \. ..  \   .*. .***\..* . .\  ..*. . \.\. \..*\.*.\#       #
# \**..*  * \\*...*  * \**.  \..* *.**  .      \ \\..***..\. . .\#*#.##       #
#.  \..\* . .... ...... .\ \**. . * *.*\.\  \ \ .\..*. \*.     \* *\*\.#      #
# . .\ .\.   \ .   \. .*\. ..*..  **** .**  . .  .  .. *.. ..*\ ... .#\##     #
#  . * . ... .\. .*.\*.\.* *R*...*. .\*  \ *\*.    * *.\. . ...*\..* ** *#    #
#*\ .. * \*. \ ...*. \ ..  .*..\*\\..... .***\* ** .. .*  ..  \.. .. #**.#    #
#...**..\*\   . ..\**.*.. * . . .  .\..*  *\. * *.    \   \ .\\\* .*  ..#     #
# \.*. . . ** **.. .\*.*. *..   . ...*.\. .  *\*.*.  *. *.....**\.\. .  #     #
#  *  \  .... *. .\... .\ *  **.   ***    * *\.. .    *.*.\ ...\  .*\*#.#     #
#.**  .\.***\ . .** .  \  ***.*.* \...  *\..\..*.   \.\.*..\ .\ . . #...#     #
#...*\ **. *.  . .*\. ..\*... .*. . .. .* . . . . . .*. \..*\ .\  *.*#\#      #
# \... .. *  *.* . *\..  ***..\.*\****   .*.**    . .\  .\.***\..\.#. #*#     #
#*  **\\.*\*.*.*.\\*\  .. * .*** *.. .  *.*\..*\* .... . . * .**. *. **.#     #
#*.*.**  **.* .*  \.\* ** \**...   ..*\ .. ..*.... .\\.\ .\ \ *\\ .*.\*\ #### #
#.\.*.* ...*. *.  .*.  .* ..\ .*   *\*.   \**.. .   ..\....*  \......***...* ##
#\  .*.*\..*. \..\  . * .\.\ .\**..* **. .*..** .   .\..\....*..   \....***## #
#.** **...\**  *\*.\*. ..  * . .** . *.*  .* *..\ * *.\ *  **..\\. .* .* ##   #
#.... .*\ * *.\.*.\ *.* \**.\. *.\. .* . .\.*.***\  ... . *\  ... .*#.** #    #
#\*.*..* ....\*.*.  .\\*..*.  ..  .* \  \ .*..\.* ***.     .*\..\ ..#.###     #
#... **.  ***..  ..*.*  **.*  *. * * \*\..*\.   . .*\.*...\.. ***.##  #       #
#\..\...***.**...*\.***\\......\***.\.**** .*.\* .****\.... *...*.# # #       #
#.* * .*\... ... . ****.**\   **. ..  .\*.  *  . \**.**\\ . \. *.#   #        #
#....*..*\... \*\.. *.\ ...  \.... ..*  .  ..** \.. *.*... .\... #            #
#*. \.  ..\ .\.. **..*..\ \*  .  * .\*..*\* ..*.. . ...  *.. .\ .#            #
#. . \.. * . *  .....  **. .\  *.. .*.  *. .  .*.\   .* *. .   . *#           #
#\  .* ..*\. \    * .\. *\*\ *.. . \.. .*\   . .\*\*\ .\.*  #\*\ #            #
#*   . .. *.*..*  \*   *. \. .*\  *.. ..\ *  . * ..*    *.  *.*..#            #
# \. .\    *...* **.\ ** . . *.\....* ..  * *  *.\ * ... ..*.**\ #            #
#\...\ .  *.\.  \... * \*  \ *\.    .  .. *   .*\  \ \. * *.*.. #             #
#*   .. \ .  ..   ..*.\ . *. .*\\*\       .*** \   . .*...  .*  #             #
#  .** ...  .*\ \  \..*.. \.  \. \.*..    **..\  \ . *.*  .*\.\*.#            #
#..\...*\\. .*..  *..**. . *  . .  * *\  .   *..*  \..  ..* .*.##             #
#\. *\**..\ ...* \ *.*\. **.  .\  *.*\.\. **....* ..** .\.*. *#               #
###############################################################################