############################################################
#            ##*. . #\ *\..*   #.*\ .*.  .* \*..#...   .#..#
#           #*\#*#\\*.\. \.*.  * **  \\  .\  *  . ## .**\ .#
#           #..*... * ** . .  #.#\*.  .  *  *\ #*. .#*..** #
#           # ...\ \.\*.. \  . ***\  . . .  .*.*.  ..\ **. #
#        #  # .* \*. . . *.\ ..*.\*.\. .*... \*.* .*\ \... #
#      ## ##*  **.  .\##\.* *\.\ .  . .. \..*\*...*.*.\  \ #
#     #*#*  .\... .* **#  \ *.\* ** . . . . . .***..  . .\.#
#     #\.. #. \ \. . .*  .\.* *. .\   * .\. *.\.#  ..*.*. .#
#     #..*..**# . *.  \.\.  .*..\*. \\. \ \... **. .\.... *#
#     ####.\..* \ ... .  .*....* .. . .\   *.*\*.#\ .\\.\ *#
#    #*    \. ..* .  . \  *\  *.* * *\.*  .*..*.  . ..  . .#
#    #. *\   ..\.*  \* .*. .**...\  ...... .. .\ * . .** * #
#     #  .*\  . *.\. **.*.\\... **\  .\**  \....  **. ** ..#
#      #***     .\ .\.***. ..    \\ ..**. *.\ ** .*. ..*.. #
#       ####\*\*\*. *\* .  .   * .\.**\   *. \.*. .  .\**..#
#        #\\ .. .*  \.* .*.\.*.*\. *.\ \ *.\*. . .  *.*..\.#
#       # *#.   **.\ *\* .\**.\.** .\\* ..*.. * .\.***\*   #
#    ### L*\ . .\ **** .\ * *\* ...** *   .\. * *\\*\..*  .#
#   #\ *\*\*.*. .**.**. ***.* ..\ .*...  \ *\ *\.*\**.** .\#
#   ##.. .*#*.**** .\*...***.*\ .\ .  \*. *.. .  .*.* *..\.#
#  #\  * .. .**. .    *.\.*. .\ * .\..... .. *.. .. . ** .\#
#  ## **.. .***  .. \ ..  ** *. \  .....*  \**\*\\. . . .. #
# #  .* *.. . . ** ..*  . \...  .  * . .* *..\.* * . *. \.\#
#  ##.*.* *.*\ **   .* * **. .   .\*.\ .* .. \.* \** .* .. #
#  #*.*\. \\*.. . .  .\. .... .. .*. ..* . **. * *\.*..  . #
#   #*.***##... .\ . \.\  ..\*.  *.R.* .*..*. ...\..   * ..#
#   #...\...\* .*. \.***.  \   . ..*\.***.*...\. ....  \ \.#
#   # \ .   \. *.......*\...*. .*. ** . * .* .. *****.*.\..#
#   #\. * .****. \.*\  *.. *\.*\ . ..** \**..*.*.* *   .** #
#    # .\ ..*.***\**.. * . .*.... .* .. ..\ ....**..*... * #
#   #. .*.  ....  .*\ \. *.\..\ .*.* \.. **.** ... *. * \\ #
####.\ ..\*. *.  \..*\. \**.*..* *.. .*.**  *.*. ...... .. #
#.*.*##* .\*.. \ . .*.* **.\.\ .\..\  \ ... . ..  \\.\ ..  #
### .*...*..\. *\.* *.*.... ..   ** .. \  *\    **.    . ..#
##*  .\ *.*.*. ..  .*..* **.  ....*\..  . . .  . * *... . .#
# #\.\. * . .. ..*.*.\..* \*\ .*  .\**\*. . .\.* .*.** *  *#
# #*\..*\.\ . \**\** .. ..*. \ . .* .  *\. * ***..  .. *  *#
#  ##**.  * \* .*.\. * * \. .   \ .......  \ .\. *.\ ** *.\#
#  ##..*\ * ..\ ... ..*..  .\ *\..*\. .* . \ . * ..* .*\.\ #
# #\*\ \  * * **\* . *..\ \.*..  *\   *. * .  . \   * * . *#
# #*      * *\.* *.* *. .\.* ...*.    *...**..*  \. .*.\*\.#
#  ##\ *. \ * ** .**..   .  . ... *\..\.\.*.*.. .*..*\*.\. #
#  #***. *.** ..  ..*..\*  . *. *..* \ * . ...*\*\..* \ .* #
#   ##.  # .*.* .   \ ***\..\..***.     *. .* ... **. *.. .#
#     ## \*....\.  * *.*. *\ ..*...\ *.*.\ .\.\.. \. .\ \ .#
#      #. *#***.\\ . .\....   \* .*....... *. **   ....*.\ #
#      #.\#.*  ...\..  .  ** ...  *.* * ..*.* .....*\  ..  #
#     #* \  \.\. ....*.*\*\.*.  . .**.* . .  *  . \.. .***\#
#      ##* ..*.*.* . **.#. . .**  \* ...   **..\. ..* *..**#
#        # *\.. .\ *.  *\\   .\*.  . **\*. \..*.*.\.*..*\..#
#        #.\..#. *.*\  .*  *\*.**\   ...\**. ** .*. **.. . #
#       #*..*\ .\**..    #*. *.\.*\..*...*..   ..\ **\. . .#
#        #.#.#** .* \.**. ...... \*\.*. **\*... *.*.\...* *#
#        #\## #.##\. #.\* *.\ .*.....*\.*...\. .*.. ..*\. \#
############################################################