###################################################
#.*...\. *\*. .   *. * *.. * *... .\*.. *\. ***.###
#.. ... .****.* * *...**   ..\    * *   .*.  ..\.\#
#..*\.. **.*  .. ... .\  ..**.* . * \.   \ .*  .\##
# *.* \.\.\... .\* .* .* . .*\*. .*.  \  .... ..*##
#*.\..* \*.  .** ....  .   *..\.. **   .. .* *. # #
#..  *.. .*  *.* ... * ** \.*\.*  ...* * . . . *L #
# *... .  . * *.  \.\*R..* .*\*..  ..\..** \ **\*##
# . *.. .. \...* *. *. .**..\***.  *..  *. *\#* # #
#**.**... *..**. .. *  \*.  *\...\. \* ..*... ##  #
#*..*.* .*..* . .  *  **. * \ \\*..  \ * * *.  #  #
###################################################