##################
# \. .*.  \. * \##
# . * *   ..**.. #
#\ ...* .   ..*\##
#.* ...*. *.##.*L#
#.*.***#  *. *## #
#\.\.*.\.*. ##   #
#*.  . *.*# *.#  #
#\.. ...\. #...# #
#. *..* .\\  ##  #
#..\ ..\   #.#   #
# ..  .***.*#    #
#\..*  R\...#    #
##.\.\ #.*#.#    #
#* #.*  ## #     #
##* *#.*\#       #
##################