############
#....*....*#
#\. ***.. .#
#  \  **\ *#
#.. ..\*.\\#
#.\.\ ** *\#
# . .**.* *#
#. . .R ...#
#  *..   * #
#...  *.*.\#
#\ * .\.. \#
#*.\\**  \.#
#*\*\..   \#
#**.*.* . .#
#**.. *. ..#
#**...\*..*#
# .  * . ..#
#\* ** \*  #
#.\ ...\.. #
#..\.\.**.*#
#*. .* ...*#
#\. .** . .#
#...*.* *  #
#.....*.\..#
#\ **..*...#
#*.\*. .\**#
#..*.\\...*#
# .\  . .*.#
##. **.\.*.#
#*....*#*.*#
# .. *.**\##
# .\..\\.# #
## #*##L#  #
# ##.#     #
############