############################################
#     *.. .*..  *. \ ..\\... \.*\*.#       #
#...**.  * \ .. .   .. .\ \\..\.*## #      #
#.\.** ..\*..*\.  . \.  *..\  .**\##\#     #
#***.*.*.***\..*. .....*...*.\ ...#.*.#    #
#.. . .**.*.**. .  . . *. ..\.  * .*# .##  #
#  *. \.\..*.*\...*\...**    .\*.. .\#  .###
#*.   .*  *. . .*\*\\\.*. \* * .*. #.\  * \#
# .\*  .\ \   .\.    .\.  . \.\*   * #\#####
#.***  .... .*..  .****\.\***#.. *.. .\#   #
# *.\**  ....* *.**.*.**....\.*\*# \. #*#  #
# *  * .\ .*.... \.\...  \\.**.#.###*.*.#  #
# . *. . . .. .. .*  *\  ..**. #  # #\**#  #
# *   **  \* .* ..*\ ....\* .*. \*.##*##   #
#.*# ...\...\ .* \ ..  *.*  * *\ *.## #    #
#\... *.\.**..\.  *  \\.\**  \ #\ #  #     #
# .#  .   ..**\  ..** .**..\ .*.*#         #
#L\.R  . *. .\  .\...*.. * #*.. #          #
## #\ ** *.\. \ .   *\.\.**#* .*#          #
############################################