############################
### . \. .\. ...* **. \***##
#. \.  ***.*  * . \.* .*.###
#**.\* .\\ . ...**..** ..#*#
##\# . \.. . . *...*\**. **#
#\ #**.. .. *  *.*\..*.\*\.#
#.*...*.\  \....\**\ \.#.###
#.#*...\.R \  \**..  .   # #
#..**. .    .......\  #.####
##*.* \. **. ..* \  .\ #*..#
# ##\ .   *..  *.. **.. #*##
#  ##\ ..\..**.*.*..\..\*. #
# #\.*..*. ..* .\** . \#####
#  ##.\. *\.. ... . * .. \ #
# ##.\*\ \*\  . .  \.*#..###
##*.#*. ..\ .\.. \    \.*\##
# #\*.*.* .**.#* .\\\ #*## #
#  ##*..#.##. #*#\*\##**\ ##
#  #.. *## # * **.* #*\### #
#  # ###   #.*..*### ##    #
#   L       ##..#          #
#             # #          #
############################