###################################################
#  ... .\\ *  \ *. \\*.*\. *...* ...   #          #
# *    .  .. \ ..*\.\  *.  * .\ . . *\..#         #
#\.*  .  *\.\.  *\.. *..  *. .  \ . ...*.##       #
#. .\ ..\\ **.*. .  .**.\\..    .\ *  .* .*#      #
#\.  . .* .*..*.*...* **.\  ...*   \   ..\..#     #
#... **.\**. \\*\  *... ....*\..#*.  *** #.*#     #
#... \*...*. .\.*\*.*  ....*\*  **..R* #\ *#  #   #
#*\    ... .*....*.....*\  . .. ... .**\..# ##*####
#.. ...\ .. .*\...*.\\    .*..* *  .\ ...\   .\..*#
#. .  ** ** .  \* ..*.* .*\** *\...**  .\.*#\ # *##
#**   .\ **. ..\. \ \.*.\.*.*..*..* . .**.## # ## #
#*.\.\.*\. .\.\  .  . .\ \..**. *..\.  ...## #    #
#\ . .*. *. . **\ \..\.*  \..**...  . \ ##  #     #
# .* .**....\**.* .. ...\ . . .*  *.\.*.\.#       #
#* .*  .\.\ ...*.**.\  ..**. .... # .**\.*L       #
#**.\..*\\ .* .*   . * * *.  *.\ ..  *\#.#        #
#.. .....\. .\ \ . . * . .*. .... #. ### #        #
#*. \.\ *. \..*..** .  *.\. *\ .** . #  #         #
#.\.....*.  ***.\ .\ . .*.***.. *.... #           #
#*. . . .. ....   *.*  .\....\. .. **\#           #
#****  . **\ *. \*\....*...\ *.\  .*.#            #
###################################################