##############
# ..\ *  . ..#
# \ ...\*    #
# . . \... . #
#*      *..**#
#.  ..* .*\..#
#*..* .* . ..#
#*.*. ..***  #
#.\.\* \\ .*.#
#*... . **..\#
#..\.*...\..*#
#.   ..*  .\*#
# * .*\..** .#
#\* R...\.  *#
# ..  *.* \ .#
#*   .***\   #
#***. **\ \  #
#\..* .....* #
# .**..\ \. .#
#\....\. . * #
# **.\.* ..* #
#.\..**.. *\ #
#**..*.**....#
#*    ***\   #
#\ *\...* ...#
#* . .\..\...#
#.  . . ..  *#
# .*.. . *\ .#
# * .***   *\#
#\.  . .\ .*.#
#*  *\.*\ \**#
#. *. .. ...*#
#. *  \.*\*.*#
#.*.. * . . *#
#* *...  . \*#
#\ ..* *  \.\#
#. ... .\ .*.#
#.  **. ..*. #
#\ **.  ***\.#
#. \...\*.* *#
#  . . *.....#
#\.\ **\   *.#
#*\*.\*  * .*#
#*..\.     *.#
#\ ... \..\..#
#* .\.*.. ..*#
#*\ . ..\. *.#
#. ...\.*. * #
# \...  *. ..#
#*.*.\  #.*\.#
###..*..**.*.#
#**.** \#* #\#
####*\  .   ##
#   ###*.L**##
#      ###.# #
##############