######################
#           ##  ###.##
#        ##L .## .# .#
#    #  #.\#.*.  \. ##
#   #*# #.\*\\.*.#  ##
#  ##.# #.... .#\\ #.#
###. *##  \.   .*\* \#
#.###*#*** .\*.**.\ .#
# ***** \*  .\.\...  #
# \*.#*  *. ..\.*.* *#
#\ .*.*. *\  .****. .#
#  .* .  ..  ..\..*. #
#*. *....\ *\  *\ * .#
#...* ..*.....**.\*  #
#.*     .  ..**. ....#
#*   .*..   .*\* .  *#
#. *.*.*   .**..* ..\#
#* ..*..\.\.*.  . .  #
#.* ..\ .  .* *.   * #
# .\    . *..  **.   #
#.    . ..*.. . .\.. #
#\\*.  *. * \  \  ..\#
# ....*.\.  .*  \\ ..#
#*.R** * .**.*  .    #
#\.*.\ ..*..*\\.. *..#
#* . *..  .* *.\ .\*\#
#*.*..   \ **.  ***\ #
#.*.***\. ..  .*.. .*#
#.\.. ..* . ..*...\*.#
#*.** .*..*\ .. \....#
#.*.\..  \..\. ......#
#.\. .\  . *.**  *\..#
#. **\ . \ . .\**...*#
######################