###############################################################
#*... . .\.***...\. \ \.. *.*.\   * * \.\  ....\*\*.*.#       #
#\ **\  .*.*..\.  ...* *. * .  . .. * .* * .*\  \.**\*#       #
# *..*.*. **... *  .\  \. **. * \ .*.. . \.\*\  .\** # #  #   #
# . . ..  *..\  .  \ ....**\ *.**..*. .  .\*.\  * .**\* ##.#  #
#\..*** . .. *  .* ..    *. .* .\ .** *. *\   .\. *\#.*. \ *# #
#.*\.\  .*  . * \ *.* ...*.. *\\.\....*\*.. * *.\ .*. ..\#*#  #
#\.*..\. .\ \..\  \ .\*. .   \.\.\* ..**..**. .#.....  . ..#  #
#**** *.  \**  * .\\...* .  . .*\** * ..\. \...*  **.**....\# #
#..* ** * .*\ .*\..\.*.*  .*. .\.. .*....  .  **\ ** #\#\*\ # #
#.\**. \ .\*\ \*\.\.....*.*. .  ..  * \.* .  *\.  .  .*#####  #
#. .*\ .* *. \ * \* \* ** .    .. ..* . \.\* .*  \... ##      #
#\.\.. .. .  .*  ..*..  .\ \.\*.  *..... \  . .   .\..*\#     #
#..  .  ..\ * .  .* \..\.*\ ..\...*  \\.. .... . .   *.*\#    #
#  *.*...\  * ***\** ** *  **\.   .    ***.. \.* .*  ..*.#    #
#\.**.. .*\.*.*\. ..**     .. .. .*. *..\.\.*..*  *\.\ .*#    #
#  *\*.. **...** .. ..  .***..\ **.. ..  .....*** .  **...#   #
#  *.**. .*\.*.  *\ * . *...\.**. .  *\*   .  \.. \\.*.**\*#  #
#  ...\*\.\...*.*.. . \ . \ . .  *.* ..... *  .*.*.**. *.. ## #
#\.*  .\ .*..R*.\   ...\*. .* *  ..*****...*.  ..**..  .*.\# ##
#** *** .*.  .*.*.**..  .*\\. \*. .*.* \*.\*\*.\ *.*. .. . # *#
#\* \. \*...***.. *.  .\*..*\. * .** \ .\......* .*\*.\   \.\##
#.    ....  .*  . * \** \ .... . ..*\.* .  .. .\ .  . ..\.### #
#\..\ . ...*..\*....  *. *.*****\ .**\*.\..*.  .*..  *\ .##   #
#. ***..**  *.*\. .*  .* *..*.\..  *  .. *..*.  *.. .\. #.*#  #
#. .\*\.\\..**\ \.*.\..* .* * * *.*....*.*.\.   *.*...**\ #   #
#\. *..\**   ..  *.. .*   . . ....\ .. .\*.\    ...*  .\* #   #
#*.* \* *.\..***\*. \  . \ .*  .  *. .* ..\.*. *\. **\. ..*#  #
#*\. .* .. .\. *.*  \. ..*  .....\.. *.\.      **. * *\ \\ .L #
#* *.   .*..*\..* *\ * *  .* .\  ** .. **\ ...\*.  .  .*##*#  #
#...  *.*.* \.* \*.*...**.*. .*\ .  \ \... \* . *  # . **#\#  #
#..\. . .*.\*\.\.* .\.*.  .. *.. *\*. .\..*..  *... .*\.* #   #
#\*.   * * ..  * \ .  .**\   ...\*\..* . ....**.  ##*.* ##    #
#..*. ...  *\. . ...\\***..\ .*..*.\**     . . *.  ** *#      #
#*\..  . .  ***.\ .. *.\.*. \* . *. ...    .\  \ ...  ..#     #
#*** *     \**....\\*.  *\\ .\.*** .\.** .  *  .  .\#*\##     #
#. \.*  *  .\....\ ..* ..**\ ...*. .*\..*.. .\  ** . ##.\#    #
#\*.\*...*\ .*\  .*.*.  ....*.*.\ \.**  *\   .\ .*\.* .*#     #
#.\...**.**  .*  .** * .\.**..\ *\ .*. *\.  ...*\. .\ *\#     #
# * ..*.*.. .*\***..  .*.**. \.*    *.*.*...** \.. *. .*#     #
#*.* .\*..\  .**\..** .. \....\*.*** ..\.*. **..  \# .##      #
#* *.\*....*\ . ..\.\  .\ *\.* **.\\*\*\.. #..\## .\##        #
# .\* .*.\.*  ..    .  *....\.\.*\... .....   ### .#          #
#\***  .\*** .*. .\ .  *  .*.* \*.... \***\. .\.#\.#          #
#   \ *\*.\. .*   * .\*.  .. .* .*.  \*...#*\###..#           #
#  *...*....  .. ...* ...* *\ ...* \ ...## # \# ##            #
# \   ..  ..\. *. \..*   * .#\*. \*.. .#    #.#               #
#.. *.  . *.   . .. *....*\*. .\.#.  *.#     #                #
#\   \.\..\ .***. *\.*  *\.. .....#.#.\#                      #
# . *. \* *.**..  \**.\.   *  \.*##*###                       #
#\ *.*\   . .*\* . .*   .  *.   ..\#                          #
#..*\* ..    .**.*  .. *\.\..\ **\.#                          #
#\ ..\. \*.*. .. ...  .\*.*#.  .* #                           #
#..*    .* *.* . .*\. \ ....*  *\ #                           #
#.**  ***..*\* \ . . *#* \ *.\*#* #                           #
###############################################################