########
#\..\ *#
#* ..  #
#.***  #
#......#
#\ \..*#
#* *.. #
# *..*\#
#*..*..#
#* *.. #
#. .\ *#
#  ..*.#
# .  ..#
# ..  \#
#.** ..#
#*.. .\#
#\*....#
#*R.\.\#
#\  *\ #
#* *.*.#
#. *.\ #
#\ . *\#
#*  \* #
#\.. ..#
#*. .  #
#..  . #
# \ *.*#
# . . .#
#..**\ #
# *... #
#\.. * #
#..\ . #
#..*\  #
# \*   #
# .*  .#
#  *  .#
# *\ \.#
# . ...#
# *   \#
#  \ ..#
#* *..\#
#.. .*.#
#*.\*\ #
#*..***#
#*..* .#
#.  .  #
#.. ***#
#  *. .#
#*\ \**#
##**. .#
#.*.* *#
#\\*.**#
#*....*#
#**.**.#
#.#\*\ #
#L#*#..#
#  ## .#
#   #.##
########