##############################
#  ## #*  * .  *.*..\.* ...\.#
# # .#*  .*  .  *.  *** . \  #
##**.**\**. .**\* * ..\ **.\.#
# #.  ..\* #* *..\.* ......**#
# ##.*#L .\.. .. . ..\   \...#
##  *#  #..\*\ . .\ . .  . . #
#****#  ### * *.. .*\\* *  . #
#####  #\ * .*\  * .*\  .\\*\#
#       ##   ***\* .......\###
#       #..* .\. .\***    . .#
#        #..*.. \# . . . *. ##
#        #*.\**   # R .#.*. .#
#       #. ...\* #\ .. .*.* *#
##############################