#################################################
#                      #.#                      #
#                      # #                      #
#                     #. #          ## ##       #
#         #           L ### # ##   #* #  #      #
#        #\## # ## ###.. **# # *## #*. *#       #
#   #    # . #.#. #R.**. \....\*.\# ***#        #
####\#    #*\*\*..#\*. .\* #\*.. ..\..##        #
#*   #   # .*...\.#*.*  *.\*...* .*.#   # #     #
###*.# ##.# .*. *##. #.   *.\. ..*****## #*# ## #
## ..##\. . .  \ .\  \.\*....\* \..*#**##* .#..##
#..\*#.## ..*..#.  . \\*..  **.  .*\  .\...## *##
# *.. * ** .*.*\ \*. .. .*. \*\ * .* . #*.*##\# #
#.. *.** .. .*\  ...**\ **. ... .. *.*#.. ..*. ##
#. * ..*\ ...* ...*..*..\.* \*...*.\.#\ .. .. \.#
# #*.\*.** .** .\ .......*\ *.**..\.*  **.\  *# #
#.\ .  \....*. \*\.\.. \*   .\.\. .*#\**#\..* #*#
#\..* *...\** ... ..* ..  ..** .*. *. ..*..\.. .#
# \ \*.. ..**... .*.     .*\*\  .  *. . .     * #
# .\.\***..*... *...  **...\ **.\ *.\ *. *. *..\#
# * *.*.. *.**  *  **  .***\**\  .*.. *.\.\ . ..#
#\\.\.. \\\ \..*. \.   . .**.*.*  ...  .  * *. .#
#..*.   ...*. \... *\*..  .*..\  ..* *..    *.. #
#\.\ .* *\. **.. **...* *. *..\..\*.*...\*.*   .#
#.  * .....\..** ..*** *.  *  \ * ** \. .*\. . .#
#**** *    .*\.\.*.*.\.\ \.. *..\.\..*.*\*..\ . #
# .\.*..\.  * ..   ..* **..\ * **\...*. *. .**\ #
#  *\. \ .  *  \. .  \ .*.**.\*..*\   **. . *.  #
# .\.* .*   .  .*\.*....* .\.*\**.*. *.*. . ..*\#
#.  *\ .. \**.*\   *.****. ....\  .\..  \  .*   #
#  .   *.   ***.*.*.\**\. ...**\. . .\..  . .*\ #
#. .* . .*\ .....* **\.*\*.... *.\.\.*.\* .\ .. #
#. \ .  ***\**  .*\*\ ..*..*.. . ..\*. .\.\  *  #
#* .. .\  \..**.......\...**\*  ** ..   * * *.  #
#.\..  **\ ...*  ..\.... .\. \*... .*   .*. *. *#
#\. .... . *\ .*...***\  * ** .** ...\**\..*\* *#
#.\. *   ..\*\*. *\*.\*.*\ .\\*.\ . *  . .\.*.*\#
#.*  *\ **.  .\ \\*** .\. ...*. *..**  \.  .*...#
#.. *.\.*\   *... .*\. .   * ..*** **    .  *.**#
#**..*.\*..* * .\   \..   *.* . . \*..\ .\ .\ \*#
#*. . .*.. ..\**     \\.* .\. *\*. ... . *. ..*\#
#.*\.\.* \.*. .. ***\. *..** *.....*. .. .. **..#
#... ...*. \ \* ..**..\ .  . ..*.  .   .   * *\.#
#  \.* *\..  ..\\ ..*\*\ .\. * ..* \..* \  ...  #
#*..*. .* \\.*\..\ \  ..... *\.. . . \ **\* *..\#
#.*.* *.***.*.**.*. .. \. ....\ .  *.. ...\ **\.#
#\.\.*...\. \**\ ..\ *.....  .. .  \.*  . . .*. #
# \.... \* ....  *..\.    \ *  * .\. .\*\.\. ***#
#\...\ *..*\**   ..* . . ..\..*. *.*.. *. * \. \#
# ..*..  .\.*. .\  . .* ..*.  . \..\*\..* .**. .#
#* *.   .\.** .*  .  \. .. . . *.* *.  ..*... . #
#.*.*  . .. . *..  ...*\  . *.* .****   *\  .\. #
#\*. .\.\ .*. *\.\*** \.  .*....**.*  .*\. *. ..#
#..**. *.\... \. *.*. .  * . .\*\.\*. ...* *  ..#
#\ . * ..* .**.. ***..\. ..**\ ..**.** .**.\.   #
#*.*.. **\*... .*..\*. \.. .\   * ......*.*. \* #
#..\*\ *.*. . .\.\ *\. **\**\\**\.\\ ....**.*.. #
#... ***\.\  . **  *  .*\.\  **....*..\. .*\. ..#
#.*. * \. .*.\* .  . . * . *...*.**.\..*. *  ..\#
#.*... \.* . *. ..\ \...\*\.* *.*.\ *.\....*\*  #
#\* **\.\.   * \*..\.*.\*\ * \...*.. \ **\ ..\..#
#* .\ *..* . .. .\*.\* ...*.*..\. ..   .. * .*  #
#.  *\...... *.* **  .*.***\*..*\. *.*  .*. .*  #
# .\.   ......   *.\ ..\*.*.*\ \ *   * **.  ..\.#
#\**\ \.**..* ....\.  *..   * \ \.\.*  . .  \ .*#
#*..**..**\*.\*.\ *.. **** ..*     \****.   .*.*#
#. ...*\...* **  *.\*...\...*.  *.....*.\ \*..  #
#.\.\\.*.   .**. \.**. . .*.. .*.. **\ **.*.. . #
#\ *.  .* .\ .* ..\..\ .   .*... \*..*\*.\. .**.#
#\.. ..*. **.* \ \.*. *.\ .\*. ... ....*\ ..  . #
#.  .. ..\.. \*. .*.*.. **  \ \ \. * *\.. .* ** #
#\..\.\  .   .\. \..* \ .  *.**....*.\ \ ...\.\.#
#.  .* *.*\***\...\.... . ..*..*.. ** . * \  \ .#
#\   .\. .\\...* \*.  . .** . ***  \. \\*... . \#
#.*  *.  ..\ *..\.... * .\* . ..\ . . .. .\ .  .#
#\.. *.*  .*.\..*.***\  .\..**  .\ *\. .\* *. \.#
#........* **  .. *. * .\..\ . \ ....* * * .**  #
#\\..*  .*.. *. *\....** .**.\ \.*\..*** . *.. *#
#*\* . ***..** *. *.*.. . .**. ...*\***\** \*\*.#
#\ .\ .*..*\. ... . *. \  .\.**.\.**.*.*..\.\ **#
#*  *   ..  .. **.**\\. *...  . .*. \.\.**...\.*#
#*.*..*..*.\.. *. . .\.*.\  .. \ *   .*. ..  *.*#
#*  ** . ...*.**... .\*** * . ....\ . ...\. .*.\#
#. *\.\ . ***  .. \.  ....\. *  ..*..*.*\.*.*.\*#
#\.\ \.\ \\.\*\*\.\  ...\*. ..*\*.\* \ ..*\ ***.#
#################################################