##################################################################################
#.\ . *....*...\*.. .\....*.\.\.***.*...\. .\..\. ... * .**  .. .. *.\ .... .##  #
#... .*.*\.\ \ ... .*.*.. .\ .  . .*. .\*\  .  *   . * *.*. ..  \..\**.*  .*   # #
#\.*  .*.. .\* \ ..* ...\*\*\ .**. *. .* .\. \ .. .  . .**..**** **.* \.      #\L#
#.\.   .\. * * . ...\\.*.*\.*\.*** \. \* \..\.  .. .\* .**..*** ****..  ..  .....#
#**\...\ . .*..**\*..*..\ . . \.*.. \..\ \*..*R* *.*.\*\**  **..* \*\. * .\  .####
##################################################################################