###################################################
#.\ .#...  .....*....\ .\.. *.  . ... *.. .\. *.  #
#* *\*  \  *.* ..*.*\*...  ..      *.\\  .\....   #
#.**#. ...  \. *   *.*.* \ ... .*..\  ..\ .\ .. *.#
#.. ...*.  ..\*.  .\ .\**. .\*..*\*... *\..**.\ . #
#.*   . .**.   . **.  . . \.  * .*.  .  . \.*\  *.#
#.* \..\*.\  .\  .*.* *.....* \..\. .*. *. .*.* *.#
#\*    *..  . .***..**\..\... . \*....\**\ .**. ..#
#.* .. .\  * * *.\* .*.    .     ..*.  ...*..**\\ #
# \   .\.\*. . *\ .  .**\.***.*.*  ..\ *. \\ .**  #
# . .**.... .\ .* .\  . *.\.. ..  * *...*  ..\. ..#
#R*  ...  .\...***.*** \*...  *  *.\. . ***.* \   #
# *\  .*...*\* ...*.\* * \*\ ...   .    ..* \    .#
# .* * .* * .\   . \ . **.\ * *.* . .**.* *..*. .*#
# .\.* *. \*  .\. . * \.. * .. ..\*...*.\*.*...\.\#
#\.  . * . .\ *.\..*.   ....*.\.* *. \ ***..**\** #
#.\L...\ \ \..**. ..*.\***.\.** . *...... \.*..\. #
#* *..  *. .*.\ .*. .**  . ....\ *..\  .    .... *#
#*..*\.** . . *... .*.\ *.\*\.* .\  *  *\ *.*\. *\#
#*.\. *\**..  .\ .** \.   .\ \.. * ..\*.*\**..*\* #
#.** ....***.*..  ..\.**. ....*.\.. *.  ..\.. .*. #
#*.\  \\ . .*.\* .\.* \.*\.\  .. . ..  .*\.\ \..*\#
#*...... \ .. ....\... *  \* * .  *.  .\*  ** \*\.#
## ....**. *..* .. \.* \...*..*\. ..**.** .. .*.**#
#*.\*.*. . .\ * \... ...\  .. .\. ..\.....  *. **.#
##*.*. .. *.*.\.. .  \\* ..  .*..  . . .* *.*  .. #
#** ** * \\*.*\ .  .  ** *\. \ . *.\. .*..  . .\ .#
#*.....  .*..* . *  . .. ***.  * *. ..* . \***\.\*#
#...* *.*      *.. \     .\.*. . .*.  . \*\.. .*.*#
#*  #*.\..**. .\**\..  *\*  .** *. \ .*\.\**\* *\\#
#.... *#.**.*.  *.* *..\*..\* *.\* ..*.. * . ..\ .#
#..* * .*\.\.. *. *\ .\.\*.**. ...*  .   \ * \.. .#
#* * .*\*.**\. ...*.\..\*** .\ \ ..  *.\\..  \ . *#
##..* *##*\## * * . *..* *. \*. . .  ..*..*  .  ###
#\** ##  ##\. * .*....*. . \ . . . \ . *.*.**  \# #
###.**#    #\##  .  . ** .\.    *\.. *..#*#.  \..##
#  ###     #. *\.\. *\.**.\  .**... *#*##*\.* .#*.#
#         #\    ..   . .\.*.**.  *  \ #\.\  ####*##
#         #*#*\.. .** .\*   ..   #.**. .\# \ # #.##
#          ###.*.* *\. ...*.  ** * .**.*.####   # #
#          # **. .\..* *.\ . . \*. *.\.##         #
#           ##.*. . **..*\..  \ ** ###\#          #
#          #*. *.*.\ *..\.*\ #  ...* ##           #
#           # *#\#.*\... ** \#.    .#             #
#           # # #\\.#*.  ..\#\..*  #              #
#            #   ####.*\ .*.*##.\  *#             #
#                 #\.\\#..*.# # *  ..#            #
#                  ## \#### # #\##.##             #
#                   #\#    #   # # #              #
#                   #*#           #               #
#                   #.#                           #
###################################################