###################################
#                           # ### #
#                           #\***##
#                          ##*.\..#
#                         #\*..#. #
#                          ## \\. #
#                        ## #*  #*#
#                ##     #\.#**.**.#
#    #     ###  #  #     # ...\ . #
#   #*L   #\. ###*\#      #\..\*  #
# ###..# #.   \  *  #    #*..   **#
##\*.\ .#.**  .*... \### #* .. * \#
##### . **#\**.. .....* #\* .*..\.#
#\# *\* ****    .  *  #.#.. \*.\  #
#\.#\.. *.\ .# . * .\ ..\*###\*.*.#
## .  ..#..  . .\.R\.. .#.**.....*#
# \.\  *...\* \ \. #.\.*.. .\* ...#
#\\. .\  \  \..\.** .*\.* \  . *\ #
#.*. \. \..  .*.*. .\.... \.. ..  #
# *\ \  .\ .\.* *.* *  ..\...  .. #
#  ** \. *** .\ * .*.**\..\  .* * #
##.*..  ...  \.*.*.. ..*\ . . \.  #
# .  \. \  \....**.  * * .. \ . . #
# *. \.  .*  .. .*.  . . .\... .**#
#  ...  *... . *..* ..... . * *..*#
#  ..\ ....  *\ .\*\. .    .  .  *#
#\..\  .*\  **.  ..  *.*\\ *\. \**#
#..\*\\* .*\\.* \.\  ..* .*\.. ...#
#  ..  \. .\ *. .**.**.. ..*\. * *#
#.   \*...*.\. * . ...* \ \ . ..\.#
# * \*.\   *.**. .   **.\ . . \.  #
#\.*..*.\* . *. **.  \.*  *. . *. #
# .**.*.  ...*\\*.* .. .. .  *\*.*#
#\*...*  \.  \**. . * *  \ \*..*.*#
# \*\ .*  ...  .. .*.\\. . .\.. .*#
#\.\. . *...     \*\ *....  .\.\ *#
#*.*\***.* *\ . ... *. \  ..  * \.#
#***....*.\.  .*\. \... . *\ **...#
#.* *.\.*   . *..  ...**. .....  \#
#.. \.....*  ...  *\* .. ...\*..*.#
#** .*.  .\\.  \. .*\. **\ \.. .* #
#.....*. *. ***  . .  ..* . ...\. #
#\. \.. \***. ... .. \. **. *\.. *#
#. *.**  .\.\.*.*.     \.* .\.....#
# . *.. .\   .. **...* .**    \\..#
#\* \ .* .**\   \..*.*\ .  *\.\* .#
# ..  *\   *  . * . ..*. .\...*\* #
# . * .... .  . *... *.    . *..\ #
# . .**.***\.   \.** ..*.\.... .  #
#. .*.. ..... \* ..\ *..\  **. * .#
#*  *.   ..*  .\.*. .* *.\**.*\*  #
#. .*...\..* .**.*  .**\***..* * \#
#.\ *\**.* ***.**.. .. ....  \*.*.#
#*\.* ..\* .. \.\.\ ..\ .\\.*.\ .\#
#.\.. .\.. . ..\....***...\ .\ ...#
#\\ *.*.\  \*.  ... .\ .*..... *  #
# \. .**.. ..  .\*..\.**.\ ** .\..#
#..\. **\*...**...\.  .\ . .*. ...#
#*.**.*\..*\ \.   ...\ .  \.*. * .#
#*\... **..... . .\.\..\  .*.\   *#
#*..  *.**.\.** ***. .  . ..\.* .*#
#..*.   .* .*.*\..**\ .*\.**.. . *#
# ..*.** ..\ . *. .   .\. *.\ \*\*#
#.**\ ...   *  *\.*\..*  *\**.*\ \#
#.... *  .* . *.  .* \*.*..*\.\ *.#
#.\ *\..\ .  .\.\*\*\ .*..* *.*..*#
#\. . *  .*.** * * \    ***\.*.  .#
# *\\.\.* .... . * .\ .\ *.**\ *.*#
# \  .**  \\\..*..* *.   ** .....*#
#  **\*. *.\  \.* * *   .\  .* \ .#
#*.*..\.  .. .  .....   * *\.. .\.#
#..*. * **  . *.*.**. \*\ ***.*.*\#
#* * ...  .*.\ **\.\. .....**  .*.#
#\ . .. ..\\  .\.. . \ .* ***. *. #
# ..* **.*.*.*   .*..  *. ..*..*. #
#   ..\. \   ..  \.      ...  \  *#
#.. .\. .... ..  ..*. ***\. ....*.#
#.\ . .\*. ..*..*.* *\ *** . \ .\.#
#.\* \. *.. *.. \** * **\**  .  \\#
#...\.. .  *.*\\.** .*.\ \ .   *. #
#.  .* . . *.*.*..   *.  .** *.\*.#
#..\**   ***..*.\** ..*  *.. .  **#
# * .* ***..*\..*.\ .*. *. .... ..#
#\. .  ...   *.\. *  \ *.. ..*  **#
#. *.*.* .. *.**... *.*.\ . *..\.*#
#  \ *..*\...*..  \ * *\*  *\.\ .*#
#.\.\.  . \.     *. .. *. ... * *.#
#.. . *  **..*.\.*.*\. .\**. ...*.#
#  *. ...\..** **. **..\.*.. \  ..#
###################################