####################
#\ \**\ .* .**R* \ #
#... .*\..\.**.* * #
# \.* .*...... * * #
#\.\.........\.. *\#
#*  ** \..\. ..  \.#
#.....\.. .* *.. * #
# ...*** .*..\.. ..#
#... .\* \.\..** . #
#   *  **\.. ...*. #
#\.**\..*\ .*   . \#
#* ...\  \* ....* .#
#. *\. . ..*. *.  .#
#.. . . *.\. .\**..#
# .\ ......\.\.*.**#
# .. ..\ ....*..\. #
# .. \ . *. \. .  .#
# ** .  *.* ..*  *.#
# .  ..\..*...\\ ..#
#*  . \.* *.\ .*.. #
#\.\    *...* *.\ *#
# *... **..\*..  *.#
#\.* . .......  .\.#
# ..*..*. \\ * .\. #
#.*..\ ....  ** .. #
#\.*\* .  .\.**.   #
#**. .*\ .* .**.* .#
#*\.*\.*.\. **. *\.#
#.*\.\ .\ .*.*\ \..#
#..*...*** * .*... #
# .*.. \.*... *.*\ #
#  ...* .* .  ...  #
#\*. ** ....\\   .*#
#*. \.\.  ...**  ..#
# .\..  . *.**. .*\#
#\. .  * . . ... *.#
# *. ***. \. . *.*.#
#\.. \. .*. **.*.. #
#.\.*...*.**\. .  *#
#\... *.. ..  * .*\#
#..**..\..*..*..  .#
#\ .....  **.** * .#
# .  .\..\.*\..*.. #
#   .** . **\. . \ #
#..**.. * ...\...  #
#..*\.. \ \*. .\.* #
#..*... .*..\*.*.* #
#  . .  *\. .\*.\ *#
#* * . ** ..*...***#
#..*\. .  \ *.* .**#
# *.. .  ..\*.*...\#
# L..*.*\  .*.. *..#
#\.. . .  .*..\ *..#
#*.\..*. *\.*\ **\ #
#.*# .*. .*\*#*.*..#
##*#..\.. .#* .. *\#
# ##\*#*.##.*.**#*##
# #\*# ###..  **## #
#  ##     #.*#\#   #
#         # # #    #
####################