#################################################
#            #####                  ###*#       #
#           #.*. .#                #\.  #       #
#          # **  #      #         #. .\##       #
#           ### #      # ###     #*\.\*  #    # #
#             #\*##   # *.*\#    ##..*\.\#   # ##
#          ###\.. \###\.####   ##...\.*\. # #.  #
# #       #* **.***..##\ .# ###*\ .\.\**  .# #**#
##.#       # ...*.\ \  . .## . \#..   ...*.\#\ \#
#**##  #### .#. *.  .* .\ ..* .# **.*..*.#.*****#
#\.\\## ....* *\*.*  . \ #*.## ..\..  *\*..  ..##
#.   #.#\.L.**..* . ..*  * #\. \.*** *.  ..  *.*#
#\.*.  * ##.** *\...  \*\. *.\ .....*.\  *   * \#
#***.\   .* .\#.. .\*  * ..***.\   *.*.. .*.*.*.#
#*\.*\.\ \.. . ... .. ** ...#.*.   \\.. \ .* *\.#
#\.  #\.*.. .\.\ .*.\..*. * . ..*.**\.\.\ *\*...#
# \*  .\......*.  * \\*..**   \*. ***..\   *.  .#
#\*\ \..*\   .... * .* .*\.\.\ *  *.. **.*\**\* #
#.\*\  .\.** . .  . .*. .. ..* .\\.**\.  . ...\ #
#.*.** *\*.*.\ .\.*  .  \.. *..  .\...  .***. * #
# .* \ *.* ..  .... * .\  .*\.  . . .\   ..*...*#
#*.  . ....*\* .  \.. *..  . \ *..    ..\ .. .*.#
#\* *.\     .**\ .**... **.. *.\..\.**. ... ....#
#\\*.*. *\ * .*. \.**  *.**.**\*  ..... \\\. ..*#
#..*. . .**. ..  ..  . ...**. .*\ . .\*\. \.**\.#
#.*   *\... \ . \.\ .. ..*.****.*. *\ * .*\.. **#
#.. ..* \  * ..*  .  **\\\....\ **..  . \*    ..#
#.* .... .   ..*. **.\***.. \.. **  \.* *. . .\.#
#\..\\. . *\. \  . * .\*\*\..*.. ......**.  **.*#
#.\   *\  .* .  **\..*\\* \*.*...   \ ... ...*\.#
#.  **. *..*\* \ ....*...... .  . *\. *.\.*. ..\#
#\ .*.\ * \* ..*.*\ ..\. *** .\.\*...\  .*.*.\. #
#   *   *.*\ *. ..    *.\*\.\..**    *..  *.\*. #
#..\..\*.  .\. *  *.*... *.. .\.\ .***.\ *.*.** #
#.**..      .**\.\...\.....\ ..\.  .**\. \..*.* #
#\*\ *\.. ..*.\ *  \** \**\* * .\  *..*  ..\\.**#
#.\. .* ***\.\. .**.\ ..**.   .   .*. **.. \ \. #
#. .  ***\*. ..\  ..*.. .\. \..  * ...\\  *....*#
#.. .\.*. .\..* ..*\*..** \.\   *.  .*** *. .\.*#
#\. ..*.\* ** *   ..\.** \..* **\*\* .. **\***..#
#*\ .\*\.\*. ..***.  **.\  *\ . .*.. \   \*.\ ..#
#..*..\.  ..*  \*.\*.\****.\..* .* .\ *....*.*. #
#..**.. .....* *. *.\*... .* \.*\..*  .\ .** .\ #
# **.  *\ \.**\** *\.\\.   ....*....  .  \. ....#
#  *.* **\   .\. ... .**. **.\\.. .  .\ *.\.\ ..#
#\.**.***.. *\ *. .\**\* \.*  *\.\**  .*.*.  \.*#
#  *\...\. .**. *  ***..   *  .\.  *\...\.\ *.\ #
#.* ..\ . . .. *\...\. .  *. *\.\  ....*. .*\.  #
#*...  \. . \. *..   \ .  .\ .  ..** .\.. * * *\#
#**\ .*.***... \.  \...* *...\ *....* .   \ \*..#
#\.\.\\*..\.*\*.***. . ..*\*. .*..*\*.  .* *...\#
# * .\...*.\..*R***  *.*....\.. *.\*.  . . . . .#
#*.....*...  ..\.** \.* ..*.* .\*\*. .* .*..*  .#
#** .. .**.\ .\.\ .\ .*\  ***.* ...*  *.*. *.. \#
#\. **.*\.. \ *\ . ..*. .. *....*.  .**.... .  *#
#*\ ...** *\..**. .  .**.  . * ... *....\ .\   .#
#*...* .\*...\..*. .\ .*.\*..*.  ..\ \ .\. *..* #
#\**\*\  .. **.    ..*   . ***.\ .....  .. . \..#
# .\.*.*\ . \..\..\  .  \ .... \ *.\ \* ..****\*#
#\  .* .*\ . .. .  ... *.* **\..  . \ .\* .. *  #
#.*... ..*\*.** *..  .\..\*...  .  *.\\.. . .*. #
#*...** . .. .\ .. \   \. \. * . .*.\ *. \ . ...#
#. * . . ..  *.* .. .\...\.* \..  ..  .. . *\. \#
#\.* ...\. ... .  *. **.* *.  ..*\ .   *\ *.. *.#
#.*.. * .. .. \.* \*\.. ...**. *.* *.. .*..* *. #
#  *.\*\   .  . . *\ **  \\**\*. **.\* .  *. .\.#
# .\ *.*. **...*. * .*.   ..*.\. *.* .\*  .  . *#
# * .. \. .*\** ***...*\*\  *.  ..\. ... . ..\ .#
#    **. ...*.\*..*\...*.\.*** * .\ .*\\. *.  .*#
#   \*\. **\.. .**\.  .* *.\..\*.   . .\ *.****\#
#....*..*....   .  .  *.\ .*    \ **.\*  \  .\..#
# .* .* **\*  .  *\ *.*. .*.\ *...*\. .\**.\**.\#
# .*. .*.. . * * *  \***.* .* ..\ \**.. \.  ..*.#
# *  ** *. *..***\ *****...*..\ ....\*\  *. ..* #
# *. \.\*...   .** \.**\ . . . .  **   **\.* *. #
#*.. ..\..\. \.. .. *\* .  . .*\. *. .. .. .. ..#
#.* **.  \.* .*.*..*.. *.   .*..*. .\ * .\*.\ \ #
# ......*. * ..**\*.* ** \*\.* .*. *\ \ *\*\.\.\#
#\\..  .  . \* \*.* .\* .\...*.*\.\**  .\. .*.\.#
#  . .. ..*.**. ....*..\**.\\* .. ..\ **\ .*... #
#\ \. . *....\.*..**..* *\..*.\   \ * .**. .\* \#
#...*\   \. .\ **\  . .\  *\. *\.\. \....  .*. .#
#.*.* .* ..*** .**\*.* .**.* ..***..*  ..\ *. . #
#*...* ..    * ..** ...*.. .  *..*\ .  . **..  .#
#*\ *. \  .*\.. \*\  **..\.**..    \     \ ..*  #
#################################################