#####
#*###
#.  #
#\.\#
#  ##
#  \#
#. .#
# .\#
#*R.#
#* .#
#. *#
#L .#
##. #
#####