##########################################
####*.\  ..*...\. . ..*.* ..*.\... *... .#
#.\ \.*.\....  .\ .\...*. ..* . \* *.*. .#
#L##.\..R.. \. ..* . .*\ **\.\   .   ** .#
#  #.##  .... .\ * \ \  *...\.    *. *.  #
# #*. .  \.*... .. *\\ *.*  .. .*..  .\.*#
# #\   ..   .*\ .*.**\. \. *.*.\ \....* .#
#  ##\..*.  **. \.\...\..**.***.  .\ ..\ #
#  #\.\*#..*..  **. .\.*\ *\ .\ *\ * *\. #
#   #*.\ *.. *..*.*..\... .  ..  ... ..* #
#    ##\*.\ *.*...*.\ ..  *\*\* .*  \***.#
##########################################