#############################################################################
#                                                           #*##\*#\#*  #   #
#                                                         ##  ##* #. * .##  #
#                                                   #  ###*#\. .# \*##\***# #
#                                             ##   #*##  #... . #. * *.**## #
#                                            #..#  #.. **  .  *.#\ .\.\#   ##
#                                           #.*.#  #.#.\..**  ..#.   *#*#* ##
#                                      #    #. \.#  # ##*..# *  .  \ *.. \* #
#                                    ## ## #. # #    ##. . . ** *    *..*.**#
#                                   #* *\.#\.*\*#   #*.. .\ *..*\ \ . .**..*#
#                                    #\..  #.*# .####.\ \\ ..*.\* .***. * . #
#                                ## # #*.*** \* *.\.... .** .\ ** ..*.. **\ #
#                               #* #.# ##.*\  ... .*...#.**    \*\* *.\\.\.*#
#                               #.# \##\.*\* *.** .*..  *.. .....\. .  ... .#
#                               #.*  .#**..*.. .*.  . .\.*\  \. ...*\ *. \\.#
#                              #***\..**.*.* .  \  #   . . .*. .*  .. .. \..#
#                          #  #...*   ***. .\. .  *.. ..*.\..  ..  ..\.     #
#                         # ##.* *.   **.\*\*** \ ***. *  .. . *  \*... *..\#
#                         # *#.*\.. \.\. *....*. ...**...\  .  \. .**   .**.#
#                          #\ ..... ...**\.. \.\\  ** .* ..  \.  . **... \..#
#                           ##\** .*.  *..\.. *.\ ... \....*  . .*.*.*.  . \#
#                            #.\*. **.*.. .*\\ \. ..  . .*     *.. * *  **..#
#                         #### .*    \**    . .**\*.  ***\\\* \ ..*. *  ***.#
#                        #*.\* ...*\. .*...    ..*.*  \..****  **.*...*.****#
#                        ##.*#.*\.\..\\ .   \.   *..\*  *\ **\.*.\.* .. .. *#
#                       #. #.\ ..  .\  .  .* \.\*\*\*R.*...\..\.\* \.\.\.*..#
#                     #  #.* ## . .\..** ..*\. . .  . .*.. **   .. *. *.  * #
#        #    #  #   #\###\. ..\.  .. ***. * **.. *\**.* \ .. *  .*.  .. *. #
#       # #### ##.# ##*..*.*.*\*  .**\..\ \. *. .  *.* \ *.\..*. * *. *.\*  #
#      ## ..*#\*  .#\.\ \. * . *. *...\..\.**\\.. \ *... ..*. *.*  . .\ . **#
#     #\# **.\.\*#.#*  .... *. \  .\.\.  .\. **\   *\.. ...**  *\*.. *.  *..#
#     #*.  .* ..##  # * * . ***  \  .  \  .  . .*. **.\. *..\ **.. .*  **** #
#      ###.\*\ *\# .. . *.\* \.\   .\ * *\*\. .*\  *.  \.* **.* *.\.. ..\   #
#      #* \.#..*\..  .* ...\.  . \.*  \...\ *.***  **\. *.\.. . .  ..* . *\*#
#       ##. ..*.... . ..  .  *    .*.*.  . .. .\.  .. *.\.*. \ . .\.  \ ..*.#
#        #\....\.\.\ .  \*\*** ** *.*.. .*..\\*...\.. *...\  \  *\*..... *..#
#        ##**.*. .*.\. . * . .*.. .**.\..* ...*.\* *\..* .....**. . *  *. *\#
#       #**.*   . **.** \.\*. * **. *.. . \*\.....\.*.*** *.\ ..\   .\*.  . #
#      #  .\.. \ .*.. *  . * \.\.***.\. **.. \*   .\. .*. .  *.*......*  * .#
#      L..\. **\   ...*.\*  .. ..\..\*\ .* .\.\ .*. .*\. . ***...*.\ .. *..\#
#      #..** .\***..\*  ***..*  **..*. .** *\* * *\. .. \ \. \* ..     ..***#
#     #. *#\\ .. .*. .\\.\ . * .*.*\...*.\ . *** *.\  *... \.*\*.  .\ ....*.#
#     #..#\...  . .. .  ..*..... \..**.\  ..*...*\..\.*.* *.\. .\..*..*\\.  #
#     #\...#.  *  \*  \.*.\ *.\ . .\.\  . .*..\ ...\.\.\. . .* . . . .\.   *#
#      ##  ...**.*\*\..  . .*.....**  **..** * \ *\  \\ .\ \*.  .. . * *  .\#
#       # #*. #*  .*     \.  . .. *  \ ***...\*...   .  * * . ..  *  . .\. *#
#     ###\*.#\.* ..  *.* .*\..*\\.. *. .*.   .....\ *.*.*.*\.*    . * . * **#
#    #. * .. *...  * ...*...  *..\...*.*\.\.*  \ . ..\ . ...\. .\.. *.\*.\  #
#     #*.* .. .. *..****\ ..***  *   .*..*.\.* ..   .  .\ *... .   * ..* *.*#
#    # ##..\*.#\..  *.***.\*  * .*\. ..*... ..\. . .**..*.\ \..* .\.*****. .#
#   #*#*\.# .  *.\. .*.\.*.\ .*.* *\*  *.**.**.. \.\*. . *.*.* \... *..\ .  #
#  # \###* \  . ..*.\... ..**** \*.\.  .*\\*. **\.. .....**.\  .  * . *. .*\#
#  #* #* ** .. ..  .   .* .*. ** ***\ ** **\.***. \.\\. ......*.\ *..*..  . #
#  #\  . .. *.**.*.\.*#\.  *\ **\\*** .\   ****.\ . ... \.\ \ ... ....\ .*..#
# #**   \ .*.\*    ..\.*  *.***. ...* *.*\ * ..**   *\\ *.. ...\* . .\*  .*.#
#  #.#* .* .  \. . .. \*\*.**\.*** .*. *...\\*.  **.*.**..* ..  *....*.*  *\#
# #. .** .\ .\  \ .....  \..\ .*.** .. *.** \.\*\.. .\* * .  .\.*.*.*... *.*#
#  ##\#.*   *. . .. *  \ \* ...\.** .\.. .. .*....\.**\ .  .\ .** .*\ ** ...#
# #.#. .. . .. ...*.*.    * **  .... *..  **.*   * **. *  \    \** * *.. . .#
# #  .. .  * * *.\     .*.*.**. ***... .  *\... .\  . *. . * ** ...****   \.#
###.\..  .... .. * *. \.....****.*.*.  .*... .\  ..\ ...*..\ ..\\*  *.*....\#
#.\**.. .\\. * \.* \ .   . *.... .*   . \.... * ...   *. .   .**.\**.***.**.#
### \* .  * .. ...**... \* ..*. ...*..**.  . \. . .  *. . *..\ ....**.\..**\#
# #*..   .* .* .\ .***** *      .. *. ..*  *\.\*.. * \ \* ..\...    **.*..\.#
#  ##\ .*..* .  .\ .. *. .\ .. ..  .  \ . \.**   *...\\.\.  ..*  ...... .**.#
#  #..\ * .*  .. *......* .   \*\.\.\*.   *\*..*\.* .*..**.\*.*\ ..**.. .**.#
#   #..#.. **\*\ .*\.*...*.\  .* * \.*\ *\*.\.\*\ \.*** *.**.***\*... ** ..*#
#############################################################################