############################
#     # #                  #
#    #* #                  #
#   #L*##                  #
#  #\#* \#                 #
#  #*.  .#                 #
###..***##                 #
#..* *.*.*##               #
##**.* .##*.#              #
#.#.. *.##. #              #
# #  *.\#..\#              #
#\*. * ..*\ ##             #
#.*.*  ...**#\###       #  #
#...\.* ......# \#     # # #
# * *   .*.#  ..#    # # # #
# \ .\  \.\.. *##   #\# .# #
#....*.\. ** .\* ## #.. *.##
#*. *.   .**** *. .###* .# #
#**.. * .\.\**\.*.# .*. ## #
#*\*. \ * ..* * * *....  .##
#**   . .  .. . . **.\* # *#
#.\  **.*\.*. \\ \..\ .. *.#
#. \*.* .\**     .**.. * *##
#.**. . .*..\ *   ..  *.*..#
# .\ ... ** .\. ..  . ...*##
# ..**..*.*\. .  *  ..* .\.#
#. \**. *\ \... ..  . .*  .#
#.*...\ \....\*   *. .*..\*#
# **.. ..**\*... *\ *\.* ..#
#.* . **\. *. .*.*...\\. \ #
#\.. *.*. *\  *  . *...    #
#.  *.*.  .*\...* \  .**.\ #
#\* *...* .*      .   ..\*.#
#*. . . ..\\ *. ..** *.. .\#
#***\*...  ..* .  . .*   .*#
#.. .*    ..**     . .\....#
#  \ .\.\ ... \....\....\* #
#*\  .. .R*   .*.*  .**....#
#*.. .  *   * **....*....  #
#.\ * \ *..\. \* .. . ... .#
#  **..\.* .\.*. *.\ .*\  .#
#\*.* \  .  .\** .*.  .* \.#
#*. .\..*  *. **..\..  *..\#
#.\* *.*..\.* .\ * * * *.\.#
#\ . .*.  .\*. .** *\..\ . #
#*. .\.  *\*.   \..*.**..*\#
#.* . .**.. .. . .\*..*.. .#
#**\.....  .*\*\*...\   ...#
#*\.* .. ..\\   *\*        #
# .  . ..*. *.**.*.  ..\. .#
#**.** . ***.*.  . .  . *.*#
#.* ..****.*      ..   .  .#
#**.* * ...\\.  .*. *.* ...#
#.. . ..\.\..  *..*  * .*  #
#\.\ .*  .* ..*..*.  * *. .#
#    \.\ *.\**......  .... #
#.\*. **\...*.*.......*..**#
# *. *.**. *. *.*\*\.\.*   #
# .\..  .  .** ...\.* *...*#
# *. . .*.* * ......\*.*. .#
#.** .. *\.\.\*\ ....*..** #
# ...* ..* ** \*** \*.*\*.\#
############################