##############################################
#     #\*. ..*\....  * . . . \** *.\.\...*..*#
#      #.\.. . * \*\.**...\ ...*.*....*...**.#
#   # ##*. \* .\...    .*\.*. *.....***.*\...#
#  #\#\. \#.. ..* *.\ *\. .. *** . \... .\*\ #
#  #* .... .  . *..*.\... .*..**..\.\.\*  .. #
#   ## * ****. .*.\.  *.*.\ .*.  .**.. .* .**#
#     #  .\.*..\*\. *.\. \. *...*....  **  .\#
#  # #.# *..\*\ . .*.*. \.  .**.\...\* .*..* #
# #.#. #..* .*. . .***. .\. ..*. ..* .. .*\ .#
# #.*.*   . \.\.\......\  ...*.  ..\ ** \*.**#
# # .*.**\ .* ** .***. .\**. *\ *.*..\* .. \.#
# #**.*..*  *... \\..   *..  . \. ..*...*..  #
#  #.. . .*..  .*  ** * *. * . . \\\.\ *   ..#
#  #*. *.  .\**..  ...\ .\\..\.*.. * . . .. .#
#   #  *..*.*...*..* ...    . . ***... **    #
#  #*. . ..R.* *. .** \.  ..\ . ..\  . .\ ***#
####.* .*** . .*   *.\. \.\.    *  **   *.*\*#
#**.*\* ...* *    . . *.* . . . \ *.    .\*.*#
####.... .**..   * *. .  *.\. .*  .  .\  *\.*#
# # *..*.*\. *\.*.\.  **.**.*\*** .   .* * **#
# #*\ *.*. . \. .\  ***  .* *..*. * .* .*. .\#
#  #.*#.#.*\. *.*.\ \.   *  ....*.  .\ \*\ ..#
#   ## # . .*.\..\#\ .....\. ...**. *. .\.*. #
#       ## .*.  \**....\*** .  .* ..**    .\.#
#        #.. *****.*#.  .. \\**.  .... *..  \#
#         ##.\..#* .\\..#*.. #*\L***\\ \ ***.#
##############################################