#########################################################################################
# L.. .  \.*. .. .   *.\\ \. *.......... ..** ..** ...*.*.\. .\.*..  . .\  ..***. \R*.*\#
#  # * . . .  .   . ..\.*     *\** . . .  .\* * .*..\ \ *\** **\*. **  *  .....* * .*  .#
#  #*\.. * \  *\*. ...\ *  \* .. ..* \.*\.\..*  ..**.*.** ...\* . *..\* ..* * ..\ .\.*  #
### \* .\. .*\  ..  **. . ....  **..  ** *.* ..\ *\. .\*. \ *** .**. .* .**\. ....* *...#
#.   \ . \ *..\*\. \*.\* \.*  \.*. \.**.\. .*. * \** * .\***.*\ \.\*\\. *.\.*\..*....* \#
#########################################################################################