###################
#        # #      #
# #  ## ## \##    #
##*L#*\#.*..**#   #
##.##...\*.*..#   #
#* #. * *#R.  #   #
##...*.**# . ###  #
#. . . *.  * *\ # #
# *\   *.\**.*#.# #
#.*.* \. .\*.. .# #
#.. .*   *..\  ## #
#\ .*.\...    \..##
#.  . . *.  \. \*\#
#     *\*\. #*\ #.#
###################