##################################################
#\ *\.*\..**... **.#*..  * .#                    #
# .*. . \  .\ \\.\# #\#\#.*\ #  #                #
#\ . * ... \.\ . *.* .\**\.##.##*#               #
#*...*\.*.*.  \ \. # *#..*    ..\#               #
#.*.... \..  .**  ** .*.*#.#\* ..##              #
# * .\  ....*. \\\..*.#.**. .\.. #.#             #
#.#.     **\**\ .....*. ..\ #*.#. .\##           #
#\* \  **.. .* *\.\ **...* . \.#.\..\.# #        #
#.*...*...\ *  .. . \\*.#*\*   **.## # #*##      #
#*\ *  \. R..*.  \\*.. * . *....*\ ## ##*. #     #
##*.*  .\.  ..*.  **\.*.  .. ..\** . #.*.##      #
#**....*.  ..**.*... *.... \ ..*..##   #\#       #
#.. \  .   *\.  .\   **  *\ . .**..\#   \*#      #
#   ..\. ... .*. .* *.. \\.. *....  #.*\.#       #
#\**. ... \* .... .\*.**.. \  .  \ *** \#        #
# .* ***** * .* ..**\ .*.    .. *\*.*. ## ####   #
#. ....*.  .*\* ***. **.\  \\. .* . .***\#.*..## #
#\ .\... \.* ..\..\ .\..... \** . .*  ***.  \*. ##
# ..*.*.\. . *\. ..  **..  *.*... ...**..## .* .##
#.  .*.* ** * .**.\**\.\ . .\*   . .***. .*.. * L#
# .*...  *  *. *.*...* \*   ...*\ ...\*\.. *# *###
#*  \ *... .***.\\**\.\ ..\*  .\.\.**..  ...# ..*#
#\*..* \*.. .....**.*  .  .*\*\.*  .*.  *\ \ .  \#
#*..\* ..\.\*\ .**.*.. .\ . *\ ....* *\*\\... .###
#.*\...  ..*..*...\...  . *..  *.*\...*. #    *..#
#...  .  **.. .* **.**.. *. ..*..\***\.*. *. *\.##
#*.*** *\* *\  .....** . .. . *. *.*. .. ..**\.*##
#* .....  .* .. .. *.. . ** **. ..**  *. .\.## *##
#\..* .  ...\...**.***\ . *....   ...*.#\*#* * .*#
#..\.*.\ *.\ .* .\ *..**\\  \**.\*. \.*..**... *##
#.  ** ....* ...\ *. **.***...   *  ..   *. #*\ ##
#\*..*\. \.. .\ *.*..\ ..\*..*\.\. *. .***.\.# # #
#** .\* .\ .  ..*\\***.*  . .**\.  .\ .  *  .#\# #
#.  ... . .* * .. *....*. .** \ . . * * ...  .#  #
# .*\...*\.  .\* \ .*.**\.*.* ..  * ...  *\.. .###
#****\ .. . .. **..   .***. ..**.*.. \   .**\ . *#
#* *. *\....*  .\*   ..\.\  *\ .\ **..\**\...\\###
#*\. *\*  *. ..**\* .\ .\...*.. * \ ** \  * \ * .#
#*.. \..*.....*..*.\*.***...* .*.* *. \. \... #**#
#*..*... ....*\..*  ..\*  . . ..  *\          .# #
#** .\.  .\  .\*\ .....\\. ....*.*. . .... #*.# ##
#*..  *.\  ....*  *** \ .  \ * .*.**  . .*. #\#  #
#..\*.  *..\. ..  \*.\. *\* **\..*.\ .. *  ..**###
#\\.* * .**. *\*\\..\ *\* **..\  ... \. \\.. ..#.#
#..\...* ...\. .* . ..*.*\...\ *. .* . .. . **\ *#
#...  .*..** ..\\.*. .. ....   *.  *\  * *. \#*..#
#. ..*..* ... \*.\. . .   . .  *\ .....*.*.....  #
#\ *\*  .. . . *.  \. *..* ..\ ... ** \.*\   *\..#
#   ..   *.. .*. *\.*    . . *..\ *.*. .###.\ #*##
#\.\.\..  *\ ***\*. . *.  \**..\...\\ .\# \ *.**##
#  . * .*...\*..  *.***  . *.*.  \... **...*##* ##
#\. *.  .   ** \\*.**.***. .\ \..*\ **.*\#... . .#
# \ \. .*** \. \*. *..   *..**.\ ...   \* .*.* *##
#*. \  \..\...*\\.*. . ..*. *.. .  **....  *.\.\##
#*  . *.\ *.  . .*. .... * *....* * \   ....#### #
#*\  *.\*..*..**.\  .\*.* \..  \***\..**. #*##   #
#\ .*... \ ..*.   .**   .*. ..*. *\. .**\ . . #  #
#. **.*\. .\ . .\. .. .*\..\.*.  ..*.. .**## #   #
#*\\ .*** . ...*     \. \ \*....\*.. ** *. #.*#  #
#*. .*...*.  ....\....... * *. . . **. *... **#  #
#.. *.... .\ *.\  .  .\*.\.*. . .*\*.\.\ * \.  # #
#* ..\ **.. .\*. \*.   **  \.\   *..\ **.  .  #  #
#\. *...***. ...* .. *..\.\. *   .. .\ ..*.*  ## #
#.**. .\. .\.\ .*. \ * .*\..\*.. *.* ..\ *.\..*.##
#.** .*  . .. . .\.. \\ \*..**.\\ .. .\ ..\#.### #
# ... . . . . ..\. \ \.* .\...\ . *.   . .#*#    #
# .\ .*  *** ..\*.  ..*..\** .*.*\ .\ .\ **..#   #
#. .*\.**\\.**\   *.  \.\ \. \. .*...**...#. #   #
# \*.\ \... .... ..*...*.*\  .**.\*\.*#. .\ .#   #
#*.. *..**   .* .  .*\*. ...\ .* \.##.# \..\#    #
#  . *.   . * *.\ . .**... .. *.\.*##*#* .##     #
#* .\ ..\* .. . *.\.  * *.*.\.*  ##  #\ . #      #
#. *# \ ..* .\ ..\.\.  \##*.*\##*#   #*. #       #
#.* . .  \\\ .  . *.*.* .\ #*#  #     ###        #
#*# *.. .  **  \*.#*\...### . #                  #
###*.*\. ...* . . #*#. \.#\  #                   #
#  ####\. ...# *\.#*##.## ##\#                   #
# #. *# *. #\.  . *# #*#    #                    #
#  #***.. \  . *.\* # #                          #
#  # .##  ##  ##.*##                             #
#   ###. ##.*. \##                               #
#      #.##** ##                                 #
#      #*##.#.#                                  #
#       ##. #\#                                  #
#         ###*#                                  #
##################################################