#######################################################################################
#. *\\  ***** ..*\.  ...*. ..*..* \. ..**.\.\.* ... .*\** ..*.* ... *.*.*   .* .*.\*.*#
#\.**\ *\.  * **.     \ *. .  *** *.  \. \.*.*.\ \  .**\*  .......*. **\..*\ \.. .*\ .#
# *#. *\.** ..*.. *   . *.\  *.*.\*.\.*.* *.. .. .    *.*. *..\***..*.* .*\ * *\. ..\ #
#* * .** ..\*\.. ...\   .. \.* *..*  *  * *. \.. .  *\. . *\....*\  \*.\.* \*\ *\  * .#
#* ...\.   *... ... * *\ *.  ..** .\..\*\ **.   \..**.. .*** .. \.... .\ *..* ...*....#
#** ... \  .  * .**.**\...* . *. \. \*..*.*..\. . \*......\. **.\ .*. *.* .*** **. .  #
# .*. *  *\**.. .*. **   \  . .*  . .\.. **..** . .\\   .*. ..... \.*... .**.. ..\*.. #
# *..*. \. *. . ..\. .\..*..*.*..* .. **. .****\.*  ..  **...\*. . ..  . \ .. .*\*\\.\#
#\.*\.* .\.**\ . . ...* .  *...*\..\ \.. . ..\.* **.\ . ..* ..\. .*. *.**.  .  ....\..#
#**.*.. *.**.  .\.**... .  ..... .\   \   * . *. . ... . *.   * .\.*\....   .***.. ***#
#..\... *...\*\ .\..  ..\\  *\.   ..  . .  * . .  ***. \ .. .*.   * ....*. *. *. .*..*#
#\.*. *\*.*\..*. ... . .*.\.*.**\.. .   .* .\*.  **. .. . .   .*.\ \.**.. .  .*\ ... .#
#. .\ \*.*\   *.. \.... . .\ ..\.**\.  . . *. *** *\.*.**\**.*.\. . *\\.\* *\.. * * .*#
#     *\*...\ \**.   .*...* .*   *. **   * .*.. *.\* *  * .....  . ... .....*.  \*....#
#..* .*  .  .***\  ..\.\.\ .\.*. ..*.* * .  .*\ .*....  .\ *.\. * .  *  **  ..\. *.. *#
#\..\.. \*. ..\.... ......\* ..*. .\.*...*\  . ...* \.*.. *\**\*. *...\*.\..  *. .\ ..#
#.. .\\ .*.\  *** . * *.* *.\ .* .*  ..\..*. . .\.*\....  ...\*\  .. **\* ...**. .* \.#
#. *\ * *.\.* .*** *..*.\ ** ***.*  *.*.**.\ ...* \...\ ** ...\      *\.. . ***.. \.*.#
#* .*.  . *\. *...\. *  .*\. ..\*\*. .. *.  . *..... *.  \ ..\*... . ..*\ . .*.* \ .* #
#\*.. ..\\..*\. ..\... ...\.. .. *...* .*.\.. ** .. \.\....  .\.*. .  .    .****.. . .#
#. .\ .   *...  *. .   \ .. \*. *...\..\..***\.\ \..**. . \..*\ . *\..  .*  .* .. *   #
#. .\  .  * ...*.. .\*.. .. ..    \ .**.*.*\**\. .\* * * .....* \ .*.  ... .* \ ... . #
# * .  . * . *.*.  *.. .\  \ *. *.  \...*.**\..  .*.. \. . *\*\.\.. * *\ *. *.  .\ .* #
#.. \ .*\* .*\ * **.*..\... \.... \   *\.*. \  **..**\..** .  ...\  **\ *\ **      ..\#
# .....* ..** \. ****. .**....*...\.. .  *.. *...* . *. ... \.  * ..\.*...\  . * \.. *#
#.*...*. .\..\ .... . ..*.\. ..\*\.  *  *. *\. ...\ **..\*.  \ *.*..... . ..  ..*.. *\#
#...  . .  *. .  .  .  *.\  . . *****\*.\.   .\\  .  . .....\. **... .   .** ..\.\  \.#
#\*.  \ ..  .   ..*.  .\  .\.   .... **.. **.   *.\*  . \..... ..\..  .\...\ *  ...\..#
#.. **.. .\   .\ \\.*.***  . ..   . .***.*.*  .  .\\ .*   **\*  **  *.  . .. * .*. ..*#
#.\... .\* .   .. .\.\... \   * * .  .*.. . *  *  . .*.  *...*\ **.**...  **\. *. ....#
#\\* .**  *\.  \* **. *.. ..* *. .\ \ .\.\ ..*  *.. .*.\.*  \.*...\. .    \\** *..* *\#
#   *    *\*\*..\ .\\   . ..    \   **. *  .. .\.*\. \*.*. *. .** **. .\* . ..*.*   *.#
#*...#* .* .... . .. . ***  . *...  *\.    * *\. ..*  *\.. *\* ** ..*\. *.\ * . .\  ..#
#*.  . ... .**.. *\*....\  . *. .*  ..*  .**\*   *....*. . .\.**.   ..*.*..*. .* * .**#
####.*.* . . .*. .*. *\ *..  . *.* .\ * .*. **..*. \  ..  . . .\.* *.. *. \..*.\ .\ .\#
# #*.#..\. .  ..\ .. .* .....   ..*.**.\ * ....***  .\.\.*. ***. .\.*. .... **... **\.#
# #* *. *.\  \ ..* .* .. *** *.*  .* . . .  \.**\.*\.* .\. \... . *. \* .*.* .*.*.*.. #
##.* .**. *.*.*. . .*\. R\...**.. *.**.***\ ...*..***.\*. . .*.. ... .* ..*. *.\.\...\#
##.#\#**\ \*  **\...* \\ *.\ **\... ***.* .. .*. .. ** . * **. .   .*..\ \.  *.*.*.*\ #
##*##.**.*... ...*  .... *\*.*. . \..\.*.   \.  *   .. *\.**\. \  *****.... *..*.\.\..#
# # # *..\ \  .\ .  . \. **  **.*...\.*.** *... \**   .\   .      .*  \*... .\ .\. .  #
#    #*.\ * *.   .\.** \.*.  ..*.*\. ..\..  \ * \.*\ . *..  **  *.*.*...*.*\ *\  ** \.#
#   #.* .**.*\.* *. ....  ...\*..\  . *...**. .\.***.\  \*.  .***.... .   .*.*. **.\  #
#   #.*  .##.. \**.*.* \ *\. *.\ .*..*..  .. .\.*..*\.. .. *. *\ ..  \..  *\*\ ...\..\#
#    #####.\*.* .\*. . .\*..*.* ... \ \ . *.  *  .\.*..  . .. **.  * .\.*..*.  .. . ..#
#        # *.\..*.   **\... *.   * * \.*. *.. . . .*  .\ .. ....*.*  .**.. * .\. .... #
#       # *.\ *\**.*\.*.* .\.. * . *  .**.*... ** .\ .* *.* .   * ***. .. *.. . ..\. *#
#       L *#*# ..\ .. \ ** . \\   **   .. ..\.*.*. ..\\.\*. ..\ . .. . \. .*.\*\.*  \.#
#        ###*#.*\ . .\.* ** .*.*. .*.*\*.  ..*\.* * ..\  * **. .**. .  . . .  *..\ ...#
#           ##.#..\.\ *.\..  **..  \**..  \.*\  * \.. *.*.***.  *... ...    \.**\ .* .#
#             ## .  #\  **.*. \\***.*.\..  .  \...... .  .*  **** .. *   . *.*.*.* \.*#
#               #\**\ *.\. ... *#....\.\.. ..* . ..\. .*\ * * ..**..* ***.*.*. .\. ...#
#                #*.#. .*  *\..##.   . *.#..... .* ..  .  * \. ... ..*..\ . ..  .  . .#
#               #.#.##.\.* #. \*.. \.*#.*.    *. .  *\ \  ... \\   . * *.*. .* *\**.  #
#              #*....* ..*\#. ##\#*.#. ** *.\.****\ \ ***.*.. \. \.  .***...\* . *\..\#
#               #* .\\ #### ##  # ###. .** . \# *\**.\.*. ..\..** * \ .\\   **\* .#.\*#
#                ###.##           #.**.*...*\ * .*...  .\.\ .\  ...** *.    .\*.#*..#.#
#                   #              ##.###\ .\   .. .. . .  .\....\*.  \**\  ..\*\.*.  #
#                                   #\#  # ** .\ . .*...  \*  *\  ..*. \  .. \ * \#\*.#
#                                    #   # \\.\. ..* *\.**..*.. \.. ** ...*. ..#*. . .#
#                                         ###  ..  .*\  **\. **\. . .\#*. .*. #**.\.\##
#                                            #.*\.\**.*.*.* .\ ..... **.* .. ..##.\*# #
#                                           #  . .... .##.. *.. ***.\\.*....*\#  ##\# #
#                                           ## ... \. .#**  .**.*.. ..\*#*# ..*#   #  #
#                                          #*#. \*## *##.\.#*. * * *\\###\# **#       #
#                                         #*\ *.#. \.*##**..* .\ #*#.\#  #\ ##        #
#                                          ####*#.####  ##\.*\..*#.#*#    ##          #
#                                           #  *##        #*.. .####*#                #
#                                            ###          #\ \. \.**#                 #
#                                                        #. #\*\#*##                  #
#                                                         # ##\*# #                   #
#                                                          # #..##                    #
#                                                             #\#                     #
#######################################################################################