#######################################################################
#   ## ## * \....**.\.\..***.   *....\ . \*..***. . #. .*..\#   #. ## #
#  #..  *\.*..\.*.\ .*.\..  *\  .* *.\.  .. *\...* \.\. \.*#    #*\*\##
# #.\\..*\ .* . . .. * .*\. ..\.*....***\ . .  ...\.*..   *# # #.# ..##
# # *.\.\ *.#\... *\*\. *.** \. .  . .\.... *.. .  *.  . ..*#.#..* . ##
##. ..*  .\. *. . ....... .*\ .   **    * \.\ .\   * \. .....** *\ \###
##.  . . **. *.*.  *...  . ...** ***. ..  .* . *.******  .\ **.\*#\##.#
# ##\*\...** . ..  .    **.. \.\.***\  ..  . *.. ..**. ..\.\.# *.## * #
#  #*\. *\* .. *\..* .*\*.*. \.  . .*.*  ..\ .. . \*.\  .. * \ .... #.#
###*#*\\\ #   \  *\.. . . \...\ ..\..*  .*.  **. .  *..   \.\ ..\.*\*.#
#\*\.*. *\.**\   ...\  * ..  \*  .  ..\**..*. .  . **. \ ***.   . .#*.#
##.#. .*\. . .\  . *....\ \. *. * *  \ ..\ \ \  \ \.\.   . \.*    *#.##
# ## . # * *  .\  *.\**. *.. *. .* * .  *. . .. *. .\*.*   ..* .*.\#\##
#   #\* \* * *\..*\..*.. ..*** . \ \  * * .  .*\..R *... . . \..  .*.##
#   #.#...\ .\. .. **.\\\. ..*. .*. .*.*.. * .\#\ .*\ . .* ...   * .# #
#   #.\*.\.\ ***  \..\*..  * *  *. \ .*.\ .\ .\ .* *. \* # ..\.. ...# #
#  #\ #* .\ ...*...\. *\* \**..\ **\  * .\.. \   .\. . .\\# *#\# *.#.##
#   ## #\  *  **\ *.*.  .\*.  .. .  *.... .\\ ... .... . *\   .###.  *#
#      #.#L#**#**\ *. . *.*. **.. .\* .*\  .. ..***.*\***#  **#  # .\##
#######################################################################