##################
# #*#  #         #
# #*###.#   #    #
###.  ..## #.#####
#*  \.*.* ##\ .  #
#\... . # ##\ #*##
## #.   .*.##L   #
#\.\\  ....*#\ \.#
#..*\. . #\# .\.##
#*\*  .......*. \#
#*..  .....\* **##
#..\ .*\ \*\..\*.#
#\* \ ***.*. *  .#
#..\ *. . *.\..\ #
#*\..*. . .*.  *.#
#. .....  ....  *#
#.\*\.\ *..  ..*.#
#* .\\* * .  ....#
#\. *  * *.\*.  \#
# ... \*** .* ..*#
#\  ... .. .....*#
#**.* *... *.\ *.#
#.*.\ ..*\ ..* ..#
#...\ ..*.   .   #
#***\ .**....\* .#
#. \*...*  \.*.  #
#  .* R  \.  * . #
#.*.*   *. .. .\.#
#**.*...*.....*\.#
#.*.\** . \*\  . #
# \. ..*\... ..**#
#* .  *\\.*.*\. .#
#\   *. *...* .  #
#..* .  . *\. .\*#
#. **.. * \...  .#
#.\..*  .\ * \ **#
#..\..   *.....\.#
#*   *....* \.\.\#
#*. *.*\ .\  *.\ #
#* *..\.. ..*\*  #
#*.\.\*... \..*\ #
#*. *.*.*.* **** #
#*. .\.*\\*..\.**#
#.*\.  ..*  *. **#
# .*.\  . .*..*.*#
#.\.**\  ..\* .*.#
#...\. .\. **   .#
# *\** ..**.*\* .#
#....\.* .. . . .#
#* *.    .\* .** #
#\.. \. .\ *    \#
#.  \ **...  ..*.#
#* ...***... .*.\#
#. *. .....\.  \ #
#  \.*.  .\*.*   #
#.\.*.. *..*. .  #
#. *. \*.\.* .\ .#
#. *   \.. ..\  *#
#.\.  .. ... *.\*#
#..* *.\  \*\\. \#
# .**.*....\.** .#
# ..... .*\  ..\ #
#. .. \*. .*...  #
#.*  .*.** . \...#
#.. . . *.*  .. \#
#\  .\..\* \.*\..#
# **.* .*\ ....**#
#\.  **\\  *. ...#
#*\.*.**. *\. \*\#
#*\ ..*. .. \.\..#
#** \ .* ..*..   #
#** * *...* . *  #
##################