####################################################################################
#               #..*.*..*.  ..#**#\ #\..**.\ . .\..  \ *#                          #
#               #\.. .***   #** *.. *.***.**. ..*.\ **\#.#    #                    #
#                ###* ....\ *\. \.*..*\\**.. \.\...*.\.* #   # #  #  #             #
#                 #\.* .\*. ..... .*\..#.... .\ \  .* \## ### *.##\##.#            #
#                 #*...**\..*\  *\ .  *.# \*.  ..* \\*.*.#\ .*\  **## #            #
#                 #. #.*..*..  \  ..**.\ *...*.*\. . *   .....#.#\*#..###          #
#                  # *.**.** *  .* .*\ \*.. \ *.*\  .\  .***\...\*\...\.\#         #
#              ####.#####.*\ .*..* *.  .* ....... *. *.\ . **.\*#.  .* # ##  #     #
#             #.*** *\. #.* .\.* .\.* **.....\ \..\  *.**# .\. .*# . . **..##\#    #
#              ####* . \ .. *.*.. ... .*\*....*  *.* *. **** *.*##* #. *.## #* ##  #
#             L  #..* .... .*.*.** \ \ ... . ...*.*. .\.....\... ..*. \. # # #.*\# #
#            #.###*.\.**\.  . *.*\.. .**.* *\. *......*.  .*    . *\#.#  \##. .*  ##
#            #*.\ ... *  . * ..*. \*.*.**. .* .*\.* ..\* *.. #  \ ...*  ## *\..#.# #
#             # .*..  ...** \ .\. ..*  *... .*  .*\... *.* * ..*.\*\.** *# *  *##  #
#             #\*.\. *. ... .\ ..\* \  ... \.**..*... .\.. .*.*..\**.\*.*. \. .**###
#              #... **\ \.* .. .\ . .* . . \ *.\ \.\.   \.. .*.** ...*..**.  .....*#
#              ##  \.*.  \. * * .. **\\.\.  ..*.*.* *.\\.*\..***.  .\.. .\.* . .  *#
#             #\. . ... .\  \  *\..*\.\\..  ... *.. \\ *.\*.\..*\.*\\**.. ** * .*..#
#              # #\ .*.*** .* .*.. ......  . .\* \... *\.\  * .** . *** * *. *. .. #
#            ###*..*   ...  *.**.   \ .  .* . .. ....\. ..\ .\..\..\ .*.  ....  * .#
#           #*..\ \     *\..*...R..\ .* * ***  *  . .  ..\ *  . .\   ..    . *. *\.#
#           #\ *.... *. . .\...*\ \ ...\.\*.\ ..     \... \. \ * *. *\.*  . ..**** #
#          #..*.*   .. \ .     .  .**\. ***\..\  ***.\**.* *..*. . .** ..*.*\ ..\. #
#           ##... *\.* \. .*.*. * *  *\ ...**\..\    .*\. ** \...*.  ***.  ... * *\#
#          ### * *.   \ .. .    **. ..**..\..\  .\\**. . .\. .**\*. .\.. ... *.* \ #
#         #\.. .** \*.*..**\ \. .    ....*\.. *  * \*. \. .. .\. . ..*\  .*  **.#.*#
#         #.   ...*.*... .*.\.. *... . ...  ...\  *\.   . *..**.\.\. \ .\ .\.\... .#
#         #\* .*. ***.. .** .*\ .**\**.\ .*   .*..*..*\...* *....**.\. *... * \. . #
#        ##..\ ...*..\    . \**.*.\ *. .\*   *..  .*... *.. ..*.***.* ****.*.  . .\#
#       #\..*# .  * .*   \   . ..* .* ..\...   *\\.. . *. ..**. .*.*.\...*\.  .\* .#
#       #. . \* *\  *\. \ .\.*. *. .*\  *** .*\\..* ....*. \.. .   ***.  ..\*\...  #
#      ##. . .*.*\ \*...\ . \.* .** .  *.... **..*..* *... .*.. .\...*\**.. *.\**.*#
#     #****.     *...   ** .  . **.... \\* .......\ *\... ..*.* * *  ..*..   *.* ..#
#     #**..\**.\. .\ ..*.*\ . *\. .**...*..  ***  ..  .*.*.*   .. .\.  *..  .**  .*#
#      #\. .*  .\  . .**.**.\ ....*.\*\...  * ** ...   *..*. . \ \ *\**\* ..*** ...#
#      #* .*.*..** * ...\.*...\.. *. \ \. .*.....*\.. *  \.*.* ......\. *. \\*\. ..#
#       #***..*\.. *. *..*\*   . .*  . .. *.\. .....*..  ... ...\ .*   ..*  *... \.#
#       #\\. .*.**..\ .. ... ** *\.*.*.\.** *  *.. .\.  \ .*...***.\.   .*. .*\.\.*#
#     ##*..*  *..\  .   \.. ** .*...\. \*.. ....**.... ... .*... *  **\. \. .**\ \\#
#    #.*... *.*.\.. .\.\. . ...** * *\   . .\ *.*.*.*   * *\ .*. ***\** .**\.*.\** #
#  ##...** \*.*..*\ ***.  .\.. .\*\ .*. .\* ... . .*... . . . ** .\..*..\***  *.***#
###  *..****\..* .  .\**  .  .\ *.*.\\.*  \. . \   *.\*.* . . **\*.     \*..  .\.*.#
#*.\.* #.\.*.  . **\ .\     .*.\. *.   .   \  .\\. .\.**.  *. *.....\ . *. \*.\*.**#
#### .. *  . *\  *    .\.  .*\ \*...    . \  \. .....*.*.  .\ . .\ * ..*. .*  .*.*.#
#   # *.\#..* .   .\   *  .\. **.\ .* \.* ..*\.* .\ *.*\  *\*. \...* . ..* .***\ * #
#  #*.#*  . ..* .  *. ..* * * .\. *\.\. *  *. .\.. ..  . ..  \ *. \.... \*.*.*.*.\ #
#  #. **.   \ .. .*. .*. \.  *. ..\....*.**. \    ... .*.. *.* .  *.*\  ..\..... .*#
#  #.*\.   *.  \*. ..**  . *.\. *. **\* * *\.  \*.\ .\.\\*.... *.* ..\   .   ..*\\*#
#  # ..#.  .* .\.. \**. *. .\  .** *..  .***\* .**.*.*. ..... \. .  *.*.*.*\.* .* .#
#  #*#   \. ...\.*\ ..\ *. *... .*  ..  .. ...  ....* . *. *\.. . * ..**.*.  .*..*.#
#   ## .#.*. .\.*... * \..\.* .* * .\*\..  .*** * *  *. .*.. .. ... *. \  .* ..****#
#   #*\ . .. ..\*\ ..*..*  .*\*.  * ..  .*.\*\.**.. *..   ** .*.*\  . *.\* ...\..\.#
#   #**## .*  *.**. *** ..*  \*....   . *..**. .*. \* \ * ***.*.\...\ * .\ . ...\*\#
#    #*..*.* \. *. \.\..*. \ *\...\. . *..*.** *\ *.\..* .\..*\ * *  ..\* *  \*\**\#
####################################################################################