###########################################
#   #.# \.*. ** *..... .**\.. .*\\ ...* *.#
#   # ...**..*.\*. \ \ * . ..  \* . .** . #
#  ##*.\ .\.    * *. . ..  ... .*.\..\... #
# #...*  \.      *\. .*.   *. *..\... ***.#
#  ## .\.. .* .*.*... .* .  . . \. . .. *.#
# # .  #    ..\.  \ *.**  .* ..\.  * .  ..#
# ## .   *.*  ...... .. ...*.**\\. * *  \.#
##..# .**.**\*  ... *   *  *.\.   *.\. ...#
# L. *\..\.* * . \. ....* .  ..*  .**  . \#
##   . \.. ***  . *\ *\*.* \.*.. .*. .*.*.#
# #\ .*...R..\ .*.*.*\ *...*\.\.   . *.\*\#
##\.****.\**.\.*.*\ .  *...\ *.\ .. .  .**#
##.*\...\.*.\* ...*.* ..***. .\*\.\. .  **#
##*.*\.\.\.** \ * . . \***** \*.. *\*\. \.#
#.*# . ** ...   *. ***.\\* \*.\. .... ... #
####   . *# . . .*..   .*.**\\. \ . *  \* #
#  #*...  .. *  ...*  .   \... \ *  .*.  *#
# ####\.  *. *. *. \ *.. * \ .  **. .**\.\#
## ..#\  ...**...*   \.. . ..*  ..\* .\..*#
# ## \  . . .*   .*...  \ . **\* * * \*. .#
# # ...  \*.\*\...\.*  ..*. \..   . \ *  .#
#  # . .  #**. ..  .* \..\  . \ ..* \.**\.#
#  # *  .**\.  *.#.\\***  *.\... .\ ..*.  #
#   ##\. #\.#*\*\.  **\.. . ** ..*. *\.\.*#
#     # \ .**####*#.**.\.\*\*.. \.\.*. . *#
#      ###  #    ##..* # .. . . . ...\.#\*#
#         ##     # **..#   \  * *\#\.#\#*##
#                 #.**# ###########*\#### #
#                  ###             #**.*.##
#                                  #*#### #
###########################################