#############################
#                         #.#
#             #         # #.#
#            #*##     ##.##.#
#          # #...#   #*#. #\#
#         # # ..#    #*   * #
#         #*  .* #   #..... #
#          #  *.## ##.#\#\ .#
#           ###**.# .\#*... #
#          # . ** .. #. .** #
#         #*. ..\ .\ .** ...#
#         #*..*.** \ \. . .\#
#         #\*#**.  ***..* **#
#         # *#\. ..*...*.*\.#
#        #.\*\  \.     .*. .#
#        #* .*.* . .. *.  . #
#       #*.\ .\#\ * .*\ *.\*#
#    #####\****  .R *.*..\.*#
#   # *.. .\ ....*\** ..  *.#
#   #\\.# \*#. \* * *\* *   #
#    #..*  ...*... \....\. *#
#     ##\.\ ..* \...* ...\ .#
#  #### ..  . .*. * .... *\\#
# L.\ .* \*.* \ .\*\.\  ..\.#
# #..*.\* .\**.   **    *\* #
## #.#..  *.\*.*.**\ *..  ..#
#..# *.* * *. .**.*... .   .#
#\**#. .  .. . .  ..*.\** ..#
##\*** * .\ *\ . * \ . .   .#
##..#. *.\ .\*.. *..\ *** .*#
#**.\* \*. ***...\**  .\.\..#
#*.\*.. .*.\ .\  .*.\... ***#
#*#..\. .*\.# .*...*...... .#
#*##\.....* .* *.  .\*.\ \  #
#*#**  * *\. *** .. *. *....#
#############################