##################
##..  *.##*.#    #
## *.R.. .\*.L   #
#\#\..  . ..#    #
#.\.**  .*\*#    #
#..  .....##     #
#...*. .*.##     #
# \  *..\.# #    #
# * ..\.**. #    #
# .*..  *.* #    #
#.*. .. .\###    #
#.\ *. #  \# # # #
# .\.*.*  * .##.##
#\* .\*\. .. .. .#
#.*. .. \ .*\#####
##################