###################
#*.* .   .. **... #
# *.\.. .* \....*.#
#.\  * .*\ .      #
# *.... ... ..\ ..#
#.  .. \\.* * *.  #
#.*\ .   *..\*.  .#
#...*.\ .  .\*.   #
# .*. ... .\ *...*#
#\..    ..\ .*. \*#
#*...  *.....*\...#
#\....* . ...*    #
#..**..\. *.*. * .#
#**. *  . .\.*.*..#
#*\*\..*    .. .* #
#*.* ...     \*...#
#\*..*.*...* ..\..#
#.\.*...*. .\*\  .#
#.**.*\..* ...  . #
#\..\ ..*. *\*..\ #
#..*. \..*.\.*... #
#.\*  . .\ *.\. . #
# . ****. **. .. .#
#  \... *..**.    #
#\ ..\**.** *  **.#
#..  * .\\* .\.*.*#
#\\..\**. .*** * *#
#  *.**.. .\.\ * .#
#\**.. **..*.* .. #
#*.*.*...... .  .\#
#* **. \* .*.. . .#
#..  \ .\.**.   *.#
#..... .*\*..\*...#
#.\\  . *\*\. *.\*#
#*...  .* . *\. *.#
# .\..\ **.  *.\..#
#.**.  \...*\...**#
#.*** *.  *.... \.#
# *  *..*..\ .**. #
#..\.. \. **  ....#
# \  R..**..\*.*\\#
# .**.*..***.. \.\#
# *.* .*.*...   .*#
#\\**  .. .. *  ..#
#..*\ ..\.\  \****#
#.**  \   .\*. .*.#
#  ....*\*  .  \* #
#\*. ..*.**.\.* . #
#.*\. \.... ... . #
#\..* . .* \ . *.*#
#* \.  *..*.\  ..\#
# \.***\...\..* . #
#\... . **..\ ***.#
# \.*   ** ...*..\#
#.. .***\...\\.\ .#
#..\  . * .*.. .  #
#****\  \* .***. .#
#.**. *\*. .\*. \.#
#..\. \.*. **..  *#
#\*\...*.***\\ . .#
#... \*.. ....**..#
#\  \* \  *\. . *.#
# * . ..\.. *  \..#
#*..   .** *.  \*\#
#*.**.*. . *  \ * #
#..*.\**..*. * .. #
#. .\.*.*\.  \ .  #
# .\.   . . \.. . #
#\  .\  . . ..\\  #
#* *\.  *  .*.    #
#* *..* ..  ....\ #
#..\.*. .\  *  .  #
#.*  .   ** . .  *#
# \.  \....   **.\#
#\.  \ *.  .*\.\. #
#\.*\. ..** \  .**#
# \.*.\ *..\.** *.#
#*. \..*..\* *.\. #
#\.  .\. ... .. .*#
#.\... ..**\ \ ** #
#.**\ *. \.    ...#
#  . *.\.* .\*.* *#
#*\* .  ...*.*....#
#...\*. *.\..*. *\#
#*.\...*\*\*\ \ *\#
#*...*\ ....    **#
#...\. *\**\*.\ #*#
# #  *.. ..*. ..\.#
##.*\.    *.\. #.##
#. ..#\.*.*...  .##
#....##\ ...*.*\..#
## ## #.\* #*.. *\#
##*### *..* .*\ ###
# ..\# #..\.   *.*#
###.# \. \.##..**##
#  ##.#L # # * ## #
#    ##. *##\#*\# #
#      ###  # # # #
###################