#####################################################
#    #.*\\#. *.\. .*...\.   .***. ..**R....*.*  .\ .#
#    #*#..*..*\..**  \.  *.   ***  ..\\.  \  *\*..**#
# L   ##\.*  *.* *#\*  **..* *.\...*.  *..... *.* \*#
##*####*. .* . . .  ****\***.....* . \ *   *. **\...#
## *.  .. .. \ ... . . **\ *   . .*..    ... . \.  \#
##.#.#. \ .  .. \   .\ *. .\.\  * ..  .* **\ *\ .*  #
# #\.#. ....... .\.  .**..  \...*\ ..**. *.. **. *  #
# ##.#\.*\. \.*\ . \ *. ...   .*  \ ...\*......* . \#
##  ....... . *\    ..**. . ** ...  \ \ \*..\. * \ \#
#\* .. *. \.. .*. *   ....**\. ..  *. .  * \  \.*.. #
###\.\.  .. .. **..  . ..\* ... .*\.  *\ ....* \. . #
#  #\#\  .*  ** .*.\ ..\..\.* \ .. .  \..* . *.\ *..#
#   #.*.#..\ ..\...** \  .  ...  *..  .* * *\*...***#
#    ##*. \.\*\.* \.*\.  * ..*  **\*\..  .\*  \.\. \#
#####################################################