############################################################
# ** * ** .*.*\..*\..*. *\*.R  *.. .. \.\*. . *\\**.#L###  #
# *.  *..\*.*. \ .. **...... ..*.\.**\  *. . \... \.*  . # #
#.*\  ..  .*.  ..*\ .\ .. *...*....    \*.. . \*..* \*#\####
#\.*  *\ . . *. *.  . . . . *\*\*\* .....* .*.. ..* .* ....#
#.*\ .***..\.*.\  .* .*... \  *.\..*. **.. .*  * ...\.. *###
############################################################