########
#\* ...#
#.*\ ..#
#*.* \*#
#.    *#
#.**.*.#
# \..\##
#*.*...#
#.\.R*##
#*\ *..#
#...  \#
#.   \.#
#...*.##
#* ..*\#
# \. .\#
#L##.*##
#   #*##
########