##############################################################################
### .*#**\\** \*.*.*.*... . **.\ \*. \  .*\. . ..\ *** **  .\ **..  *.\..*.  #
#.. #..**.\*. \..\.*.*..*.\.*. ..*\*.. .\...... ..*\ \ .*\.* .. .  \....\*..*#
#### .\.* .\..  .  *\.**   ..**.   *..\ *.\. ......*. **\*....*  ... * *.   .#
#  ##*#\.**.\  *.**..*.  . *....\ .\*  ... .*.** ..*.*. *\. .*...*\ **.** ***#
# #* .** #....*..*.  \ .\.\..  \ * *.**\*... *** *   .. * \  *   .*.  ... **.#
#  ###.# * \ *..*\.\ .  .\ **.*. * \  ...\.**... .* . * .*. \\*.\ . . \ .  **#
#    #.#L#.#.*  ... ..  *..**\  .*\  \ \*.*\. \ * . \ ..\.. .\. * *.  ** . ..#
#     #  #\..*.*\. ..*...\..**.     ... .\. ... .. *.\ \*\..  .*.**\.*.. * . #
#         # *..* * .\.   ** ... * *\.\.* *\*.  .  .*    ...** *..**. *** ...*#
#          ### \.* *\***.*.***\ **..** .\*...   \  *** **.*..\ *.***R.\. **.*#
##############################################################################