#######################################################################################################################################
#                       #.*.* *. . \  .\ .\..   \ . *.*..**..*..***... .  ..*..*** .\   .\.     .. \.**..\ . *\\..*\  *\.*.*.   *\**. #
#                        ###* .* ...\  .*...   ..   * \.\*.* .\..*.* .  .* *.. \.\.. *..*..*.\  *.*... .*..*..* . .*.**.*.  ..\*  .. *#
#                      ## ##  \..\   * *** *  .  *. *\* ...\ ***.*\* ..... \.. .**** .*..... .* *.**\.. .*  \ .\ \ **..\*. *\...\  \ .#
#                    ##***..*\ *.  \   *.. . ....*  ** .\ * ** *. \.  *.*. . ..\ ..**.\ ..\ . \ *.*.   . ..\ .. .*\*.  .*  .\  . .\...#
#                   #*...\.**.**\.   **..\\* * ****\\**\.*\.\. .*.\.. . \.*. .. .. *.**.... * .. ..   ...* *\*. .....*\ * ***\.  . .\*#
#                    ###*...*..\. .\..\*...\  *\ \..**.*\  \ . .*. . *\\ *.\ **\.**.\ .. *.\ **\.\  *.**. *    \..\\ \*.*.\.*. . . . *#
#                      #*\* *.  .\.**  .**  . *...\\  .\ * * .* ...\.* **** .... *...  * . . ...\.\*. *...*.*  ** .**.*\.. * \.. .*. .#
#                      #\.# ... *. ..   ...* **.\ ..* .*.**. *\.**\. . .. * * ... .\.**.   **.*... .. *  .*.*...\. .\..*.. . . \..\**.#
#                      #..   * **...\**  .*..... \*** .\  ..*.*... ..*. *..*.*.  . .\..*.****..*.\. ... *.... .\ ***  \**.\  .\ .   .*#
#                     #\.\.\*  ** .*... .. *.\\ . .\. .*.\ .... . .  .\ ..** .. \ ....\***....  .*.. \.**\   \\ **.\  \.***  .*..  ...#
#                    ##   .*.\#**. *. .   .*.....*.....\  * *\ .*.  *..  **  *     **.\*.\. *\  .. .  ....* .\ .\.. .*. ** .\ ..\...\ #
#                   # \.\.*  . .. . ..  .\.\.* .. *\ .. .......  * \.*..... ***.\.*  **....\ * *  .\..  *.\. .. * .*. ..  **.\. . *. *#
#                  #.\#*..\.*    .    *  .\..\  . \ ..\. *   .  .\ .\.*.**...\. * . *\*\ *.**..\ * .  .****. *.   .**. ..*...  \.\.   #
#                  #**#..***\*.\* \.*.**. . \...\ .  \. .. \*\\ \*.*.\.*.**... *.   . ..**\.  .*.. .\   *\.\ \.  \....*  *\** \  \*.*.#
#                   #.*\..*. . . *  ** .*\.\. \..  ...*.\..*. *....\\.\* ....*..\*\  .  * *. . .\*\.*.***.\. ..\. .\**. *.*\ *.  ....*#
#                  #..... \*..\ .......*.*  . . \.**. . . \\. \*\ \ . .*\*. .*  **. .*  . ...*.  .** .. \..\ \  \. *...\.*.*** ...\  .#
#               # #*## *..\#\.*  * .\. . .\\\*  . .\.\. *..* .\.*  \ .\... *\.  ...  \ .*\.\**..\ .*\  .. *..    ..\ \ . **.*.   . *. #
#              #\# .. .* *** ....\. ..\*\\. .* . *\.  *\.  .\.* *..\.   \**\  \ *\ . \. . .*. . *. **.  .\. \\. \ \ .\. .**..* * ..*..#
#             #. ....\ \.**.**\*\..  *\ *\ ..* .\..\.*.*    . . **.*\ ** .\.   .**.. *.  ..\. ... .*. .*\**.. *..*.\  *.*\ *..... ....#
#              #*##.  # \.**.....**.*.\.... .. . .  *.\...*...   \***. .  * .**.. ** .** \. * *.* **. .\..\* \ **.*. .\ *. .*\*\  *.\.#
#              ##  ..*\ .. .* * .*.** .** .   *\. *...... .*. .  ..*.   \ .* ..\* .\***  .*\\.\****.* \.\ .*. .\ ..\.. .*. .. .*. *.  #
#            ##\ .\  \.***. *    *..*\.*.****..\\....\   **\*\..\  ....\.. *\*\*.*. ..\ . *..\   *\** *. ****   *..\ .\...  .\ \* .*  #
#         # #.*   . *.\.*..\.* . *\...*....*.    * \ * . \*. .*.* .*. *      . * ..\* ..*\.  .\  .\*\.\*  ..\ *.*  *.**. .*  **. . ...#
#        # #  * *****\* *#\* .... **.\  . *\ .\.\. .\..*. . ..\*  *\ ...*   * .\.*...*  ..*  .*.*\  * ... .  . ...*..... ..*...*... * #
#        #.#.**  *.\  .  ....*.*.\* .* .**....  .*\  * . **.*\..\.*.*\ \ .*.\ .*.*.\ .*.  .\ * \..  ..***\  * *.*.\ *.. .* *.*..\* ***#
#       # \* *.\**\* ...*.  **\.... *.*.*.*\*  . .. **.\.*.. *\ . *..*... .  \ *..... *  ...*\ .  .\ .  \.. .\.. .**.** \.\\*..*   *\.#
#        # *.#\\*..**\*.*.\  .. * \ . . *. *.  **   ..  \.\\*\ .*\..\*\.   \ .* **.\ * *  *  ..\ . .*  .*\*. ..*. .* .\..*.\ .*****...#
#        #**\.**. .***\ * *.    *\*..  \..*****\....  . .\ **.  *..\ ..*  \*\ .*. .***.. \*.. *... * .\**.*.*.*.\. .*\.*. .. ..  .\.  #
#     ###\#. ***\* ..* *\ *.  *\....* *** ... \.. ......*. ..  .\*. .* .. ...*. \.**....*.*.* * *.. \..\. .*. ....   **..***. *..*.\ *#
#    #*\.**... ..*\*. .***\* ...*\* ..**..  \\ .\. **.. .  \.***.. . .*.. .. . . \*\  \\*.**...  . .. .*\  ..\ \**\\*.. .*\. ......* .#
#     #. .*.# .  .*\*..*..   .**. . *.\..  .**.... .*\  *.  .... . .\ .*.* .*\  .... ..\. .......*\ *  ....  . ** .\* *..  *. *    .\.#
#     #. ..*.* * .* * ..* \*. *\. *.. .\ ..   *.* *.**.  \\..  *   \. \\ .. *... . ..\  .\.   .  *... * *. * \..* \ . ...*.. . \ . *  #
#     #\.......*. .*.   *. .... .  \  .*\.. * . .   . ..*..\ **\ \..\. .*.* *.\. .\ \ .\ **\.\  ** .*.*  . \.   .*.   .\ *\ ..*..**. .#
#    #*..  *#*.\*.\.. . *.. **..*   *\ .*.\ *. *  .   .\. .*.\ *.      .. **\* . .  *. \.*.\ . .. .*\\ ..\*...*. ..\  * *  *..* *\* ..#
#  ##** . ..*\* **** *.\*.  ...***  \..\***..*\. ** . ..\ \. ...*. * ... *..*. .  . .... .* ..*.\*. .*\..  *  . .  . *\ *  ***. ...  \#
# #.##.. . . ..\ ****\  * ... **..\*... ..*\*\..*.* *.* ...** * *..\ ...**.\. .\*  .*.* *\** *. .**  ...\.   .. .\* *..*..*... . .\ . #
# # #*\* *.\*\ * *...*\..  \* .....\.   *\*..*...\*.  .  \.*..\*.\ \*.  *\.**  *.   \...**.....*...... *..*. * ..  \..*.*..\ \  * ..\ #
# L.* #*\\ ** *  . \**\.\**.. .* ..*\  .*..\ \. *..\ .\*.  .. ***  .\ .\. ...  .. .*\ . *\.   **.*.* *\.**.  . .*...* . *  .\**.\*\ ..#
#  ##\#.*\..* .. * \.... ....\ .**\ ..* \.*. * \... .*.. \*** *..\  .\ .. \.\...\ ..****. *.  ..*...**. .*\.   . . .*.**\ .\**...\..\.#
# #. .**. * \ * .* \.\...\.*\.. .\**  *..\.\ ...*. *..\* .\.* *...    *\ ..** \\* * *.*\ * \. \. .\ ... \* .  *\ \ *.*.* . .... *.* ..#
# #. ###\.* .*. *. . *.***\ * * ....*.**  *. .. .* . *. *** ..* ...*\*\.**\* .  .. *...*..  \*\\..*.**\ ..**.\. *.  \*...* *\. *...* \#
# # ##. ..#*..\.\   ..*..  ... **..*..\. **..  .**\  * .*.\.\*.*  \... \.*..\. . * ****.*\     *. .  \..* .. * . . *......* \  .*  .\.#
##*##\**.  #.\. ...** ...*..*** .\*\   ....   ...\. *.   ....* ..  * \. .\.....  \\...  \.  .. ** * *. .*... .  \* \...\ ..\.* .. .\**#
# *\.*.*.*.. ..\. .. .\ *. *.... .*.*   .  .\     .**\  \* .\*\ * *... ...* ..  \   * \ *. ****.*\..*\  *\. *\ *.   .  *** ..    .\...#
##\#  **..\.\  \.\.   . *.\.   \*.\.*\     * ..   .\ . * *\.*.. .  **..\*..\ . .\...* ...*.. **   *. **.\..*.. ..*.*. * ** *\.*. *  .*#
##.# ***...\ \*.*.* *\. . .\*\   \*...\  ...\.* .      . .  .. .  .\.*\*..*.   * * * .  .. *..*.\ *  .*.. .**. . *\\... ..\**  .    *.#
# # ##.*\. * .    .*..\ .  **. ***\. ... *  *.*\.*.   *\ **. \**\.*  **. ..    .\*\.\*\. ** . . .\... . .\... \\** .\ *..* *....  *.  #
#    #\##. . *\*.  \**..\.*.*.*..**.\* .. \.. *..**\ *\   . . ..* . .*\ *.* . \  ..*.*..**.*.**. ****.   .. *.\ .*\** .. * .\*. .*\  \#
#   #..\. *\ .\....**\.**.*.\.\* \.\ .\.  .....**.\ *. .   . *... \.. *..*.*\**.\   ..  \*    \\*...** \. .\... \  . \*.**. .*\*\. . .#
#   #* \...  ..\......*.. ..*\ ...*  \* .\*.\.***.. .\  . *\ ..**..\* *.** ...\**.\. .. .**\ *.* *.\.*.*.. *.* .*  \*...*.*. \...  .\.#
#   #*.\ *   **.. * . .   * .\.**\..\.. .*.* .*\.* *  \\\ * * \.. \.***. ..**...*..   .   .*.* ..*.**.\.*. *\. *. ... . ..*  ..* *. *.#
#    #  .\\* **..*. . .*. *. .**..*. \  \ **.*.**  .* ** .\  .. * ..**.\   ..\* .   .**.*\*.\  .\*  . *..  .**...  . ... . .*  .*.\ \*#
#    #.*\  .. . * .*** ...*  *....** * .. .. *\. *. **.* *. * *.. *\..*  ..  *\.\ *.... * .*.* .\ .*  \.*\*  *..**.  \..\  *.\* .. .. #
#   #. *.\..#\...  .** *.\* .\.   .* \.*\   .. .   \*....   ...   .   * *.*..\. .*.. \ .\ \. .**. **.*. ...*...\*.*.\.**...*\..**.* \.#
#   ###*\.\*   .\. *..\***.\* .* ****.**. .\*\  . .  .**\**  *\.\  ...\.* . ** .*.** .\ .*.\*  ..\.. \*.**..*.\.* . .. \.\*..  ...\  *#
#  #\  * .#*** .*.  .**...*.   \..**.**.   .\..*... ..*. ..**.      \ .  .  *. ** .....**.**\. *.\....\*\**\*  *\ *\ . *.**..*   *.* .#
#  #.  .\. *..  *\ \. . .*.*..   \**. .\.\**.*\.    .*\*.\.\ . *\ ..*. **. .\*..* **...\**...* ***  .\...*\..*..  **.  . . .. \...\. \#
#  #\ * .# .\*.\.*\.\.\..* ... \.... .. *.. .\..     *..   . . . .* ** ..*  ...*.***. **.* .** . *  *\.. *.\*.\***\\.* ....\ *....** .#
# #..\* .**... . .  * .\*.  \ ..\.. *  .*.*.R...... ..*\. * *.... * .. .\.. ..*.*...\ .. .*.. . *  .*\***\. **\*.  \.\\**..\   * ...  #
# #. ****....\. * *\......*\. * *.\ ***..\. ... \ \  *\* \. **...*..  ..  \.  *\* .**. ..**\.*.*.......*..\*   .. \.\* . ...\*. .\*. \#
#  ##.** .**\**.  .    *\.\. .\....\..\...*. ..   . . ...\..\...*\ *\  ..\ * .**.* .*.* . .* ..... * . *.\**...*.\...\ \** * *.* *.. .#
#  #.\..\  *. . ..*.\... . *.\.... * .\ *.*.*.   ..  .*\..\*.* ..*\...\ *.  . ... * \.*.. ..** . *..   \  ..\ \.*   . . . **\ .\ \*. *#
#  #...  .\.. *\....*.\.*\*\****.**  .*.\.\.*\*.\.\   * . *.** \.. .\ . *.**. *\.*..\ *.* .\.\. *...   \. **.   .*..**   .*\. . \ .  .#
#   #* .. . \***.\......*..* ..**..   .\ \. ...  . \...\\* . ..**\* *   .**\   .\* *. . .  *..*. * ..* \ \.\  \ ...*..\ **..  *...*. *#
#    # \*..\.\.*..**     ..*  *.\* . ...  *. ..  *.*.*.*.*.* *.* .. . \* ..\     .*.  \ .*. \\.*.  .\.*... *.. \*. \**. .. ...** *..* #
#    # *..  .*..  .. *\ **..\ ....*   .*. ... \ .\. .**\.. * ....**** *.  .\* *.*..*\...  .  .\*. ...\ .  .* \*\.  ...\.  .  .....\.* #
#   #\.#*. . ..*.*   ****.  **\...** .**. \\.*.\.. \**\ \*.*.* *.\ *. * \*..* \... ..\**.. .* **... * \.* *.*.. .* *\..\.\.*\. \.*\.*\#
#######################################################################################################################################