################################################################################################################################################
#*... ..*... * . ..*.\ . **. .* * ..*.\.. *.  .   *.. *.* *..  .*.. .\ **.. *.* ...  ..*. .. .*\. **\ ...\* .  .**\.\...**\ .**\ . * .\**.\#   #
#....  .*\.. . . .\..* \..*..\..\.* *** \ **.*.\  .\*\...  .*.*.* .. ...* .\.\.* *\ .. .* *.  . * ..** .**.\..  . *.. \  . * ..*.. .\ ..   #   #
#*.*\. .. . * ...    . .\ . *\ \*\.*..\\ *....\ .*.**.**. .\...****   ..\   \*.\..  .   *   .. ...  **\*.*.. *   *.***.\*  .*.*.*..*...\ *.*#  #
#\.**  *. \.\ *. *.\. *..*. *.***. \*...\*.\.**** .\. .\   .\\ ..* \.... .....*  *  \\. ... *..\.* . .. **.*\*\. **\. \ . .\*\*...*..*.* .#.#  #
#. .**..\ \* *. ..*.  . *..*.\**\  \  .\....*..*\.*.  .**\.\ .  *.  . \  .   *.* ***.*.. \* *.* .\.** \.\.**. .\*.\. *. . . *.. ....\* .*\.#   #
# *\.*..*\.* \.. ...**\.\. .* .* .\..\ .*\ \. **.\. *.\.\ .* .. \  \ . ..* .\. ..  . \... *\.* \.\\ . .  \...* ..** .  *... .\*.    ..  \*#    #
#....* \.* .\.*..* *...* *.*.*.. *.* ..*... \ . .. ..   . **\**.* *  * *   *... \ \.*.**\.**....\ ..\   .. \**.** . .* ...*\ \.* *\..\....#    #
# . . *   **. .**.\.*...\*..\*..\.....*.   **  \** *\.***\***.... . .*.. \*\**\..*.*  ..\.\ *\.* \ . .    . .. *.  *..**\ .     \. \  . .#     #
#**. .\.. ..*\..*\..*. ******  ** \. *..\.. .*.... .  \.*..*.  \\**..*.. ...*. . ..   \.\ .\**...\*\. .\. *\ **...*.. ..*  **\..  *..\ #.#     #
#.* *.. .* ..* ***.... . *.\***\ *....  .. *..**\ .. ..\.\ ..* . * *...*.*. .*.**\ .\...  *..* ..* ..\.. . .*.. .\..  \*.  .\. **.\*.  ##      #
#.\ ..   .* ** .... *.     *.*** * .* \ * *... .. * \. . **.. . .*\  *\.**.*  . *\\ *\ ** * .. *.\.\..\\ \ .\\    .*...\. . *\   **.. .*#      #
#.***\*.* . \ \\..* .. .**.\.* \ . ... ..*.*     ..\.\..\ . .  .* *\ *.*. *.*  ..*.  *.\*..* .\   .*\\*. . .\.  *. \.   \ .\. .\*  .  ..# #    #
#\..*   .  . .  ..*   .*.*.  .* \ .. . .\*\*  ..*\  *.*\ \*..*   .**. *.\*.\.\ .*\*\. .*\ .\ ..*\.**.. .**\  .  \*.** *..* ****. ..    .## #####
# \\.... .. ..*.  *** .. *.  \ *.*  ... \...**\*..\*. . \ .  ..*\... *. .   . .\.**  \*\ ..*\*...\..  * *.*\ *  .. * \ * *\.*.*.\  \* *\##.#.\ #
#. .  ..  *.. . .*....*   **\ ..*..  * .  *\ .\. *.\.     . . ...\  \.*...\. *..*.* .. .  .\ *. . \. .. *.\**..*    ....**\..*.. \*. .  .\.*\###
#.  **.. .*..*..*.*  \... ..... .\. .**.**...*\ ...**. *   .*\ ..*.* *.\*.*  \..  \*.  * ... \..\...*. **. *** . .\.*\***. \ ..*...   \# #.#.# #
#** . *\  .*.*.\.\ \   ..\.*\*.  ..\ .*....    ..  **\..\ . .** .*\.\.*.* *. *... ..***.*. \  .***. .*\.\ \...   *...*.*..*.\ **. ...*.*### #  #
#*.. *\*. \*..  * *.\. *\ .  .**. ..*.....*\***...*\*\  .... *..*..\...\* .* ..\*\**... .\.   ..\  . \ *... \.\  .\.*..*.*..**.\.\**\. . ..#   #
# .   .. *.**\ *. * .. *.  ** ..  . ..* * ....\..*. . .\.  . ***.\   .  ..*   .  . . \.***...*\  . . ..**. ..  .***.\.. .. *\\..  \*...  .*##  #
# . .\****  ..**.* \ .\.\. **.* *\*\**. **\    .*\***..* .\* .\. * **  *.*\ .*. *\ **   ..  .\ *..  *.*\. .**.* . \ .*\\ .\ **...  **\.*.*\.\# #
#   ...*.. *\ \  ..\ * *. .*.  ..  *..* *..**.. \*...*.\ ...  ..\  .   ...*..\* .** \ .\ \ .   *   .\.. *...\. .*. .*. .**\ \.. *\\***  ** .#  #
#.*\.  ..\ . .    .*.. ..* .  * .*\.  .\   .\..*..*\. ** **  .    **  .  ..*.\.**\. .   *.\  *.\  .\.** ...* .*.    \\.\.. *  \\ .\...#.\#*#   #
#\. ...*.\..*.. .*\*.\ ...  .\. *. .\....  .*  ..** * .* *.\..\.**.*.*... *. *... ***** *.********. *... ...\...  \\ \. . . *.....*\.*.*###    #
#*..\*\ ......   .**\.   *\\****. * ... * **.**\....\ *...*..\.... ..*.\  . .  .\ .*  *\* *.....**.*.* . **....   .\.. .*.. *\.\.\...*\*.*#    #
#.    .   .\. *.* . .** .\...*..  * . .*.*\*  . . *\.**.\** *.* ..\.\..*.***  *\.\..\. *.*..\\ ...\. * \ ..* .* ..** *\.\.*..*. .*\ \. . ..#   #
#.*. . .** *..\ .\.\*..*   .*. .***\**\* . .  .\\  *\.\** ..*..*   .. *.**.* *..\ \**.\.\.*. .\* \ .*\..\   ... ..*.  . **\.  *... . \. .\ #   #
#\.* .*\*\ \...  .....\* . *. .\**.  ..\..* *  . .....\. ... .\.   *  * .\ . .. ....\ . .*** .*.\.* .  .* .. .  .\. *\\..\ *** *.  ..  ..##    #
# \*.  \**\.*\\.*..*\..* * *..*  \ *. \. *.***.\**\\. .   . \* *\.\. *..\\* * .\  .\ *.*..*....**\.  . *.*   *\ .   .*. *  ... .  .    *.#     #
#** * . .. *\. *\.... .\ .   .*...**\*.\...*..** \\.  ** . .   . ** ..* .***\   ..**.  *\ *\   *.  .* ...*\ *.**   .\.... *. .\ **..*\ #*##    #
#.*..   *\ ..*\. .  *.  *\*.\ . .*. * .  . .\\.*. .....\ .    *** *\.*.. *..*.*.*...***\.*. .\**..  .\\ .*. \ .*\ *...**.  **\ *... *\. #**#   #
#\.*.* .  .. *.  .... \.. .*  .\ .\*...*  * * \*\  *.  .* *. \. . *. ..... *..* .....\..*.\*.* * .\...*..* . *       \. .* .* ..\ . .\.*.*# #  #
#  . *.. . ..\ ** *  .\**. .*.* \.*\ .*. .\ **...  .. *.\\.  .*..***\..*..*.\ **..*.*.*.*.* \. . *... .... * * .****.\..\ . .*\*\.   .**\*##*# #
# . .. .\ . * *.. ..** .\.  *\   .*. *\...*..... .* *.. .\...***\..*** .\.\*\**.\  ..\.*. . . . .**\. . ..*\..\..* * .\. \  *. .  \**. .*. #*# #
#.\. * \* ... .\.  .*..*.   **.*.. . *. **.*\.**.* ...  ..* ......*...\* .*\.*. .\*\ .*\.**** *.*..\*.* *...***.  \. ..\.. .  . . \*.  *.\  *\##
#.*. .. ..\...     ***   \ .* .... \ *\   ...*.. .\ **  .    ..   .*\*. . *  .. **\.  .. ..\*\**...*. * .. \*\.  *..  .  *.\. .\.* \*..\*#\#*# #
#.\*... \ . \* .. *. .\**  *..\ *. . * *\. ... . .*... .*  \  **.\...  *\ .     ***  * \ *  ..\.. *.* ..*.****. *.\.. ** .  . . ..*..* *# ...# #
#  *.   ..*...**..\.   .  . * **.** \. ..***\  \.\.. ...* ..**...***..\.. ..*.*\. . .. .\ ..*\...*. .\. ...*.......*** .*.  * **#\.  . .   *#  #
# ..*.*\***. ..**  *..**.\* .\.\. .  *  .*.*.\ .*..*.\ ..  ** ....*. .*. ..\\...\..  . .. * \ .*\. . *..***. .*...\..* \\*....*. .#\*\*\\.\ #  #
#\ *.....*.   \..* ..  * \.*.\*   * .\ ..* .  ...*...* ..* \.\  .*... .* \. .*. .***..  . \ .\  .    ..*..***.*..\ . * . **..* ..\* . .****#   #
#. ..*.  ** .  * *.*. . .\ *.*\.\. \..*. . .   *..*\...* ...\  **..* ***\.\ .. *....\.*.* .*...* . .*.*. .*.*...**. *.* .\*.\*. \ *.#  ..*.*#  #
# *.\   **. \... .\*.  *\ *... * . . \*\..***.\.**...**. * .*.*\.. * ***\**.. *... *\* .\ .*  **  *\.\*. ..*\ . . *. . .  .\*  . ...\*** .#* # #
#*** ......... *\ .*.**** *.   \ \ .\ ..***\.*\ .   .*.* .\ ** *   .*..* **  *\ . \***  ** .   \***....\* ..*\ * ..\  .  *  . .*.*\*..\. *\#.# #
#..... .\*     .* \ \.... .\  ..\ . \.\.*.. ..*.*.\  ...\ . ** *   *.*\. .\  ..* . *\..**.    ...**... .. \\.* .*. .\..\*.. *\. *. .\ .. ...#  #
#*\.\\. .*  **....... \.*    \ .*.**..*..   .\* .* *.\*   ... .   .*..*..\**... .\.*.**\* . .. ...* \ \*. .. .\..   *.  \.*.*. \.*\  \**####   #
# .  *.*..* *.  . \.  . . .*. . .*..*  ..**...   **.* ..*. * .***  \.*..*.*\..*  .\*..... * .*... * \.......  . *. .   . *.\ .*. ..  #.*#      #
#  .** .***.* \. . .   *   *..*  ......* ... .*.*.\.. \.*...  .*.   ..* .\*    \.\ . *\ ...* .\ *. .   . .. \*.*...  .. \.\.  .  \#.#. .#      #
# **.\ ...... .. ** ..***.*\. \. *.  .*\  ... .   *.*..\ . .***\ *.  . *... ..\   *\....\* . *.\*.\ .\. *\. \* .     ..  .*.\. #\. ##.  .#     #
# *. \*...*  . * \..*.. * .*\  . *\ *\*. ..*.\* *.. *   * *  ... .*..  .* ..* .****.\.\ \.***. . * .\*...*. .*.*...*. . * . .*.*.*  #..*.#     #
#\.. ..\* *.\**..  ...*.\.   *. .* .. \* \..... .* *.. .***\ * \  ....\.**. *   ..** ....*\.* *. .  *.  ..\  .** .\**  \*. .  *..**.. ###      #
#*.*. ..*.*\..*\.... ...* \ .\.  . ..*.* .*.* ...\*.\ .**. . \ . ..*\. .*\. .  .*...  \..***\***.. .* *. * * * . ...*.\*\*\**   \.\ ##         #
#. .*.\.  .  *.**.*... ... .**. .. .*..*  *... . *.\. *.****.. *\*.. .  ..\. ***.**   . .\*...*...\.***\.* \ ..\.. .**  *.*. \...  \.*#        #
# *****  ..  .\ \ ..* ..**. \* . \  .\  ...   .*  .* *..\*.. ....\.\.  ..*.  .\*\.. .*****.\ .  .\.\..*.\ . \.\.  *...\.*\. .*.  *.###         #
#\.....\ *..*  *... .*\*..  .  ....\**..\*.*.*\.**. *****.**.    .\.* .  .  .. ...  \*.*.  **.  **. \ * *..*\......*  .**.  .*..**.* .#        #
#. \*  ..*.  *.*.. \*......\\  \..* .\*\  *.*..*.. *\.. . .. \ ** *\*\ .  \ \.***** ....*\...  .....**.*  \..  ...... .\.**  .*  *####         #
#.*.\ .. *  .... .  ..\. **.*.  **.* ..*\ ..*.*.* **....\* .\ ...\. .. \ *. ...*...  ...* *.  *. *.\..\*  .. .\\ \  * . .*..\ . \. #           #
#\ *..  *.\. *...\*...** .*.** .**** . . .**\***. *\. \ *. ..  **.*.*\*.....*  .\*\*.*\\* *.. \.... * .\ . .* *  .*  \\.**.*..  . ##           #
#. ..**  . *  .   .\*.** *. **.  ..\..  .**  .*\* **.**.*\    \*..\\\ .  *..*.  ..\*.. **  \ .. .*\ ...   *\\ . . . *\.*.. ..\*#\*#\##         #
#*.. *....  ..\ \\....*\ \.\.\*\*  ...*....  \..  ....\ . \**\..*.*.. ...\\... . ..\. ....    .\.*\    \ ...**\\  *.\ .\. *\.\.*.* *. #        #
#*.*\ ..*   *.....\ \.\.\\.*\.* ..  .**\*.   *.  \ \.    ....* ..\.* *.  *.\.*\.\ ..**. *  *.  *\...\....   .  .\  \ . .\.... #..##\##         #
#* *.\*** \ \...\\ *\..*\  ..* *....\..\.* ..\.*. .. \*** *\..* . \***\.  ***..\....**.\..*... .... * ..\..**\  *.*** . .*.. *. \ .#\#         #
#\ \. *** . .\..*\**.*.. \**.. .  ..** ... ... . * *\...**\   .\  *.... .* ..*  .\.  * .\. *..\* .  *\.  . \.. .* .\. ....* *.*.#  #*.#        #
#**  ...* \*. .\*...**    \*..* . \.*.\ *.*. * \** ......***.. .. .**  ..\  **\* **\* . **. *.*. .*..\* ..*. . ...**    *.* .*..*.#.*#         #
#*...*......*.\*.*\ .\. \*   *. .. \ .**.. . \. *\  *   .*** . \ * **  *.*...**\*.  .\  .*.**..\ *  \* .\  .**. .*..*.*.. .#\   . *.\ #        #
#... \  ..**.  ...\...* ...\ .  \  .**.\ .\  \. \.. . \.**.    ..* .. .\  \* .\ . *..* .** **  \..  . .    *.*.* *\.*.**\..\ \*#**.*..#        #
#.\.....  * ...\  *  \**.. . .* **\.. \ ...*..*...  . ... **.*   . \...**... .  * .  ..\**.\*  *\   *  \*... ..*..   *\*. ......#..*.#         #
#\.*. *   *. *\ .  *\.** . .**. .\ ** ..*..  ....\ *** .. ...*\ \..  **.\*  **. .*\. .*...\ .. .* ... *.   *  .*.* . . . **. \####* #          #
# \..*...\*.*\* .  \ .. . ..  \\** *.* ..*\ .. \   .\..\ * .\.*** \*.\*.\ \\.* . \.\  .*.* ...\ .\ ..* \ ..\ * .. \ ... *\*.... .## #          #
#  ..*.\..*\. .*... **\ **.*\   *. *.\  * .\..*.\.\. .. **..**  .  \*.**.  \ *..   .   ... .*\ ...\ .. .  *  .. **.*\\.*...***.# *##           #
#*\* .**\   ** *  .**.*  ...  . .* * \. .** **  .*.** ...\. . ** *\.*\..*  .... . * .  \. *\..***... \.. .****. .*.\.*.. ...*\.. . #           #
#. . \*.*. *\ . \ ....* . \.*    \  \..**...*. . ..\. *\ . \. *. .* ..  ..* *\ . *.*. .*  * \*.   .   .\*...**... .  .\**\...###  \.#          #
#\..... \ ..... .. .\*.  .  \** ... *. .*\.\* .  \  * .*..\....   .\.* \ \***...\.\... .  ...****. ..*\   \.*\. *..*.  .\ ***.. .##\#          #
#.*\... ...\ .\*.  **.*\ \. ...\.. .*.**.  \.*  *.*.\..\. *\. *\.*.. \\\ ...  * . . *.\ ..\ .**.\ *\...  ..\** *.  ... ** .  . . .#.#          #
#. .*\*..   \  *..\.* \.*\**. *** .*.\ * *\.\**  ..** .. .\*. ..*. * \ .. *\.*..   . .  .***.***.*... *.**\.*.\.\.. ** .\. ..  \. *\ #         #
#* .\. .\.**..** ..*\*.***.\.***.\ ... *. * .* .\.*..  . .*   *.* ..\  .  *..* ...  . .* .....\..* *...  *. .\.\*  **....    .* . ###          #
#. *  .*..\ ***.  *. \.*.* ..*.    * *\ \ *. ...**.  .. *.******.* *.  *.\.\*.**   *   ..  *..* \. ..** * . .  ....* .\.. . *...  #            #
# .*..*\\.* \.. * **\ * .. .. * * ..\......\.  .*. . * .\ ..\...\..**  *\.**.* .* *\* *..  * .*..*. ** .. *\  .\  * \ . .*. ..  ##             #
#**\...*.**.. *\..... .. ..   * *  ..  *..*  . . \ \ .  *...  **.*\ .*\.. . *..   **. * *. .* *\ .....** ..*.  ** .\... \.* . * #              #
#.. * \ \.  \ . *****.   *\.* .      **..*. \.  *.\.. . * .*. .\...  ...* * ..**  * ...\.  .*  .*.\**\..*..  \  .*.......** # .\#              #
#\ *...   * \.. ...* ..... *...... \..*. .* .   .\.*  *\.  *  **.  .\*\... \.**.  .\  ..  *.  * ..**\*   ..\.*.*  ..   *\*\ .###               #
# .**..*..\*. . .\ *R.**. **.\.\ **.* ..  ..\ .. .*.\ ... *\ \.\*\*  *.\*\ .\.**.     *.\ . . ..  . ... \  .**.#.** .  . .###                  #
#  *** .**.. *.* . **..  \ ...*.*.*   \ *\..\ **   .   .* ... .*.*.\.*. .  .**..\.*. *.  .\   . *..\ .  *  \.   \*.. #*.. \ #                  #
# * .. .*.**. .*... ...\*...**. ..\\***\\..*..*..*.....*.   ...\.. .  \...\.**\   .* .\.....**. * ... *... . .  \*.\  .*\*# #                  #
#***.....*.. \ *. ****\*\ .\*.*..*. \**.\*\. ..**\ \.. .    .\ . .  ..... ...... .\..**\..*... *. \ ..   ... .  ##.*##\*.. #                   #
#. .  ..\.* *  \ *.* *. ...    .\. *... ....*.\*.. ..\ * *\  . ..  **  \  .* **.. ...* .* *.\  .* .*..\.  \*.* .# ## # .\ #                    #
# ** \.**....\** ..\.\.* .....* *. .\.*. ...   . .\ .*   .  . .* .\.\...\ .*  .  .\.*.. .**.. *  * .\.  *.\**.\*.#    #   #                    #
#\*.\  *\. .* .* \ *.. .  . **\ . .**.. \*. **\.* *. *\.*** . .\... ..* .  *\.\ ..*..*.\ *.  .. ... .\.## \### ..###   #.#                     #
#.   \\*.. *..  **. ..  \..*..\  .*\..   * .\\\.**** .*....  .*  .*.*\.\.****. .\.\**.*..*.\ .. .*  .  ** *. *   .*.#   #                      #
#*\... *\. .\. ..\.**\   .\.* *  ..\.* \. * *.* *..*. *  *   *.*\ \...\...... * . *.\.*.* \..*.. .* *\ \  ..* ..\..#                           #
#* * **. .\*.** . **.*\*. * *.\.  .  ...\   ....**  . . .\**.. ..\.. .  *..*..\.*.\*.   *..**  ..\.. **..**.\\ \##\\#                          #
#*.  ..  *.. *. * .*\*** .**.\ .*.**  \  ...**\*..  .  .. \*\ .. *\  *  . ...*  * *.\  *\\\** *    *\ \**\.. ..L #.#                           #
#*.\**\*.\ \*.\*..* .*.** ..*.* * \.\*.*.\ .*..*** .* ..\*... .* .\.*.. \  \...*\ .*\\ \ . \. *\. \. .#\ .\#..*\# #                            #
################################################################################################################################################