#################################################################################################################################################
#  #.#*\. .*.**... ..\ .*...*.. .. . .*\ *   **\ .*. ...*. .*.*. .\*. \** . *.  \.\* **...\.. \*\*.  .*   .**. ... .\** *. *.**  **.* \  *\\. . #
### *.\..***** .\.* *  .. .**       .  .\  ......  .. \ *.*.*\..  *..  .\.. .. *.*..***** ..\*.*.. .... .  . *\   ..* . ..*..*\..\ . *  **.** *\#
#*.\. *.\*.. .. .\*\*.\* .* .*. ...*.   .. .**.\.*.*\.  \** .*  *.. \ . ..* *  .\*....*..\ .  ****.\     .  \*.\ *.  . .  .  **... *.*..*..** *.#
####  #.. ..     *  **..\*.. * ..\ **.\*..\ .**.*.\*...**. ... .. \ .  .  *\  \\ ..\*  *  . ..*... * \ *  .. .  .. ..*.**   ..\.\..\** ..\**\.**#
# #.  .\. .\ *.  .* .*\.*. *.\. .*...***\*\ *.. . * .\.*.  \*..\ \. .\. . .*.. *\.\... * .* *..\   ..*.**  .***..** \*...*\  ..** * *.. ..*  **.#
#  #\ ..** *.*.   *\.*. *.. *..** . \*.***    .*\ . **.*..\.\*.... \.*.. .**. ...   \ .** * .   ....*\  .. \.*\*.  \.\. *.* **....... . .*..\**.#
# #*.   *\.*.*\  ...** \. . .\....  *.....*...\  .. *\.***.\**.* \*.\.*\ *.\..  \*** * ** ...  .\\..* ***\* *.....*\..  \.***.. ... \. . ..\.\..#
# L.*.      ..    .\.\. . ..* *\..*.* * . .*.  .\** \  **.  .*.*...  .*. .*..\ ..*\... ...*.\  *.  .\ * ...\.\ *\*.* \*\.*.\ .**..  .*\ .*\ . .\#
# # .\ .\*.\*\ .*.*.* * . .\.\.**\. * ** .*...*  ...* .\.\ . .\**\ \*.** .**. . ..  .. .*\ ** .*. .\. .*   .. *\ .*...*.*  ..\...*R** * .\ *  . #
#  #\** . \ \**.*.* \.\**\ *.* .\ **.*.**..\ .. \ **. *\. \.\**. . .* * \...*.*\*\.\.. *. *.\...*\ *\ **\* .. \*. *.\*\ ..\*\ ...*\***.  .** .\ #
#################################################################################################################################################