##########
#.* ... ##
#\R* **\##
#* \...  #
#.  . \ .#
# ..\..*.#
#\*\*\***#
#...  ** #
# .* ..*\#
##*. . *##
#*#.   # #
#.*.\.* ##
#** # .. #
#*#.#\*.L#
## # #\# #
##########