#########################################################################################################
#        #.#. *\ *\  \...*. *.*. *\**.\.  *.**.\..*.    \. ..\... .....*\.  . **# *#                    #
#        #.#  . .. * . ** **\ * *.*.  *.***\*.\..*   .  .. . . .   **..\**..* ..\ \*## ##               #
#      ##  ***** # .. \.. ..**.*.*.   ....  . .   . .. * .\**.**. \*.\*. \. # #**\ ##.#.\####           #
#     #.#  *\..**.. .\.\*  \. * *. **. .\ .\    **  *.** *. ..*.**.  .*\... **.\.*.## *\  ...#          #
#  ## # # *\#\ .\.* \ * *\*..*\ * . .. . .**..**\\ ....*.. **\. \  *  .** \*..*... \#.. . .*\#          #
### .##\*... ..** .\ ** *\.\* * *\ *.\   .....\... .*.\*.\ ..*. \ \. *\*...*\ ..**....*. *** *#         #
#*##  *...* * *....*.....*  .*.\ ...* .*.*.*... *\*.*.....\ ..\      .*\* *\..*.*# **.*...\###          #
#* .  .\ *.*.\*.*\. .  ..  .\.\ \.**. .. . . \** ..*.\ ..\   .  ..  . **..* . * \. * .\*.*##            #
#\. ..*..*** *....\*\\.\.\....*..\*\*... \  .  .  .... .  .\*.**  ....\.\ .  *  .. #R....*#*#           #
#* ***.. *.* . \ . ...*    \ *\ \*. .\ .  .*   . . .... .. \.*.*. *.**. *\.*.. .   *.  . ...#           #
##..\. *.. * *\..* . ..\*.*.*.*...   ***..\..*.  . .\...\*. .*..\..*\ ... .*\.. *..* .  . ..###         #
#** #  ..  . ..*...  . .\*\.. .. ** \*..* *.. .  \ ...\.*....*.\**.**. *\ ..*..\..\.. *.*#*\\..###      #
#.\* .. * \..*.\*\. *... *.. \.*.**\..\.\\.*\.* .   .\ ..*\.\* .*\..  \.. .*.*\... \ #. . #.####..#     #
#.. **\*.  . .. ... .\  .. . .....\.**.\*\... \* ...**....  ** .*  *.* *  .*. .*... ..*\ *##\. .* #     #
# * *..  * *\.** \   .* .. ..\ \.. \.\**. *   ..\.\.*.*\**. .  * .** ...\..\\ *. *\*\.\*#   .\... #     #
#....\ .*.\.*.*  .....  ..  **..* \.. ..... ..* .  \.\* ..  . *.\ **.    .*\..\...***...#\*  \* #*#     #
#*..\* \*.  *.* \*.*.*** * .....* . .\  . *  ..\..*..*.*\   * .\  *.**\*..*..\.\*\..* **..\ *.. \.#     #
#..\\\ ....** *..*..\... *.*.. ..\ * ..   * ...***. .\\... ..  .  . .****\..*. . * .* . .. ** .*.\.#    #
# .*... \. .. *  . *.** ..* .**\.  .*. .*. . .*\...* * *. ...  . . \ ..\******.  .\*.\.  \ \*. ..* .#   #
#  .. *.... *...  **  \ *\.  *..*   * . .* * *..\  * *.**.  ..\. **..  *\*. .\. **.* .. *.# * .**\* #   #
#  .\..   ... *...\*\  *.*.. *  *   *.*\..*. . . * ... *...***..\.*...  ..   **. . .*.*.\. *\ \.. *#    #
#*.*** *.**\ \* \* ****.**    *.** **.. **.*.*\*..\ . . ...*.. .  . .*   ***\.**\ *.*.. .* **  .#..#    #
#.* . \. .\  *  .....\....*.  \*.** ..** *.... ***.\.\\   \.**     .\.......*..**.* \. . * .**  .  ##   #
#*..\  * ..  * .. \*.  .\.. ....*.*. \.*.**\*.*..\ ** ****. *. *..\ * \*   .*. .  ..*.*  .\.*.   * .*#  #
#. **\ * \ .*. *.. ..  ***  ..\**.*\*\. **\ . .**\. *.*.\\.\*. . \*.\*...  *..\ ...\**.. . ..  *.\.##   #
#. .**..  * ...*\* \..\ \. *\  .. .*...\.***. **.. *.. \.*  .  * .. ...* ....*. \.*.*.\.  .*   .. #     #
#.. .. \ \ .  .* .*. ..\. .. * *.  .*\\*****\ ..\. . *..* ... ... ** . .  \ \.\.\ \ .  *   . *.**\*##   #
#\.* . . .*.***..\ . .* .*. \. ...*\.** *.\.* .  .*..\.\\ .  .*\ \..\ \ \*.**.*...\.\...\ \  .\.\*...#  #
#.*  . *.\. . * \.  *\  *... .\. .*.*.*\  .*\..* *.. .*** \*. ***\ \. .*.  .\ ..  \ .* ** ..**.*.*.\#   #
#\.\   ..  \.\** *.\. * * * .  *    . ..\* .*.**\.* .\.* ..\. .\.*.   *..* *.*.....* . ...  *.*.*.\.#   #
#.\ .*.\ \*.  .**..* ..\. *.* * \*\.. *  . .  ..\*\... .\   . \ *\ *.*\ .....\.. .\..* \ .  \*\ *##\#   #
#  *\. .   ....*.*... \.\\.*\.....  *\. .\. .\..*. .  . *\  *   .*.*.*\..*..  .. .*\ .\.. * ... .# #    #
#* .*.*.  \ .**.*.. *\.. **\**\ **\..**... .\.. *  *. ...*\*..  .\ *  .* . **  *  .*\\**\.*\..\.\ #     #
#  ..*.*\\ *\.\.....\.\*.*..*..*.**  .*\..   *\ * .. *** ..** *  * . .  ***..*\. . ..\*..   *\ ...#     #
# .*  * \ .*..*.\.\\.. .\\  \\ ..**** .* *...   .*.. *...**..\.. *. .   *.* \.. \. ..*\*.\*..  .*#      #
#\.*. . .* .**...\***\ * .***.\**.. .  .*..\  .*\.*. *.*\. *.*..  .\* . \.  .*..\  ..*.*. .. . *#       #
#.\..\***.  * *  .... **....\*.\.\. *  ..\..*\ . *.\***....\*.  \.*  \ .\  .*\.\..\ *.  ... \. \ ###    #
#*  .**..  .\ * . *   * .*\ **\...\ . .\\ \.*..... \*.\  .**   *. . ..  ..  ..  *  *  .\  **. *.#  .### #
#.   *\ .**\** .\..   .\..*....\ ..** . **.*\.* . \ .\.\.** * *\.\** .*\ ..\..  . . *\..  .. \*\* .##.*##
#* .\..* ....\\.*.. .*   **.. ..* *. .  .\.\.*.**..\ .*  *. \ **.*.. \   .\.\.\** *  .*\ \  .*..*\ #. \.#
#. **.\.*.*\  *  *\....**.\* .\**..\.*.. .**\\ .. * .\.  * *. *...\.*\..*  *.  *..\**.....*\ ....#*.  #L#
#\* ... **.*.*\.\. .*  ....* . . . .   ....**.\ *\. \*. ***.*.** \** \ *. .. * * \ \.\ . .**... * .\.*# #
# ..  **..**...  *   \ *.*\....\ \.****\  ..*****.*. * .\..*...*\*..*.***.\.. *. \*  .\   .* **\.***\#  #
#.  **.. .. \\.. .   . *.*.\...*. *.\.\ .  **... *. ..  ***.\..*...*.\*.. * \ .  .\*. .  \.. ..*  **#   #
#\ *...\.* ** . ** *  .... \ ... .*  *..*\*.... \*  . ..*.** .*.\ * \\ .  ....*.\. * .   .***. .  *.#   #
#*.** \  .\ * .*.\ . *.*\.\....**.. .. \* \*\. ..  . *\**.**.*. .\*\*\* \.  *\*\   * \    .*.  . \#  #  #
# ..*  ..** .*.**\*..\.\. * * \*.\  *. ..\*. **.\ .* ...*....*..\*. * .. . *. ..**.. .* ..*\*\ ..\. #   #
# .*.* .*.. *.*.**\...*. ***.. *.. .... ....*.*.. \\*.*.. *\ ... * . \  .\**. *\...\. *.*..*\... *..\#  #
# \. ***\*.\*.\*..**..\ *..* ***.\...* *. \. *\ .\..*\ .*.***.*  *.*\.\  ...\ *. . \. ..*.   \*. .**. # #
#*   *\.  * .. *...*.*.\*.**..*\.\   *  \  \....  .*... .\*..**.\*\ .. \**\.*...* ...\. *. \\.*\ **..#  #
#.* *.*.\*. . *\.\ .\.\*  .*.\*..*...\   .*\ \.* \.** . * ** ....\\ ....* *\ . \ \.. .*\.*  .*. ..\  #  #
#########################################################################################################