############################################################################################################
#                 #*#\\.\    .** *. \.*..\* * *\.    .*.\... \ *.\... ..* *  ..*.... \ .. .\ ..  . ** .* *.#
#                 #\.* \.*.. *.\*\ . ..\.** \*. .. * .* .*. \. . **\\\ *.**   \.  .**.**. \ . ..  \..**.\..#
#                #\.*  #\\  *.  *..*. \.*. ..\ . ... *. .. *.\.*.*.*\\..*.*\*. * *.*.*. . . .\.  . . . *...#
#              L #.. \ .**.**\.*.....  .\..*  \    \*.\*.\*.\. .\*  .\ .*..*..\\ .. ..*. .*..**.*.. .*.    #
#             #.# ..*.\..... .*.*    * **.  ..  \ \.*\.\..* \. . *\ .. \* ..\ ... *\\..* *. \.*.\.   .*\.  #
#            # .*.  ..\  ** \.......*.*. \*.  * . * \ *. * .\ .* ..*. ...\*\ .**   *  \*\.... .* .\.\. *\  #
#             ##*\  . .. .   .  **.** ...*..   .*\.\**. **.\  ..   . \  .... **. *.\.\...  .\.\.   .* .. .\#
#              #* .**\.* . .\  ..*\..*\ \.* ...*\..  ....**   . ..   . ..* . \\. .. *     \..*....*  .. ***#
#               #\ ... **..\*....... ..*.*  \ \...*. . ..\..\ .\*   \..\...  .\.   *\ .\. . \**..*. .*...\.#
#              #.**\. * .... . ****   **.**..*..*\. \\ * .\ * * .. \..\ \ . . *.*...  .*. **..* .... . . *\#
#           # #\ .   \*\*\.\*. *..\ . *. .*  .\ **\ ...   ...*.*\.*.* *..... .\...*.*  . .*\..... * .****. #
#         ## ##. \..\.*... .\  * * .* .\*..**\.*.**..*\. * * .*.**.** *...\. **.\..** *   ...\.**.***.\. ..#
#        #. .. \..    .*..     \ .*.*. .* .\.* \\...\.   .*.\\... .**.. ***......\..  .  \* ..  .\\ .*.*\  #
#        #\**... * ** *\..*. * *.. * .. \*..*.**. .*..  ... *. . \ .***..\. ..\* *...*.*\..... .* .. *.. \*#
#         ##.*\ * **. *  *. ***.\. *   \  * \..  *..   ...  * \ ...**...\.** . .*** ..\. * **....\ * ..*  \#
#         #\.#*\....\ .*..* ***.. ...\* \..*.. .*    .   ...* . \*...*.  .\.  .\. \ ..* .*\..*.\ .*.\..*  .#
#          ### \. .*   *  ..\**  * .* . * .   . \ *.. .*.*  *..  .  .*\.\ .**..\*\*       .  *.. *.*..*\*  #
#          #*  .*. .  .* \*. .  ..\   *\..*\ . .. *  . *\.\..   ***\*.*.\.\* * *\...      .*..\. .*\* . . *#
#           ####. .***** .***. ......* *... .  .  .\ ..*.\ .. * *\...*..**. .\ . ..*\..  *.*. ...\**... . .#
#            #.\.*.... ..\\...\* \.\* . .* .  ..**..... * \*..**..\ ... ..\.\. .\  *  .. ..*.** ** ..**.*\ #
#            #\...* \*. .. .  .  .... .... .  ... .*. *.*. . ..* *..  \.. \**  *.* .*. .**  ...*. *.\. *  .#
#            #.#\. ..*****. .... .. *.. ...* * ** ..\ ..*  .  *  ..   *  . ..  *** *.\.*.\.*  \****.. .*. \#
#             #  .\\**..*....***. .*. . .\ \ .\. . *.  *\  .*\.*  .\.\  ..\*\  . . .   .  \.**  ..*    . .*#
#           ##*  .. **.  .\.....\* ..* * . ..*. *. . \ .  \..  *.\\ . * \....  ..  \.....\. .*. .**. .*\\..#
#          #*. *..\  *\... \  . \.   **\. .\ .. .  .* ..* ..*\***... .*..  ..**\..\  .*\\...**..**.\. *  ..#
#       # ##.. #\.*\*.**\ *.\.. *. * **..\ ..\ . *.*\ **.\ .*..*\. .. . * * *  ... .  ...\* ..*...  ..*. * #
#      #.#..\  * .. \*.. \* *.  . ..*.*    .\..* . .*.*.  .  *....\**...  **. \\.. .\\ *.*.  \\ ....  *.** #
#     #.\. *  ..    ....**. \  . \* . ..\  \ .** .\\.*.* . ***\\  *.. **. *.\*.. .\ **\... \*.*.*\***....* #
#      ##* ..\*.\\*.\. .* . **    *..**  *.   .. .  ..\.** .\..  .  **\.. . *.\  .* *\.*\\\. .. ...*\ .\** #
#      ##.*\*..... \.   \ *\.*..\*..... .\.*.** . \ .. .. ...\....   \.  *..* .**.\...*..\ *\*.\* **  . .**#
#     #\  . *#. .*.. . *.. .\. *.*..*.* *. .*** \..\ . *\.\ ...*\*  **.*.\. .\*** .. \*.. .* ...*. .*.*  .\#
#   #  #.*\*#\\ *..*   .* *..\*.* *   . * .*. .  \.. \.**..\.. .*.* .* ***   ...  .. ...\ \ . . .   . . *.*#
#  #.##\*... **...\.  .. *. \..\*..\ \*. .*.* .\*.** . .... *\*** .  ** ...** \ * . *  . *   .*\  * *\ *  .#
# #   *\.    *\  * .. .\ ... .  \. *. *   *\    \. . ** .\..*.\. *.** .*..*..\..\.. *.*.\ .*. ..\ ..\*.*\  #
#  ###.. #  ..**.\ .\*  ***\*.. *\ \. .\..*..*\* ..\.*.. . **\....*\.\ *\.. *\  .**..\    * \....\***..*.. #
#    #\*\*# *..  . \***  * .*. *. *   \ **. \. . *\. .*..\\*\ ...*.  *  **\....**.. .*.*. .    .. ... .*.  #
#    ###.   \..*\  ..*. .\  \..*  .\*   ...\.   ** *...\.* **** . ..**...\ ****.*\ \.\ .   . ...  .**\.\.\ #
#   # \.. .* \.* .. *.  *... *.\. . \ *..*.  ..***.*  ..*.*..*.  *\.**.. \...*.R* *.***. .\*...*.... ......#
#    #. #\ # ...*...\.*. .*....\* *\ .*....   .*\***..\.*\ **\.*...*...  .   . ....\.\*\ ..*.*.  * ...  ...#
#    #*\.**. .\ .. .   *..\* \ .* * *** \ \. \.* *... . *. ....*   **.*.** \. *.*  *\ .    **.. .. *\. .  .#
# # #**. .. ...\.\.\ **.\.** ...* **..*.**..*. . *..* . . . .*  . .**...*. *\..***.. . \.*..*.*\* *..*  ..*#
##.#\*\.\.  . *.*.\. *.*  *.*\*.* ..\ \. *  .   \\.*  ..*\*. *. .*.***. .*.* \....** *\ *. *...\\.. .. * *.#
#.*. .  #\ .*..*.   .. .. . .*.....**\ .....\ \*\.  \..*.  **    . ** *\ .\*..  **\**. ** *.**. .\  * ....*#
#####*..#***#*\. .*  .   **...  .* \.* ..***. *.*.*\** \*. *. ..\*\..**\.\.. * *. .\**.\* * .* ****.*.  * *#
#    #\# #.**. *  \\* *..*\ *\.* .*...\.*.\. *. * \ *..*.**\.\   ** .\**\*. .\  . ...* ..*..**......* .. .*#
#     #  #*#\ \.*\..* . . .*.**.*..  ...*.*.\*..** .*..*.\ . . . .\. \...  .\*  *   **.....*\.* \\ .\.**. *#
#         ## .. .\ *...  .*  .. . \.... \*   \ ....\. *. . . .  \*.\ .*. .. .* .. *\ ..\ .**.... .*..\.. .*#
#         #* \ .\#\......**.\ *.*.\. \.*.. .*  **. * **...\* .* .. ..*\.\  . .\**.* .*. . .*.*.   . \  . ..#
#          #.*#.. .\ .\...*. **.* ...  .\ *.. ..**.* *.. \. . *  .. **....\.\ .\* *.\. *. .\..\ .*\ ...*\  #
#        ##\ . .    *\\..\ . * .**...\.. ..   .  *.\** *.*\.*..   * .\  .** . \*.*.\**.*.*...*.. ....* .. .#
#       #\###.\ *..* *.  .\ \..\..****.  .\.***.*. ** .......*.**... *..* **..\\ ...\ *\..\. *..  .\...*.\.#
#       #*## #*#\ \ ..  * . . . .  \.* *\ . .*. \ ..*.*\.\\. . .*.\  .*\  **\. \.  ..  . *  \.   * * .*.* *#
#       #*##.#**...  ***...*** .\.   .......* *\.**\.\* . * . ***. .**.*. ....*. \ **\.* .. .*\ *\ *... . \#
#       #\ . *#** \... \ .*. *.  .\.*\ *  *..\.*.  **\*. .*\..\. .  *...*  . **. . .. ..\ .  .....\ \.. *..#
#       #..* . .**  *. *.**.*..**..\.. .....*. \*  \*.*..\...  **  .. .\    .** . *.\*.\.\  . ... * ..*\ \.#
#      #.#*\ \ .\.  .\  ..  \ \**\ *  *  \ .....**\ ... *. *.. ..*\ *   ..* * .  \**..\ \ *\ .   ..  .\ * .#
#      #\.\.# ..*  *. .*.. .....\ .*. \ * .* .. .*.*...\.  *\. . ....\**. . \..*\\.\.. . .\ \*\ . * .. *..\#
#       ##* .. .*. ..  ** \  *  \... .. ..***.  ....*.\.*\.*. ....\* *.\**.. \.. \ .****..* \.* .. *.. *  *#
#        #*.** .*.\ \ ..\.*.\.  . **. ..  \.\.  * . .. **.\.\ *. \.  .  .*...\*\ .*\.\*\* .\ *.*\. . *..  *#
#       #\\ *\. . .   **..*.** ** .\  .    * \ .*\ \  *\..  *.\ *.  \  \ ...\*..***\*.*.\. ..**..  .*.*\ .*#
#     ###.\**.*.** *. ..\.. ..\*\.*  .*. *** .  *  ....*\. \ **\. .*  ... . *...\*. * \. . . .**.   * ... .#
#    # ** .*. . .  . ..  ** *.\.* .   .\ *..\ \...   *. *\.  .*.   *.\.\* .\.\*\.\.*.\..\.*  .....\.\...\..#
#     #.* .\#. . .   .\ ..\ .*.*.** \.\......\    *  .**....*\....   .  .\ . .\.\.\  * ....**.* *. * ..\*..#
#     #  \ ** ..  \**\.   .. .\..\.*. *.. . **\.  ...\ .*   .*   .\. **   .*\*... *\..\ \.\.  *.*\*.*...  \#
#    #*\.#**.  .. .\.. \   .\...\*.\  *** ..*.. .* .\   ..  .\.***..\.*\ .* .... *.*.*...**\.    .. ...\.\.#
#    #.*\# ..\*.\.\.* *\..   *  ..   *.*.  \*.*...* *    *\ *. .\..*.\  . .  \ **.*..... *.*\.*..  . *.  . #
#     ####\ .#\*.**\.*\.  \ . ..*...*\.. .  .*.**.*. .\.....\. ...\. \*   \ *. ....*.\*. \.  * \\   .**.*. #
#      #*\ ..#**.*..\*...*  . . ..\*.\. * .\.*...*.**.\.\ . ..*   . ...   ...  \.*\.  *...* *. .. \.\.* .  #
#       ##* . # *\.   **.* .\ .  ... . .. *.\.\. .*.\.  .* *.* \*  . . *. .\*.. \... *... . .\....\. \.  .*#
#        #.* ...\ \\  .* .\ **.* . . * .... . .\ \.*.. * .\**. ...  ....*.. . .*.... ..\\.  .* .  ...   . .#
#       #* .... .*..  *\. .   ..**  .\ * .\. ***\.**.*\**. . ...*\..\* *****  \\ ** *  *   *..  * * *  .* \#
#      # \ ##* \*##*\ *  ..\  \*. \.\.\  \ .*  ..*.  *\*..* .\ .\.* **\.\\..\ .\*\ \*.*.  *\* *\*\..*\* . .#
#       ####*  ##  #.#\** . \*  *.\.** ...\*\\ .*.\.** .*..**..   ..**.*.*. **  ... ..\*\ \ . \**.  .*.  .\#
#         #*. *# ####\#.. .*.. \.*.\**\*.**. *.\***\ .\....*..*   **** .**.\\.  . *\  * .\...  *\   **\.  .#
#          #### #*..#.     .\   .\...*.\.**. .......\ ..*  . .**. **.   .\*  . \ .*.*.*. .* * .. .* .***\ .#
#           #*#  # ..#.  \  ***.   . **. \*\* .\  .\*.* . . * .  *...  .. **\\ .. *.*...  *\*  *.* \\**.***#
#           #.###.\. ...*.**.\\ ..\  ......... .  .. *..*.*.\ .** \.*** ..\\.  .*\. . *..*.*...*.\.*.*\.. *#
#          ##. .#*.#  *..*.\.....  **\.\*  \** .\  .*..*  *. *.\..  .*. .*.\.*  * \*... .\**\. ..\.*.. . **#
#         #*   .#*.  *..\*\. *\ \...**  *... .*  . ..*...... ..  * \ . \ .. *. ..\..*\*\\*...\  **\**.. .. #
#          # ...\*# *. .*. ..*  \ .*...*... *.  .*..  ..\**.  .\*\ . \ ...*\.. . .*.**. *. .*\.. . .*.   * #
#           #.*##* **  \\ \ *  .  ..*\  *.\ ..**. .\ . ..\. *  **..*  *.. .\* ..**\*..\..*\...*..  **\* \. #
#           #*.\.\  .*.**. *.\*  ** *.. *\*...** .*. .\. *....* .*. \.  \.  *..**\.\ .**..*.\..*\  * **.\*\#
#            ### *\**. \ \ .... ..\ .*****....*.  *.***  .\ . .*.\. . .\.\. ..\.  \   \  ... \*... * .. .. #
#               #.#.* \ **\  \\..***\*.*... **...***...* . .\ ..* ..* ...\*. **  .* *..*.* \ \. . *..\* ..*#
#               #..*\  .*\   ..**\ . ....\*.   \*.\..\ . .  .*  * .** .  .  *\*\ .\\.  . ...*.   *.* ** .*.#
#               #*.\#..\.*.*.*... ... *.  .\  .**..\**.\ **..  ....*\*  **...\. **.\ *. *..  .*.*...*.. .*.#
#                #\#\.\. *.**\   . .*\.\..**       ** *\.*.\.*\ **\.** \*  *\**.\... .*\ \...*.*****.* ..*.#
#                 ##\  . .*\*  .*  .\***  *\ . *. .**\. .*..*.* \ .\.\  * .. ..\ *....*.*.***.\... . \. \..#
#                  #   #*\*.*\**...\ \ ** . .  *\  .   ..\\ \ .... . *..*.*\\*. ..\*. ... *..\.**. ... *.\*#
#                   #\. * .*.**.\ ..*. . . .\. .* *. .*.*. .***\   *.. \..\.* .\ ..   .*  \*. * ..**. \....#
#                  # . #\*..\.*...  .. .\ *  \ *.\.** .\.   *...*\ .  ** \...  .*  . * ...... \ \ .\*\..\ \#
#                 #*\.#\*.#.* \. \  .\.   *  .\. .*..  .   .* .*. * ..\. .\.*\. . **.  * \ \ \.\..\ * ** ..#
#                  ##*#*#**\* .*.  ** *\.* * *   .\    .  \. ***.*. ... \.. *. . .. \   *.\..... *.\....  .#
#                    ##*..\  * \. *# *\. .\. .\*\  ** *\*.   ....*....\ . \\*. . .\...** * ... ..\\*\ *  ..#
#                      #..#\.#   *   *. .  . \*.*. \  .* .**. *. * **...\* *. .* *.*  ..*\ \...\. .. . *.*.#
#                      #\#.**###\ .**.\*. *. .**..** .   ** ...\*.* **  *...*. ....*** *.....  *....\..* . #
#                       ##\###.. . .. ..\*. .\* *  . *..*.*.**... . .. *  \.**.* * **.\*  .\ \ *.** . .  *.#
#                         # #\ .  \.* \ *** *.  . .*.**\ . .. .*  .  *.*\. .... .\ .*. .\**..  \ *.  ..  . #
#                           #  .\* ..  ..*. .*.....* .... ...*\*** \ . \..* .\\\  .\*.   .* * \.*.. ...*.**#
#                          #. .*.***.  .\*.... \...*  ..*\ ..\ *.  .*.\.* *.*...\.....  *  \. . ..... *....#
#                           ##\##*\.. .\*.  .  \.... . ***.  **\  **...\... .\...*\*...\ \..   *  ..\*  . *#
#                           #.. *.* . . \.\*.  .* ..*. *.. .**.   ** \ *\\.\ *  ..*.*. *..\ *.*.\*\  *  *.\#
#                           #\**\ . ...*  . ..*.*.. **\. \**\.\.**.* .\.**..**.*.\ .*.\. \  . .  .*... .\  #
#                            #*.   \\ \***.  .  ...* .  .*.**\.. **..   ** **...\...\. \* .* \*......*\*  .#
#                           ## \ ... \....  *    *.* *** ..*..... .\.**. . .*\..\\ \ .\.* .   ..*** \.*..**#
#                          #**..#.\  ...*   ... * *\  \  *  * \.**** ..  ** .*.......*....* .\  * \\. .\..*#
#                           #\*##*. .\*.*.. * *.. *.*  \*** .*  . *\ .  *.. .  *... \.. . \*  ....*.    .\.#
#                            ##  # * #  * * ..*. \. \.. *.. *\ \.*...* .** \* * * . *. ..\ . \   *.*\.*  .*#
#                                 ## *..*\* .*.\ .\\.*. \.  .*  . .... \*.  \ .. *..\.. \..\\  . \.. \.\ ..#
#                                ##...\ ... *..* .** * .. ** .   ..* *\ .\ ...*..*.**.. * *.\ ...  . .**  *#
#                             ###* .  ..   ..\ ..**. \ * . .**.\***.* ..*.\.  .*.  ..\.** \* ..* .**.. .  \#
#                            #* .\.*..\ .\*\. ** *..\.\* *. \. .... .**  . \   * *\*.*.*.\.*.... *. \..* ..#
#                             ###### #**#...  .\.*. .  *\.****.* \ ..**.\........*.**...  \ .  \**  ...*  .#
#                                   ##.#.\##*\* **. . \...*.*\.** ..... **.. * ..\..*.** **.  ..\. \.*\* * #
#                                     #  \*##*...\*\*...*\\\*  ..\ ** .*.* *\  *..*.*.*...**\.* .\ * .*.\*.#
############################################################################################################