################################################################################
#* *.  *. .. . .**. *.* ..*.**.\*.  \..* ...**.\..\ *\*.*.\ .\*\**  \. ...  \.*#
#*\.\ \. ***.*.*.* **.*.. .\... \. * .\. .. ..* * ..*\*\ *  *.**** .\ \***.*.\.#
#. .**.\ **..*.\.. *..*\.  ..\. . .*.**..*  * .  **\*.* .\.....\\*\ \   \. \ . #
#.* .\ ..\*.\\ .* \.* *.*.\.*...*  . .\..*. .*    \.*\*  *.*  *.*..\ .  ...  **#
#*. ....*.. **. .*.* .*.. . ...*.. *.   \.**\.*.* ..*..\\.*. *..* . .  **  ***.#
#* . ** ** **\..*. ..** . .* . **.*.. .   \.\..*.. .. **. \ ..  ..  *\..** *.\.#
#..  .* *. .*.. .*****\    *\\\. *  ..\\**.*....*  .*..** .. ..  \ \.\ .\* \\ *#
#  \\***\*\ .* * *..   \  \*.   ..\\.* *...   *.*. **. *\ * .\..  ... ... . ***#
# .\\*..*\.  \*....**.*  ..*.   .. .  ..*. . *..*  .* ... *. * . \.\... *..\.*\#
#  *... . .** *\ ..*\..\*. * \..*.**\.* *..\.*\..  .\*.  \..  .. \ .. .\.....*.#
#. \.**.  *.*...** ... .\ ..*\ .*....*\..  .*\ \ \* *.*\ *.\ *  ...***..* .**. #
#*   \.  .* *\ *.. \*. .. .**.\*.\ *\\..... .** ..* ..* *.\*... \.**..* \ .***\#
#  . ** **\ .   .\* ..** . .*.. **.   * ..* *.   \. *..  .*\.. \**... . .\...\ #
#**. ..  \ .   .\ *. *...    \.\..**. . .*\*...... .**. ***\ ... . .\..  . .* *#
#...    *. *\.*  ..* \\\   . .* .\.*.*   \** . ..*. *.*.\.. *...... *. \ . *. .#
# .*  *.*.*..\.    *\. *.*.  *..\* *..\  ..*\*.  \ * *.**. .*. .   *.* .\ .*.*.#
#.  . \*.\*  * .*..*..* *\. .... * *..  *.\ **   .*. ....**  ..   ...*.   \. **#
#\ \*\.*.\**.. .. \*. .*.*..*.....\*\.\ .... ..*.*\..\*\ *...\   .\. **\ ..\*..#
#.*\* *.  . *  .  \. ..*.. .\. * . . \.*. .  \ * * .. .* *\  ..* \ .*\ *. .*...#
#\**.*  .  .\ .*  .\      **.  \\. \\ \**\\ \ . *.. *\.*  . * *. **\ ***  *  *\#
#*. \.\*.*..**...*.*\*\* .* *. .* . * \.\..\ .\...\.*.***.  .\. *..... ..*.\ . #
#\ \. **..*..* * *.. . *  *....*.   *.*. .\. .* *.*....*... *   . *..\*\*. * **#
# .* ..*.* **.\.*..*  \**...\ ....\.*\.*  *\* .\. \* .**.*..*....... *.. **\.*\#
#**..*\..*.  .   * ... **.\ .\*  . . .\. ** \ .  ..\ ...*.. *.*   \ \. ....  .*#
#..*\   *..*\..\\*.**\****. \..*.* ..\*\\\...\*\**..****.* .**  .. . .  *\\*  .#
# \*.  ...*\.  *\*. . ..*. ...*...   .  * *.** *. **. . . * .   * . . .*..*..*\#
#. ..\  .\* **. .** \ * *\*\**.** . .*\*.\***\..* ..   *  . .\. ..*  .**  *.  .#
#.\ ..**\.**\*\. *... **. * *\ .. .. .\*  \*..  .*   **.* .  .. *\*  \   . \.\.#
#*.  \*..* .... *.. ..... . ..*\  * .* **\ * **.*..**.* *    .* * .. *.\ .... *#
# \....\* ..*..**.   .\..*\ \ .\*.*.** **..\**. * .***.\ ..*.*\*\ . .\ .  .  ..#
#\.  . . . ..\.*  . .*** ..\. \.* ...**... ..* ..\*.\.. .*.*.\  .....** . \. * #
#.*.* *.. **.* *   ***.*  .*... .\* ..  \\*.*.\ . ***.\   \.... .... ..\*.** **#
#..* \*  .*. ..** \....\  .*\..*. ..\    ...* \. ......  \.\ .   .\ \...\.  \*.#
#.\. ..*.\.\ . .  .*...*\. *. *.\. ..... **.. .* .*  . **.\ \. \**.\.*... \\...#
#\.* .*** \. ..*..\...  .\  \ . \.**..\...\.\ .*  \\ .\*..... .\**\.*..\  ...\.#
#.*.\.. .** ***..*  \ *... *. ..***.**..* .\.....\  .   . ..  *.**. . ..  * *..#
#.. \\. *.. .****..*... ..**  . *\.** * .  \** \ .. *   ..**\*..*\* .*.... ..\.#
#\  ..\ ..  .*..*. ***..  *\ \ *.. *. . . *.\ .. ** *  .*.*\ *\* *. . *\. .\\**#
#*R .\*  **. .* *  ***.* ...  **.. .*  .  \.  *\ .*.\  ** \.  ...  ..\.\ ...  *#
#*..  .. *. *\\ . *\. ** .**. .*\ ...*\\.\. .\*  ....\ *.   ..  . . . ..\\ .**.#
#\ .\. * ....**\  .. \.. *.\..\*. * .*. ..\. .....\*. .** ..* ***.  .*.**.*.\..#
#**. ..\ .*...***... .* ..*. *... .. \ .  .*.  * \*.* *. .   \**...*. .\ *.*. *#
#.\ . ** * *\.*..*  *. .. *. .       ..*.   \.*.*..  \. *. *. .  ..*** *..*...\#
#.  *\.* .\*. .*\.\**\\... .\\  .*\ *\*..\.\ *.**.\.*.*\.. *.    **.  **   .* *#
# . ..** **. * .  .* \ *..**... .*..*..* ....\ .... .* .. **..\*** *.\*\*\\.\ .#
# * * .\  ..**.*.\\  .....\**\  \...*\..   .......   \ .. \. .**.*.*\  *. . * *#
#..\.\\..\*...*.\.*..  .\*..**  .\..\ **\.. .  .. .. .*\* .* .*. ..\. ..*\ \ *\#
#\ \ .* * .*.. .*..* .* .*\..\\.***. *...* .*\..\\.\ *.****.\**\*  ** ** .\. ..#
#*\ .*.*.  **  *.**.\*.*    . *\*.* *****\  ***...**\*..**.* *\..*.\.**\.*  .  #
#*.*..*.  \ .. .  . * ..\ \.\*.*. .**.\..... **.* . .. ... .\.* .\* .\ * . . .*#
#..**** *\ . .   .  . *\  . .*        .*. .**  \ ** *.  ****..*\\.. \*..\  \.  #
#\. .** . .. .**..**. ..* .  ..*.....* .* *\*...*** .*\ .*..***.. *  *\.*..***.#
#.\ . ...\ *.. . .*.\ \\..\.   *.*\ \..\* ...* *\*   \ * *\.* .. \\. ***.. ***.#
#**. .* *.  ...*.**\\ .*.   .  ..*. .  .  .* \ * ..*\.\. ..*..*.\.**....   ...*#
#..\. *\.\.\* *.**.\** . .\*. .***.*. **.*  \ .. ..***.\.  .\**\ *.  .*\.   . .#
#  \*...**\ * \. . .** ..*.* \ *.  ..\** . *.  ....**. ..\ ..*.*..\ \*.\. .*..\#
#.  .\. .*\ ..*\ . ..***.\......   * ***\ .\..\\ ..... .\*..*. *. .**..   ..\ .#
#.\ \* ..*   *\ *  . ...* *.* * .....*.*. *  *  .  \*\. . \.*. ..  .**  .*..   #
#. .*\ .*.**.\  ** \.*....... .  \  *\.. .* ..\   . \ ..   **.*  .\. .\.. . ***#
#*.**. .  .*..* .*\ \.. * \***\  .*\.. ....\*.* \ . . \   *...**  . .\* . .*.*.#
#\ .* \*\ .*. .. * .* .\.*.. .\ .\..\     ...*... .....**..** *.* .  ..  * *. .#
#.   *. .*..**\ *...\. **.  .\ .* *  \ * * * .. . \ .  *...\. ....*.. \. \..\ *#
#\. \*  ***\...* *. **.*.. .  *.\.. *... * .  . \* ** .  \.*. ..**.     . ..*\*#
#.*\*  *.*.* .\ ..*\.* **\..*..\ .  \.. *.  .. ..*\.*.\ \  *.*. ..\** * *.. *..#
#. ** * \*.  .\  *\.*.\ * . .\ .. . .  \.  .\... *. . . ..\.*. . ...**.\.*..\.\#
#.*.* .  ***. ..*\.\.....   ..* .*\..**.**\ .\...*.**.    .*.*  .\\.*.\ ..  **.#
#..*..\. \**.  *.. *   .  *.*\..  *....*...*.*  \ ..\*\ * .. .\   . . \.**.*.* #
#* * .  \.. * .. \...* *\..\..\..*.*.*\.   **.  ..\  **.....  *.\  . \.\.\ * ..#
#.\. \.*..* . *  ** .\\\**.*\   *... *..\ \...\** ..\*.\...  .\ . **. . *.\* \ #
#..... *. \. .\.\. \ ***..*. \. .**\.. *. .* * *. ...\... .*\     .**.  \ **   #
#*.. ..    ****  . . \*......* * *.***.  ....**.*. \ *\ .**.** ..  ***...**..\ #
#. *  *. . .. . . . .... .****.* . *\.*.* ** \\ . ..*.**\***..\*...\.\\ **..  .#
#\*. .*\...*  .*.  * . .. .*..\.* .\. \.. . . ..*.  ...\.\.*   *  *  . ..\.\  .#
#**. .*\*****\\**\*.\ ...*.  *..**... \ .*.\ \ *\.*.. .\.***** **\ * * .\.*.\.\#
#*.\ .\.**.* ***.*.. * * . ...\ \.**.   ..** ***** .. **   ...* *. \ *\** .*.\.#
#....*.**.*... .*****.*.\ \..*...\*.  .\. ...\\...... .\ ..\ .\\.. .*.*... *\ *#
# ..\**..\.....*. **. **  .. **\ *. *\ .\ *. ..*\. ....**.*..*  ... . *. * ....#
#. \*\. .*. * *\ \...\\.  *. **. \ .**. ..   * *. ...**\.*  *\   .\ ...  **   *#
#\....*... *...*..\  . . *\**** ..   *    .\.*.* *\.**\**. .*.*  . . \* .\.. ..#
#.\ *.  *\*** ..*.*  .. \ .....\.*.. .*...   *.\..\ .*... . ..\.*.\*..*****\  \#
#.\**  \ ..*.\ .*..\\.. . *\ ....*.*..... ...\  . .\*..\ ** \ \ ..* \.\.\.*.*.\#
#\*.  *. *   *. **\ *  .. . . ** *  .* .\*\* .\.*.. . *. .\  ...*\.\*. \ ...* .#
#..\.  **.*.** \*. .. * *.. .* *..*****.....\ *\   . .\.... *  *.  . .*   **\\.#
# . \.\*  . .*. ****. * . \\ **.\...\..**...*...\*.*\*  \\\** ...\** **...  *. #
#. ..\* \...  . ..*..\*.....*.. *. ... * . **** *.*.*  \. .*...\\.*  ....*\*.. #
#. *\.\*         *.   .. . .\\..*..*\ *...\  *..**.   . \ \*\*..... .*\... * . #
#.* .**.*.*\*\ .  .... ..*\ . ..* .   . \..  \*\*.\*.  .  .\ *.  \ *.\**.  .\*.#
#*.  . ..*\..  * *..   . . . * \. .*\.  .    .*.**. * .*\ . ... *.\.....     .*#
#.*..\ .*..  \*.  *...  .* . .\    . ... .\ . \.**.\*  . . * . .*...\ *    \  *#
#* *\.\* . *.\*\..... ..* .   **..\ .* .  ... * *\\*...\. *.\.\ \. . \ \... .**#
#*..\..\.  .*.*. .  ...\..  .\...\.*.\.*. \\*\. ** ..\ * *\. * ...** . .   * .\#
#. . \ . *. *.. ...*  **\.. *.***.*.  *.*\\.* . \. \***\ *......\ ..*. *.\. \. #
#\..\\  *.* ..\ ..\..  *\*\.\ .\. *.***.*. ...\*\..\..*. *   .*. ***** . \ . * #
#*. *..*.... \.  .. \  .. \*... \. . ** \*.* \..    ...... ..***.*....** .   ..#
#\*.***\*\.\.... .  .* * ..  ..*.*..\.**\ *\ \. ...*\*. **..*.......\ .*\**.*..#
#*..*\. ...*. *.*.\.* *.\ *   ..*...* ..... ...   ..*\.*\*  ..  *. ***....   .\#
#.. ..... *. \...  ***.\ .\..*\...\. \****.    .*  .\ *.*.  \ .\. \..*  ** .*.*#
#.\.  .. ....** .. **.. .*** .... \  ..*. \ \ . .\ *...\.*\ . * *\.* * .*.\ **.#
# . . .* ...*\ * \ .\.*\***. *\ \\. .*. * .*....*. ... *... .\.... . .*. \.   \#
#*.  .\..   \..\ .\\   ...\ **\*.*.  ..\*. . . \. *.\ \ .\.. **.. .\..*\*.. . .#
#\. ..  ..\..**. ***.*\ \ \.*..    ....*. *  *..*.  .*.***..**.**.*\. # *..* **#
#. .*. .  * **\*\ \* **\. .\**...\..* ... *\.***** .\.  ..\ \.. ..*   .*..*. \.#
#.  ....**.*..*  *.\ .**\.  ..*... \**  .*\.\.......** **..* *.\..\ *\*..\.  . #
#  \ . .*.*\*\.\ . .* ** \. .*.* . \.. .\..\ *. *.*\.* ..\ .\.* ..****. \ .\*..#
#\.*  . \*. * ..\. .*  \ .....\. \*.  \ .*.*  .*.*\* .*  \\ ..** **..\ .#.. .*.#
# ...\ ..\  \.* *\*..   *..........* ....* . * ... .\ . ...* .\.....**.  .*.***#
#*. *. *..** * *.** . ...*\****.. **\*. ....\... \. ..*  \ .  .*  **.. . ** .*\#
#*  **\*. * **\***..*  * \.**. \\...*.*. .* ..... . .. *\.....   ***  *** \  . #
#....***... .. ..**..***\....*.\  .** *.*..\.*.*****   ..*. .*..  ## .\.* ## .*#
#*..*.*.. * . .. .\ ..*  **.** .*.. . *.. *  . .* .*.*..\.*.****.\  .  ..*## .##
#** \ * \*\.**.    *.\*\*. ...\\... ..\** .. **** ..*. ***\*.*\.  .#*# #*#  #*##
#.\. *\ .  ..\.. .*\ ..   \*\*\..   .. *..\\....   \*.*.\ *.****\....*#..#   # #
# .\ **  ** ..**  \.. .   *\ .   \ .\.. . .*.*. .*..\*. * . .\.\#\  *\*\.#     #
#..* .  .*.\ ***   .* *.*\**. .\*.\.*..* *  \..  *.......   \*## ##...###      #
#*.. . .*\.#*..... *.  ..\..* .*..* . .\..  . *.  .*\.\.. .. . *# #\.. #       #
# *.. .*\..... ....*\ .  *  .** *\***  *.. .   .\. \...* . .  *.# #*#.\#       #
#\* \  *. .\  .    \* ***\*.*..**.. . ......  \ . * ***.\.\.\ \#\# #\ #        #
#\   \*.\. .... \*.*  *...\*..*.**. .*. .  . \.*..*\.. . **##*.\.#  ##         #
#**   ... .  ..*. .\. * \\  ..\ \.\ *.** .....\* *. ## \#* ..####              #
#..\ \  \ . . \*.#.. .. *..**.**. .*...   .***...*..*. \#.  #                  #
#... .*..* *.*#* *\*..*\.... ** *  *\..*.\..*.\ .\ \#\.##\..#                  #
#\.\ \. .*\. *..*\.\ .*..\ *.#. # .*.....\ . ... *.#  *# ###                   #
#**..*.\\...#.#..* *... . ..*.\... #*.****  .**...\   #                        #
#*\. **.\..##*\* .*\*\. **.#.  ..* .. .\.\.  *#*#\* . #                        #
####..*...***## ... ## .*   ##\#\\ .  *. \ .\*#.\ .  #                         #
#   #.# *..* # #..*  *\...**  *# ..\.*.. \.**##.*## #                          #
#    # \#*.***#  ...*.*..*..*#.#\**#  \ *# .#  ##*\. ##                        #
#     ## ###.##\...*\.\ *. .\\ #*#\* \ *#\.#     ###\.\#                       #
#          # ## \  ##.. #*\# .  .#*.....###         ###                        #
#          #.#.    #*\ *\..#*L#*##.*. .#                                       #
#          # ####..## *#.## #  # #*#* #                                        #
#           #   #.*# ## #         ##.*\#                                       #
#               # #                 #.#                                        #
#                #                  #.#                                        #
#                                   #.#                                        #
################################################################################