#################################################################################################################
#..... . .*.  * . *  *   ..**.. * \ \ ..  .*   .\*.*..*. * .\ ..* .*   .\.  \ *......   ...*..*.#               #
#   . . .* *  \* \*  .* *\ *.   *..** .\.\.. *.  .*. .. \.. ..  \ .. ****.  . ..*.\.*..* .\.##\.*##   #         #
#*\.  . *. . \.. * ..*.\.****.*..  ...\*  **..  . . ..  .   .*\ \. ..\*\. \  .* .* .. ..  .*** ....# #.#        #
# * ..**.... ..  . * .  *.....\*. *  ..**\...**. . . *.*.*  ..*\. * \*.*.*  **\\..**.* . ...\  \ .###\.#        #
#*..*\.. .**..  .\..\*\ *\.\ **.. * .**   * **.  \ . .\* . . * . .....\.*....\ .\...*.*.**\ .*  .. .#.#         #
# .\\ *.*..* * .\*.*........... .***. ..  .  .\ .. *.\. .  .*\ * *\ \\*\*\   . .  *\\ . ...*.  \   * \ #        #
#\ .*. *.\ . ..\ .*\. \.  ...* .\*\ . **. * \..... .. . *........\.....***... *.*.\* *. * .***.. **#.##  #      #
#.*..***  . *.\*\ \...***.  ..  *.. .**\.\*  \\ . ..*.   . ...\ . .   *.*\.  .**.\... .** \... *\\..*####.#     #
# .\ ..\.* ...*. \   ***..  .\. ..  .**  *.*\..\ ..*\ **     ..*\.**\. .*.\***  ..*** *.* *.*. *# .*#...# #     #
#*. .. * .  .  .*.  ..*. .***.*   *..\.**. ....** *. .. .*\.*\ ..***...  . ... .*\.*..... * * . . *..\#  .#     #
#.  \* \       .** . .\ ..*.** . .**. **\  *\ \.. .\*.**.** ... \  .  .. \ \  . .  ... .* . .\  ..\ \#*  *#     #
#. . . *....  . .. . ..* ***\**  .*.\.*.    *\ .\ \.\... .. ..  . *. *... .. *. **.. \.\..\*.*.     ..*.*.#     #
#*.\ *.. .  * ... .*  **.\...* .\..  .. .* .**..*** *.**..* *..* ....\ .\.. .*..*.*\ \*.\ *..\  \.#*#*.  *#     #
#\*\  ..* **.\.*\*\....... .*.* .. .\.* ..* . \*.  \....*\.*\*.*\*\.\. *** \ .**\*..  \.* .   *..\*. .***.##    #
#*\\..... .. * .*. *\*. ..  ...\    ... **..  .\ .*..** .**\*..*\.\. ..*\.   *\ *. \*** \.. *.* \.*.. ..\*.*#####
#***.*..   .*\*.*.\...* *\*  *... . ** .\*. .*..\   ..** . .*.\*.***  \** *.*.  . ..    . ..*..*.\\ . *..* . \* #
#..\ ..     . . *  ..*.  .. \\..**. .. \.*   .** .... ..*\*.. ..\ \.. ..\ * ..... \ .\ ... *. .*... .\.* . \ #.##
#.. \ *.****...*.  . *   **  *.... . * .*  *  .....*\..\. *  ..  .. *. .* .\ ...   . .*\* \. \ \.\* .*..\   # # #
#* * *....*.  *..  . .*\.* \...\.*\. .**\..* * *.. * \*..\.*.**   ***  .*. .\. . **.. * .  .. \  .R. .. .\. #   #
#... \  .\*...\ *...  .**.. *\  .*. . .*\ .. *\.\*.. *.*\...  ..*\*.. . *..\  ..**   *....  . .*\ #*  ..****#   #
#\.     *...  . .******.  ..*.**\*\\   .. . **.. ..  .*. .    \ * ..  * .** . \\.\ *.**. \   . .**  \  \****##  #
# \ ..\**..*.\....*.*.\ **..**  ** ..\ * . .. \*\   * .\...\ *. ..\ . *...*  .*. ..*  *. . .*.  .***#\*#*#*.. # #
#\ .  *...\*...*  .. .***..*.*\ *\  .**.\..** \*\**..*.* **.*.\  \.* \*\..\\.*.***.*.*..*  ..  .  ..\ ##*.*#..# #
# .  *.\.\ .  .\\ *\*.*.....*\.*. ** ...*.. ..\.*   ..*.*..***... .\ .\\* ...*\ *.\... *.\ \*\\. *\*\ * . ####  #
#..\..   .   . .... . \*.  **..****.  *\* \.*.**.\ .. . *. .\..*.*...  \ .\....*.. . \*..  .  . .\*.\.*\ #\.#   #
#\ .  . *\. .* .. \. * .. ..***. \.. .  \** ..**.**.\.. .   . *...   ***.* *  .**\... .    *.   ... ** .*.*\.#  #
#* ** .\.*  *..*. ..\. \* ..*.\  .\. . ..\.**...*..  \*. *.* .\. . *\*....\*\.\.  \.. *\ .*.\.  #\**\ \\.**##   #
#. *....*. .\.\..** * ......\.  *.*   ** .. ... . .  *\\\... \  **....*\...\  *. ..* \ **.*.*\.** *\   *  *\#   #
#\.*  ....\*.*   *\.. ..\    .   ..*.\..** \* *\ .  *****. ...*.**\. \.... . *..*..*  .. *\\*. #* .. . . ...#   #
# .\ ... .\.  . .. * . \.***. **. *..\ .*\ .\* .. . ....* *.*. *.\ *.*...*\.*..\....... \*  * .*. .*\* * . #    #
#.\* \* .*. .\..  ***  .\.... **..* \ . **.\..\.  .*\. *.\ \*  *. ..\.. *.. . ..*  ***.\..\.. *.. .**###.\.#    #
#**\. ..*.. .. *\**\ \*  \. \ ..... \   * *..*  .  ***.\ . ... ..\*\*....\.\**\****... .\.**. .\  ..##*.\* .#   #
#.*.  \.***.  .*...** ....*\ \\*\.*. .* . . .. . **...*.**  .  \* * \ **.....*..*\*. .  .*.*.. ... *\*.#####    #
# .*\...  ..*  ..\ . \*\ .\***\ * .. \*. \ .  .  .. * . .. *.** ..\ ..\..* ..\**\ ** ..*\.\...   . ..#*##       #
#. . *.\.\..*  .*.  *.. ***\\  . ...*.\*..*  . .\ * *. \    \..*. *. .* \. * .*. \.  * **...\.* .**. *.#.#      #
#..  \. \ ** \ ..\ .**. .\. . **\ . .. ..*\ \  .  .  .   ..* *.    *\\  .*... .*\..*. ..*.  . . \.  ..*\.#      #
#..** . *.**   \*.\..\   * . .*\ * ..    .....* .** \.*. .*..*. \. .*\ ... *  .* .  * .   *  .*\..   \.. \##    #
#  * . *\\.\... ..*  * * *.. .\*..* .\...*.  *  *.*\ *..*\.. *.   *\..  **.  . .\  **.*.*\  \ ... \\*.\..**\#   #
#.\..\ . \.**\\.* .  . ... .  *..*..  .**  .*.\.\....* .* *. \**. * .\.\***..*  . **. ...*\. .... .. * .*.##    #
#\.*.**.. .* *  \.** .*...*...***..*..*.*****..    .  *..... *...*. .*.  **  *\  .** .*  *...\.*.*  **\.# #     #
# .*.*..  . .\*\ *.*\ ..\**\.....\..**.*****..  .***..* * \  .  ..*.*  .\.. \.*\* .\ \* ..*.  *  ..*.*.*.\ #    #
# \* *    \. **\\* . .\..*\** *..  .*.*.\ \. *.  .....*\.    *  **.\*\** ...*\ ..*  *.. *..* * * .\*\  . .#     #
#  . . ..\ *\..*..   ..*..*...\.\*. ..\  *.*.    * . * *\ *. \*..\....*.\  \..\. .  ..\.. .. *\* \ \..# *  #    #
#.*\..    \*\ ...  .\.**. .. .  **\. ** \\*.\ \  .\ \.*\. .**...*   .*.*.**.**..\\.\*\..*\*\ ..  .\**  * L\*#   #
# ..  *  **. .*.  \.***.. .   \.\.   ... ... .  \  ..*..*  *. ** .\ \*.. .*\* \\  ..*   . \.\*\   \\*. . ..#    #
#\ \\ . . \*..   *.\. .*\**\.**.  *...\..     \.\ . *..**.\.*\. ..\\.  .\ \.*\ ...* \*.\  *  .. .\..*\* .* #    #
#\**\.\ .* . *   * ...  ...*..*. .   . .. \..*. .. *.**\.  \ .*. . *\..\ ...* . ..\ * \ \ \ . . ....\..\ .#     #
# ..   * ..  *. *. *\ . *\ . *.*..... * ....\**\ \ \\..\..*..   ..*.  . ..**\\*.* * . .     *.\* *....* .*#     #
#* *   \**..\.* ** *\\*\** .**.*. \ .*.. **\ . **.*.\ \ .\ \..**..*   \*  ..  . .***\ * *..\** *  *\.....\.#    #
#. \ ....\.. ..  . **\ ... *.\.\.*\  \.* *. .*..  . .* .* . *..*. ... .* *. .**. .*. .\*. **.* . .. #*..*#\#    #
#*. ....\.*\*..***\*..\*   . ..\..*.\ *...**\.*\. .\*\ .**\ .  .*\...* \....**.\.*. .. .* .*.\ \* * \. #\.*#    #
#.  .*\ .\.**. ..\..*\ .*\..\..**\.* .\ .. ...*.  **..  .* .**.*.\*... ..**.*. *.\. .  .* .... *  . ..*.* #     #
# *  .....\..\. \* \*  *\. .*.  .\ *     \.\* . . ..**\. .  .\ .  *.. * * *\. **\. * . ..*     *  . .\*###      #
# .\** * \ . ..\ *.. . \.*.  \.  ...  \.*.  .  .. \  .\..    ..*. ... .. *\.   .\\..\.\.*. * .. ..\ . ##        #
#. \.\.... *.  \\... \*   .**.    *  *.\\ *.  ..* *. **.. ***.*..\   \**. . ..  .\   \.\\.   * *   * \*.#       #
#...\*\. . ..\*.  ..*..* **\.. .*\\  .   ..\....  ..* .* .*\**.  ..  ..* \**    .... \*.**.* \ *\ \.\###        #
# ...\* \  \.. \..* \.  ...*.\.**** \\ ..\  * .*   ..  *\** .*. **...  \   \  .\*..*...\*\..\.*..\* #           #
#** \  . .  ......  .*  .*\*.*.**.. ..*.**. . ..*\...**. .. **\.*.  ... .\.. ..*.. .*... .  . *.\## \#          #
#\* .\ .  *. .\.*.. ..\. * ..*..*.**.*..*\* *\.*** .....    \**\.*. .*. * **. .**\*.....*\...*\ ..*.#           #
#\*. .  *. .. * .* *\  ..* * * \........**......**  \. . \* *.*. .. \.*. .\.\  .\  *   *. *\.*   .**#           #
# .    \ *.*..\. ..  *.. . .\..*..**.....\.    * \*.. \ **.*\ .*** * \....    ***  . . ..*. \*  .* \\#          #
#\*. *.. ***  .\* .*.\ .\ . . \*\ ..\.* *  . *..* **. ..\.*  .\... **\.\..\ **... **  . *\.\. . .\ ##           #
#*.**. *.***\ **..  .* * .\* .... ..* . *..* ....\*.  . *\ *  ..\ .*. ...* . .****.. ***..\ . .. #.*#           #
#. ..***\** *..* \.  *\. **..\  .\*.. *\..** .\ ...* *\*.*. ..  *. .\  ***..*.\.*. **.\... *#*#*\.\*#           #
#    .\*.. .*. . .*..\. \**... .**.. .*  **.. .**. *.......\*\.  * *\  ..***\..\..  ***.*. .#\#*###.*#          #
#. *   \. .*.* . *. . .. \.*  .\*.. .\* ..\ . .\.*.\ * .*\*..*  *.*.. ..**** ** .*  *.*\   * # #  #\#           #
#\.\*. . ..**. *.*\ .**... . . ...*. *. ..* . .* \* \\* ..* . .*.*...** ..*.  .*.. .\*\**... .#    #            #
#..  .  .\  **.. .** .*...* .  *. *. . .*.. . ..\...*** ***.*\*. .*. .** **.  \.\ **.*****.#*#                  #
#.*  .. ... .. . *.\ .    .. .\.\ .*..* . *\*\***. ..*..**.** ..\.\\. ..**.\*.\ .\**\ ... *#*#                  #
#.**\*\      \.  .*..*.*.**... .. . * . .\. *..\* .**....\. *** .\*  ....\*.*.*\ * *..  *.\.*#                  #
#..\ \ .. .*  *\.\.** ** *..*.*\. .\*..\.**  * .\ *. \..\ ...\.. **.  .\ *. . . *\. .. **#***.#                 #
#\ *   ** .. ...* ..\*.    .*...  ..*. *.\....*.. *  . . * ..*...*\*   ... \ .**\* . . .. ####                  #
#     . *.\ * . .  \*   .*..**\\ .....*. * \*\.\ .* . . .*.* \. .* .. .  .* ...\ .  .. . *#                     #
#..\**. . * . .\*.* *\*.\.\  . ** *\  .\ \.*..  .. ...  *.*.\.* .\*.. \* *...*. .\.. .  ..#                     #
#\*...\   *\. *...*.*.\.* .\\ ... * \*\. . .**.*.**.\.\ . .***.\*.  .\...\ ...*   ......\##                     #
#*. \  *     ..\**\..*  . .  . ..*\ .\.  ** .* **.*  **   \....*\.*....*. .*..\.  * . #*##\#                    #
#* * .\... ...\.\..*\...* ..* .\ ..\ .  .****.... *\**.  .. *.   \*..  ** ..  *\* ....*.* .#                    #
#. .* .* *\ .\. . . .\*.*.* .\* .* .. *.*...*..* .*..*.*\  . .\ *. .\*  .*\  .*.*.\ \   .\ #                    #
# .*\..  **.*. .*. ..*. ...   .  . * .. \.\. *... ..*..\ .*. ....*  *\*\ ..\**......  .. ##                     #
#* .* ..**..* . **.\ *.\ ..*\\....* .   . *\.*. .. *.\*. .. \ ..***.\*..*.*... \\ \..\.\#                       #
#   * *\.*.\.*\ . .*.\.**\* \ *\ **...  .\.*.**... . **\*.*...*****. * .\ . .\ .*#..*.*#                        #
#*  ... \.. ...\ * ..** ..**. *.***.*  .\ *\*. *\\ ..\.*.*.*..*...\ .\*. .....* # .\#\.*#                       #
#.\  \. **.\  .  .  ..*  *.\.  .* .*.*..**\ *\ .* *  . . .*. .\**.. ...\.\..* \ *\*#.*##                        #
#.. \.**\\    *.*  ..*...\.** .... .\.  .\.*.*\. ..* **..*..*...\ \* \*.\.\.*  .*  ###                          #
#* .*\.******.. \ .... \..\**.*..   *..    .\..***\.\.*... ...*\. ..*.*\  ..**\ ..*#\ #                         #
# . . *.**\\\  *.  . *  *\  . .. *\.  .\.*. \**\*.  * **.\.*. *.* *.. . #*.\..#***.\.#                          #
#\. ..\..**  ... .\ . . *  *  \ \. \ *.*..\ .**. . *  ..\. *. ..* \. ..\..*#.\*..**#.#                          #
#\.    . ..* \ \..***\*\\. \*.....\**.* .. . *... \ .  ... ..\  *. \    \ . \*.# ***#                           #
#* .\*.*.  *\. ..**.. \.**...*    \ **.  \ *.\ \\ \..... **\ ..\\. *..**  .*.###.**.#                           #
#\\..\*\** \..*\*.* . *.\. *.**. \.**.\  ..\.*  *.. \ * \.*.. . .  .* ***\\..\## .*.#                           #
#################################################################################################################