######
#*\*.#
#.*\.#
#. #R#
#.\# #
#**#L#
##**##
#* \ #
## ###
######