##########################
#          #.\\.. . . * .#
#          #* * **  *. .*#
#  ### ### #. . .\. .# ..#
# # ..#.\.#.\*\.*.* ..\ \#
# #\* ###*# .\. \**..\#.##
###.\ #..*..\*** ... .  .#
#.\.** ...*. *\.  .  . \.#
###.*\  ** \*\ .* *..\ . #
## ..*\.#   ..\*. *. . ..#
#*\*.*** *\*  *. .*\..*..#
#**. ..**.* * .. \.**\**.#
#\...* ...*  * * * .** *.#
#.. **   \. \..\ .\*.\.. #
# * .. *..*\. *.. .**.\..#
#*.\. \. *.. *. .*.* \.  #
#** ..* .\.. \.. \. .....#
#*** \ . . \ . \\  .** ..#
#.\*.\   \...   .*  .. *.#
#\..*.*.  *.. .\...*.  . #
#* **.**\.. \   .\.*\*.. #
#. **.... . .** .. ...*. #
# **\ .** * \ . .\   ..\\#
# ** .** *R\ **   *\. \  #
#..\**..***.***\* .\\.\ .#
#**.* *. \. .*. .   \.** #
#**...\.........  .\ .*. #
#*\.\..**. ..    \..*..\*#
#. \.\ ..*\. .***.\*....*#
#.. .\. . .  *.*#\****. .#
#. \ ** ** **.  .. *.  **#
#.. .*..  * * *\ \.\* ** #
#.** .*  ..*\ ** .\..*.. #
# .. **. *.  .\   *\.*.  #
# \ .* *\.  \ ...\  *.*\.#
#..\\. .  **  *.  .. ... #
# *.#***  .*.. *\***.\\.\#
#.. .# *  *. .\\.*\\* *  #
#\ # **...*..\*\ *  *\ \.#
##.#.\#  .. *.*    *.#*. #
# # ## ##\. ..\\**.\##.  #
#       #* L * *.#.*\#  .#
#        #*. *.*#**. # *\#
#         ##...*#*# ##\ ##
#        #.*. *# # #  #\ #
#         #.#..#      #\.#
#          # #*#       ###
#            #*#         #
#            #*#         #
##########################