######
#..*.#
#\*\*#
#**..#
#.. .#
# ...#
#  .*#
#\.\*#
#\ *.#
#. \\#
#. ..#
# *\.#
#*   #
# .\ #
# . *#
# **\#
#\...#
#  . #
# *.*#
# .*\#
#    #
#  .*#
#**\.#
#.\.\#
#\.**#
# ...#
#\* *#
# . *#
#** \#
# . *#
#*\ .#
#**.*#
#.   #
#..  #
#..\.#
#   *#
#* *\#
#*\* #
#*..*#
#\ * #
# ..*#
#*  .#
#.\.*#
# * .#
# *  #
# *.*#
#  *.#
#*...#
#\** #
#**..#
#..*.#
#\*  #
# *\.#
# ** #
#... #
#..\.#
#\**.#
#. ..#
#***.#
# ..*#
# **.#
# ..*#
#. **#
#* *.#
#.\..#
#\ \ #
#.*.*#
#. ..#
#.*.*#
#..*\#
#\ . #
#*.*.#
# \..#
#..  #
#   .#
# *..#
# *. #
# **.#
#\..*#
#...*#
# \  #
#*.*\#
#..* #
# *..#
#\...#
# ...#
#. .\#
#\ \*#
#.\**#
# *\\#
#.. *#
#*\ .#
#*. \#
#***.#
#....#
#.\.*#
#   *#
# **.#
# R. #
#* * #
#. * #
# .**#
#.. \#
# * .#
#*   #
#.\. #
#..# #
##**##
#... #
# L#.#
## # #
######