#######################################################################################################################
#   ##\ .. \\..* .. . *.**...  .\..\* .*.*..\. *   .\\. \*. *\.....*\ **...*\* * .*. * *..... .. . \. \* *   ..* .\. *#
#  #.#.  *...\*\.\.   \....  *...* ..\...*.\*\ *   . .*..  ..*   \**...*. .. ..* .   . *\**.*. . \*.**\*\.. .\ \ * \ *#
#  #. .\.\ *\..*  *\. . * \*..\..*   . *\.\* ...\ *.* * . **   \. .. .*... .** *.*.\ \ *.** ..*  .* ..*.\  . .\...\.  #
# #**    \*     ** ..* *. .* .***....*\. . ..*..\**\*\*.\\ . *. .\.  \*. \* .. .... .. \**...\   \.***. . *\ \ .... ..#
##. *\#*. .. .* . .* .*. ...\*....*  \   *\*.  *.. *. * .*.  .. \*\*.\ ***.* .* .  .\.\.\.... .*\..\.* . \...\.  \.\.\#
## \*..** .* \.  ...  *  .. .*\. . .. \.\** * \* ..* *\     \..\. .*. . *..* *.. .*.... ***\   .** . ..* .....* *  ..*#
# ... * .  *.. \ \   .*** . ..  \. .. \  ..*. ...*..*  **. ..**.\. . .  *.\. .**\ ..\**.\**.  * . \  **...**.**\*\..*.#
####\ ..    ..*...\ ..\*. .. \\ .*\ \. *\**.*. ..** \.** .  .... .\ ... ..  \..\ \. ...\\ \  .. .*.*..*.\\**    . *\. #
#..#.# . ..*.**\ .*  \*\.* *. .\ **.\**  \\\....*\ **\\ .  . .   .... **   \  . *.  \. * **.  \.\* .\ .  ...*.. ....*\#
##\ **\   .. .. .*\\*.*.*. .*.*.*.*.\.* .... ..* ..\. *  ***\** .\ . *.* \  . \\***. *.\...**\. ...* .  .* ...\ \.... #
## #*#  ..     .\..\.\..\.\   ..\ * .\...... \.. *.\**. *.....*.  \.*.\* .* \.* ..   *     .\  . . .*  ***\ . ...*..\*#
##\.. ***..*. ** .****\ .*  *\ \. . * *. .. . \ \.\. .\.**** ** ..\ *.**.** .*\. \.**.. *\.\* ...  *.\*.\...\ **\..*\\#
## # **..* ** ** ...**   .. \.*   *\* *\.. . .* .**  *. .*  . *..\. \...*\. \* . .  \.\.. \..\.** *.\..\*\     . * \.*#
## *...# . .*... *..** ..   . .**.. . .  \ . *.\*\....\  .\.\.. .*.*.* .. **.*\ . ..*\ ** *.*\.*.\.. .\..  . *  .*.** #
# ##.. # ..\.\ .*.\  *.* ***\\*..*. .. *.  **..*. .*. ...\ .**.* .*\ *.....\.**.**.\..... ..\  ..* ** *\* .\.. .\**.* #
# ##.*.\ * ..\ \\*  ....**\* *.* .*  \ ..\*.* .*** .* \ . .... . \*.\.*\.  * **.** *\. * .*\    .\\.\\.** ****.. . .*.#
##\. *.. . ...*. .\.* *. *... .  .  *....*...* ..*  . . .. \. . . .    * \ . ****. \ . .R..*\.**\.     ......**.\  .. #
###\*.*...*. *.* .  . ..  .*   \.  .*.  ..*...  *\.*       .\.*.. *.. .. * ..\.\*.\ . ...\ *..**.*\ \.. \* . ...\.*. *#
#.*   . .\.  . \*\  \..\*.*.   .  . .*\*.\* *\. .\.\ . *\.*..\.. *...\ .**  .**.\..\*.. *.... .  ...*.   . * ** \.*...#
###*. .. .  . \ *.*..\... ** .*  ...\ *. ** * \. \**..\.  **..***.. **\. ** .*  *. . * *  .*   \  *.\.\*.\ ..\.*\.*.*.#
####*\\*  ...\ .*.*...*.**.**..\*\**..\ * ..\*.  .*\.. \\..**\**... *.*. .   .***\.  .. * \   *...\ .\..* .\** *. \.* #
#\* * ..  . \.  .\  . *.*..**.\...*.. .*. * . * ***   *..* *..**..  .\* .  *.* .**. *.*.... ...   .\ ..... .*. ... *. #
### *.\ \  *   * *\  **.*. *** * ...* *\.\.\*.. .*.  *. *... *.\  * *\.* *\...* .*... \.\. . .\  . .\*.** . * .   ... #
#.\\.*  .\   ... *..*.*..\ ..\ .    . *..  * *  ..  *.\ ...* * . .\\\..  ..\ *. *.  .\.  *..\...\  . ..*. . \ *  \ ..\#
#* ....* .\. *\.\. . \.***  \ .  *.. *.. .*... ***. *...\\.. * \...\  \.***...  .  .\*\ ***** .* .* \.\.\*.*.\**\.\ ..#
##\  .*.\*.. \ .*  *   \\.. ..\ .**....*. ... ..\ * .  . *......\* *... .***\*. \*.* .  \*\.   .\.. .   ** ...\.**\ .\#
# ##**..* .. .  .* .. *.*  .*.. ..*.\\.* * . *.\.* *.\\.\ .*. *... ..**.**. .** ..*..\\..*.\*..* \ .\  *.*\. * .*\  **#
# # ..  *. .\..**..* .. *.\ .\ \ .*. * . ..**.  \.*.**.  **.\ \  *   ...*.** ...***.*..  .  .\ .\. *  *.\\* *.\*..  *.#
# # \   . \*** *. .. *. . *\.\..*  ..\ ..  .....  . \..*.....  *.*\.\  .....* ..**  . . .\**.**.. *.. * *. ..*..\.\ . #
## ..**.*.\*..*\.  \.  ..**  *  \.\* *\*.*\*. \ .. \.*... ***.* .\.*.**..\..\ .* *.. *..\ * ..***\...\. ..\ .\  .\**. #
## .*\.\*. .  . . * ..\  *  * \..\ ... \.. . .  .\.....**...*****.**.\.....  \ \ .*\.. \...**  *. \*.  ...*\ . .*..\*\#
# \...\**.*   * *\.*  * \.*.. *  ...\ \  *.\*\* * \* \\. .****.\. **\.*...*  .. ***..\. *  *.  .*\.*. \  \..  **..* . #
#*# *..\.    \*\ ..\ *\*. . .  .. . . . ***.*...* .*   *\*...*   \*\ ** *\..*\* ..*\ ** .\**\*\.**** ..\. \*. *.  *.**#
###.* ... . *\. .. * .*. \*\   ..... *  *.... **.\... .\*. .*.\...\........\. . * . .*\.\... \  * .. . .*... .*. .*. *#
#  #.\#*.  .*... *\. \**\..* * .. . *...*..*....* . *  .**** \*.* . * **..* . **     .  \. **.*  ...\ .   .. *. * \ .*#
#  #.#..#***. \\ . ...\  * .\.*  . .*\** * .\.. \ *.   ...*\ .. *   **\.* *..\**\ .  .\ .. ..  *. \*  .  ..\   \. .  .#
#   #*\##.*.# ..\** . **\. ..*\.*   .. . ..   .*.*\ .\  *.* *  .* \..*...\ .\....* .*   .. . \ .* .* .\... .*.. \.\.* #
#  #*#\ \\*\. . .*\**..*...*\.  \\.  *   *..  .****.  . ...*. . *... ..**..  ** .* ****  .*\ ....*\*      .. ..  **...#
# #*. .##... * .\*...* *   ... **..**.\* .  . ..\*\* .   . *.\*.*.*\. *..*. *..  .\*\*. ..\** .* **\ . . .* .*.*..*.**#
#  #####**...   ***....\\** .*...** *\..\.   .**.*...**....\.  \* ..\ .\... \ ..  . .\    . . \*. \.\**\.***  .*  ....#
#   #\   \*\*\. .\\..\* ..  \.*.*** * .* *  . * .*.**.\**  .\.. **.\ *\ . .\..\    .\   . **.. \ .* ..   *\*.*...  *. #
#   #*#.*..   .\.*. ..\   * .*. \.\ . .. \.\*.** .*\ . ..*. * *\ . . *...*\. .*. .  * .  \*.\ **\ .\. ..  \..* *\\.. .#
#   #\#\  * \ **...\. *. .. *.  . ..*... .. * \.\.*  .\  .  *\\ . **.. *\.*.* .*.\ **.\..\.   \...*.* * .\.**  \ *... #
#   #.**.*.* **\ **.  .*..* .* . .\\*.* ..\*  . .*   ..* *...*.*.\ ..* *. . .\ .\....*. **   \.*..*.*\ . ..* .*. * ...#
#    ###.#*.*.*..*\..  . \. ...   .*.\.*  *. \ **\.  *.*** . * .... *.*.** . .\..*. *.. \\\ ...\.*.***  .* . *.  .*. *#
#   ##*.*\#*# \. . ** .*\   . \.\..* .*. **\\\..\. .  * *\.**...\  .*\ ...   . .. *** **.*. .\..**\. .\. .\ *.. . \*\.#
# ##.. . . ..\ . *..*. *.\  *\*\.  . .... \    .. .*.\** *.  .\..*\  **.\  . .\  \... ..\.  *. \...* ..  *..**** \ . *#
## \** \L.\ #  \.*\ ..\... *....**\**  *   *   .\.\...... . . .* *.. *.*  \*.   *. \**.\*.  *... ...\   *\.*..*\...***#
# ###### #*#* \*#.* .  ..  \. .  \...***\*\...*.. .*\ \* . \.* *\...*\*..\.*\\ .* *..*   *.*. ..* ** .*..\*\ ..  ...**#
#         ##...# \*.# *  . ..\.**.. ..\*      .\** * . ... .\*.* *...*.\. . .\  .\*... . \ .\    *..  *\ * ..**\ *.*\.#
#          #\#\*\ ... \  .* \***\ .\* ..  . ***.... ..   *.\.\ . **\.\ . .* .  .*...\*.***... \. .. *\.\.\..**.**....*#
#           # #.#* * . #. ..\ .*.**.. .  \*..*.*  * \  .*...*.  .\.*.*  *.. **  .* *.. \..\..  \ *.\.*.  *....... . ..#
#             #.*.*.\\.*..* * ****. * .* . * ... .. \ . *\. * *.* ...*. *\*..*..\......\.  .  \.\. **... \...\.  .\* *#
#              ##.#..* *. \..\...*\.*  **  ..  .\*.  \  . \.* . . .\..* *.\* ...*\*.*\*.  * ..  * \.*  . .\* ***.  . .#
#               #\#*\ .#. \..*.* .*\.*.***. \  .**. .\***....*      *   *..*.\*.....\. *\**. ** \ . *  . . * .*.\ . * #
#                ##\.#\  *.*  ***.*. \.\*\.  .*.*.** .. .. \..\ .** * \... . ..\  **..* **.**.**.\  ..\    . \***..  \#
#                 #*..*. ..  *\...\*.  ...*.  ..**..* ..*.   . .  . * .  *. .*. ..*...*  .**. *.. \ \ *..\*\  **..* ..#
#                 #**#*..*. *.. *.. .* .*\*\*   **.*\ .\.*..**.**\\*.*  ..   .\* *.\..\**...**.. \.  *. \ .\ **.. .   #
#                  #.#* ..*\.** *. *.   \** .*..** * \   .. . \*.\.** \* ..*. *...    **. ..*.  .*   . . .\*..\... *..#
#                   # ##  .. .. *. **   ....*.* ..  .*..\ .** . **.. *..... .....  **\.  *  .\  *..*. .*\...  .*.* . \#
#                    # ##\ .** .\ \.*\.*.\ * .. *.\. *.*.\ . .\ ..** \.*...*... .. .. .. *\**. .*.*.*  \***.* .*.. *\.#
#                   #*#.*.# ...**\.  . ..* .... *  * . ..  *... . ....* .**. .*.   ..\*....  *  ... . ..*\.** .*\...  #
#                  # * .***\   * \. \   .**\ *\. \**  \\. *..*\.* .. *.*\.\. *.*\** ** ** *. *.\   * **.\ ***.\..* * .#
#                   # . . **. \ *#  ...   *.\** . ** .  * **\*.\  .  * .  *...*\.\**\ *. .. \..*.. . ..\.\ ..\...* . *#
#                  #. *.#*.. .  ..\\ \.\  *.* \ * *. . ** \  .*.* *\\***.*.  *.. .. . *\*. *\..**.\ *\ . . .  *\..\*. #
#                  #\*###\..   *#.. .. . .\*. . . \.. . *.... *\*.\..*...\. *. ** \ \\* .  ** *.... \......  **\.....*#
#                   ##   # .\# #..*.**.* *  * .**\  *..**\.\ .\.. .  *  ..\..**\  .*. .\* .\.. \.  * *.\.*.\ \...\*. *#
#                        #*.# ..*..*.\..*.*...*....*.. .*.\.*\**\ *. . *\\  ... *.**... . .\.\.. . . ..* ....\ \ *.. .#
#                         ##*. .*. ..*. \.**. **.\*.  . ..*\**..*..*.  ..*  .****.** **\   . ..  \ .\.*.\.... *.\*.. \#
#                           #* *.#*\.*\*. *    * *....\   . *. ..*...*. .* *..\.\ . .*\*. \.**.  ..  *.*.. \*\*..\* . #
#                            #*  *# .*.*.\... .* \  .**\... . \. *****..*.\**  \ . ...* *..\.\.\.. ..\ .. \ .*.* .    #
#                             #\#  #* #.\. .\   \..**.\. .\\  .. .*. \ * * *. ..*\ . .. \ * *... * .     \.... .\  *  #
#                              ##*\.#*  *.\ .\  .\*..***. .... \.......  .\.\ \*... \ \.  *.\.\. ..  .* .*.   \.*.*. *#
#                                #*.*\ \*. .***  *.*\...\.  ..... ..*\*....\.*..**\ * .*.*.\ *..\* \***. .\ .  \.** *.#
#                                #\  *.*..  .\.  **..* ..  * ..\. **.   * . ..*\....\...* * *..\.   * . . *. *.. .\.* #
#                               # .*  .\.\*\...\ ..**.* \ \..  ..**.. . ..\**\....*....*..    *.*.**.*  *\*  .*.  . \.#
#                               #*\...\ **..** *. \. *#.*.*.**  ..\.  ......\*\ *.*  ***.* .* .** *. .**. .*\..*.\. .\#
#                                #*### \*#*..  . \  ...*\ * ***\* ** ...* .*  .*. *.. \...* . \.*.... .\.\.* . .* ....#
#                                 #**   ***.# \ ...\ *..* . .*. * ..*\  \. \ \. \ .*. ..\  \. .\.*..\*......\.  * . \.#
#                                 #\. ..\##  ..\.. * .\.\.\  . \*   .  ... . . * .\.\.*\.*.**.....*.*\  ..\*  \. ..\. #
#                                  ##* \*\#.*\.* ...  *.*.    . .**.\ \  . ....\ \*..  ... .  . \      .\ ...*.*.* * .#
#                                   #*.### ##.#*.. \ . .*  .*.. \ ..  . .  *\.\ ..   .. *** * . ....*.\\ .*......  . *#
#                                    #.#   #.* \.\ .*    \**. *\..*. *.   *. **.  \ \. ..\ \. .  \  *. .  *..*\     \.#
#                                     #   #\*###.  *..\ ...*   .**\ ..*...\\..\*\  ..\*.***.*\  *.* *.\.*\. **\ \..\  #
#                                          ##  #.. ..\.  *\*  . *...  \..*.. \ .*  *\..\ .\ *. *. ...\ *\ .*...*# *.. #
#                                               #. * *  ** *.\.....  *.. .\* .**..*.. \ *\* .. *. **.*  .* . . *.\* * #
#                                               #* ##.\*. *\.   *\* \.*.\ *.. ..**.**. ...\\. .* ...\ \  .  * \. .\   #
#                                                #\## .\.\*. . .  .*. .. ....\..\.*. ..**.\.\#  *.*\ *...\ *##.**..**##
#                                                 #  # #*#\  \  . \\  .. \.*.*.** *\.* ***\\.*  * #*.\ \.**\.#**. \ .*#
#                                                     # # #.#..  .\   ** .\. * .\... .*. \ .*... ..*\ . *.*.*\#*  #  .#
#                                                        #   .\*.  \...\  .\. *\*...  .*...* ..\\.\..#..*\. \..#. *\..#
#                                                       # .##  #. \..\ .. *. *##*... ..*.. .*. \ .##* .  ## .*##\#..###
#                                                       #\# ###.* .*  ... \..*.*\.**. .* ..**\#\\ ..# # *#.* .# # ##  #
#                                                       #.## *##** .\   **....*\*. .....\   *. * .. ## ###..\#        #
#                                                       #.# #. . .   . ..\.* .... #\**.*. . .\.\* \ #     #\#         #
#                                                        #   ##*.#. \.\   #*. .*\ .#.\.*  .\###*\. ##     #*#         #
#                                                              ###\\. # *. \.*\..  ##\**  .#   ##.#\ #    #\.#        #
#                                                                #.#\ .*. .. ..* *.#  \. *\ # #\ . *.\#   # #         #
#                                                                 ##*...#.*\.  ...  ##*.#\  ## ##*#\* #    #          #
#                                                                   ##\*.#. ** ..*#**\* \ ....##*.###\#               #
#                                                                     #*\##.##\  *\##*#.#  *##  ##   #                #
#                                                                      #*# #  ####.*###.## *#                         #
#                                                                       #       #  #   #  ##                          #
#                                                                               #*#                                   #
#######################################################################################################################