################################################################################################################################
# * *\.* *\*.*\. \.*** \*.  . \.**.* .*.**.* . ...    \.. ....* .. *  .   .... ...** *..  *.*... * *.* *.*...\ .  .  ..  *. *. #
#\  \. .*.  *. .*. ...\*\ ..  \.** *. .....* *...\\*\*.*\ ..\.*\. .. \\*\... .*..*\*.\.\. .\*.\..\*.\ *.. .  . \..* * \\ .*.***#
#...  .  *\.\ \ .\ ..\.\.. *.\*.\. .  .\.*\\ \*\.*** .  .\ *.* *\ *. .**.* ** \  * . *\.\ *.*\   .\***\ .  \ *  .*.\.   .\***\.#
# *. . ...*.  . *.*\** ..*** .\\..   *. **** ..*..*\\ \  \ \..*\..*.*.* .. . **. . * *..*.*** . .. **\..  . ***\ .  . .. ...\*.#
#..  *.  *.**\ *...\***  .. .\   ..**..*\*.\.**\..** ..**.* *..* .\.*..   \.... .   .  *.**.. *\ \ .**.*  ......\* .. .  ***  .#
#....\* \.\**.**\ .**.*\*..* *\ ..**.\*. *...\  .\*\.\...\*. * .\ *.*.\.**..    *.*\*** *..\*\. \. *...\.... *   \.\ *.****... #
# *\* .\.. ....\**\ \.  ..* . .**.****\ *\*.. .\     *.* .   \.** .\.*.*.*.\\.. .*\* ...*  .. .*.  ...     .\. ..  . *\*.. .\ \#
#.**\  ..\..\\* .* * \*\. *.\.*\.\*.. .   ... \ \ ..**.*\  \..*.. .. .* \*\.** **.   *\**.  ..*  .**\\..**\*  \ \ .*\..\. \**  #
#.*.\.**  \ *  **\.* . ..\. ....   ..  *  \...\.** . \ .. *.\ .\*..   .*.\* \* .\*  .\****.\. . \ .\*.  *...   * .\*.*. .*.\...#
#.*.*\ **\.\.*.\. **. ..  *  \.. . *\ *.. .. . ***. .  ** . . *.\***\  * .. .*\* . *  .\.*  ***\.  . *\.*.\ * \ . **.. * . .. *#
#*.\.. \. . **** \.. *.* ** . .  * \ .**\.*..*\\*\.. . .. ..  ... .\.. . \..\\ .*  ..* .** .*...   *\.** .. * .. \...*  \ ** ..#
#*... . ...\... .. .\**. *. *** .* ..*..*  *... ..   *.\.  **   ... * ... ..*.. *.... *..* \.* .*\** .. .\. *    .  *... *....*#
#.. *   *.\ **.**.  \.. **..*...** \..\.** .*\**\.\...*..\* .*\  .  \   . \\    * *** *...\ *\\\ ..   *  ... .*.  *..*  **\ \  #
# *.*  .*..**\* . *...*.*\\*.\.*.\* *  .....\.\. .... .  .  .*.\\.  \\* *...\ *.\ ..*...*   ....*  ..* ..\. . ..  .. .. \* .. .#
#** .*  \..*..*...*.  .\*.\.*.*.\..\. * .*.*  *\ . *\ ... ... .....   .***......\   * . \ * \.* .\* \.\  ..     ....*\*...   *.#
# . \**  .*. ...\*.* *.. \.*..* ..\ \ . *. *\ .  *.*. ..  *   .* . .  \......\. .  .* . * *  .   *. .\ ....\ *.  .\  *..*.. .  #
#    .* . . ...\. \. . . . * ... .\.*.* *     *..*\.. .\ ...  ..\* **\ . *... .\  \**  ** .*   *.**\.\.\. . \.* . **.*\ *   .*.#
#\.  ..*.*\ * *....*.. .  .  .  ..**. * . ..*..  * ** *.*   \*\* *.\*.*.*.*\.. ... . .  *  ..    *\* .*   .* .. *. .... ...*  .#
# \*.\*.*\. . .**\**.\.* .  ...*\ .\. ..\. *.**.  \*..\ ...   .. \... ...  *\ .. .    **\ .. .**.. .... \....\ *.. .\ .*\**.* *#
# .* *..*.* ..**. ..* *.. . ..*. .\  \.\.**..*.***. .*.\**. .*.\.  . \ ...\. ..\*   .*.* . .*\..\.*..\. ..*  ... \**..\. \ * *.#
#  ..***... *. .. * *  .\    *.. ..  .*.*.. .\.* \ . *\ * \*\*.*. .*.  **.\\.*\*. \.*.*.  ***.....\.*.**\****\\   *.*\* . .  .*#
#.\**. *..*** *.\*. ...\....\*\   **\ ..*\  .**  . *\\*..   *. . \ .  * . . *\.**  .\ *..*\.. .\ .   ... \...*** .....*** * \..#
#**.  *\.\*. .*.*.*. .\  . *  .* *.  .  ***.*.* *..* .\ .* .\.\ ..*\. .    \ .*\*.\*. .\ ** \...**\ .    .\... \. . \...* *  *\#
#\..\  * .. \ . . .\*  .  *.\\ . .* *  .\.* . .  .\.*.*. .... *.  \.*\ *.**. .* \ *\.*. **.. * ... ****.   .*.\. *.* ..*. . ...#
#. \..*..\\ ..*..\ .. . .*.. *\ *.* ** . *. *\ *  . .    ..*.\*.\..***\*. ...   . \... \..\.*\  .\***\..* . .\.* ..*\...*. *.\.#
#*\..*.. . ....* .\*..** *.\.*** *. .   .\*.\* ..  .. . .**.* . .  ..* ..*..\.  **.. *.. * \..\ ...*.* *.*\   .. * . \. .**\  *#
#*.  *\   ..* ***. .* *.\...*.*  \. \  *. *.  .*.*  \**. *.*** \   * ..\*\. ..*.... .  ..\**. ***.  \. ...  \ .. .  .**  .* *..#
#\**...\\ .\. ...\ *....    *.*  ....**\ ..\  \ *\ ..\. .*  .\.* *    . .**  *.**.*.* ... *.*..\.\ .*\.\*.\*.... ...\..\*.. ** #
#.*.* ..\*\*\ *  *\ \   .* \.\.\*** .... **. ..  *...*..\.   .... \ *.\. *. *.** .  .\..\  ...\ *.  ..  * ..*\* ***\.** .\.\*. #
# .***\.\ .\..***..*. * . ..\.* \..\ *.. .*.  **\*.*\. *.  * \**  ..*....**  ......*\. *..\.*..\** .\\*\* .\.  ...*  * *    . .#
#\*\ . \** . *...  *. ..  .. ..\ \***..* *.. \.. *.. ...   . .**  .\.*\. . . .***...*.\\ . \* .*.   ... . . ..\.  \ *. * ..*.*\#
#*.\..*.*. *.\   .*\*\. ..*\ .....*... **. \. \.*\ * . \   .  *. **... . . *\.*.\ \ .*.\\. ...\..\.*   \  *.*..  ...**..\ ...\.#
# .\*.\*\...\**..*.*..**.\* . *\. .*.**.* ..*.* .    *...  ..*.. ..*. ..  .*.  * . * *..*  .\*\.\. \  *.\\* .. ...*.*. \*.   ..#
#\ *\ . *.** .  \*...*.*  \** ...\ ..*...**\.\*.*... .  \*\ \...   .  ..\  ... .  \.\\* .*   ... ..\.*.* .\ ...*.*.*.\.****. .*#
#  *\*. *..*.\  ..***  *.   .** \.. . *. .  *** .\ ..  \*.   . **\*. .. \  ..  *.*.*. .....   \..\.* .*\  *.    .*.. . *..*  ..#
# .* . *\*.*  \ .. ..  \  * *\ ...*. *..*\\ .*.\ \  .* ** ***.*.. **.*. *\* *....*.**. *.** . .  . . .\***\  \ ...* . \.. . .. #
#\ .* *....*\*. .. \ *. \*.   ..     *.*\  .* \.*. \  ..**.\...*\...\..\ ..** **.\*.\ \.\*..**.*.* . *. .* .. .\  *. * *   ....#
# * ..*\. **. *\ . .\.*..*..*\ *. ** **\*\* .  * .\.\. \*.... *..  ..\ *\.\.  \ . *.* ..\**..\*.. **..\.* \..*..\*.. ... *\.*.*#
#.* . ..\ *..  ***\ .*  \.\..\** *.. \* **... *. .*..*\.. ......\*..*\..*.*.\*.* ...\    ..\ .*  *..*. **  *  .\. .**\..\*..\..#
#.*.\.*.. \**..\*\. .*   *.*\*.*\ .\  **..** *.  \..*\.. .*\ *.\ ...* ..* .*.....   . \. .*.R . .*.**  .\ \.**..   * ...*..  .\#
#.*..*..*. \.\ *.* ....  *... .*   *\  * \\.\..* *.    ..*...\  .*\ . .*\ \.\*.*...\\ .*.  *.\.   *.     * .\.*. .**   *. .* **#
# **\.\ .\.. .*  . .**    *  *...* . * \     \ *.......   **  .* ** .. .  .\..*...\.. *** .* *  .\\. . .\.  . . .. * ...  *   \#
# *      .  .\**\.. ..\ \.. *.  .*\.**..\.\ **.*.\* . . *\.*.* .\ .***...  *\.** ** * ..*\* .\.\. * . *. ..\ *\.*  \  *..\ .\*.#
#.\ *..\    ..** .\ .\...\\* * * . ..*. .. ......*.*. .*\.* \* \ .*...**.  *.\*\...\.  \*.\.*.  ..*\....  *..\ ***\.\..*.  ...\#
#.  . ..**\*..*\ \ .\ **.*\ **.*   ****.... **. ..\. .... .\* \.  .\\. *...\*\   .*.*. ..\.*\\ *.*.. \*\ \*..*\. ..** **...   .#
# .  ...*****... .*  *\ .*  ....  . ***.. \ *  **.*\ \.  .. \...*. * * *.. \.. * \.**.\.\. ..*...\.* . .*.\. . *..    *.\ .\.. #
#\. *\.  *.\*.\* \ .*.  * \.\ . \..* \.***..\ ..*\*.... \*.*. .*.. \ .*\ . .\. *..  **...  .  .\ .*. .  .*..* ..*.* \*.*.*\ .  #
#*.     \** *..* .. .*.\.. *..  ..*\*..*.*  .*  .*.\ ... * ..\.*.**\\ *. \ .. ..\.....* ..*.*  . * \ *.. *\\  .*...*.*....*.\. #
#*. .*.\ ....*\.. * *. \.\*.**.   \*.\..*. .*. *.\ *  .  *.   . .\... .*\. .. .\     \* *\\..\.....   .  ..\. ...\*.\*  . .*   #
#* .*.. ..*.  *...*.** ..*.  \.\**.. *..... . ** ..** . ..**.. .* \* . ...* ....\.*\*..*.*. *. \*\\ \.   ..* .*.  ..   .*. *. .#
#.***  \...\*.  \ . ...\ *** . .**..**.* ...  ..  *.\  *. ...***.. . * \   *\.\ *.  * .\ * \ **  * .. \*.\**.    ** . *\.\* .  #
#\*..*..\ * \ \    ..\ .**\**\. ..\*. ... *  .*... * \..***\.***.. \ \ *.* \... \ *.*. \ .*.*.* .\.\ ..***...\ .* .*.   \. . ..#
#*. \.. * \.. *.**.\  ...  ..  \*  . *. \ .....  *........  ..\*. .  ... *. .*.**.**.* . .  .** .\. *..\.\.  .  . ...\ * *.\ * #
#.....*.    \*.  .......\.*. \... **.*...  \.\*. .... * \.\  *\ .\  .*   .* *\ ..... . \.   ....*\**. .\ .. .. *   .. . \*\..* #
# *. .. ..  .\ . .*.\. *. . ..* .\....*.  .* ..* *.  .\..\* .\ .    ..  *..\\.* *.\*   .\ **.. ** *\. * *   \. *.. *.. \  .*\  #
#\.. *  ..*..   .**..* ..  .  .**  *.\.. .\.. \*.\ . *. \ .\*..*\*.. * .\..  *.*\. .\ ..  ..*\\.. ..  .*.   . .*\**.\.* *    \*#
#..\ *..*\.*  **\* .\...***** .*\ *.*   . .\. .. *\.\....***** . * ...*.... .. .* *\  **  * .* \*. \  .** .*\*.. **.**..\ \ \.\#
#.  *..*  ..\*  **  . *\.....*\.  \*. \  *. *.**.    .\*\*.****. ..*......\    *. *\*.****. .... . .**..  * .. *.**.\..\..\  **#
#   ..*. . .\***...* ...\* \ * .*. ..*..******..   ..  *.\.*..*..\.* .*\\*..\.*.\ \ .*.\ . . . ..*.. **.***.* ..... .* ****..\.#
# * ....* ..  .* \*.\.*. . . \..*\*   .*..\ ..*. ** .\\.  .***.   ..\. .. ...*\ **\* *..*.*.*...*.*. ..\**....*\*  \ \ ****\. \#
#..\.\**    \  *.... .. .. *\..*\ .*\ \. ..* \.\ ...\ \..* ** *   *..    * *\. \.*.***...*..*.\\\..* * **\.*\ . .*\.* . **\ .  #
# . *\..\ .  . . *. .\..*\\ **.**\. *. *  *.*   **..\*   ***....  . ..\ \....\.  .\.\.  ...* *\.  *  .**. . *  \\..*. *\.*.    #
# . . ...\..*. .*\ .   ..*\...*\** **  .*.\*..\.\* \.    ***.*\.  . .*. * \ * .   *.*  *.. \ * .*.... ..  . . .   . *\\\ \ .*..#
#* **\.\. ...\*.* .\   .* *.... .*\*.\  .\ *.. . *. *.. **.\*. .*    .\ .  *.* .\*\ \\*...*. ..... .**\ ..\.   *.  \.*..  .\.*.#
#.\\.*\ ..\.*.*. .**** *. .  * *\. ...***  .*  .. ..**.\.*.**.. ..*\  **.*\ .*. .  *. ... *. .\.. *\\.*  .  ..... *.*.*.**. ...#
# .*.\*.. \..*\.  ..***\.  ..\. ..**... * * . .*.  \* *.*\*.\*\  *****.*.  \\.   .... . *.*\ *. \.* ...   *..*\.  ...*..*\.* \\#
#** *..\. *   **... \ \.*\.*\..   *. \  *.. *. . \. *.* * *.*.   .*. . .\\. *  **..  *\ . *. .. . \. .. * \  . ...  .. ...*\*..#
#.*\....*.\ \*.*****.**\  *.*.**. .*. *.*   .. *\. .. \..  .. ... .*  \* .. .\.\..* ** .*..*  *\\\ .\.*.. .\\*.*   .** *.**.\*.#
#**. \*... * .. .\\*.**.*\.\. ....    .\..*.*  \. .\...\*.*  .   \ .** \.\*   ...*.* .    ... .*  .*  ....\**... .. *.\ .*.*  *#
#*.*. .\.\ \*.*..*.*\.. .*.*.. .  . \.\*\ **.*  . . . *. ***   *.*.\*. .\ .  * **   ..*...  .   .  \.*.. .... *..** . ****.\...#
#..*\ *. *\..\..**..... .. .\.  .. *..*\ . .*\ * *  \ .*  **\* .*.  .  .  . .* .. *....** * .\*\.\.  *.*\ ..  .\. \  \. \  * ..#
#*..*. \**  .*  ..\  .\ ....*   . *.  .. \ ..  \*..\.** ..* .  .   \.*....* **  *.\ \.    .  * * \.* ...* \ \.** ..\.\.. .\ . *#
#*.* .\*\..  .\.*\.*.\.\\  *   .\ *  .*.*** \ . *\*. ..     * *  *  .  ** *...*\. *\. *\ **  *\.*  .***.** .\\...\* * .*.*.*  *#
#.\*...*.\.  .  ** *\.\.. .....*.\ *....***.* .*.  .*\.. .* **  .\\. *.**** *.*.  **  ... .*...*\  .\.\..*.*.*\.. .*. ....* **\#
#  ** \***.** . . \.. *\ ** . \... .*\..\.*\. \*** .\. ..**\ *     *.. \. **.*...**...* *.  *.. .*\ .\...**.*.*   ..  *.\..\*..#
#* ....* **\***. \.\.  ..*.\. ...*.\\**.* *.*\..*.   .\...  .. .   *   .. *  . **.\.* \ \* .. .. . .\*..*.\ .*   ...  . *....*.#
#* \  . \....*.   .  **...... ..\..  \.\*..*..\.*\ .. .  .**.\ . **.\\ * \.   ..\**..\ *.. ... \.  .. . *.  \...* .*.*. .* ...##
#. .*\ ..*\*\*... .* .**. .  .\***.*\.* \.\ * .*.. . \. * ***  .* . .  ...* *\.**..* * ..*   \.. ..\     ... ...**....   * ..  #
#*  ..\    ....\.. *....    * *. *.. \* .. .\  . ..*\.\......  \* \.   ....*\.*\..*\*.**.*. ..... ..  * . * .*  \..*.*.. ..\*  #
#.* . .\.* .. .*\  * *.. *..  \.\\ ...*\ . \...*  *\.*.*.  *. * * .**..\* *.  .* **.*...\* *.. *  *\. .  *  *. . . \. . . *.. *#
#\.  ....*. *****\... ..*..* ..* .* .*\* \.\ .**  . \.\. ...**...\. . ..  .*..*.\.  .*..**. ..  .\*.. **.. **..\. ..\ * \*\\.*.#
#..   \*..*...****..*....***\ .. *  ** .\ ...*.* \  ... **..* .\*..** . *.\..  **. *\.***\.  .\  . \*..\***.. *.**..*.. * *.\.\#
#. .*.  . * .....   *.\*.\.. .\** .  .\*.*.* \.. \**. *    **\**   **.  . **\.\.*  ..\. .  * **.. **....*.* . . *.*.*.\ *.. **\#
#\.\*..\ .\.*\*\.. ..\.\*. ..\. . . . *....*...*  .*....* ....***.\\   ...  .**.* .\.. ***..\**.\***  .\*.. *. *\..*..  .\..**.#
#.\*. . * \*** .*\.  .. \****** .\*  *.    .* *. .* .*..\ *\.  .*. . ***\  \ .. \..  * *.*  * \.....**  . .......  . \   ..*.* #
#. *. * ..\.*\* . * . * . *. *. ..\....  * .. .*. ...\. ... .*..\\.*\..*.*....\.** *. *.  *\* .*.   \\. . ..**\. \\  .\ *  ...*#
#***   \. . . **\ ..\ *\ .* *.. * .**. \.\.\*. * .\**.* \ *...** \   . * ...\*. *. ..\.*.*. ** *...\. .*.  *... .\\. *.**\*\ ###
#*....*. \ ... .*\*.* . \ *\... ..... ..    \*... * .**..\ . .**\. .*. * *\  *.  . \.  *... *.\. *.*.... *.**...**  **..\.. *.##
#*.. *..*.*.. \*.  . \..  .\ .\\.\**.*.  . . *..*.\ *. *. **\ *.. .*. *..\. .\\*\*\. *.*.  *.  .*.\*  .\*.\ . .\.* .\.  ** ##.##
#.***.\.\**..\* .\.  .  .*. .   . \..  *.. . .*  ..** *........ ...*\*.   *.\**\.  . .*.. .  **  ..\  \...*.*..*.\*\*\\.*\.#* ##
#.**.  \**......*.* \.\*\ *. * ... \.* **.  * ...   ...*. *\ \  ..** *.\  .*...* ..\.**.\\ .*..*.\.*.\.\...\.. \. . **.....*.L #
#....* *.\**..  . .. . ... *.* . \\. .  .*** * .  . *.*.  . *.*  *.*...*......*** . . \ .  ** ** .\*.** *...  ..*.\.*.*.*  .*# #
#*\   ..    \ . *\. . **. .. .\* .. . *\\.\. \.*\.*..* * .. .  \\\...\.. *   . * *  .*. **\ \ .*.\  .** *\...***. * .*. ... *# #
#* *\ . \ \.. .*....\....\...* **. *.\. * *.* \..*. *. .. ..*.\ . .. .. \*.. . ..* * .*\.. .\..*  .\**.\... *.***.**\..*\*..*# #
#..*.. .  . ..  \.*.*  *  ***.** *.... \. .. .. \.***.\..\ .  **  \. .\ ...\  \.\*\. * . .  .\.*.*.*.*  ..*\ ..\*...\ . \\..*# #
#.. .*. .**.\. ** ..\ .. ..\. .\* . \ **.   *** ..**... .*\\.. .  ..  .  \..\.\  \. .\..   \. . *..\*. \ *. .....#* ..\\..#\**##
# .* *\ **\ .**\* ... *. ..    *.* \.*.\ **\.\. *.*.. *  ..\.\..*  .* * *..* \**..  *.\. .\. *..* .** .. \   ..  *\* **..##.**##
#\* ... .*\**.* . . *.. * ..*.\..**. .*..\..\ .\.**\.*... *.* . .\  .* \ . .* *.  * ..**.**.  ... **\.*..*.*.*\ \...***.* #**# #
# ..\.*  .*..\.  .*.  .\ *\. ...\ .**\\ **  .*\ \*****..\.**\.*\...* * .*.... .*. .\  . ..*\*.*  ..*. .. **\ **   \***...# #*# #
#\ ..\ ..*.* . \. .....\ .* .  **.. .  .\.. .\. .*\.\.\*\  .* .*\. *..\ .\ \.\ *  * .\.\ ...\\* . \..\  \**. ...*.*\ .*##   #  #
#  ..*. .* ..*. .* ..\  \.. *****\. **\**.* \  \*  \*\.*. . .  .*.\.*\*  * ...*. *.*.*..**.*. .\* .\\*. ..* .#*..#.#. #        #
#\**  \   .\ ..\ \ \.*. * .\\* \*.* *.*.*\.*.* *. * ..**  .*\\ ...*....* *\ *  \**\\ * *** **. ..  **.   *.  *..*.\#**.#       #
#.. ..*\.  .  .* . .*...* \..** ... ..\..  \.*   ..\.**\*.  .   *.* \.*..\.... .**.* * .....* *\...\* ***..*.** .#.#.#*#       #
#.*. .*.  *\ *.  .. . ..*\..* *   *  *..**.. ...*.\ \*..*.. * .... .. .\ .  ..*\..... * \\....\*\ ....* \ ....* .*#.*#..#      #
# ..*...  *..**.\*.* **.. ..\ ..**.** **** *\*..\. ..  ***..\ *. . ....*  *\..*** \  ..\. .  .*.*. \..\*.. .  \**# #\###       #
#. \.**\  *\*.\.  **\\\ \\ ...  \* .***\*. .* ** * *.\\ .. .. .\\.   .\.\...*.*..*.. \ **...  . .**    ..\ *\. ##   #          #
#      \*......\. .*.*...\*. \.*.\.\ \.** \  *.\.\ . . . \  * \.  .*    ***.*\..\*\ . .**  \.\**\   .*  *.*.*.#                #
#  .. \ .\.\..*****.\  ..\..\  . *   .*.*..\.*****..*..**..**. \.* .. \.*\.\..*\ . \ *..   .. .. .  \. ..... .*#               #
#* ..  *....\....*. **..*.**...* .. ****.\\.\*.\* * **\.\ ......\ .** .*.**  *. ** \ .. .* .. .\****.\* .\.#.#.#               #
#.*. \ . **\* * .. \..*\..\.*..\  *.**.  *\.**...\..**......*.   .\.* ..*.** *\  \ .\.*.*   .. ..#.\***\*  #..#                #
#\     **.  ..*. .\.* **. ****.. .* *.\ ** \.**\ .**. ..  . .* *..*\.   . .* . *.*\ .***. *.\.  .. .\##. ## #*#                #
#...*  .*\. . * . *\.\*   ..\\..  ...**.*  .*.\*  .**.** .. *.** ** *** \* .   . *  *\*...**. \*..\..\\ #    #                 #
#\*  \**   .* .. ... .* \**\ .    .\..\.*..\. *. \.**. . .    .\ \. ..\ ..\   ..*\*\..* .*.****. \.\##*.#                      #
#.*   .*\ ... .  ..* ....*.*.*\ **. \\ *..*.   .*.\*  .  *.\* * ... ....****.. \* \.. .**\..\.#.*..#  #.#                      #
# . **..*\ \ .*.*\.\ \.... \ .. .*.* ..  * .\. ..\** * .*.. * *  \*.\\ . .*... ..*.\.* ** .##.\ *# #   #                       #
#\\\..**\ ..  .... .. *... . \*\*.\ .* *\.\ .*. \  . .  **.*. .  . *..*    ** .* .*  \.** . ####*#*#                           #
#.\*. .... \. ..\***.   .   \.**.. .\. \**.  .   ***.  *.\\. .*  \.* ..**. *. *. .\.#. .#*##    #\*#                           #
#.#...  .. . .*.....* **.\\ .  ..*.********  **\   .\.\** *. *..*  .*. #*\ .* ..\.*...## #       ##                            #
#*.\.  **.\*.#.*  *\. .   .\ .\ **......*....... ..*\.*\  .  ....** .   .**.*. \...* ## #                                      #
# *...\.*\.# . ..*\ .. . .. . ....  ...\.*\   .  ..* **.\..*. .  *..  .. ..\.*  . *# ..\##                                     #
##. \ .*#*.\  .* .*.*..\...\*. *... *\*. ..# ..\  **..\.  .\.\ ..\  \. \**  \\ .\\ *.**  *#                                    #
#..*  .**##*  *. #.****...   ..*\***.*** * #\...\\*. ...*  ..  *. . .  ..* **.# .\**..\#.\#                                    #
#.*. .#.**##. #...*.**.  *... .*...****..*  *\ ..\.* \.\** *\*.\  *.  * .####.  . . .*# ##                                     #
#...#\..*#  ###*\#...*...\.  . *.* *..\ ... .*.**. . *\.....**  .     .\### #**...#.\#                                         #
###.#*\ ##   #.. # .**....  *\.**. ..  \. \ .# .*. *.. . *. *\ .\.*.\  . *.# #* \##.#                                          #
# #.##.\ .# #\*\*.   ..\.#.*.\.*. \.\ ..\###  . .  ..    \#..**\. #. . **##   ##. ##                                           #
#  ##... #   #.#.* *. \.\  .* *..#.*#*  ##*.\###**.* . \. \ \. .*.\*.**\.#     #\ *#                                           #
#    #.\.*#   ##*\ *. ......\..\.#.##. ## #.*#*#..\#*.. \*** ** .*****.. *#     # #                                            #
#    # .*.#    #.#.*.*\   * .\ .###  # *.# #* .*.*##*\  ...... *.**# .#*\*#      #                                             #
#     #*##      ## #\ ..    * .  *#   ###   ##***.  .\*\*..*\ ..*.##*##*##                                                     #
#    # \#         ##*. *.. *.  .**#         #..\.#*\.#\.  #**.\***##\#*..#                                                     #
#     ##           #.*\ #**\*#\ ##          #\##*.* .. ***.*. ***# #*\###                                                      #
#                  #*  # ###.##\#            # **#.* .#.*.\ *\.\.\# ##                                                         #
#                   ##*#    #  #             #. # #*\##\*..**#####                                                             #
#                     #                       #\#  ## #*###**.#                                                                #
#                                              #       #   # .#                                                                #
#                                                           #*#                                                                #
################################################################################################################################