#################################################################
#  *.***. ...***\. *. *...*  \. \. . ...*\.*.\ .*.* \###        #
#* \ .*\.**.*\.  * .\*..**\ ..****  ..\*\*...*  * * #. \#       #
#  .. ..\..\..*.. .  *..*. .* *\*....\.\..*. .... . .# .#       #
#. *.\**\*.\\ ..*...... \ **.\ ..** *. .**\ .  .\.  ...*.#      #
#**.  *\ . *.*\.. *.*..\.\*\*... ****. * . *\*..\  \ *\.**#     #
#..***..*  \*...\.  * * *.  .* \..\. . \ * *.*.     .. ...#     #
# *\**..*  ..\*..** .*\.* ... *. *. \ ...*...\ .. ***  #*. #    #
#.***.. .* .\ .\*..*. ***\..... \.**.  ....   ..*\ .   .\. #    #
#*.\.\.  * \.\. .\*.\  .* * * ..* .  .* ***..\ **.*.* \ \##     #
#...\ ... .   ***.\. .* .\\*. * *.\ *\.   *..*. .\...\ *\#      #
#*.\ .  *   . ....    \. . *...\.*.*.. ...*.\*\.*.*.**..# #     #
#...    *.\ \.* . *. .. *  ****.*. \.. ****.* ***..*#.. *#.#    #
#\ .  .. .  . ** ..\*\..\   ** .**..\  **\. * **\.*..*.. #\.##  #
#*... .*. \  * .\. *.*  ..*\.\  ..\ . \ .* ..\..* .  \ \.#***\# #
#\..\..\.   .\.. * ..* * ...\..** \ \\. .**.... .... \.\ \. .**##
#* **. .. *** \   .**..*. .\\**.. .**.  \*\*\. \\.*   .*.***#*###
#* *.\ *** .\  .   ...*....*..* *.* .* .**.* .. .  *R * *.***.*\#
# ***. \  .*.. .*\.. .... \.\.* *\..\.***\.**. \*. .#.\.. *\.**##
#\  .*\*.*\.. .*..\. .. .  . .*..\\ *\  *.....\  *..\**  *## .# #
# .\*. .. .**.. \. .  . \ ...*.. *\*.. \. .   *... .*.  *#  # # #
# . . *.   .\.\...\ \. .**.\ .\..\.*\. . \..... *.\  *\ \#  #.# #
#*** ***\\  *. .*.  .   \ *   .*\ \. *.*.*.*\ \  * .*##..#   #  #
#.**...**..  \.  \.*   ....    *. . *\.\ **.. ..\  *..*..#      #
#\.*.* ..*\..  * ..** * .\. *  ... .\..* .*  .     \ ** *#      #
#* ...* \\*. \ .    .\.*  ..\..    .**\.\.**   \ *.. *.#\#      #
#. *.* *.\* ... . \**\ *..  .*  .**. .*\. ** ....\  .*.##       #
#\ * .. .\.** **\. .*  \.. *. .. .\ *\ . .   ..*. .*\.#         #
#\.\. ..  .\.*.. . \. *.. .*...* *...*. ...*   .*#.*##          #
# .* \ *.*  \* \  *   ..\. *.. *.*\ *..*.**  *\ .*#L            #
#* *. *.*..*.*  *... * .  ..*\ .\  ..\ .. * *### #              #
# . * **. . . . .  ...*.  *\. ...\*.*.  \ \..*\##               #
#\..* .. * . *\.\. *\ * ....  . ... *\ ..*.*\*#                 #
# * ..  . .\*\*\   . ... \ . . .*.. \\. #.\#.#                  #
#*.  .**\  ...*      .\...*.\ .  *\\.   ..*#*\#                 #
#.*.* \. .. .*.\ *** *.\.\. .*.  \. *.*\.## ##                  #
#**\\ ...*  ..*.*.*. .*. * ..* .* *** # * .#                    #
#*\ * \* .* ... * .*  . .  .\. ..*\*.*\**\*#                    #
# ...\. ***  **\.\..\ \..   * .. . * .#.#.#                     #
#\*\.***.*.\.*\\ *.\...\  ...*  \....\.# #                      #
#################################################################