#############################################################################################################
#               #.\.*.*.. *..  .* \...  .*.*..****.   . \*. . . *.\  . * .  ..**. **\*. .\   *  .*...* \*..*#
#                #.. *.*. .* ..**.. *. ...\..**.. ..*....*.\   *.\ *\.**.\. .\..**.\ .  **   .   * .\  .. ..#
#                 ## ***   .  .**.* .. . .*** * .  . \*  .\***\..  .*\.* ...**  .**..\.*\**.*  \.* * .\.*.  #
#                #\*\#\. \   \ ..\... *\* \**.\      ..\ **.\. .. \.\. *\ * ..*. * \*.***.. .* ...*\ .  *.\\#
#              ##\*.* ..\. \  .* *.\.\ . . ... .  .\.   *\.\*.    .** ...*\..**  .  . **. *.\.*.*  .. . .  *#
#             #*. #\\..\ \.  **\... * .. . .\*   . .\.*\**..\. **    \ * .\ .*.*..*.. ....*. ..  *  ** ** ..#
#             #..    .*..  . .*..*  \ .... \..\.\ **.*. ..  * *.\.***. .**..*...*.**\ .\..\.\.*  ***.  .*..\#
#             #*\.\ *...\. *.**\*.  . * . .. \..* ..   ..*..\  \. ......*\. .* ....\..  .\. *..  ..\..   .\*#
#          # #\.. .  .\\* *. .* ..    ..*  \.*.*\..*    \*  *.  .* ..*..* *..\**. \ . * \. \..*..  *..\*.**.#
#         # # *.*...* .*.**.* .....*\ .*.\. ..* . *. .*...  .*..\ *\ . \ \* *..\*.. ...  *.\..* . \.... *.  #
#         # #...**\  ..\ \.\**...\*.\ *..*  . *. \\ *\**. * *..  .*..\. *  \..*  *\..\.* ..* .\  . . . ..   #
#         #\*.*.**...*..\*. .*\ \*.. .*.*\..\** .*\**...* .\.*\.  . ..* . . \*  .\.  .\* .\ \.. ... ... .  *#
#          ###\... *..\  . . *\*...\.*\.. *  . .\.* ..*.*\  *.** \* . ..*\ \. . \.....\.\. *. **..  \ *. . .#
#         #*#*..\ \*  *.....\*\***. .**.\*..***.. .\..  *  ...*..    .\..\ .*\. .*. ..*..* .\...*\... .. *\ #
#         #...*#.\..... ..**\\ . .* ....*.\ .*   .*   \\...\*...*. **..* .. *... .*.\* * ..\.   . *..*...\.*#
#          # . .\ ..*\..*\.**\ ***\ .* .. **.** *.\.  .. .. .*.   *.. *..*..*\ ***.  ... .\*  .*. **.\.  . *#
#           #\.\. .\.  .** *\. ..  *.*.\. .\ *.  . \ * . ...*.*.   .\ ..\* . ..... ... * * ..  \*\.*\.*...*.#
#         ##. *#*. *.\.*\..\. .\.*..*.. .\ **.. .*\.\. \.*... . . . \ .*.*  *\.**\*....** .*  *.*. *  .. ** #
#        # * \*#**#..*....\.  .  ...* \\*..* .\ .*. .. ..*\.  *.. \..*\**. .\ \.*** . *\ .**\ .\   . *      #
#        #\.* ##.*.*.*..\   ***. \.\*...\  .***\ .. ..**.\.. *  **.**.*\..  *..*  . * ... .**.*.. *...*  .\.#
#         #*. *# .*..  ** *..\. \ ..  * . *..*.*.  \  .* *...* .*. * *\..   .* . \  .\* \***.\.*.* .*    . \#
#        ##. #.\. #...*.\ .. *.....\ ** **.  ..   \\ . .\. . .  .\*. *   \** * . .*\  . ...* .\**...\* *** \#
#       #*.  * .*.*  \***\.** .  \. .*\ *.\* \ ... .\.  *\.* ..*\*. ..\  *..** .\*.* *..* .**.\.. .   .*... #
#        ##... *.\*...**...*\*     ******\.. \.     . .... .  .*\ . \. . .**..\ *.** . ...**.. *\.*.\* ..\. #
#   # # #\* . ..**.. *.. .*.\***.\**..*.*****  ..\*.*\. ** * * . \ .\\..  \ .. .. .\. . ..*..\   *** .\**...#
####\#\####\\.* .*. * * *.\\...\ * .. \ .\** \ ..*.\. . .\.* .***.  .* .**.*.*. ..* .*  *  ... .\*  *.**  * #
#\*. .\ * # .  .  ... * .  *. *\.... .  ....  .\ ..* ** *.*\....*.*  .***.\.\ * .*. *. * \*.. .\ .\** * .\. #
####\..*# .. . .#.... .*. ..\ **.* * *.\\ .\  . .. * \  .\.\.   **...*...\.\ \ \..**  .*. **.  ...*.. .. ..\#
#  #** *..* . . * .* \..*  * ..**  . \ *  \.\..  *.*\ ..  * .\ **. *.. * .*....  .\.\ .\*\ *\..\ .     .   .#
#  #.\#\  *\* ..* \\. ..  .\. * **.\ .*\ *  *.   ...*.  \.**. *.* ... *. *\.\.*\..*..\**..**  **.* \* *  \ *#
#   ## ##*. *. . \*.  .*.* *  \.\.\ .*\.\  *.*.*  . ...*...*.   *   **\ .\*. *... .   *\. ..*.*.*\  .*. *..*#
#       #*\*     . ..* ... ** ..  .....**...\*    *\\.. . .*\ .** . ..\..*.***.. . * ...*R. .****. *\.\\\.*\#
#        #****....*. .***\ . **  \*\. . ..*** . \.\..*   .. ** ..  *..*  .* ..  . ..*.* *.\ ....\.\. ...\ * #
#         #*.*. ..\*\...\.. .*.* .\*   .\**..    *.* *.\.* ......    .  *..**.\*.\*......**..   **.  **\... #
#    ### # #*. . .*...** *\*.\*.*.*.* \* .* \    . ....... * .. . *  ..\.. ..*..  *..  *.***\\...\\. *.* ...#
#   #.*.##  .*\   . \** *.*  .*  . \    .*.\ . *..\ . .*\**.\..  *.\  .. \* ..   ..*\ \ .\*\ * .*.\ **...* \#
#  ##.\ # #. . .   ..**..*\..... **. *..\\* \  *  ...  . ..  . ..**...\..**\** ..*..\. .**.. .*...*.. ..  .*#
# # \ .*.L.. \.  *\.*....*  .\*. *..*...*   . .*.\ .\ *..\. **\ * .\.***.\. ... *. .**\*\.... *.. .*...    .#
#  ####.*##\  . *....* .*. **\..*\ ..**...\... .\..   ..* *\. **\* .*....  *.\* .....\.  .**...\*..*...**.* #
#  #...*\ .  *  ..** ...* \.\ *.\ ***...\*.*** * *\ \\.\...******. *..   .*...\**  **  .***..*  .*.\.   \*\*#
#   ##*.*#\* .\* . .*.* * ..\ **..\..\ ..*\.*. . *.*..\ \...*\.... .....\... . ..***\.\..\.\*. **. **.  \ **#
#   #* ..#*. *..   ...*.. *\ \*..    ..*.\  \.*.  .\.* * * ** .** \ *    .   .\.\.*.*\ .\*.. *.*.\.*.\ *.  *#
#    ##*...\ .*\\.*. .. . * ..\\. *\*. *. . .\.*.\ .\... ****\**\   \ \  *.*. * \**...  .*\ .  \.. .. ..\ *.#
#      #*.\..\.. * *.\ .*.* .*. \ ... .**  .* **\.   .  ..\. ... .  ....*. ...\.*.. .\*.\*.\.... .*.\. \\* *#
#      # .* \* * .\.. .**..\ ** ..\*  .    ..\*.**  .** .\.*.  \.\.*.*. ..\ .* .....*.\. .. .. *  .*.*.. *..#
#    #  ##.   .* \.**    *\*....*  . * . .\  \.\\.**  ...  .  \* .**.. * ..\ ..  .. \. * ..* . \ . . *. \.. #
#   # # #..*\.   ...\\ .\.*\.*\ . .\.* *.** ....*\\*.\**. *. . .* .\ *.. \.. *\. * .\.*\. *..* .\    . ..*\.#
#   #*.#.*...\ *  .  .. ..****  .*\***.* .*\.*. *.*****...\\* **.  *.*.*\. ...  * *\*...*..*..*.....*** .   #
#   #..**..\\ \*..** . ** **...*.* .*.* *..  .*  \*.**.\** **.*\*.... . . ... .*\ ....**.* ....*  .*.\.\ ** #
#   #* *.   #. *   ..\*.. *.. \.*. ..\ .*.  .\*. .\*.  ....**.\ ...\*.\ *.. ..**....  *\** **. *..\* *.*\.. #
#    #...##*. **\. *...  .\*\.. ..  **....*.*.   .     \*.*.\*.....*\.\*.*  . *. ***\..*\.*.....\. . ***.**.#
#     #..#  .*..  *.** .\. .. .. .*\*.**\..\\.   **.\ * ..\*.. .*  .. ..\..\ .* \*.* *** .. ** ..  .   . .* #
#      #\#\ .*\.. *.*.\..*  \. .  \..\.** ..\*.*. \ . \      .  *\ .* ... \.  . ..**..\\ *\\....*.  * .*\.. #
#      #\.\* *#\ *....* . .*.. ..\.\  ..*  \.* ..* . *\.\. ..*.\.*.*  . \*.* * *\..**.\***  .  *.*.  . *. *.#
#       # *#* *....\\ \ **\..\ ..*  .. *...**.* . . *.****..  .*.*..   *.. ...* . \.....\  .***.**  \** .\. #
#      # \ \.*.*\*.. *. * ***    *  \. \*. ..**  .* *..*.. * *\. .  ..*. . \\ .\.\\..** .  *\\.* * *... ..**#
#      #\ *... **.*\.. *\..*.. *   \.\.   *\.*.   \*.\. ** *.....  \. .*\ *.*\*.\*.. ..\ \.... ..* .   .*\.*#
#       ##. *. \ .. \** .  ..*\*\  ..*\....  *\ .*.... \**\ *...\ \**.\.. * **.** .\* *.   *\..\.\*. .\\** .#
#############################################################################################################