###########################################
#            ##*#                         #
#           #*#\#                         #
#         ###.#.#  #  #                   #
#        #**#.*\.## ##.#                  #
#      ## *.   .\#. ##\*#                 #
#     # .#\.*\..##\ .#...#                #
#     ##*.*.*.\.#...*..\#   #             #
#    #\..#.***. .  *.#..#  #\#          ###
#     ##\. **.*#* .\ ...\L#*. #  #######*.#
#      # #*#*....\.. * #...*\.*##\...*.#\.#
#      ##.#*.# * ..*  *.#  .. . *.\ \.\..##
#     #\*  . *..\.. \ .***\.*. ..*...##\  #
#  # ##  ##* .   ***. .##.\\. ..    .. \ *#
# #.#.  . \. .....**.\*.*\.*\. \*.*.. *  .#
##  ##.\* . .* . \* . ..* .\* \ .... \**. #
## \..# * \. \..  . ***  *  ....\.   \**\ #
#  ...  .... ..\*\**.\.***. .....*\***.**.#
##*  . \ *. \ ........... . .*.\ .  *.\\\ #
#\....*.. .. ..*  .*\.... *.*. *\ * ...  \#
#.*.\ ... \  *\.\ ..**.***. * \   \  **\..#
#.\ . ..*\.. ..*..\..\.**.\ . **   *\..  .#
# \\ .  ......**.\.\.* .*..\ *..\..\. * . #
#\. *\..* *  \.  ... . ..\\.*..    ....*..#
#*.*....\. ...\..\. * **  . ..*.* * *...\ #
#. .*\  .*. \..\** **.\..***.\  *\. .*..*\#
#. *\. * .\  .**....* ..  .*    .** .\  . #
#. ... . \... *** ..*..\ ..  \.*..***..**.#
#\ .*\.**\ ....\.** \.. . .    * .  \..*..#
#.. . *....*\. \ ...  .   .. ...*. \ .\ *.#
#\ \*  \..*.\* ..... .  .\.  .\*..*.....\ #
# ... .. *.\ \.*\*  ..\.*. *\\.... *  \ **#
#.****\\. \ \. .   ..   ** .*  .** . . **.#
#.*..*.. * \. .\    *\....\...**\.*\.\... #
#* * .** \\**\.*** \...\....\\.\ ..  .*\.\#
#. . ..*...\.*.* .\.*.\...*..\.*\.\  .*.\*#
#     *\.\. . **    .. \ *..\. \**.\.\.\ *#
#.\.*\* ..\.. .   * \ ..\R..\ .*\.* \*....#
#..**.**. * .\.  \.\. ..*..\ *\*. . ...  .#
# ** *.*  *..\.** **.  ..\..* **..   \ .  #
#.*.\*.* .\*.  .. ..    ***....*.**..  ***#
#** . *\*.  ...\.. \ .\...\ *....\. \  .*.#
#\**... .. .   .* . .*.*..* .*.**\**... ..#
#*......*\.\ \. .\  .. **......*. \... .  #
#*..*\  *  .*..\..*\ . . *\*..   .  . . **#
#**\. ...* *\\*..*..*\.**.*.*..*.. .* *\ \#
#.*  \.  .... ..  ..*. \..\... *.   .*..*.#
#\..*.*  .*\.\.\.*. ....*  .\ .. .  .\ .**#
#****..  .* *. ......*.**\  .*  .* .*..\*\#
#......  ..**. \.*\ ..\*..*\ ..   * .  ...#
#  .\..*.  \* . .**\. ... *\ \ \*..   .. .#
#.* .\*  . .. *\*...*.\*   .  .*.\*..  ** #
#\ .. ...  . \ .*  *\ *** \ .**\  .. \**.*#
#  \.\\*.\  ** *.. .*.\.*  . *...\* *  *..#
#\*.*  .  * ..\ \.***... \ *... *..*.*...*#
#...\*\\  ..\ \.  .\\ .\*. \**.\..  ..   .#
#*\ ...\. ..  .\  * * * ..\ ..**   .**. **#
#* \  .  \ \.\*  .*\\ ..  *\ .*\ \......*\#
#* . .... * .*.   .*.*.\*\..*..... . ** ..#
#.\*.* . *\    * \ ..* *. ..**.\*. **..  .#
#. ...   . .\ *. .   * .  ..*. .. *...  .*#
#\*.  *\ *  . .\ .* *. * *. .   * .\**.**.#
#  * .*. \  .\ *.*\.\* . \. ...**. *\....*#
#.\*.**  .\.  \*.*  \.\. . .\*..*\ ...**.\#
#  * *.*.\*\  ..*.\*..\\.\  .. .... *\. . #
#\\.* ....* \ .\.  .  **\ \ . ..\    .. \ #
#*\ .  \. .* ... .*\**... .     . . . .. .#
#. .*  . . . *\..*.\..  **.*.*   .\ .  *  #
#\ . \\. \.* .*  * ... .\* .\...\..\ .*. \#
#.*  ... ..\...... .*.   .. *     * *\.\  #
#...*. ** *.   *\ .\*\** ** . ....* \*. * #
#*.*.  *.\* \  ** . \.\.\*.*. .\**\\\*.\. #
#..   *.  **. *.. * \ *..* \*.\... *\*.*.\#
#\  \. \ .\***..*... .  .*....   *.....*  #
# ... ..*  ...\ \    ..\\.**..*\ *. ..\  *#
# *\  \**\**....  **   . . .. *.*\.* *. . #
# .  * .\ ... * \.*\ .  ..\.\ \.\ *. ..*. #
#.*.*.*   * *.**.*. \  **\.\.\.\.*..  *...#
# **.\..**. .\.***\*. .**\ * . \ \*  *.\ *#
#\.. ** .\ * *.*... .* \. ..*\\ \ .  *   .#
#*.  .*\.**. .\*.\.  ..    *. .. \.***   .#
# . .\. .....  . *\ *\ . .\.*... *\ *..\*\#
#.*..#..*.....\*\..  .*\ ...\*.* \  .\* ..#
#.***. .\ ... .. .**\** .. *\.  \*   *\ **#
#\\..\. .. .*. . \* .**\\ ..  ..\\  .\.  \#
#   .* *.. \.\ \.*.\\..\.*.\ * \*\.  .  ..#
#* ...  .....  . .. *\. ***  .  ..   ...  #
#.**.\. *.** * .  .*.. \*.\. *... ..  .*\ #
# \\   .\**. .  .***.......  .*    \ *\...#
# . ...\. . .. *.*.* \..*\..... *\ *\*.. \#
#\. \.**.\ ...\**..*..* . * * * .. ***\ * #
#* \  ... *....*..*\..*  .*..*..  ..\* *..#
#. .**#  .* . ..*.... *\.\..* ...* ... * .#
#*.\.*.   #* *. *.*   . ..*.*  \ .  . ..\*#
#*. ..#\\..*\. **.. \...  . .\. ...\...\..#
#\#*. *.\.\.  *\.#  \*. \\. ** \** * * *. #
###########################################