#############
#  ## #.#   #
# #* #..*#  #
##..   \*## #
#.**\ ###* ##
###\  *. . *#
##*...*\.# ##
#*. ..\. L .#
#.   *#    ##
#.  .*#**..\#
#\.  .*.. .*#
#.\.  . .  .#
#  . .*\   \#
#. \. *..*. #
#  . .**. .*#
#.\ ..*. *\.#
#\* ****.*. #
# .\*.\. .\*#
# *..\.* .*.#
#..*  ** ..*#
#.\*.*..  *.#
#*..**.  ...#
#*\...\*\* *#
#\.\ ... *\.#
#.. . * \.*.#
#\\ *. **  \#
# .*.* . *. #
# **\.* .*  #
#*. **.\  \*#
#\...\*.. **#
# *.. *\ \ .#
#*.. ..\.\ \#
# *\. \  *..#
#.*\.* * .. #
# .. \ . \..#
#  *.  **..\#
#.*.  *.\\\.#
#\ .***. .  #
#**. *.*.  .#
#. *\.**. .*#
#*.\. ..*\.\#
#*... . ..**#
#  * **\. *.#
#.\. *\. *..#
# ..\\* .*  #
#\ . *.. *. #
#* *\. .*..*#
#* ..  *\ .*#
#. .**....*.#
#** *.  . ..#
#..***. \.. #
# .*\..  *\ #
#...  * ***.#
#.\  .. * .\#
# *...**** .#
#*.*.  . . .#
#.\..** *** #
# *.\.\ .**\#
#. . .. \. *#
#* * *  . . #
# \. . .*..*#
#.  \ ** .*.#
#.. ........#
#*\ .  .  .*#
#.  *..\* * #
#  ..\... \*#
#.\*** .*\.*#
#*....* ..\*#
#.. *\..\.. #
#..*. . ..*.#
#  .\.\   .*#
#.*\* .... .#
#\  * .* \* #
#.\**. * .. #
# *. R*.\*\.#
#\.  .\ ****#
# * \* \... #
#**\.. **\* #
#.\ ....... #
#. \.  .\*. #
#**.\.\. **.#
#.*..*. .*  #
# .  *  ** .#
# .  .***.\*#
#   .*....**#
#..\.**..*..#
#\. .\. ..\\#
#*.\  *  .  #
#\  . \.   .#
#*.*.*  *  \#
#..\*. \.**.#
#  \**  .*\.#
#* .** *....#
#.  .. .... #
# .\   *.*. #
#*\ * \.* **#
#. . *..... #
#.* **\.*.\.#
#*. ..*...**#
#*.  .\\*.. #
#  .. ..\.*.#
#\.*..*.*...#
#.\.* . .\ .#
#.**   .*.. #
#\*.**\** . #
#...... *\. #
#...*.  ... #
#  .*\*.\  *#
# .. \.. **.#
#***. .*..  #
#############