######################################################################################################################################
#             # #  ##\ #  * *\.\*.   \ . .**  . * *   .**. *.*..\* . ....* . .\\. ..   .** *.\\ *.**..* ..\*..\* . .*\* *.*  * . *.. #
#            #*#\##  .*.... *...*. . .* *. ...... \  .*.* .*  \... .\* .**. .\*\*.   .*.\.. * .*. .\....* *.\.... .*\...\..   *.**\  #
#           #.*#.\ ...  \\.\.* ..\  ......\\  . **.\ *** . \ * ..\...  .*.\ *\* \ ..* . ...*\  ..\  . .**.. ..*.. .**  ..    *\..** .#
#            #\ \ * ..\..\.  .. \*  . \ **.. .\ ...*.....  . \.\ .\ .    \ .\*.\. .\... .  *.. \* * * *.*** .\.** .*.. *\.\  \.* \.. #
#           #\ \.\ * # **..\****..\   .\.\.. .***.*....\.  *.. ... . ..* .*. \ . **. . *   *.  .    * . ...\ *. ..*... *\   *\ . . *\#
#            ##. ****\ .. * *.** \..*\ .\.* . \...\ \ . .\** .**  * \ \*. *. .\*.    ..\ **. * \.. .. ..* . .* ***.  **....*...  *\*.#
#          ##*#*\... *** ..***\*  *\.. *.*. .**\... ..\*.  *\.*. .. \ ..* .*..  . * *. \........ \*.\  .. \* ...\.*\*\\.\ *.*\ ... * #
#         #*.**.. \*....\  .\  *  . *\...\. *. ***..  *.   .  \..      .\ .\.\* * ..\... .*\  *\\ .*. \**......*....... . \..**..\\ *#
#        #...##\.*...\ \..* .... . \..*\\*. . ..\. \  ...*.\....**\. .\.\. *. **.* ..\. .\. \.*.. .... .\.....  * .\.****\  \**\.*. *#
#        #*\*.###. *.* ** **.  .* *.  *\... *.\ ..\...\.  *.  \ \*.. *.\*\.\.    .**. *\.\...*  * .\  *.  \ .*.\.\*  .\*... .******..#
#         #*\\ ##...*.**\ .*. **\.*.* . * \ * ..* *. . *.*. * .* *.   \ .* *\.** \.\. ..  \.\. ..\ . *.\. .**.** .\**  **\ . .**.*. .#
#          ###***\. .\.* .\**. *\ *...\ **\ .*  .\.\  . *  .*...*. **.. **.. ..*..*  *\ .\.  . .\ * ...  \*... .\ **.*...** .... ... #
#            #  ##*  . .. * .  **** ... ..*\* ..**   * *.\  . \.*. ..*\*...\. .. \...... .\.*. \ ..*\\. * .* *. .*..  .   \* . .  ***#
#             # #\. ..*.\.* .**.* .\.**\.\.**....\   *\\  \ \*. *.\* ..     \. \ .\*\ ..*. ..\.. .*.*. *\* .\.*  ..*\ \.. .* ****...\#
#             #*\..   \*.*\#*\. ..*...   ..\ *.\*.  \. .  .*.\*.*  ..*. \ **.** .  . \*...**\..\* . .**. .   *.\. * .  .\...\*.\*\.\.#
#              ## . . .* *..\ .* \.*  .**.  *.*... *.  * . .*...* *.\* \** ..\  .  . .\.\\...** *\.  ..*.*. *...  \. .. .   .*....* .#
#            #####\ *\ ....* * \ ..*\.\..* ..*\ .* \  *. .\..* .**..*   ** \..  ** .   .*\...**.*.* . . .. .     * . ..\  * .... .* .#
#           #**.\*.*.... .  .*     . .  *..\**..  .*.. *.\. *** ..\  \.*. .. \ \ .\...*\.\*.\***. . \     \..* \ *. \ ***\.\*. *  .\.#
#           ##..#*.*...   *  .**......  . \..\ ..*.*.* .  ..\. ..\. *. \.**.*  *.\..  *. **. .\*.* .. **\.* .  \..* * .\.\** .*.  * *#
#   #     ## ..**\#.\. .*.. .\.*.\.\ *\. .  **\.*..**..\ .  .\\ .  \**.. ..  . **.  ...\ *.   .. *...*\.*\*. .  ... .  * * .\.**...\.#
#  #*# # #.. \#..*\** .*.* *.  . .\. ** . * .*** .** ...  .  .  *\***.* .. . \...\...* ...**    \.\  .  .** .*\ * *   *. ..*.\..  *  #
#  #.*#*##. ... ...*.    . .\.*   .****\ \.* *.* \*. \* ...\\..** \ ..\  .* \**. \ . *   . *\..\... \\ .*.\ \.... \\\ *\..  *\ . \* *#
#  # #** ##\.*..*  .. *  .. * * .....\..\. . *..*..   *  *.*. .*\.. . * \ . ... *.  . ..   ..\ .   *.  . \ ..** . ...** *  *\... ..*.#
# # . *.*.** *\ *.\ *.\ \ *** .     . .*...\... ..\..*.*..\.. .   \ .** \.**   .\* \*  *\*. .  \  ...\.*.. \ *\ .* * *.**  .. *.*\*. #
# #**.. .. .... **. .   *..\..*. . *..*\.\ . **.*\.*.* ***..\  *    *\.* *\* * .**... .* .\*... .\ \.... *.*****\. ** *.*  ..... .\* #
#  ##     ..... .. \. ****. *.. \. .    .* ...* .  . \.*.**.*\*.\ .*.. ..  *   *\*.** .*  ... *  .*\... .. *.. . .*. *\.. .  *.*.\ \ #
#  #*.* . * ..  ..*. .*...\ *\.\..\*.* .\. .***..\*.\. . . **..     \ * \ *. *.... .. *.*  \* * ..* .\  .*  .*.   .*.**.... ..\ **.. #
#   #### #*  . *#.*\**. ..   .\* * .\**. .. *..\**\ \  \..\... * **  ..\   . . . \.   * ..\.  .*... .* * .\... **  . ..  .. .\***.  *#
#  ##.#####.\\ **.* ..  **\. *.* .\*\...    . .*..... ** *. *.. .\**..  .. * .. \. * .*\\* .   * \*. * \. .\   .****..\*   .**....*  #
# #.  ***.##*.   ##..\* ...   \. *  . . \. **. .*..\  **  * .\ ***.. **.*\ .  \*.  . \* *.. .  \..**.   \ .*.* .\*.\.**\ .*.\\...\* \#
##   ..*. *##\.**.\.*.   \ . \ .. *  \ . * \..*. **. .*.  . \.... .*.... .* **...*   .*. .\ \ ....\...  . * .**.. \*\***.**. .\ *   .#
# #*.*.    ... \*.*\. **..... .\* ****\*..  .**   *\ * .. \ . . * * **\ **\ *\* *\ .\.. .**.....  **\. \  .*.. ..  \ ... .\.* . \    #
#  # * \ . .. \.. ...\... * \.   \...  \*\ . .**** .\.* . * \***\ *..*. ..*\..**..\ .  . *.\\.  .  .. ...\*.  . \ .  .\**  ...**.  *.#
#  #* \  **\ *.  \. *  ..*.*.  * .*\*\ *****. \. . * .....*.......  \. * ...*\.*\**. ..*\. ..* . .   .*\*\**\ .*. .**\** . *\ .*. * *#
#   #\.  \.*. * ..  * *.*...*\ ...**.*......*. . ...\ **..\  .    . ..\.  \ ** .*..*.* .*.\ \. .*..*.   . .*. ***.\..**.  \.  .. .*  #
#  #\.#.#..\. .*..* .\ .*\**...*.*..*..\*. ..*  . \** *\.\.\..*  .\**..*\  .*\ . \*.*\. .....  *\. ..\ .**\.*\* .. **.\ ..... .\**.. #
# #.  *.\.**  .*\*.  *\.....  ...\.* \  .* . *   \...\ . . \. .\ .*..* ... ... .. * .  *  ..*\ .*  . .......*.. **\\    * **... *\  .#
####* \ *.*\.**\...  .\. . **\*.*.\*\.. ...**..*..\.*** *.*.   .\.\.*\ .. .. *. . .\.\*....\.** . *.\....*.\ .***.**... \  .** .\....#
#**..#.\.#.  \. \**. *..* ..\..\*...\ *. ...*...*  **\..\ *.*.* \* ....  *** .*. . .. .     ... . * .*.  . . .. .\*..\. .. * ... .* .#
###..\** ** \ #*.*.* \ * \\ .* .\.*   ..* * .\. *.....\ ... . .*  ***  *.....\...*.\    *     .*  ..*..* .  .* ..*  .          . \*\ #
##. *#..\.\  \ .** .*..\\. ..*\ ... ** ..\* . \ .*. * *. . \.... *.\   *.*.\     .** \* .. *. .\  \*..... .\ ... . .\ \.\ * **. .. ..#
##..# ##\\. \.\ .\ .... *** .\*. .\ . ..\\.   .  ..*\ \..*\.** * . *\ .. *\\.\ . .*\.. . * . **. *.\..** *. *.*. . ..  .\.. ..   **\.#
# ##    #\*#. ***** .*\ * .*  .\ * . .. .. .* \. . .... .*.....*\* \..\  *.*.*..*\.*\.*  **  *. .*** ...*.. . *.\.. ..** .\. *** ..* #
#    ###*#..\ .*....*...\...  \ .*  . \ ..*\. *.\.  ..\...  ..........*\ **.  \***..*..\.*\**** *..*    ....\*.\. . \.  ...*.*.\*..*.#
#   # *  .\    . ...*\ .. ..**.. ...*.....\ * ..\.\*\    . . *. ..\ ...*\.* *\..* .*  \.\. .. * \ .. *.*.. *\**.. ***.\  ...\. ..* \.#
#    ### . . \*\ *.\. \ \* *.*.* .***..*.* ...\ *.  ...*\\\*****  .. . . ***. ... * * * *.* **.  .\ .  ........\ *.\*  .*.\    \ ....#
#     #  # **..\ ..  . \.*.  ..\ * *. *.\   *\   .* *. ..*\ ...*..  . .  .\. *\ *..*... ** .\*.. .   .\    * *\* . .. . .. \* . \  \ #
#      ### ##\..\  .  . ...* .*.*. .  .\*  .* *..*.  ... . .  \.*. *...\ . ... ..*\*.. *\.***. \. * \* .*. .  *\. *....  \*.. ..\\ .\#
#         ##*.* .*... \.  **.*.. *   **\ ..\* *..*****. .. .. ...\ \* ..    *.\.  **\*.*  .\....*\.\..  * *.. .* .* \.. *...\  .*.  *#
#           ##*.*. \*\.\*\** \\* .\  . *   .....\*. **  *\..*. . . . .  .* ...**   **\.*** * .  ..*..\**. \. ....*\ .**.\\*\..*\ \ .\#
#          #\.  .   *..*. *.\* .\. *\*.. \*. *.     .\. * **** *. **. ...*.**\*\* \.*...*.***** **.*\ **\..\ .*. .. *** ..*  \..\.   #
#         ##.\\...* .. .  \  .*  ..\*****.\. . \....\.\ . *.*.\.  *.. ..*.*\..**.. *.. \.... \*.\. ...** *. ... . \*. .** .....*.* .\#
#        #***.*  .*.*\  .** \*.. .\.  . \  ..\* ** \..  * . . .\.***  .. \. *... .\\* *.   .*.*  * ...** *\ *\. .\ *  . .  .*. .*. \ #
#        #....* *\ . *..\.*.\..\\ .\.**. .\. .\ .*..*\*.... .. .* ..\. . .\*\.. .*..\*. . ..\**. .  * ***.......  .*.*.   \ . . .\. *#
#       #\.     .. *... . . ..\** . \..*.... . * . .. .\  *. \* .\ ** .\   ..*.*\.. .*\  *\*..\ . **..*.**..  .  .*.** \ \.  .   \  .#
#        # .\  .\ .\\  .**     ..* .   . .\ .* . .... ........ *\ .*\..* \ *  .** * .\* *..*\\..*  .\...\.  *\\* \...*... ..** .*.**\#
#      ## * ##\. \.*.   ..* \.*\\**\ ****.. ..  .*\.\ \*..\ \. *..*.* .\\ .  *..\.*****\.**.\ . .\.*.** ... *.\**..... .*\ *\*\** ...#
#     #\ *. *\..\. ..  ...* . *..\.*  .*.  ...  . .**...\\.\. ..*. .** .\\ *\*.* \...\* ...* \. .* .*\.. .. ..***  **\...* ...**.\\. #
#    ##*.\#*\....\ \ \. * .* .*  .  *.\. \ .*  ** *.... .*  ..*\..**\.\. \ ..**\.  . ..*  ..  * . \..*\.\ .**\* *..**.*... . . . . .\#
#   # .#.#**. .**.\.\ * . .\ *     .\\ \.  .....*\.*   *\.\*..* * .\* **.   *. . .*. *. ** *..\.....***.*. ....\.*.   *.  *.\ *.     #
#    #. .  *    \**. ..\  ..\.**\*\..  ..\    *......\ *.  .  .\  ...* *\...\ \   .  *. \.***.. \..*\*.*.*\.     .\ .** . ...*.* ..\*#
#   #**#   . ** .*.  .... .. *...\ .\.  ..*. .  . *.* \*  *   . **  **.. \..*...*.  *\... .***. \...  .**... .*\  .. .\ .  *.....\*\*#
#  # .# # *L##*\ *.\* \ *.\   .*.** .. .*.  ** . .\*. .\*\  .*  \.. .*   . ..* *. .\ .*.*... .. ...   .*. ..... .*.*.\....\ . ..*.. .#
#   #\# #*.#.*.# .  *.. ... \.\. .*  . * * \.*. . *\.\ *.  *\.\.. *.. ..  **\....\\* .\*..\**  \.*.  ... \\ *.*  *\..*.*\*. . *\.  ..#
#   # #  ###\#\#  . # \ *\..*\** ** .* \ . * \ **.\\   .\**  .\*\ \.   *. *...  .*.*. .   ..\.**\...*  *. .****.... \.\ \...**.  **\.#
#    #     #.#. \* . \ \..**. .. . .  * .*.*. \ .  *\*\.\.... ..*..*\ **.*. *\.. .\\ \*\**  . *\    .. .. \*.**. *.\ *. .\*..*. .\. *#
#           ## *.#*\.#. ..#. *\.. *\* *\ .*\*\..***  ..*.*. . * .. . .*.\   ..*\.* .. *...*\..* .. \ **...........*..\* *.. .. .\.  .#
#            #.\##.*. #*\ .. .* \  *\...  \.*.*..*.. ... **  \.. .\. .*  ...  *  ..\  .\ \** .. *\. **.**. ...*..*..\...* .... *..*..#
#            #\.\#*\\   . * . \ \..** .*   \...*..*\** ..\*  .**\.*.*...**  * .* .. **... *\ .****.\\* *.. . \.*\...\.\\...**.\.*..**#
#            # #.\. ..*.. *\  .\.* *..\ *  .**\.*...  * ..  .  * ..\**\..*\ .. .\  *\.\ *.* .*\.\. . .\\. ..*.**.\*   **   ..\**.*.**#
#            #\  # # *\.**.*. .**\  .*...\.  ..\*  \ .*   . \..\* *  ... .\ . . *.*.... .*.  .. *. *..**\   \.*.\..   ***.. \ ...*.\.#
#            #  *** \ .  \ .  .*.** **. *.. .*. .  \ .. **  . *...* \ \. ** ..\*. .\  *..*  .*. .**\ \..*.. .\*\*....*.. .\..* ...* .#
#            #\ \.* #.#. *...*\...* \.* .\ . .* . *.*..*.* .  **. ... .\.** .\*..\.   .* *  .  . \.\. .*.\. . \ * *\. **\..* .  *.\* #
#             #*#**#..# .*   . ...\  ..**..  \* * ...\.. *..\* **.. \* .....  .*  *... .\.... \. .***  *** . .*.  .**..** **  **. * .#
#             #.#*# \#*.\.**** .* *.**..\..     ..  * \. .*   ....\...* .  * \ .  ...\  .. *\. *  \.. \. . ***.*. **..\.\..*\ \.**..*#
#              #.. *.\*.*   .  . *.*...*\ .    \ \ .... *..**... \.\...\ ...  .\ \*\* .  ***.  .\ .\.*. .  .\.\* \ .\.. * .\. .*. .\.#
#               #*.** . *\R ....\.\.\  ...\ \**.*.   .  ...*..*  .  ...*.\... ..*..*..*  * .*\*** * \\ .. .\. .\*   ***.*.* \.***\.*.#
#                ##.##*\.. * *.     .   \ ** **\.\.. .\ .. **\*\  \..*.\..*.. **.. ...\...\**...  *      .\ .\ **. ....\.\.\....*  **#
#                  #\** \. . . \ * .. ...*   .\ ..\. . .***\.*.\....\*.\* ..*.*. . *.. *.. .*.\.   **  \.*.\ ..\ \...\.  **. * .\ .. #
#                 # #\**.*. \.**. .\..   * ..  .*..*.  . \*\*.\*  \\..   . *.***.. .  .\  ..\\.*  . * ...*\.....\..*. ** . *... **   #
#                 #\....*.. ..\... .* .*\..*\ *\..\*...\.....* .*..  *.*\.   ..** .*.   .. .\.*\   . *\..\.  .*\.\.* **.... *  .. * .#
#                 ##.\ ...  .  *\ ..\* .* .... . ..*.*\.\  . .*\* ..** . ** *\ *  *..*.\ .\*\    . ...\\ .* .\\* .*\. ** **   \.\.*. #
#                #**\#     .\ ...* * ..\. ..* **\**.*..*. . .**** . . *\ **.\..*. * \. .** .*.. *....   . *\*.. \...**..\ \.. . ..*..#
#                 ##.#**\.**.* \..*  * ***. ..* *....***.*   ...  .\..**.\  \ \.*\.\. . *. .*   \* *\*.  ..*.*. * \..*\ ** *.. .*\. .#
#                  #*.*#. *..* .. .*.. . **.  \ *.** ..\.. ..\.*** .  \ ..\ ..*\..*   *.*\  . \... .  . *\.* *. .\ .*. \.. . .  *.* *#
#                 # \.*  *. .. *\*.*. *.*...    * .*.\ * \ \ .  * .\.  \.  \ ... **\ *.\*...       . **..* .\.* ....\.*..   *.* \  ..#
#                # \###....\...**.*.\ *\..* \.  .** *   **     *. *. ... .*.    *...  *..  *..*.  *  *.\ *    *.. . *.**  .\* . .*  .#
#                 # \#\.. \..  **.. * \.**. .. .*.. \  \ . ..* . *... ...\.   *  .*.  ..**\....\ **\*.. .. \.*.**  \.*. *.  .\  ..*..#
#                  # . \*.. *\..  . .  ...*     \  \  .. \  *. .\.. .\\.* \  *.*. \\  *  .  \*. *\*.. .\*\*.\\.\.\\  ..... \.. .*\ **#
#                  #\...**..\. \ .***\ *.*.. .. .* .*\  .  .*   *.\ \. *.... .\..\.\ ..*.  ...   .**\..*.**.*  . .*..\ .\*. .* *. *..#
#                   # ***.   .. \...*.*... *.*. *.  * * .* ..\..**  ..** *\ . ** . *. \ .    *.. \.\   *. .\*.* *   . \.*.**..*. **\.#
#                   # *...*... ..*\ ..*. \.\ .*\\. ** * *. \** .\..*\. \.. **\.\ \\ ...* * \ *\**..\.\.* * *.\.\\**\ \  *..\*..\..**.#
######################################################################################################################################