########################
#**...\ . **   *\.R*...#
#..*.* ***\**\*..*\. *\#
# *. . .*****.\.** .*..#
#\*\.\.* .\*. .\ ..\**.#
#... ..*.* .* **\*.\...#
#\.*\ **..  . **...*.. #
#*..*.*.*. * . ..  ... #
#......** ..*****\. \\.#
#.\.\.\  ****\. ..\* ..#
#..**  *.*..*\.. . . * #
#  * ..  . .***..*\ .* #
# *... ** .\. * . .\ ..#
#\\ *.**\...* *. \ .*. #
#.  * \.\\  .*.  \ .*.\#
#..*.\.. ...**\** \  \.#
#.*.**...**\*.*.\ \ . *#
#.*\ . *.*.**..** .. . #
#*.**  * *.. *.  \    \#
#* *.*\..\. .* *  .\ ..#
#*  ... *. *.\*\ .   * #
#*..*.* *. . ...* ..*\.#
# \*  \ \*  . . ...*.. #
#*.*.*..\ *\.\**..* ** #
#.   ..**.\   ... * * .#
#.*....  * **. * ..\\.*#
#..*.*\*  .. .. \.\*.* #
#\  .... \.*.\.....\...#
#.\. \ .\  *\** \**.  .#
#*.* ......**.* *.**.  #
#****\.  .\#. .    * . #
#\\......\. .  * *.\.\.#
#  \**\  . .  \ *\***\.#
#*\.\*. * * . .   **\  #
#\* *#*.. #.#* *** .*. #
#.\ .*\ ..#.\#\*..\*.\.#
#.*.*...*\*\ ***.\**.*##
#**#.  .\* ##***# .***##
#\.* ..*.#..* #.* \*** #
#*#\* *  .##. * \ .#**.#
#*..\*.** .\ .#\*   . *#
#.#\* ..\#.*\#* *\*# #.#
## #* . *#...###### #..#
#   #   .\.##       #*.#
#   #. .L #          ###
#  #. *# #             #
#   #*#                #
#   #.#                #
########################