#################################
#            #*#                #
#      #######.#                #
#     #\.*...#.\##              #
#  # # #**.  *..# #             #
### #*...\.\ .#.#\ #######      #
#. * . ......\ *.*\ ....*.##    #
#\ ** \ *\.** #  ..*.....* .#   #
# *.*\... ..\ . . #**.  *\.#    #
#* .  **#**.#.. .*.. \. .*  #   #
#...  ..*\* . .\ .\# .*\ .\*.####
#.*... \**.. \***  # *.\    \***#
#.. .. ....   *..  .***..\ ..#**#
#   ..****\  \* \*\..\.*\  **...#
# .\.*.\.\*.  ......\  .*.....\ #
#**.*.  .\*\*.\ .  .  *\.  *#\* #
#* \..**.*  . . *..\. ***  \ .###
#.  *..*. .\.. *\  .\*\*.* #* *##
# ..   ..* *.\ \.  ****  *...**L#
# ..*..\*.*.....\\ \. . *  ..#.##
# . . \.\** * ***   ..  .\.  #\##
#\ *.. \ .*\..*.....*\...\ . *.##
#...\ \.\*..\**\.  .... ***. ..\#
#*.*. ..*..**.. . \*\ ..\.\.*\*##
#..\.**\.\ ...\ . .**.*.. . .\###
#  *\...\  . \.*...*. ..* \ * # #
#* .* ...     *..*\ *.  \..\.\# #
#  .\*..\  ... * * *\*   .\*\ .\#
# .**.  **.  ...*.\..*.* .*.* **#
# ..  *..     .  *. ..*\ \... *\#
#. ..\...\** R .\*.*\ .*\ *.... #
# .\.****. .** **...   *\*..\.\*#
#. .\.\.....\..*\ .*** .*.\  .**#
#...* .* .***  ..**.*. .*.\ ..###
#..  . . *..*\ .*\* * .*\ *. \ *#
# .....  .*..*****. .. **.. *  ##
#  *\.\  .\ *..* .  *.  . **\.*.#
#.*\. .  **\.\\**\*  **   ** **##
# .. .  \ *....**..**. ...*. ** #
#  . .\*... .**** .. .   .  .*.##
#*. \..*\*.\. *** #*.*.\ \..\\*##
#################################