#########################################################################################################
#                         ## *..  # \. *\\. *.  ... .**..*.##..##..##     #.\ **#.*#                    #
#                        #.#..*.*  **. \.#\\.\.* \..*..  .\.. .#.  #*#   # .####\ .#                    #
#                       # \* .*.\.. .  . ..\*...*.*.\ . .  *. *\ \ *\#   ##\ # ##\. #                   #
#                        # ##\*\..*\ ..*\\\* . *  .\*.\*\  .  *. .***#  # * #* ** *.#                   #
#                         ##**.*.\ .\  . **.* .\\ . *\ ..\...\...*.\.##  ##\*.#.* * ##                  #
#                          #.\#*\ ...*.*.. ..\*. \ ..* *  \.  .* *..\#.# ## ..#.*\\.*.#                 #
#                        ##### #. ..\. .\.** *..*\. ** *.\ ....**** #..*#  *\ .\.*.\.##                 #
#                       #.**# #..   . . ..**.. .\*.\ *\.. *.\***\ .. . ... *  ***# ..#.#                #
#                       # #*.###..\.\*.  .*.*.  \*  ... \ .**.**..* . *.* * . \.*#. ##*\#   #           #
#                       #*#*...   . *\ *  * .   ..\. . *\* ..\  . \...*..#*.* .*. .\*#\.#  #\#          #
#                      #*\##.#. *.  . *\* .\  .*.    *.. **.\.\.. . .*.* \. .. .*\**.  ..# #.#          #
#                     # # . .*....*\ \. .  *.*.  .\*\ .*...... . \ *.. ... .\.**..##. *.###*  #         #
#                    # #\.  .*. .\** ....  .*.  .\ *.  .... *\  *.\* .  *   * .\  *\.\* .*..#.*#        #
#                  ##  .**\...\ \ **\...\... . \. *. .\*  \ * **.\ ..* *. \*  . .*...*   .*.. . #       #
#                 # # #\*. \. * ..*... *. * *   \..*.*.. .. . .* * \*..... .  .. ***.\*\. * .**.###     #
#                #\*.\ *.  ..**  \.**  ...\*.*  ** * .* *\*.\* .*. ..\.** .*\  *\..*..* *\*\ **.*..#    #
#                 ###.**. ## *.*\ *. .***  .\**.\..*. ..*.*.*.  . *.......\.**.. . .\.  ... *\.*.**##   #
#                   #\..\*\. *.*.\.   .*.  . .. .*.  *.*\.. ** * *\\ ***\** *.  .  *.  **  \..\ .\#.*## #
#                  #*  .. \ \..*  ***...**.   .\*..** * **....\. ..\ .*   . \..  . . .**.* \..*. .#.*. ##
#                 #*. ..... .  .** . ...  * *** *.\.*\.. *\\...*.. *..**\*\ *.\......* *** ..* .* * .# ##
#                #.. **  .. * \*. **.**.**\ *\*..\..**  . .* ...  .\ .\. .. . .*.  .*.**\* \*.. .*\. \# #
#               ##\* .\.    ..  ..\*\ .*..* **   * .....* .. \\   . .  ..  .* .\..  \  .....\ .* .* ## ##
#              # \   ..\ .\ *\   .*...*\.\*\..\ .\  .\..\\ \ .\ *.\* . \.\*.\ *.*.*  *.*** *. .*.. .\*.*#
#               ## .* *.. . . .   .*. \*.....*   . * *.\ *..*.  .. \ . .. ..  ... . ....\*  *. .***.#\..#
#         ##   #*.. . \   *..\* \..*.  .  ..*.. *. *** * .\** . .\ .\ \.*..* *.** \.\.* . **.**.  *. .. #
#        #\.#   ##.\ ....*\. .. * ....* .*... * **..\*......  *\.  .\ . * .. .\.. . .*.*  *.  .***.. . \#
#   #     # .###\.  #* ..\\*  * .\. *..*.\... .\.**\*. . *.   *.*.*\..*.\\   . *.\.* . . .. \*.\\* . ** #
#### # ####\##\  . ..   .*  .*..* .*.**.    *...** ..  \ * *. \ *\*. *\ ..**.\.\..  \  .*  . . *\..*....#
#  # ##\. .. #*#.. *\ *. . . . \.*.. .\ .\..*. **....  ... ..*\. ...  .. \\*. \*.. ...  *\*... .\  \  .\#
##**\*.#. .. *.**.*\ .*.  .* ...*..\ \ *.*\.. ....\ .*.....*\.....* *\ \ ....\.. **. .\... \  .. .* ** .#
# ###*  *\ . \ ...*  ..  ..\ ** .*. \. *..*  .\.*..* .* ..**.. .* \\*.   .*\**.*... ..*..*.. **.**   . \#
#  #*. . .*. ..  ***   .*\  \.*  * *. \ ..**\*..\  ...\  \.\ . *.\.*....** ..* ..* ..*..\.*\ .*.** *  ..#
#   #*  #\\ #.*  **\.   . *.*\\ *\.*..*.* \.  * .** .\ .*..  . * *    .. \.\ .***. .\.\..  *.\*.**\..  \#
#   #*\.\*\*.\. \..   .** *..\..* **.\ .\..\.... .\ .\  ...\. ..\* .. *  \. .. .* \*   *. ... .. * .*.*.#
#   #\*\ .#. * ... \*   .... *    ***  .  \. . \. ***..   *.... *.****..*.      * .. \.** . *\ ..* \*\.\#
#  #.# \ **.*\. .**... \ .   .*.* * .\**.*.*..... .\.\   **...\.*.*\.... ..\..\ *  *    **.*\ .  .\.\.* #
#  #..\. #.**#\  .. *..\*  *. .\. \** *  .*.\. * .   .\ *...***.*.\*  .****. \...  . ..\.*.  .*\.\ . *\*#
#  #\### #.*.*.*.*.\*\. .* . *.* ..*.\*\ \... .\. **.. ...\*..\ *  **\ .\*..   \ ..*. \... .*\ *. **\...#
#   #   ## .*. .    .*. .* *...\*\    **..\ *..   . . **\* * \ \.* \*.. **\.\ \  . ** ....\ \* \ **. *..#
#        #. #. *\    \*. ..*\.*   . .*.**\.\* \\.*..* ..*. * ..*.\ *\.\*\*.   *.*.. .*.*\. ....  *  *..\#
#      # ###. *..\.\..* \* .*.   *.  .\.. ... ..\** *.**\ *.. *.\.  **.   \.. .\. * .* .\*\ * .\**\*.*.\#
#     #.# #\  **. .\ *.\.** . * ..\ * *\ ** .*  *.*. ..*.*.   ..**\ . **..*.*\ *\.\ \*.\...*.*\ .* \. \ #
#     #\* ..\.....* *  .. .*.*.   .\*\.*  *.* ...\* *\.*..* ***.. **  *\\...***.. .*..  * \\* **.  .... #
#    #  .#**\..*\*.*.  ..\. *. ...*.*.\..*\* * . *. .. *  . .\.    ** ...*\.\..\*  . .* .*\**\\**  . \ .#
#    #*..*.* .\. .\* ..*  \* * ***..** .*...**\ *       .* **  *. ..\ .* ..**.. *   **.**. .*.\.**\ .  *#
#     ## ...  .*  *. **.   .\. .\\.* **.\.\*\. *\.. ... ***.* .\..****..\  ..**\..  .\.*.  ...\ .* .  .*#
#      #   .   **\\........ *.   ** \\.****.\... \..\......\*.\*  .**..* ....*. \**  .* \  \. .\*... *..#
#       #**. . ...  .\.\.\.\.  . \. * ..*\   .*..  ..* .\. .*...*.*.\.*.   .... ..*. ...*.. .* ....  .\ #
#        #\.*\. .\\**   .****.*  .*...* \ .   .*. .. ..\   ...\\.*.*.\.. .   ..**.. **  . . ** *.\.\  .*#
#        #**\.*.*. .....\.* ***. \. * .. \ *. \.*.* .   *** *. *\**  \. .* *\  . . ...   .. ** \. *..* .#
#       #**.*   .\. \. ..*.*.* . . .*.*.....\ . \... .*\ .. *   ** .  .\ .\* ***.\ .  .  \  \.\.   **.*.#
#      #*\...   *......\.* \*.  .  .. .  *.\.. .*... .  ..\ . \.. .. . \  .* *..  \.**.  .. **     ..  *#
#       #...* *\...* \\.\*.*.\*   **\.*.\*. *....  .**   ..*\  *  .. . ...*.* . \...\. \* *....   ..* ..#
#        ##.*.*.\ ** *\* **  *.\.....**  ..** \*\ \*\*.. *...*.. .*..   \...\..* \ \.\*.*\..\.\.  .   **#
#        #.  .    *...*...   *.. *\  ***\. .. *. \ **..*\ \* *   .. ***.   *.*\....  .\*\ \* ...  \.. .\#
#         #.   **....\.*.**.*.*  *  \**..*.\. .\ .\*\ * **.. .  \ .\ * **  *.. .  \....*   *  * *. \ . .#
#        #.*# *\.* . .. ..* .** **. **.  *\  *\.  ...   *.\ \..... . *.*.*** .\ . .*. ..\ .** \.**\*\ . #
#         ###\*\.\  *.\. *.   .... .*..\..*.*  \\*  **  *\.* .. .* *\\  ......* **...\   . ..*   .   .  #
#     #### .#... ... . ...  *.*    **.\.  \.**.\*\ \..\*.*.*. \ **.*.. * .**\.*.****.**.\.\ *.\..*.. \*\#
#    #..\#.\ ...  .. ..* *.*\*.. *  ** . ...*.  \\. .**...  * . ..\\ \.. *..*. *..\.\.  .*.\.\.**.  *\*.#
#     #   ##.    ...  \ \..*.\ \*.  ....** ..  ... ...** *. .   .*. *......\* *.*\. *...*. .\ ...* ..*..#
#     # ** #..*. ** .* .. *\.*  \**  ....\ \. .*  ..*.*..\.. ..**\  **. .* *\ **\*...\ *.R ..\ .\. . ..*#
#    # ***  .\..* \* .  *   ..*\..\ . *  *..\ *...  . *    .   ...*\**.\ .*.** .* ..*.. \.*. .. \. *.*.*#
#     ##\**.  *\  .* * .\   \.*   ** \*..*.......*.. .\.*.*\*. .\\*  \* . .... ... *. ..**.*.\.\   . * *#
#   ##\. *.\..\... \ \... ...\ .\\.*\.*.*... *.. *\  \.. *.  *....*....\..  **\.. \**.* . .\...*. *. ...#
#  #. .\.*.#..*   \.*.* ...  **  \ .*\\.\.    .  .*.  . .*. *  ..*\. \..*.\... . ...**\ ....***.  \.***.#
#   #.* ..#*.\. #..*.**   *  *.. . .\ . . **.\ .\.* ** .** .* ..\.  \..*\.  * \. \ \.\   .*\.\.*.\ *\. *#
#  #.*#* ...\  \  # *.* ...*.. .*.**\   ** ...*.....*** *.  *  *\*.* \ **   .  \....\  *.. .\*.  ...   .#
#  #**### \.#*\..  .      .*    .*... . .*  . ...   .*.\..* *.*  ..\ .*..  ..*\.*.\ *...*.\.....   . .* #
#   #.#  # * . .**... ..\.. ..**.*.\ . \ .  ..\ ... *.*. .. . \ . *.*    .*\  *.*.\ .\.*... \*  * ..*..\#
#    #  #*\.. .\.\  *. .*\.\.\ **.\ \.    ** ** ..*.**\ .  \  ..  \* .* ..\*.*.*.  *. .*\  . .  .. *.*. #
#        ##\.*#  .* *\....   * .*.* .. \*... .*.... .\.\  *  .*  . .  \ *\. *\.\*\ .\. ..... **.\*.\..  #
#          #\*.*  \. *\ \.\    .* .\.  \.*.. \\ \. \*    *. \..\.*\  ...* .* **..*. .\..     ...*... *  #
#          #*\*##. .*. ** .**.*.* . .. *\. *. .\**   *.*. .\.. ..\. **\ *. . .*.\*.  ** \  .*. . \.. \\*#
#          #.## * .#\.*\.*\..** .\* *\ *.* .*.\   .**\..\.. **\\\ \..\.* * ...\**   *.* **.*. \ ..  \.**#
#         #. \.**.  .\. ..* \.****.\.\....\ .*\ **\. ..\. *\.\* * .\**.*. .  *. * * ..... *.\. * .*.*...#
#          ## #.   *\...* * * ..**.*\.\*.\* ***..* \ *. . .   \ .  \.*****\  ..*.*   . *..*.**.\\*.*\ *.#
#            # #. *#. \ .**\  ..*..*..\.\ ...\.*\.  .. **. \.** .*...\... .* **...\ .. .....*..  . *. ..#
#               #\#*.*.* .*.*\. \. .. *..  \.....\ *\ **   **... *.*  \. . .\\.*** ... *..  *.*\.  . **L#
#               #**. .... **.*#.*\.. .***\. ****.*.. ..*   **  * . .\ ... .\.*\..  *.\*\.\\. \.    .*#*##
#                ##\. *\  *#.#..#..\* #\*.  .*.....* .**.*...\* *\ \.* * .\. **.\. ....*..* * .\\ .*.\#*#
#                 #....* # .\ \*.*.\.#*...*  ..\. \*\ .*****\*\**..***. . * .*\ \* *\\..\** \  ** \.*.\*#
#########################################################################################################