###########
#*.\.*L.#\#
#.. ***.\ #
###*\.\* ##
# #*..\. .#
#  # *. ###
#  #\#. * #
#   ##...R#
#    #*####
###########