#######################
#.. *.  \ **. * ..* *.#
#...\.**.*\ * .  *#\**#
#.* ..* ....* \ ..*.*.#
#.\..\ . *..*. \. ..\*#
#.\\.*\...*... *.**..*#
#\   **...   . \....**#
#... . *** *\\.. . \.*#
#.. .* ***.***  \ .  .#
#\. \.* . ...\.  ## \*#
#\. \ \.*  \*. * \   \#
#\ *** *.* ..  \ *# \.#
#.*.*\ *\..*\*.* **..##
#.\ ..\*.*  .\** .\  *#
# .**  * \  *.\.\\ \.\#
#\ ...\**..*.. *  \#\*#
#. .\ ..\ \.*.*..R..* #
#*.\. .\..*\*.*.*.\ *##
#.*.\   \   .*. ..  # #
# .  **.    *...* .#  #
#*.** ... ***.\.  #   #
#**.#..\..#**#.* *#   #
#*\##*.*.. *#* *..#   #
#* # #*\.*\.. \.* *#  #
### #\.* #.\. . .##   #
#    # .\##L ##.#     #
#     ###  #.\##      #
#          #.#        #
#######################