######################################################################################################################
#                     #. **. *.... ...* . .....* ....\ **\. *.. \.* .\...*.\**. .*\** .*\.....\.### #                #
#                     # \ .*   .   . .. *\*\ \.\.  \**.*.*.\. .\  .*  ....\.  .... \.  \.**. **..*.#.#               #
#                    #\    \ \.* ***  *.*.  *.\  . .*. \ ..*\.  .*. ... . *   *  \ . .*..\ ... *.. ..###             #
#                     ##\.*. ***\..\  .*.*  . ..* \.. . .*..**\. .\ .\\ .** .\** .* .**  *.  *\.. . .\**##           #
#                     #  .* .\.*.*\*..\*.. * *\ .*. \*. .**..*..*\. .**.\*.*.*.*..*\  .**.* ..  .  ** **. #          #
#                   ##\  **\. *  \.. ...\. * .*\.\\.**\*  ..\.* ..*\..*....*.*.*  .    ..*\ *..*** **..###           #
#                  #\..**#.\\ .\*\    * *... .\*.\  ...* * .. .\.... . \. *\*\* *.  ..   . ***.... *..\. #           #
#                #  ##  * .. .\ ..\ *... .\**\ **...  *\ \  .. *.\*\. \.. . .  *.\... .**\** *  *\  *.# .\# # #      #
#              ## ## *...* \**..\* *. *.  .\ . .**\\ .* *. . ...*.\    .*.  . .*..\.\**..... .**.. .*.##\ .# # #  #  #
#             # .\ .\..** ..*..  * ... * *\*. **.*.. ..*.\  .*.\. *.\ .**. .  ..**.. . *. *...\..  .\ * . * \..\##\###
#            #.\ *. .  *.. .*  *..*.\ .......\.\ ..*\. .. ** . . \ .. \..* \.***** .....* * \*.. .*\ ..#\\.#\ *## .. #
#             ##\. *\ *..  \.\..\.. *    .*\. *.\. .  ..\  .  *.*  *.... *\ .* *..*.  * *..** **\ * . *#. **\ \.#* **#
#              #*..\ *.\\ \. . ** * . \*..**     . .\*..*. *.\.\...*.**.*. * *.*  \ \.\*.. . ***..\\* .*. .\.. **..*.#
#             ##*. .\. ..\.\.   .#. .\ \.....*.*  . .   ..** .\   .\.\\*. **\.*. .. *\.. .**.. \.\.\... . \.* * \....#
#            #*. *. * \* ... .*.*   . ... \   \..   *.  **.\ *..*   **\*....     \*.*   . .*.. ...*** . .. *.\*  . **#
#            #.\.#. .*. *\*\. . \*\ \ **\. .*..*.\. . .\*.. \ .\.  .**. .\*\  . ..\.. .\ \*.\* *.**.*.*\*. .....\.#*.#
#           #.   . ...*\..**  *..\.\. \* ..**\. ..**..  \*. .* **.\ ..* .\*...* .*  .\**..**. *.* *.. ..\**.\.... #.*#
#          ##**\.*  * . .\..*\.  .. .. . \. ** *\ .*  .  *.\ .*.*\ ..** ... .*.\.\ .. * .* . *  ....*.**.\ #*..\.*.**#
#         #.# . *\...   ...  *\** ..*.*  ***. *. .*. *\.\...\...* *..*. ..***.***  .\\..*....\ \*.*.. *... \*..*.. .\#
#         #\  ..*#\ \* .  **\.  .  **..**\ .  *.*\***...\ .  *.\\   *.  ..*.*.*..  *.  ..* *\....\..  ..\  ..* *.. * #
#         #* .  * *.\.  . *\  \.**..\.*.. *. ..\.*\.. . *  ...\.   ** ..*...\**.* ..\*\.\ *. .*.* .  \. *..  ..\.  . #
#        ##*  *** \**.\\.*\ .\.\ ..\. *..\*\.*  .   ..\*...***. ..\.. *...*.*.\ . \*.*.\.\..   *.*   \..* .\.* .* \. #
#       #..***.#* ..*\  .**\.  .. \.  .\\... \ * ..    . *\..*\. . *.. *  *....\   \ .*... . . .\..*..\*. * .. \ .\\.#
#      #.**#.*. .\. ...* ..  .*..* \  .*\.* ...*. . .\  *.\ **.  . * *.\*.. *  .***  *. .\*..\.   *\ .. \ \  \   #*. #
# #####*.***..#\..**.** *. .. .*\ * .  .. . ..\ . \ ** *..**.**  *\. .. .*. .  .\\* .\ **..*.* .\.\  \**.   *.\.*..# #
##*.    *... .. .. \ ..\R \. .\..**  . \**  . *** . *...  .*...  ..*. ....**.*  .*. \*..****.\.*. .\* .*. .... *..*#.#
# #. *. *\  \. \..*.*\..\..* ..***.\\..\.*.***.\*.**.\*\*\.\.\ .\..*.. .\*..\.*\\*   .* *...*. ..\* * ... *  ***\**###
#  #*...* .#..# \...* .** \. .... ..*\*...  ..**\.*.\**.\**.*  *...*  *  ***. .  .. ... .**\* \ . * . ....\ ....*..* #
#  #.##**\ .*. *  *** ***...  .\    * \ * ..* .\.*..*. *.*. \*\ .. *\ \.  *.\.  *   \ .   *.\*..   . *\  ...\...*##*\#
#   #  #... ** \* ...     * * .  * .**\.\\..* *. ..\.*.\.\*\...*...\*\...\****.**. ..*.*  *.* ** \ *.. . .\*. .\. ####
#      #**\.# * *   *.*  . \.   *.* ** .. *.. .*\  ...* . .**\..\. *.*\.*. *.  **.*\\**...\\...* ...  .  .*.. ** .#  #
#     #* #. \ .   ...\  \\......* *\ * .****..*.  **\ .. * ..\**.*..*.*.\. **.....  ..*.** . .**.. ..  *. ..* .*. #  #
#    ##* *\ .* . .. .. .. .\.\ .. \. * \ *..*.* . . .   *. **...*.*\...\*..*\* .*. ..\. .. *... .* ... ..\* . * *#   #
#   #    .. ..   * .*\ *.\ . .**\ \ *\. *.\.. ...\*\*...****.*. . * .... **.*.\ *    *... ****\ *.. ...\*#\ *\*\#    #
#   ##\*.*\ . *\.\. ..*.  ... *.  ..*.*..***. *\. *.*.\\.. *.*    * ***.. **. .*.\.**\ *. .\*..**\*.* ..\**.#.*#     #
# ##*\# ##.**... . .\**.*. .  \ \...  . .***\*... .\.\ \ *\ ..\..*. * . .  .  \***....*.    .\ \* .*...\.\..*.##     #
##\.* *## ..\ .  \ *.\\ * \*.  *. . *.*\ ..**..\ \.  .. ....*.\ \.*..*\.*.* ..*. . \. .\.**\ . . *.\.*  ..*\ .  #    #
###.#*.**...  ** . *..*.* .\.*\..**.\..  *..* \*\.*. *\ *.\ .*.*.***\** *..* .*.  ** .  . **\. *\... ..***.\*.##     #
#\ \.*\.*.*. **  . * *. \.*. *...\.  ...*.\..\\.* * *..\ *..... .. ..*. ....  *.*.*.      .\* \.*..*. * **. # .#     #
##*\*\ *.. \ ..  . . *\....\*.*\*. **.\***. . ... * \\\  *  \.\ . ..\. .  * .\* ** .\ ..\....\ *\..\ *\*\  ..  #     #
##\*\ .. . .* .\. .. ***...*... * .\*\**\ *.    .**\..****\ ..*     ....  ..  *\*.  .*** .. .* *. ..* ..*..*.#.*#    #
# #\#. .. . *\ *\\...**.* \..\. ..\*.*.. .  \. ..**\*\*..\ * \ \.* * . ** *.\ \ **.\ *... .\ * .. .\* .\##\*  .*#    #
#  # #.*. *  . .  *. .*..   *.\.\\* *** . ...\ *\*.*.. **.\*.*.* *.*.. .\ *\* ...**.\*.\.. ...*   \..*.\. .**  .###  #
#     ## .**.   * ** ***  ..*.  *   \*.* .\.\ .....*.. .. ..*.  ..\.\. ..*\..  ....\**\  \*\.**. *.\\.  ** . \ * ..# #
#    ##. \*....*. \..*.\\..  \ .\.*\.*..\. *\. . * .*  .    * .      .\....*\   *\.\..*  .\  *.*\..*    * **. .   #  #
#   #*\ *\#  ..*....*.*.\.***\.\.\.***. ..   .   .. ..\***.  \ .  *\ ...\. *..  \. ..  .  *\   *. *.\*.... * ..\ .#  #
#  # ..*.*.\ .\..*... . ** ..***.. \ .*  ** .\. . * \* .\*\....*.*..\ ..* ..**\\.*\ *.... \* ..**.\.** .*     .\##   #
#   #*##*** * *. #..\*\.\. .*.. \ *..*.**\...   * .*.. . .  *  .... . *.. *... \...  * * *..\*.**.  .* \. ** *#.#    #
#    # #*.. . .* **.* \.#\.**\ *.**.**\.  *  *.\*.\\.*. * .   *.. . *\ ..\. * \ *\.  . ..*.. .*. .. * ..  .  #   #   #
#     ##\.. ** ...\.....\.*.* .\**.*.** *   .\* *.. *.\ ...\. \.*...*.  *. *.  ***\.*****.\*    *  \\.  . . \  \ #   #
#    #***# #\. \..*. .. *.*\*.\  *.  **..  . *  *.*\\\.. *  . . . \\.. *.* ...  ****.\.*  .*.* .\ .. *.\ ** . *.#    #
#     ####.# . .. ...     ..\.  ***\ *.* . \*. ...*** . .. *  *.   .\  .* . .\* . .\\.**.  ....   \ . \.*\*\ .##     #
#         #.*#.\ * \\\.**. .. * *.**\.*..*.   *  \* . \.\*** * \ .. *.\... . .*..*.*.*\.*\ *\.*.\\  *.....   #       #
#         # # . .\.# * **\ .  **..... .\ . ****\..\.. .*.*.\  * .**.\..  *\    * . ..*  ...*. ..\ **.*\   *\.#       #
#         #\.. **.  .. .\ \.. *\ * *  *****.*. ..\***. ..\ ..\  \. *   .*.. .  * . ..*.  ...*   \..\ \.. *..##       #
#          ##\...  *.\ .*..\*.*****..\ **  ....*. ...  **.\   \. * .\ *. . **. *\..*.\  *.... ...*...\. *.. #*##     #
#           #.#.\*\.*.*\* *. *  **.*.. \...*...... \*.\ \\..*.* ..  .... * ..\ *..*.* \**** . .  ...*  .  .#**\.##   #
#          # #..\* .* . * *..\  *.*.. .. * \\.   .*.. * ... .**..\ .   ...... *.*..*.* .*.. *.   ..\*\  ...\  # .\#  #
#         #.##....*\.  .*\  * . ..*       ...\ .. **\\*. .\.... . ....**.  .\.\*.. \**  .. **  ...\*... \ #* .. #*#  #
#         #.*.\  \..\   .  ..\.\*.. .\.***\ ... *.**.*.* .*.  .  . *. ..  *  . * * ....* \.***. .\*\.*.\.. ..\. ##   #
#         #.#\##...****\ . *. . *..\ ....*  * . \*.*\..  *.\..**  ......\*.*  ...\\.\ ** .\..\ \ *..  *.. **\ ..*#   #
#         #.  .*..*. .**.* .....\* *.**. *  \. .*\**...\*\.** . \ *. .* **.. * *\  * ..      \....*\... \ . *\ .##   #
#        #\  *.. \..* .*..  ..  *..\... *  *\.*......** \*\\.*\.  *.. .\....\..*..\\.  \ * ....  .\*.   ..**.*.\  #  #
#        #...\ .\. # .**.   \ ... ** . \**.. \.   *\\..*. .\.\.\.*. .\ *  *..**.*.*   \ .\..*\. * .. **.* ...\ #*. # #
#         #\#.\. * .**..*.....** *    *..  \.*\  .\  . .*. * ** .. *..\**..* .\ . . .\. \.\.*.**.  ..\. *. . . .*#.# #
#        #  .\*...\* . *. *  *...*  * .**...  *.\ ...*  ..\.\.. *...\  ..\.* **.  *.. **. . *..*.\*....\  .*\ . # #  #
#        #\* #\ .. .\. .. ...*.*\. .. \*.  **.*   \.\. .\\ **....*.\  .* .**\ *  ...\**\ .  ...***.\.\*.*. *.#* #    #
#        #.#.\# . .***\  .\.*.\\* *  . *. .....*.***. ...\ .*....\.  *... .. ..\*  .\.*.  \**\.**.\.. .\**..  ##     #
#         ###   . .****. *\*. .*.** *\***   .\ *.. .**\...\ *.  \**\ .\.*. . *. ...\ ..  *. .* .**\*  . .#\\  \##    #
#       ###\.# .*.*.\..*. . .*\... .\..**. **.   ***.*  \***.  .*.. *   ..  ** \  ***  \*      \\. . * .*.*\. .\*#   #
#    # #\...# * .  *.*.*.  *..**. ***. . .**. .. ....**  .*  *.\ \.. ..\   **\... \ ***. .**.*\. \*  *  ....*\** #   #
#   #.# .\  \#*   \. * *..**\***. .\.  .\ . **\.  * *. \*.. \.\.* ..    *. ** ***   ..\*. *. *..\.***. .. *.*#..#    #
#  #*\\ **\ .\.#** **\ \..\. *\  ...\*\. * *.    .. \\  .   .* *\.\.. ...*.*. \.* \\* ...*\**.  .*. ...#. . .*##     #
#   #.## \*.......\. *\.\  * ...* * \*. .***  *.*..  *.***\. .** .. .** .\*.*. .**.*\*. \\ *.\.. \ .###. \.\.\*#     #
#   #\##\ . .#*. *..*\. *.*.*.  .*\*..  ...\ \*..*\**. .\ .\*..*.** .. ..\. . . .  . \*\.*.\. *.. \ #####\**L #      #
#    #  #\  *.* *..\*.* ... .  \.*.  ** *.**   ..**..\*.**. .  .    .*.*  ..* * *.** ..* * .  ** \ .**\# #### #      #
#        #**# *.\  * * *\.*..**.\.* \*.\\ .*..   ..\*. \..\ **.  .*\.*  .* .* \ *** *.\* * * \.\. \*###      #       #
######################################################################################################################