#############################################################################################
#\* *.  * .  *...*..*.*.**\.* ..\. \ *..*.**. .\  .*   **..\..\*.\.* . \...***  *.  *.\*. # #
#* ** .*. \*. .\..\.....**. ...  .*.*\.  ...\***..\.\ .\.\..* *. .** .*.*..*.\  **. ..\.\.# #
#.\ .**...*.  ... *.... \. .\.  ....*..   ..*..\ ..*\....  *. * . *. . \.* * .* .\  ...*#*# #
#*. \..\* \.\...* ..\ ..  \ ...**.....\  . .**     * . \..\*R. .. **   . *\..\\..* \.**\.#  #
#* *** \.. ..*\ .. ...*\ \.\. \.* *........ *  .   *\.... .**. .*.\*...\ ...\  .\*. .\*. #  #
#. *..\. \  .... * .\. . .. .\\ . ..\*    . ** \  **.\.*  **.\*.\.** **. \ \....*.  *  * *# #
#\*.\.   . .*.\*\. *. *  ***\*..*..  *.**   .. ..* . .***.\...** .*\ .** .. *.. .\  \*.\**# #
#.*\ .***.  .. \*   *.. ..*.** .*.*\* *.. *. **\.*  .***\.  . .. .*.*\...*... *\.*. ..*..#  #
# *... *.\* .*  .*****.*. ..*\*  *..* ... \. .* .* . \\.*.**.\.. *. .  **.... *.*. .**.###  #
# .. *  .*..\. ..*.\..* * .\.*.* .* \   *.\.\*.\ *\...* **.   . .... * .*.    ... .. ....\###
#\*.***.* .* .\*... *\  .\ .*.**. .* * *.*   \*...*.\.\*..\ ***  .\\..  .\.\  **. **..#..#\.#
#.... .\.\  .. ..\ * . .* \..\.\ . \ *\.. **.*.* \\  *   *..* . **\ * *.\ * .\.*.\** .. *\.##
#.*..\.* \. * . .*\*..\..  . **.*. .    **..\.*.  ..  \  .* .   *.* **.\. *.*.* .*.. *\... ##
#\....\***.* .*\.\ .*..*..*\*..**.\.  **.* \.. *.  . \.**.*  ..***. .. .*\* *.. ** \ .  . # #
#.*\ *.\ .*.\*..*.....    . * \  .   .\.*.  \ . .\\.*\**.*\ *  ...* *. .. * .  *..\   .*.\ ##
#. .***\ *.*   *\ .*.  .   .*.*. \.\ *\.  . ***\\.\\.*\*. **\\.  \**.   \*\.. .*\*. .. #* *##
#.* . \.*\\.**.***..*\*..\ **.*  ..* \..  . \.**.*. ..**. ..\ *...\*...* \.....*.... #.#### #
#\. .*  .*.. *.... .*. . *..  *\.  .*..\.   . .*\... ..*.* \  \  ....**.*.*  . ...* ##*#    #
#. .\... .**.**..\. *   .*.\*\ *  * . *.*.\*.. .. \.  .\.\...   *.*   **.\*  . * .# .*.#    #
#*  .\* .*..\..*\. . . *.. ..**. .\.*.. *..\* .. \.   \\. .    ....*  *.  ..*   *    ##     #
#. .*.*\ *.   ... * *\ \\. \\.*\.\ . *.*.\ *.  *\  \.. **...  . .\ .. .......  ...*L#       #
#. .... .  ..*\.\.\ .... *..\.**  \  ..* . .. *\.  .\.**. * .****.  .   * .\.    .\#        #
#  .  ..*..**.\ .\. . .* \. .\*........ **...*. * *\. *\. .*.\...* .\. * .. *  .   .#       #
#\*  \*.....* .\ *\\  .. .  ...*.** *  \.*\  .. \ ..  \..*.*\  . .... *.  . \..  * *#       #
#*.   ..\.\ .  * .*. *** *\...* ..**...*\..\* .\.\.\*\.**\ **  .  \.\.*. ..*.*.**. \#       #
#\*\. *\  ..\ ..\ .  .*...**\* *  *    .  ...  .  . *      \.\*  ...**.*.  #\\ ##*..#       #
#***. *.* .  ...*.*  .*\. *.*\..\  .\....*.  ..*   *....*. .. . .*\  **\  #...\.#..*.#      #
#*.\..\*. \ \.\*\*. .\....**.*\ ....*\**\**. *\*.*\ .  *. . \.* ... ..   *#\. *##\###       #
#############################################################################################