###################################################################################################################################
#*\...\......  \ ... *\.  * .. . \**.* .. *. * \** . . ***.\* *.*** *.\..*.** **.. * ..* **..* ..*\.     * ....####               #
#*...  \.\.*. *\*\\. .*\ \.\..*.. .* **  .*..\.***\.***.*. .... .\*.*.. *. \.\... .  ..\... \.\ .\ *.*.\**\*. \.*.*#              #
#*. .*.* .*.\..**\\\ *\  .  .*.\.. .\... \ .*.**.*  ..*.*. *.*.*. ....  .......**  .. ..****  *\  .* .\.\..  .#*#.#               #
#..\.. . .* \**. . *.  ...\* \ *. .  * ...\.\... .*   * *\ .*... .  .*..     ...*  .\ .\ ... ..**.*  .*.*#  .*.. *#               #
#   . * *..\.** .*.\..\*. *.*.\*\   \.*. . *.. *\. .  .**\.\.. *\    ..*. .**\ *.**\.* * \.*.\*** .*\..*..  #\*. ##               #
#    .... *  .*  .* *  . *\ . ***..\   ..**.**... *\ ***** \. *\\ *  \.\. ..\\..\ .*** .  ..* ..*\ ...\ . .*.  * \.#              #
#\. . \   ..*.**.**.. .\*.. . ...*\**\*.**\.*...\\.  ....... .**..\. . .*\ *.\    *  \.\ .*\ ..**  .\ .\ \** ....##               #
#...* *. *..\** \..  *. * *.*.   .\ . . *.  *\\ . ..* * *. . \.*.****\. .... \  **\  .   . * *.\..**   ..**\ .....#               #
#\**. *\ .. * * .\.**. . *\.* . .. ..*..*  ... .. * . *\.  . *..\*. . ...\    ..*.** . *..\. \ **  *  *   \*  * .#                #
#.*. .\*\. \\   * \.**  .\.\*.*..* \*.** \ * \ *\ *\ \*\** .. .\.* \.\.. .. .  *. .***.* .  ..*.   \ \ .* ...\##*#                #
#*. ...*...  . .. ..* .....*. **..... ....**\...*...\*\**.*.*.*.*\** .\\     \ * .*\.*..\ ....  *\ . .. .* * *\*# #               #
# .\....\. .\.* .* *.\ *.*. *\... *  ...*\. ****.*.. * .* **. .**.*\ . *.* \*.. .. *...    \   ..*. .*\ \* . ### #.#              #
#. *..  ..*\.*  .*\.. *...* . .   .*. ..  .  ** .* . .  ....*..\*\ ..\   * \..* .\ *. .\. .*.\ .*.**..  **.\ ##*#. #              #
#  ..  .. .  * *...*. . .*\ *. .**\.. *..   .\. \**.  ..* \..\. \.*.  .* . ...*  .\..** ***\.. **\  *  *.\.   * ..\#              #
#   .\*.  *    .*\.* .. ..* ...\... .... .*  \*  .* . ...**.  \ . * ..\*   ..*\ *.*\ *\ ****\  *.\.*.  **    .*  ##               #
#\**..*.\*.. *\*..* .* * **.  \  ...\ \** *   . * .\**.\ .*\\..*. * \ *\.. ..  ...* .. * \\.*..\*..  **.\ \ . . . .#              #
#.** \.*. ***.*\**  \. \ *.*..* *..   ..* .. *  ...*.. *. .  *..  *\*\. \  *..* *\   . .  \*.*\ ..  . \. \ .\\ . ..#              #
#\..   \* *.*\..**   .\. *..*\*..*\* * *. .. .\*\* ...\. \ ......\**. ......*.. ....  ..   \.. .\**\**.*... *#. * .*###  #        #
#. . * \\ ..  . .  ... *.*  *.*\.\ . * .. .  ..*...\*.. .\ ...** * \*.*\ ..*\.. . *.  *.\ \ .*. *\.*.* \ .**. **.\*\ .*##.#       #
# .*..   ..\*\.  .\.**\.\. . .\  *. ....      ..  . ..\* * . \....  .*.**\  ...... . \.***.. .     ..\ .\ .* .*   .#...*.* #      #
#* * ***\ \ **...\* \ * .  **..*.*\.***\* \..*.   ..\ .*\**\ .* .  . .\ .* * .\. * .\....\*.\..* *.  ..  *****. ##\* \*###L       #
#\.**..  * .*... *.. ***  ...\ .... *.\.  ....** . \ **\.   .*..    **.** \.   * .  .  ...\  .*..**\.* .*.*.\.  ...\ \ \.#        #
#\ *\  . .\ ..*\*.*. **.\ . *. * * \*. \ * *.*.* .  .*.*\. \..\*.  .   ..\.\  .*\..   *\  .*.*\*. * ..*\. **.  .***.. .# #        #
# ...**  .*.*\**...\..*.*.**.*.*  . \*. .* .\  .* . *. .* *. .. .  \   .\..... . *.*.**. \.*\. ..*.\.****.** .  .*... .#\#        #
#\**.\\\\.* ...*. \.\*..\   **..  .... ... * \\ *.  ...* .**. *.  . \. * .\... .*   ..*. ... \.. *\ ... *\...\.* #.\  ..# ##      #
#.*. .**.***\. ..* *.. .. *. .*. \.*.\ *.  . . ... .   *  .. ... *.*.\ .    *.. .\ .\*.   ***...  .*  .* .\ .*\* \.*.**.##* #     #
#\  . ..*.*. *. *..\..* \  .. \\. *.. .*\**  \.**.. .* * \* **** .*.  .*    . \..*\  *.. .. *  \**. *\\.....*.  \*.\ *..##..##    #
#.\*** .. ..\. * .. **.\ *..... *..  .*.... \..\\ *   *.** .*. * *\.\.\*  . **..**. ****.. ..* .*\ .\.#*  *.. . ....*.  ##\*..#   #
#\ ...\  . **.  **\ .* * .\.*  ..* ** ..* .\.\ .*\.\  .*.\.*   .\** .* * .....* .\*.* ...... . \. .*.*\ .....* .*\*..*..#.***## # #
#\\*.\.. .\..* .. .\*...\.. .\.***\.\ .\...*..  .. *.. .\..*\* **\. \.\. *\.*....*...  *  ...* .  \. *. .*. *.*\**. \..  *.##  #\##
#.*.. \ .   \***..**.\*\*.*\.  .. . .*.*.*\  **  .*...  * \**. ...\    \ .* ..*.*.\.\.\.  *\.  \ \  .*. ..* *\..\ .... *.*.** \ .*#
# . .*. \.\ \... *....*. .\*.**   * ..\*  * .*\.  ..\* **. ...*  .*. .* .*. . ... **....* **\  . .  * ..*.. \. . .\**# \.*\*.\ .###
#*.  \.*  * .**\.* \..*.. \.\*... .. **..\..\.* .****.... *.***\**\  .*\ ..  *. *.\  *  *\.... .. ...* \.\  * \.. .*..\... *\ .#  #
# .. .\* \. *.\ .*  *\***.*....\ \* .** ..* .  *..* . .   .*.** ..*.*...* *..* .*.*. \**.*\**. ..  \ .\** .*.* \.* \.*..\*..  #   #
#\...\*.  . . .\*.\ \.\.* ...  *\.. * *   . ..**...\..*.* .** * ....\. .....*.  . *.* ...***\.*\  .. *.. \.. .  .*  . *\#..#\ #   #
#    * *.   \. ..**.. .\   *\...  .**\\ \ .. \*.\.  ... \.*.. .\  .* .*  .\\. **  R\**.**...* .* .\ \.. *.  .*.*.\   *#* #  ##.#  #
# **..\****.\ . ... .*   *... \*. **... **   .* *..* . *. .  . .* .* **.*\**\ *.*.. ...... \. .***.   ..*.\ ...\ .   ...*.*### .# #
# \.\\* \.*. *\ ***\...*.*. .\.\ \ . *.\.* ..*. .   * ..\ . * \ ** .* .** \.***..*. *.\\ \*  ...**\. .. * .  .\*.. \*\  . #\..\ *##
#* .* *\. *.. \. **.  *. .*\****..* .  .\.   .  *.\** \\.*...  \\*....\.*. *.\*  * .\.\*..** ....  *..\\.  * . .*....*\* .\.*\*.# #
#*...*\ ...*\ .. ..   \. \.*.*.\  .  \* *  .. . *.  .\ . *\* . . *\  . \.... ..\*.\ ** \. **\ \**  .*.  . \*.. ..    # . .. ..##  #
#.\*\**\**.. .. .    \.\ .......*.... ..*.**... *...*.** ***.\.  ..*... * \  \.*\..... .\. \...\*  *. *. ....*.. . \***  ...\ #   #
#. ***\** . . *  *  ...\.  \ ..  * .* .*  .*\\*..*\. \.\ *. * ..   .*.. \* *.* * * . .*.. *.*....  \.**\ \ .*.  .*. .#.\***\##    #
#....***.. *  *\ .\*.** . .. .  ...\.  .\**.*\.  . **.* \*\ \.*.*\. .  \ .** * . ..  ..\..*\.\.  *\* \** .  \   *.*\ .. ##*#      #
#.  *. .. *.* ..\. \. .\*  .\.   .\ **  *.*.*.\* .* ....  .  *...*..\.  ..*\ .  \.****    . \.\. ..* ..*.  .\.* * * .* *###       #
#...*\ .  ...* *. *.\.*.  .*    *  . *  * ... .. \.*  ..\.\ .. \*.... * *..* **.. .... ** \ .*.\.. .  \. \. \\*\. .\.##.*.###     #
#.*\.*....\.** *. .* ..*..    . . **   \..*.*....**.\*. . ..\*....*\ *.**. . ..  \ .\\.\**.*.. .\*. .*. ..*** . * ..#\..*.*..#    #
#*. ...\* .* \. \*.*** .*..** . .\*...*  .. .*..  . *.*\ *.* .*.. ..*..* \..**..* ...*..* .\..* ..*\**.***..... ..   .***   .#    #
#..*    .*\.*\ *.*  .. * *\. \  ......* ....*.. \* ..* *\*** .. \.. .  *..* ..\    \   ......*\ \..*...*.. *.. .  \.. *.*. #*#    #
# \.   .\. . * ....*\    ..*.*\ .  ....\.\. ..\ . \. * . .*. **..  * ..*. .. . *\.*..*.\*. *.. *.  *..*. . ..\.* *** #. #\# #     #
#.  \ \  .*.\ ****\.   *.**. ..  .  **.**. \* *.. .\ \ *. \ \*.*\ .*\.....  ..\..** ..*.\*..*. *.**..... *.***.*.***\\\..*#       #
#\ ..**....\.*.*****.\ .*..     *.. .\.\*.\.* * ***.\. *.\. ...\ ..\*\...\  .\ \ *. \.. .   *  . ..*\ \  .\\.. \ ... .* #.*#      #
#.. \.*.\ *. * . *. *  .*...*   \ \. **. .\ ... **.\.\ *\.*\   .*\* .*  .* *. **.* * **.  \*.\  ... **...  **.. **.\ *..\..#      #
#\*\..**\*. .*  .....\. . * . *\*\.  .\*.*.**\.*\ \.\  .*\.*\ .  .\..\*.  \.  ..*\.....*..*\.****\ ...\* .  .\  ..*. .*..# #      #
#.. * .  .*\*.*    ..\   .*. ..*.** **....\. ** **  **\ . ..*. . * \.*.\*\.* .\..*   **.  .. \..... ** *. \.   ..\#*. **#*  #     #
#. *.  .\.. ...  *...* ..*.**\ ...\ *  *\  **. .\\..* . ..\*... *... .* *.*. * . ..* \.  . \* ..\ \..*\. *. . *...* *.\.*.. ##    #
#  *...    .. .\ .** . .*\*...*..***     . ....\*.\*.* **   \..\*** * . *.....\ .    *.. . .\  \  ..*.   .. .\. . . .\*  .**#.#   #
#\  ..*.*.. . *.*\.\ *. *.\*...* *.* ...* ..**\.*. .... .\.\   **.* .** .*  * ***  * \*\* . ** ..**\ ***\..*.* ** .\ .\  ** #**#  #
#.\ .\**. ..*.* .** .*.*.. .* *...*.**  \ .\*\. \   .     \. . .* *\**** .  *.*\...**.. .  ..**\.... ...*..**.\*.   *.*#..  \#.#  #
#. . \*\.*  **\  *\ ***.. .**** .\***... .*..\****. .  *...**.\*\ \.\ \  .\.**. *.\*.  \.*.. *. .*.\.\* .  \.\.* *...  * .\.  **# #
#.*.*.  .\*.   \\* *.*.. **\.*... * . ...\.\.*...*    ..*\. ...* .. . .. *.****\*\.....  **.**. ..\. *...  ..  ..\ ..  *..*..* .# #
#.* ***.. *.\*.. . . *\.*\.*\..  ....   . * .*\**.** * .... .\ . ...*....*\.*....   ..... * ..*.* **** * \ *..  ..\ ..*.# .\ *##  #
#. *\.**.... ..  ..  .. ...\   .  . *.. **.  ..*. *\..** .\* *   *.*  .*\**.** .*.**. .\.. .\ . .**. ..  .*\* .  ... \.. \ *.# #  #
#.\. *..  .*\\.   *  \ \..... *  \. * ..\*..\  * *  * \.  \.*. . . * .... ..*\. . **  .*\ ...\ . ..* *..\... *\\*\*  ..\ .#... #  #
#  ***.\.. ..\\  .\ .. ..*..*.*.*. ..... .*\.\ * \\  .     ...\*  ***.\**\  **..*. *\ ...    *  .\....\.*\*\..*\. . .#  \ * \ .#  #
#.\..\ .\ \. .\.*** ..**\.. *.\..  * ..\ ***   . .****    *..\.\.  \.\.** *  * *.\ \.  ..\\.*\*.**.*.. \. *** .. * .. #*...#..#   #
#  \*..  *.\****..*.  *... *.* **.* \.**.. * * .\**.....**.\. ..*   \*... .  . *  ..\   .*....* *. *.\ .. .\* *.\*  .. .\#*.\ .#  #
#..****. * *.*.\**.\*. .**.* .\\. **..*.\   **\ \. \ * **. ..**\*....*.* . *.. **\*\**\.*..*\*.\.\..* .*\.... \ \* \ #*. #\###.#  #
###################################################################################################################################