######################################
#        #. .*** .\.*     .. \. ..  .#
#       #.*.....\**..\ .  .\....* \ *#
#      # *..*.  *  \* .*  \.*\..  *\*#
#     ##* .** * .\...  *.*.. *.  .. .#
#    # ** *\*...* **  \\ . .\..    .\#
#    # .\  ..*\..   *. *.\ \*.*.*\ ..#
#   # .. *..\. .\.\ *.*.\  ... . .\*\#
#  #    ..\. *. *.  . . .\*...* **...#
#   #.. .L.. ..\.. ....\.** *...\.\..#
#  #*.   ** .  *.**.     *..\  .. .  #
#####\ *\...    .** . **. .**. \ *\  #
#* . ... ..*... ..\*.**.R .. ... *.**#
##..* \ *..***  * * \*.\.\.*..  ..  .#
# #  \#*.*\ *.  .\*\*.*.*** **\*.**.\#
######################################