################################################################################
#                    #\ .  *.. .**#.. .# ## ...*. .  *#    # ##*#..\ #*.#      #
#                    #...\*..*  . *\.#.* *.\ . * ***\ *#  #*#*#** * **.#       #
#                    #.  ..\....\.\  ..#\. ## **...##*\###....*#*.*... .# #    #
#                   ##** ... .\..  **.* .*... \**.*#. ##. #\  .#. .  .  ##*#   #
#                  #**.*.  . *.*\* **\.\.. ** .*.\. *  \. *.*.***\ \** ..#*#   #
#                   ##*#**.* \..** *.. *\   .\ ..   .  .. ***\#\.. .\.  . .*#  #
#                     #\...\ . .\.\*.\ .*.\. ..* **  *  \ ....  *\#.  .. . .# ##
#                    #* \.**** .* **\ . ... .... .  .*\...  *.  * .**...  .#.#.#
#                     ##*. ...\  *.\*\...   .** . .. \ . *..\ ...  ..  ..***\  #
#               #    #.#..   * ... ..*\**\.**.\*\* **  * ....\.\ ..*..**.**#L#.#
#              #.### #* .\ *.*.* \ . ..\..*.\  ..* .*....\ *.*  ..*. \.**\.. .*#
#             # *#\\#.*.**\  ..** \.* * \..\. \* .**.\*   \.\\  **. .. \.*  *# #
#              # .*\.\*\.. \\*\*. *\* * ... . ..  \. ..\.*  . ....... *\.\** # #
#              # ...  #..\.*\. \* .* .\  .* \.**\*..\ ...\.* \**. \.\.. \ .\ . #
#              #\  \..*** *... .. .*..***\.  \....\  .\. .......*  **\* ...   *#
#               ##*. . .\...  .  \.\*.... .\*.***..\\* * *\ .\* . *.*..  *  **\#
#               #*. .*.    \* *.*.  .. .*\.*  *.\* *.*.**\ . *\.\*\.*.* .... . #
#                #. ...\  *..*... *  .. .  . .........\.\. ..*\ .. ...*  *. .\ #
#              ##.#     ... .*  * *.. \.\.    *...*....  .. *..* *\.\ \ ..\. . #
#             #\*.# **.\**..***.** \.\ .. .   . *\\ * .*.*\... .\.  *..  .   *.#
#             ###*\...\*     ...\. .* **\.. ... .    **... * \.  ***. . \ \   .#
#            #.**..   .. * .   *   \.\..*..**.\. \ .\*. ** ..   *.... *  . .*  #
#        ## ###....*.*\* *.  .**\ *    * . *.    . .\   .\ .  *..*.*. * .. \. .#
#       #. #.\#.\*\* * . .\ *. .*..*\. ** .*\..*\ \\.* \  . .*. \.*. .. *.\* . #
#     ##**#\**..*#*.\. **\ \.\***.*.* .*. *..  .*..\ ..    ..** ..*  ***.\.*..\#
#    #*# *.#.***. *. \. .\..*\  ......* ..*\*.*.\.\.* ..\\. *** ... .. .*. .   #
#    #*#\..  *..  . *   *.\...\. *.\...\*\* .. *.  \*\.\*\ **..  ..*\ ..**\.*. #
#    # .**.* \. *\ \...* .. \\.* .  **.\. .    .*. .\. .. .*. . ..**\ * *... \\#
#    #*\..*. .  \.\\.*\*\.  .  * \..\**.   .*. *\*..\*\  * ... . *\    ... . ..#
#    #\.# * #* .   *.\ *..*.  .. **\..\..*....\\ . .*..* ...  .\  ..* **. **.. #
#    # #...* *\.   ..*  .\.* *\\**. \**\ .. \ .\.\.... * . ..  ..**..*....\  *.#
#     ##. .*\ .. . .*\.\ ..\...*\... ..*. . . * .  ... . *  *  *.....*.*\*.\.**#
#      ##\#.. .....\..\ . . * \ ..  **.  .*  .*\  \.\..\ .  .\..*\  *\.\ * . ..#
#     # . #** . * \ . *  .. ....**. .\..*.  \ * . . *** ..\* . . .* .* * *...**#
#######\. .** * ... ....\. *..\ \.  ** *.\ *.** .***.. ..**. .  .\* * *.  .* ..#
#* \. .*.***\...*     . *  \*. ... *.**. *\. \.\ ..  \   *\ \....*\ ...\*.... .#
##\#\ \  #.#   . \*\   .*   **.. .. .* **. *   .. . ...\ \... .\ * .    \ .\.\.#
# # ##*\\..*.. \ ..*\..* .*\*\* .\.... *.  ..*.\.**.*\**.\ .\** .*. \  *.* ...*#
#    #*\#\ .......* *. *... .*. *.* .\  *\ .\..  **.*..*...\ \.\...  * \.  \**.#
#     #.##\. ...* . . *...*\ \ *  .   \  ..\.**  .....** ..*\   ..*.**\  *..*..#
#     #  ##..*.*.    \.\. . .. \.. \ .  **  *.\ \ * .. \*\  \.\*  .*.\.**.. . .#
#     #\*#\.#.\#.. *\.\ *\  . \.\.\.. *...*..\..  *\..  ** .  *.*  *   **..**\*#
#     # **.#.*** **.  .**.*. * . * . .***\. *.*.*** ..\.* . . ..*....  ** *.*\.#
#  ###\**. # * *.*. .*.\..* .\.*  .*** \.*. \*. .*.. .       *\..  \.\\**.*..* #
# #* . *\ *.....\.\. **.*\.  * .  **.. . .   ...**\ .*\\.**.   *.\ .*.\.\ \*\ .#
#  ##  *\ \# ...  .  .. ** ****.  .. *. \  **.\\..  **.* ..\.**..**.* .\. .\ * #
#   #\ # .#* ... \.*.\ ..\ .\\. *\. .*. .\...*.** . ..     *....... .*....*\ . #
#   #. #  #.\.*\ .*\*. *.\. \..\* *  ..  .*. .*.\.  \* ...  . .. ..   **\\**.. #
#    ## ###\ ..  .*..\..**.\*  *.\.*. .\**\*.*.*.*  . \..* * . \ .\.\.*\ ... \.#
#         #. *    *\ . *..\ ...*.\*.. *...\.*. .*.* ... *. ...*.** .**   \\  .\#
#         #. ... ..  \...... .*   ..\  ......*..\ ...\..**.\... .. .*. \..\*\.*#
#        ###\*.\*. .\. *** \**. *.\.* .**\*...** .**. .*.**.. .\ *. * . .. .. \#
#       #\ .*  .*.* .  \.  .*.*...* .. .\..\*.*\. .\...\ *\ * *  . .\*.*\**\ ..#
#        ##.**.\.*. ..  *.  .*. **. \  . *.*  ..***. \\ ..*.\.... ..\. .*.*  .*#
#      # # ... *.*.\*\.    .*.*..    *. *. ...\... ** .   ..** * \   .**. ..  .#
#     #.## \ *\*\.*\ .**   ..*\\.*\*. . .. *\ *   .\.*..*  \.... .  *\* .\ ..  #
#     # \*\###.\.... .*\.*.\.. *   .*\.**  .*  .\  \   .\ ...* *  . *. . ... .*#
#     #*\.# ##\ .\\\* . \. *. .\  \ \...\***\.\* .*.*... .*\.*\\\.*  . ..\. *.\#
#      ### #*.\  .  . *..\ .\. *.. .\.\* *.*. ...*.\.  \.*.. \**.\. * .*.** .. #
#          #*..\ \.\ *.. ...**..** * \.. .   .. .. .  \**\\** *.\.*\. .**.\..\*#
#           ##**.   ..*.  *\..  .\..  \* \ \ **  ... *...*\..\*\*..*. *  . . .\#
#            #\#\ \ \*\\* .*. .\    . ...\* ..\ * * *.* .****..*\.\.... .*.\\ .#
#            #  .  \.... *.. . ..\.*  *.  . .*\ * * .*.\\***...\    ...\.*...\ #
#            # .*.* *. ...\.\* * .\. *\.\** *.. **.*.***\..*. * ..R..\\. ...  *#
#             #.#..*. . ..*.*. *.\ .\\...**.. *.*.*\*.**.  .. ..* .\.*\  \.\...#
#              #. .\... \ *\....  \.*\ . *..* \\. *..*\ *.* \\.*\ \***\  ...  *#
#             #. .*. .. ..\.. . .*. .. ..*\ ...\..   . \.\* ..*.* .\. ..\..   .#
#              #**.... .\...   .*. .*\.** .\*\* ..\ * .\**\ \*\**.\...* **. ...#
#               # .#* \ *.  \  *.  \ .\*. **..\ .\   .  .. *.***...**.* .. ..\ #
#                #.###.....*.*.. *...\*.\ .**** . *.* .*\* .\.....\.\ *  .....\#
#                 ####\.\\*\\*. \. ... *. *.*..  *   * **. *  *\.*\...   .\ \ .#
#                #. . # . . .\ ..*.*****.\* .\** ..\\\..\  ..... *.   \   *.. .#
#                 ## ..  ..*   ** .. .* **.. *** .* ..\..*    \ ..   . .*.\ .. #
#              ###*#**\.\\..*  *..   \.\.\*. .\.\ *. \ .\** ** * .**\.. .\..\ .#
#             # * ..*#.... ..* .\ *  \ *\ ...*.....\     * \.. .  ..**.*...\. .#
#              ##.* *# \ \*..*\. ..*\. **\ ..* * . . .  .\ .  .\ *.\.* .\** ..*#
#               #\ .# *..#\*\#.*. . *. . . .**  \ .  .\  . **.  *.*... . .. *..#
#                #.*# #    .# .\.  ..\   . .. \.*.*. \ *.* * ..\* * . * *\ .* .#
#                 # #.  ##... * . *..*..*  ..  . \... **.* .  . . .. \  .\. . .#
#                  # ### #* *\*   . \ #.. *   ***\*.  .\*.\\ * ..  *\.. .  *.*\#
#                         #.**#....*\  *.*.\ \*.*.\  .*.  *.* \.\* ** ** ..\ *.#
#                          ##\\*..*\**. .\.*.. ..*. \..*..\. ...*.*.*. .\. *...#
#                            ###*#..\. ..**.  #\ ..* .*... . \  .**.... * \# * #
#                               ##.\. .# ...*\.. * .*\.*   \. *. \.*. ..... ..\#
#                                 ##** #\ ##.*.**. *... \ *.* .## .\.. *\   . *#
################################################################################