########################################################
#                                    #.######          #
#                                   #\ #.\.  ##        #
#                                  #  .\..    *#       #
#                                  # . # **. *.*#      #
#                                  #..\# \.*.**#       #
#                              # ##....#\ *.**.##      #
#                            ##.# . *#.\ .\#*###.#  #  #
#                    #    ### #  *\ ##.. ** **\#\ ##\# #
#                   #.#  #.*#.#*.*.*\ .\ ***#*. ..*# ###
#          ###      #*###*.*.....\ .#.\ ..*.#.. .\.* .*#
#       ###*.*#    # **\.*\.\*   *..\ #.*\.#.  ***#...##
#  ##  #. .# * #  #.\.. *   *.*.\.*..#\** \ .* ..**#*.*#
# L. ###\.\.....##*. ..#* \*. .* \.#\. .. \ .*.. \ .\.*#
##.  . *.....\..#.#.#*#*..## \.* \**.*. ..*\.\.. . ***.#
# #*** *#\ * * #  \ .. ..    . .\. ..#\ .*.*...\.. .. \#
#  # .*. .\*..* *\. \... *.\*..  .  .. *..\  .... ** \ #
# #*...*\  \ *. # ** . ..# .. \.\ .*.  .*.... *.\ *.\. #
#  ##.\..   ..\ .\.\. ..\# . .**. *..\*. \ \*.*\.*.\.  #
## #.*  * * *\* .**.  ...     . ..*\ * *   .*.**\\. ***#
# #..\.*#\.\.*. .\.. . *   ..  *\.*. \\.. . . .. .  . .#
#.*.. *.* .. *    **  *\*. **\..*.\. \\\\\\.* *.  .\\* #
##..#\ .*..\  ..\.* *.*\\.\.* *.*\ .*.*.\.\ . .. .*... #
#*.*.* .*. . *    *\...*   * *\..*  \ *   .    * .*\.* #
#.#.#\ \..\ \.  *..*.. . . **..**.\   .    \.\..  .**.\#
# ..*   * .\\  .    **\    ..* ...*.\.     .......\ \*.#
#  .. .  .\ .\...**....* *.*. ..\.\..  ..\.*\.* .*\*\.*#
#.# . .  .\ *. **.. *  ...  .*.*. \*.*\.\* .. \  ..\*.*#
#....* ** .**\ .   \...*.\.\ ** * .*\. . .*.\ ..*.\. \*#
#* * .\\***.\.*. ..\ .\    . * ***. *.*. ..   \\. . .\*#
#  \\\....*..\ .**.  .\ .*.*\. ..**\.. *\...\..* .\. ..#
# .# .. *.*. .  ** ..*  *\.*.*\ *\.*.  .. .  . * .\ **.#
##  #* \ .\ .. ..... .  . .\\.\*. *..*. .\ **  .* *  *.#
#..*.* \\ .*. ...*.  .  .  *\.*. \...*.*\ \.\ .*   . \*#
#\..*.\.. \*..  \..**. * * ....****\ \ *.\.. . * *.\\.\#
#\.*. *.\ .*. *..  **\   * **\  ........\**.* \. .\....#
#...\.***. .....\ *..*.\. .. \*\**.*\ **..\ **** .. *\.#
#.** \ . .* \  ... *\..** *\... . .*. ..*\*.**.\.\.....#
#\*.\ ..  .\*. **.\\*..\. *.*.* ..\. . \. \ *.. \*...\*#
#..\. .*\. .\*....*.*. .* .*.* \.*... ..* .\ ....\*.\  #
#. .*  * ..* .  *\*.* . *  * *\..  .**\ . ...  \..\ ...#
#   \*.....***  .*..*.* *. . **  ...**\ *. .**\. . ..*.#
# . ..*   ..\\ * **.. .*. *. \\  .. *.*..\..* . .. . ..#
#\ .*.. .. .  .*****\.  \.**...\.   ..*.*\.\.**.\ ****.#
#  ..  . ....* ..\.....*..\. . **.***. \.   ***\ ..\.* #
#.*\.  .\.  ****\**...**...\. *\.\...*\. *   *.\ * **.\#
#\...   . \..\** .*\\..*. .   .  . .\* ..* .\* . . ** .#
#*.\. \..*..*..\... . \\ .** .\*\ \* .  \. .*..   .\ \.#
#*..*..\.\. * *.   .....\****\...*.\\.** *\...      * .#
#**\..**\ \...* *****.  * .*..\     \\.. . *..  .  .. \#
#..***.*..   ..\.\**.  ..  *\. ..\ ...\. .\.*\ *.. \ *.#
#  *.. .  * .    *** *.....\.*.\.* ...** .**\.*.. ..*..#
#\*\* \   . * .. *..  *. \ .*\. **. . ..\ *\..* \ .  \.#
#*. .*. ... \  . .\* \ .* **  .\***.*. \*.***. ...*\ . #
#   * . \*.\.** .\ . .. *\.. ..\*.**.... **.* *\ ..... #
#\* \.* .\ \..*\.  ** .*.  *.*.*.*...\..**\ ..*... \*..#
#.\  .  . .   . \ *.** \*.** ...*. \\..\. *.*..\ *\* . #
# . .\ .     **  ...\.*.* ..*. .. \.\ *\  .*.****.** .*#
#\ .**\ . \***. \. \ *.*. ....* .. *...*.  . *.*.\..\*.#
#*  *.\ *. .\.* \*\  .*. .... .. * ....**. \\\.\.* *.. #
#.. \.**..\..**..** . ..*.\ **..   *\.*....\*.*.\..*.. #
# \ .*.*. ...... .* . *.. .....  .****. .\\ * .  *.\.\.#
#. . .\ .  *  .. * ...   . ....  *.*.. .   .. \*  \ .  #
#   *\ ...**. .. *..\*.\* \   . \...*\* . .    .\*.*\  #
#* ..**\**.*..* ..  . . **  .***.**.. *.*\ *. .\*\ *.* #
#* . **..*. *... .\. . ..* *...***..\*. ....  \*...*.. #
#\. ...\.**..     *..  \ *\....* . . **.  \*.*.* \   *\#
# ...** .* \ \.\*.*  \ . ...** ..\*. \..\. **\ * . . *.#
#\ *.\.. \**.  ...\...*. .\ *. ** *\*.* .*\ . *\.\.. ..#
#  ... .\ ..* *** *.....*.. .* .\\.   ....  ..\   *  **#
#. ...*\.*.*\ .** . .. .**\ *.. *. . . ..\ ..... *. \*.#
# *  *\..* *....* *..*.  \ .*.*.. *..*\. .  ...*.** .*\#
#.*.* .\ . **\..  *. . *..*.*\. .\. ..**  *  * * .*. . #
# * *\ . .. *. . . *  *\ \**\. \*  . *\   .\*.\.* *..\.#
#\.\ *.**... .*\*  .* **\ .\*\...*.  *.\ .....*..*.***.#
#*..*..*..*.  * R  * .\.. *\..*. .***.\  *  . *..\ * ..#
#\*\*  * .*.. ***. .** ...\..\ \ *\*\. * . .  ...  .. .#
#**...**.\.*\*..... ...\ .**\****\ *\*\..\. * .\... *. #
#\*. *.\*. ..*\* .. .*    .*  \.* .. .     . \**\     .#
#**.*.\..*. . ..***\ * ** ... ..*\ \   \..*.  *.* *  *.#
#*\\.* * ** .\.. ..\**** .\.* .\.. . *. *.*\. . *. . *.#
# .  *....\.** *.\.\. .. .*\*  .\...\.*.*\.\  *\..*   *#
#  .* * *  *.*. \ .* .  *\.*  ..  .  . ... . *.. \..  \#
#*\.   .. *\*.*..*..*..*..*.... ..***\***\ .**\ \   .. #
#.*.** * \  * *  *...* *.\   .\ .\ .** .... .\  ..\\ \*#
#...*\ . . .. .  . *\ .*. .*   .\..\*   \    ..* \.   .#
#* *.\.\  \*\.* \*.*.  .  *\*\.* \ *.* * *.*.*..*.    .#
#*.\ *.*\ .  ...\\. .  ...* *.*....  ... ...\.   ....*.#
#*. \* .**.*   . \ .*  * .. ..*..  .\... *\*. *   .\ .*#
#.\ ... .\.**  . ..\.* *.*\.\ .\..**.    \   \.  . \*\.#
#\**\*. *.\.*\  .* .  .. * \**\ .\\*\..*\   \    \.. .*#
#..*.\  . *.*  ..*  .*....  .  .\\..  .. **\*\**.. **..#
#**. *.\* .*. .*\.*.**.\ *. **..\  .*. \ .. . .  .\ .  #
#*. *\  ..\ ...\ \* .. *.***.*.. .. *... *. ****   .\ .#
#**\.*.  *.\  .** \  . .* .*.. ..  \.  *...*\... .\ .\.#
#*\ ..\ ..\..* .*.* . *..\.. *...*.*\**. *** \  * *\ . #
#**\** .  * ... ....*..  ... . * .**.*.  .\.*. *\.\*  .#
#...\  \.   *\...*. ..**\..\  *.*..\...\ ** * *..*** . #
#*.\. *.* .  *.*** .. \*  .**.. .. .  **.*\ * *.  .. *.#
#.  . .\.. *\....*. .  *.. .\ \* *\*. .\**... .  *  ..*#
# *. \ ..*..\.. *. \* \*\* ..\ .. .\.\\* **  * .\..* \ #
########################################################