############################################################################################################################################
#.*. **  *      \ ....   \.. .\\*\ .\..  \.* *\. . .  *.. .*.\  * \. *.* .*\ *\ ***.... *..*\\.\*  *\..*. .# *\  #                         #
#*#* *..*...** ..\.\.*.\ . \...\. **..  .*\  *\*.. *  .... .\**.**.*...  \.*..  *.* \ . * * .**... ...\***. .\.\ #                         #
#*\*. .\\ .*.\*** \* .* . .*\\.\......*\*...*. *\. .\. . \ .... *..\ ...*. *\** ..\*...\.  . .. \***. .****  **.**#                        #
#* **. .*.\...*..\.*. ... *. .** *\*...*  \ ** .. .. *  *. *.  .*\** * *.*\**.* . *..*\.**.*\.\*..*.  . \...*. **.##                       #
##*#\ .*...\.\.**.....\.  .\* *.\.*\*.  \ ..\* \  .*.\... \ \* *. .**  .... . ..*. \ ... ..\**. *..   *\ . \.\.. *..#                      #
#...***. * .*\ *. *..**. .*..\..*.\...* .  \**... ...*. .\   *\. *... R**.**\. \*. \**\*. * .  ..\.\**\  *..* *# #. #                      #
#\#..\ *.\\...*..*.*... .*.** \ **** *. *.*\.*. *   .\. \ .. . *\*\ *. ....\**..**\ *..*  ..**. *\ ***.. ....*. #. .#                      #
#**\. **.  *.... * ***  .* .\*.\*. ...... .**.*\.**.. . ...**.....*\.**\..**.\\*\.*   **\\ ***...\..\*\.*\. ..*.  \ #                      #
#..  .\   .\ *..\.** .* \. .*. .*   ...\  \.\  ** ** . ....*.*\ .. .... .\. ...* .\.\.**   .. . .*.\...**.\.\.* ..##                       #
#.  ..\.\*\ *.*.\.* \*.\ \.. .... *. .  .*  .. ..  *  *** .....\ *.. **\...  *.\.*  *\..  \\*.. *.\.\. \..*  ..  \#                        #
#...*\ ..\.. .....*.*  ..*\\.**  \\.*.*.   ..\....*\.. **   *. * . . *\...\* *. * * * * .  .*   . * * . ..* *.\.#\#                        #
#\.\ *  .* *\....*..\.* \.  \. ...*\*.    . .*. ..*..* **.. **\. * . *.\. .\ .  .*.\.\\. \ ...\ ....*. \.\. ..*\..#                        #
#* .. . *\*...\ \.. ...*.*  \  .**.  ..\.\.  .. *\*   \..\\..**...\. .*.*.**.*. ..\*  ....*.   *.. *.. .\** **.. .#                        #
#**.. ..* ..  .*.* .*..\\. * .  *..*  **  .\..\.. *.  .** ** ..**\. \..*...  ....\ *   .\..   .. ..\..\.* .\*.  .\.#                       #
#*\ *   . .*  ...*.\....\ \.*....*\ * *..     .***.. .\.\ *\ .\***.*   .\  .\ ...  \...  *  .\*\\*\ *\*  \ *...*\*. #                      #
#.. ..  . .    *\.\  \ *.*. ..*  . **.**...\.\ *...* .* .***.\ \.. .*** . .** \..*.. .   .\..*. .\.\.** \. ....  . *#   ##       #   ##    #
#. . *..*. *..*** . . \. *...***.* \.  ..* ... *. \*. *  **.\ .. *\ *\*.* ..  .*. ..*\.\.****. **. * .\*.. .. . ..** ###**### ###.# #.*### #
#  *.. .... \***. . .. .  *.*\*..*  ..  \*. *\...* ..\. *.. *  . . .\..*\   .**.\  .\*\.* *.\...\.*\.*.**..\. .. ..\*..*#  \.#*.   #  .\*.##
#  ..\. *. *\.    . .\. .\. * ..\* \*. * . ..*.  \ ..*. .  ..\. \ ..  .\  . *\\. \.* .*** .\**......\.*. * * *\*.\*... *\.\ ..#\ ******##*##
#\ *.. \*. \* \.*. \*...* *\. .  .\\***.*..\ .**....\ .*..\.... ..  .\ *\*\.*. *\\ . \.\*   .\ . .. * .* .    ..*..\  .*#. . *** ...# #.#*##
#..\  ...  .* . \  ...*\*.     . \. * ... **.  .   *. ..\*\.* \ \.\ .* \ . .. ..\**\*. .\**  . *.* .*.   \.     .\**\\*.     ..*. ##.\*..*.#
#.  *\\*. *.. \\.*..*   .  . \   ....*  ..*.\*.  ..*\... . .*....*  \*\. .** * \.. ..**  .  . . .. .\  * \* *.* \ ..*..*....\ #. \...# #####
#. ***.*\*\   .   *\..\   * \.. \*.\ .. *  \. .\ ....  .*\* .*.\\. \*.. \*..  ..*. ....*. . *.*. *\ ..*\ ..   .\. *.   *.\*.#*.\    ###    #
#. *.....*. *\ .* \.\ . . . .*** .. .  \.\. .*..**..\    ... . . **...\...   . *.  ....*. *. ..\ . . .*.    ...*.\*. .      *..* * \..#    #
# *..*\.* .  .. .   *.\.*  . ... . ..\*...\ ***. . *\  .\ ..*.*\...\  .\ *. .* . \. .\.*.*..  *. .  . **.\\  .\ *..\*..*.*.\.\ ...*#\.#    #
#. * *. .  .\ *  *. \   . \  *\**.  * .*\*.\..\*.*\..*   . .*\  . .*... \.*.\.\*...* ..... * ****\.* **...*.**..\**.\  \* .**. \ . L*#     #
#* *  *\.   .*. *.*. \.   \.\. ** **\*..*... **.\. *..*.\ *....*..*. **\.\.****\.*** .\*\..**....*\..*    ..    .\** *.... ..  .**#\#      #
#.   *. ...*\*. .*.    .\* . *.\ .*.\.*\.  \*.* .*... ... .\ .*    .. ...**. *\*\ . \ .. . .*\*..\.*..* .\.  .**  \...**\ ** \.** # .# #   #
#  *.*  *.   * .* .***..* \* ...\* *. **. ..\* * *  * .*  .*. * \..... ..*\.**\.\.\. .... .* *. . *.  .  . . *..\ .\.*. ***.. ...** .*#\#  #
# *.*.\..* * .....*.. ..* \*.**\... *.*.* \ *.\. .\ ....* .\ \..\. *..\*\.\*. ..* *\ \*.\**.*.\.....    **\*... \.*  .***\*#*.... ..  . #  #
# .. .**\.*** * ..*.  ..*..*.\*.**\ *.*.\  .*..*...*. * ***. \.\.  ..\ \. .....  \.*  *. ........ \* ...**.....   . . * .  . *#\\\..*\ *#  #
#**..\\........\.*\* *  *. *. .  \.  .*\.. .  *..* . *. ..*....  *   ..*.  .\. *\. . *.* .\** ** ..   .*\.. ..\ .**\\ *\...*.*. *. #\* #   #
#...\* ..* . * .*.. .* .....\****.  *.\*\ .\ . *.. ..  . .*   . *. * .*.**. .\.\.\*.*. .*.* ..... ..* ..*.*   .\**. *\ *..\.*\ \.\**.* #   #
#.* .**. .**** \ .\*...** \ ...\. **.    *. \  . \.*\*..\ .\ .. ..\*  .*.*  *.\. . \*   ..\  ..\ \\ .   **\.  \.*. .. .. . ..  ...*....#   #
#*.*\*.\..*\*.*  *.\.  .  \     *..*\.  ..\ *...\... ..\.*.** * .\ .   ***\**\.\...\.. . . * *  ..*.\\*..**.* .\.*\. ...**  \* \ #** .*#   #
#\ . ..  .....\  \ .  **.*. .. ..*.\*  . *  **..*  * *\. ****.. ...\ .*. * *.. .   ......*\*   *.\ \*. \ **.* . ...*..*  *  .. .##.# *#    #
#  \* \.  \.**..*. .....*\.*.   * . .*. * .\..*... *... . *..*  *.*.. *  \ ..*  ..\*..*.  *.** **.. .  .*.**..    *  .. .. .\*.*.#####     #
#\. . ..\...\. ***..*\\ \. *   ..** .\.. *\*   * . ..**. ..**\ .. \\  \*.. \*. . *. . . ...*..*..*  \.****. *   *..*  *.**.*.*\.### #      #
#..\***\ **  *.... *.*.*...**\ . .\. *.\ \*...*\ * .\..  * .* .** **..*.  ..*. .  .*\.*. * .\.*. . .\ .**.* \*\**..\ \\...***# .. . ##     #
#*. ..\ .. .*\.  ..**.** . **..\*.. .... . .*.\... .***.  ..*   . .\.\*\  \...* .***. * *.. *.... . .\ ..***.\.**  \  .*  \*..#\#* ..*#    #
#*...    .\*. *  *..\ \.. .\.. .. *... ...\ .**.**.*.*. *\ *. .\.\ *  ..  .  *.** \.\ \ .\ ..*\ ..*.. * *\.*  *.*\ .\ .   ..\. .\  *##     #
#* \.. \ . .  .  *   * * . .\*.. .** .  .*..\..\...* ..*\*.*.* **.\*.  .. . \. *\***  **  *  . . .*\ ...*.*\..\\\  *** .*. * *. .*##       #
#* .*.*..  ..* .**.\ * . * *....**. *  . . ** \ .  \ ...* *. *..   \.\.*..* .... .*.\.\ . *\**..*.     ... \.*... .**\  * ..\    \#        #
#.*  .*.    .* ... . \*. **\*. \.\*\.....\... .* . .* *..***.\*\ .  \.    \  * . **.*. .......\ .*\\ .  .* ..\*  .  ..\.. \ # \##.*#       #
#. \* .\\*...* *.*...... ..*.* ..*..\ .\*.\ *\\..\ .. .. \*.*. ..  ..**\*\ \*. \\.**. *...**.* ..*. . *.*.. . .  . * \.* *...\  .# #       #
#. .* . *\*.. \...\.*.\ \.\... ***.*.\*.*   **\. .. .*.  .**.    * \ *\.*. ..*.. ... .\  .*.\   ..  .\*.*.**. . .*\ * *. * **.\   \.#      #
#....\  *  ..*.  *.*.. *.\.  * .\ ..*.. .\***.*.*..**\*   .  * *.\ \.\   \* . ..  .  .*  *. . *.  .\..*..** \ *  \ ..**\\\ \****\ ##       #
#  *... .**. *.*.*.*  *.\*\. .\*.   *.*.\*...\*.. \.* *\ \ .*. .*.*.\ *... .\ *  \. .*\. .*\**.. \*.. *. .    *.*\. . \. .  *.\ *#         #
# *.\  *...\.*..*\ .*..*.*.. .*.... .**\ *. \*.*.  **\* .*..\  \*** . *    **.\ *\..  . ****..*.\**. **  *.**.\..* .*\ *  . # #\#          #
#*.\.. ...\.* .*.. .\. **. *. \*. . *.\.*** .  ..*.... .*..... .*...*\. ...*.. . * \..* *..\* .  \.. .    *\..*   . **\ .\  *\##           #
#*. .* .\......*\.*.\  .*..*  **\  ...* **.\.***...***  .*\* .. . .....\. \.\* *.\... *\* **.* .**.*...**.\ * ...  *.. \... \ #            #
#*. * \ .   . * . \*.** . ..\.*.*.. .\* ..*.*.\.\ .**    * .  * ...  .\  *.. .\. .*  ...* . ..* ***.. \*\.. **.*** . \*.\..\.#\#           #
#** .\ . * *.\.\  .* .. *.  . . *   . . .\. ..**.  .. ..*.*  . *.*  .   .. .*.. .*..\.**  . \\*\. ..**.*  . *  **. * *..* \.\ ..#          #
#..  .\. **.\ *.  \. . .\.     ...*.  ..*.\   *..*.\   *  .  *.\*..\. ***...* . \.* .. .. ...\ .\.....*\.  **. \*. . .\  *# .#*#           #
#* \   . .**..*   .****\.* *\ .* ..\  .\\......*\**..\...\  *.  *  .* .. *.*  ... . .\ ..\\\...* ..\..*. \ ..** ...\..\.\.\ .\.#           #
#*  .\ *  ..**.. * ...\ .* . .    ..  *  \  *....\. ..... \...   .\.. .\.\*.**..\.\. *.. . *\........ *.* .**.\*      *  \#.\#**#          #
#.   . .\...***. *.*\..* * \** ....\.*.  .*. .**. .*\*****.** \. \....\.. . . *.. .*  *...\.\*....\.. . ... * .*. . \ *\.#  .###           #
#   *.*..\.\..\. .. . .... .\.   *.* * \  .\.**    .... ..*..\   ...*\. \.* ..\ .  *. *.    .**. .*..*.. .... .  .\..*.\ * \##             #
#.* . \**  .\\\* .* .    . .\*  ..*. . *. ..**\*\.**  *\.\...\ * **..* **....* . . .. \.** * *. .\.*.. \*.***  *.*. .  ..#### ##           #
# .  \ ** .  .* ....     *. * .* ****\.\... \..\  **. .*\..\.... *\...*..  \*. *.\ *   \ .* .. *\.*.\ *...\..*.\        \.*.#*\.#          #
#**\\..*\...* \ **\. \ .** *\*.* ..**..*\ \*..* \ \**.....\ .***... .*.*.\ .*.\.  \   .* *. * ... *..  * ..\  ..\ *** .\*\.**\##           #
#.. **\.*\.\.\  ..*. ..\.. **. .*  .** ....*..*.\*\..* ** *.. .* . . .  *.\ . . . .***..\.  . \*\ .\. \*\ ..\   .**\..* . *.#..#           #
#\..*\   * *\.*.. \\\\ .**.\. . **\. \. .... *.*.** . ..\ .\\  * *  .*. *\\.  \. * ..* *..** ..  . .. \*\ \** . *.. .*.  .* ###            #
# . ..\ .. .*.\.\* .. \ \.**. .*..*  .* \.. .. *\.. ..*.......\. ..\.\* . . ..**.\ *\..\\...\..  \ **..*.*.**\.*....\ ..\   ##             #
#    *..... .\.   *\* \*.... ***\**\ \.\*.. ..*..\.. *. ...*\**\.. \  \.****.. **.*.**. *.*\ *\.\..*.\*.. ..\  . *  .  . .*##.#            #
# \  . .   *\*.  .*..*.*.*. *..\ .*. . *   . .\ . ....   *** ..** * .*.***.. .*.*.**.. .\ . ..**.* .\*..* . ..* *  \* * . .\.*#            #
#*\\    .. . . *.\ .***.... .* .* ** * *.. .*\**\.  .*.*.*.. * ...*.\*.... *.\ *\ .. *. *  *..\ *. ...**.\. \*..\  .. .. \ #..##           #
# .. * .\\ .*. * *.\.*.\..* ..  .*....\.\. *.****.  \*.* .**\. *.***.. ***.\. .**.\.\ ...*** . \ \. \ .\.\..... ..*\. *. ..  .#.#          #
#  *.**....*.. ..**.\..**.\. ...***.**.   ..**\.....***. .....\  . .  * .....* ...  \.*\ \..  \. .\. .\ \. *   \ \ **..*.  *  # #####      #
#**.*.* ***..\ * .*..*.** *.\  *... . ..\  ....**.. ...\.. ..*. .****..   \**.* **\ . *.\** \ .\... *. **. * ....  *\*\.  \. *.*.* ..#     #
#*\.  . ..*  . *.*\\...*. \  .\..* *.**.\ *\ *..*\\*\. .**.\.\ * .*.*.. .*..*  \..  .\.\ ....** * . *. **.**   .\.\.... **.  # \ *.# ##    #
#*.\ * . ... \ ..* .\  .. .\. .* *..\ *. *.*** \.* .\ \...** .*\ **.* ...*\. ...\.*  .\ . *. .\..*.**\. ..*.   *  *. . **\***  ... .  *#   #
#\\\.\   \.\ ..**.   *.  ...  *. .*   **. ..*. ..*\.**. .. .*.. ...\* ..******..* .*  . * . ..   .***.    . .  . * \ .**.*.**..   **#.#    #
#*.  \.\. .*.*.**.  ....\ \** \ . ..\ .\ . .  \ *.  .. . . ..*. .**** *   *\.\. . .**.* *. .  *.  *.\ ** .. \.*\*\ .  *.*   *  *   *.#     #
#.\ \** . *.*. ..*.\ ..*  ..*..*  .   .  ..  * ..... . **\  \   .\ \...*  .\.. .\   *\.\* \\..\ . . . ..***\..\...  .*.\.   * ..* .. ##    #
#**\ *\  \.\.*  .. . .....\*\**.\**.. ... . * * \ . \ ..\..  .*\.*..  .*\  ..  .. ..**. *... ...*  * ** .\.. **. .*.. ..*\ ** * #.* .#\#   #
#*.* \*. * .**.\* .* *.\ \ \.**..*. *..\* *.\ ***\*.\ * .\*.*\ *\*.\*\*.\*\   *\\.*.\*  \ *.*.***  ***..* ...*.\\ .  *\*\*.. *\*.**. \*#   #
############################################################################################################################################