########################################################################################################################################
#                  #\**# #*.**\. *.   .\..\ .* *.\ ..*.. *.**.*.. \.\ . **.\. \..* .. . \*   . *...**  ***.. ..\*# \*..#               #
#                 # **.\.   ...  .  .*  * .  . * * * *\* .*.. .\*\.* .\ *.\*\. ....***  ..\*\  *. ..*\..\* * .**. .. ..\#              #
#                 #.* *..*. *  *.*.* .. .  . .*..\ . . . .*...**. *\ *    *** .*. ...\ . .**.\....  *...*.. . ***.  \   #   ##         #
#                  ##.#  .* .\** *... *   .\ **.\*.**  .. .**. **.*\.. . .*.\ ..   .*. ***... *.\ *\*..\  ..  .* *     *.###  #        #
#                  #*.*\  .\\..*. **\.*.   . *... ** \  \ .\*. .  ..\*.\ *.\ .... * .\ .    .\.. ...\.. ...\.\ .\.*.\  ..\.   .#       #
#                   #**. . .*..*.\..*..**. . . **..\..* **\*.*\*\*\***.  *. ...*. *  *.  .  . .* *. ..* *.. \. * *  . ..*  .*\ #       #
#                   #*#\  .\ *..  \. .****.  \*..\..* .**\*.  .. ..\...\....*. .   * ..*. *. ..**. \ ** .*.. \  .. \   \.** **#        #
#                    #.. *.\***..*. ....*.  *.. \* ..\  **.\ .\  .*.\*. *  ** ..   . *\ *... **..    * \  *** *.   .*\ .*\*#\.# #      #
#                  ##.    *\*.  ***  *\\   ...* *...  * *....*.. \....* \ .. .. .   *..*\*.*.*..  *..  \ \.\**. .  .. . *#*. . #*#     #
#             ### #*. . .*..\    .  ..\.. .. .*..\..***..   **.\   \. * . *.*\. \\ **.*.*\*.  .*  .**.....**.\ *\   *\   * ..  ***#    #
#            #*  #.#* #**.... *.*. *.*.* ****\* ..**..* * .\...   .*\..\. * ..*..   *.*..*\**\ *...\.* .  ..*..\ .**.*\* .*\ ...\.###  #
#          ##.\#\.*#.**\.... ..  *.*\.*...**.*. *.\*...\* *.*. *. .. .*..*. \ * *\ *..*\.*\.. ..**...*\ .. *..\  .*.*.* \*#*# ...#\..# #
#         # *# ** .**.\.*..*. \ *\\*....\ .. \.*..\.\*. \.\.\.\*\ \  ..*.. ....  .*\. . .  ..* \ . * ** *\ .*.  . ...\.*.. . . ...# .# #
#         ##\ \*#.\.  *\* \.*  ..... ..\  .*\.\. ...*.\.*..\.\  .  **.\* ..** ... .\* .. . ..... .\.\.. . ..* \.*. .\ ..*** \  *### .*##
#      ###....# #  .\**R.\ \.. .*...   .  \..\  .. ..\**\\*   .* **.\ *  .*. . \*.\*.\*.\..***** .. .* *..*..\...\. *\ *\.* ..#.#\##.*##
# ##### \..\.** \.*\..\    .. * .* .*\ *...\.* .*.\* \.\ .\.*.\. ..  ** .** .  .* \ ..*   \....\\ .*....* .\.**..    ..*  *    *.*#..\.#
##.\  *\ #* *#*.. *. ... .  **..  \.**.** \* .**\ . ..\.* *.. **. .  ..**\.   . *.  **\   .* \ .*..\.\.***\.  ..\ **.  . .*.. . \.....*#
# ##.#....* #.*\ *... \** . *.  .\..*.... .*.\*.   .  *.. ..**..*\   ..... * *...\\.. .*  \... *. . \ .**.. ...* ....\  . *.****..**..*#
#  # .* *.. .\* . ..*  .*.\\.. .  ... ..   *....*  .  ..\***.* ...\* ..    ..*.  .**. *. *.*. \*.** ..**.\*.\**. * *\   .*. *.*.*\...*.#
# ##  .\. \   .   **\.*\. *\  **.\.**.... \** **  . *\ \**\. . ..  \ ..\   ... *\.*. ....*.  .  *.*.*\*.. .* .*.*.*. **. .* .\...**  .*#
##. * . .  **\.** *. \... \.....*. *\*.*.* .  \ *. .* ..  . .\ .. * * *.\.*  * .\**\. .\.. * ..  \*\*.***.*\* .\***. .. \ .\ *  **.*\  #
# ##\.* *\*\.\\*. . ... ...  ....*.*.*..*.\.* .**....* *.* *.. \*\. \ ...\...\ .**.     * .*\.. * ..*.*\...*.**.. *\  \*   .*. *..*.\ *#
## #..*\.# #\.*.\.*\.\.  * .* * .*..*\* .*....\\..*\ **.*. * ....*.  *..\. \ *\ .\*. *.\\\*\ *. \  * *.  . *.*..  ...\*..*.** ... *.*..#
#.  \\.#..  .   . .  ..* ...\.. \*....**\. *\ ..**.. .. .  . .\  .\ *.. .*\  *\*..\\.\ .. *  \ * \*. . .\   **\. \.\ .\*\.\.* ...*.*.  #
##\   ** \*\..* * \.. *  *   *   ... *.** .*  .**\.  \..\. \.\ * \..\   *\ .\.. .  .*.**  . \* ...*\.   ..\**...*  .\..\...\. \\***. ..#
##..#*#.  .. \.\  *.. ...*.....*\ . ..\ . *.*. .. * *.\ .*\.\* \.*..\ . .. . * .. * ..**\**.. .*. .  *...**.* .*.   . \.\* .\ .*.*#*\ *#
##*\.##**.*. .. * .*..   .  * \. .*. \ .....* .\**\ * .. *....**\\*\.\ .*. ...*  \**\ .......\*\.***.*\  .. *\..\. **\*. .  *..\ *.* ..#
# ####..*.**.**..\*..  **. .. \.\  . .** ***. **  .\ .  .. * .***. **... *... *.*.*. .*.\ *. . *...**.*\.\. \..\ *\*....*.* ..  .* ..\.#
# ####.\. .  *\.*..**....*.  \ .. .. * ..**..*.\     .. . \* ...\\ **.. *\*. \. .\. .\. *\. **\. . . .*..  ..* .***..\  *.*.*\*\ ..   ##
## .\.\.\*\ *** ..... **.\  .\*\ .*\\\... .\ *     \..  \ .\ .** .*\.\*  .*... ....  . ..   ..* .  . .    *.*\**..*\ *... \ *...* *. . #
# #### .. *.*\. *\ *. .*\ ..  .. .***. .  .... ...\*\    \ .   ** ..*.\\.\ .  . .* .* \ *\.  **     *** \. *...\.\ * \**.*. ..\*\..    #
#   #\.  .*.  *. . \..\  \. \ .\.\* .**.*.\ .*.  ... ..\*.  *. *\. ..  ..\.. .\...\   .*  ....**.*\.**  .  .   .\*\. *....  .. .....* *#
#   # .*\.L** .    .**....\ .* **.......\.  ....\ * .*... * ..** ..*.*  ..  .*..*. . **  *.\..*.\** **.. \  .* ..* ..* *.* ..  * *  . *#
#  #.  * \\..   \*** **...**\ .\* \...\...*..***.*.*\***.\.\ .*. \.\*\* \ \*\*     *. . .*\ \ \\...****\. \ **  ..** .\*\.\ *.*\ .\ *\.#
########################################################################################################################################