#################
#.  ..* **. \. \#
#  *\ .\..\*  *\#
#. *..\\**\.\*..#
#  * *.\*.\. .. #
#.*. ... .  .\\.#
#.*.\. **.  ..*.#
#...*\.**. *.** #
#\\  . .***.. \ #
#*. .\  .....\. #
#*.\.. .**\.   \#
#*\. *.* ** ..\ #
#*. .\* ..  ... #
#.    \..\.\ \..#
#.\  . .**. \*  #
# .\. *...\. .  #
# *..\\.**.  ...#
# \ \.\... .\.**#
#. \*.*. *.  ...#
#  .\  *\* . .* #
#\*.**.*.* . .* #
# ....*.*.** *..#
#.* .\.* *\.*.  #
#.. ...\.**.. * #
#*.*.\ * \  * **#
#.*. ..\*..*\.\.#
# .\  . .\* . **#
#.*. *\.. \ ****#
#. . . *\ . *.* #
# ..*\*.... * \ #
#*\*...*.  ..*..#
#*.**.\*   *\..*#
#.. ***.*.* *...#
#*.... *. . *.. #
#.. *..** . **\.#
#*\ \.  * .*.***#
#.* .**  .\..*\.#
#..\ .\\   ..\..#
#..*\ *.\    .  #
#..* *\. **\. * #
#*..  *  **.\*..#
#.\ ..  . ...  \#
#*.*.*\ * * .*\.#
#**. ..*  .  . .#
#..   *. \ ..*  #
#   . .* ..**.. #
#.**. *.**  . .\#
#.*\...   ..*. *#
#...*.\.   *    #
#\.   \ .* ****.#
# **..  ** ...* #
#*..*..**.. \.\ #
#....\ .\. .\*..#
#. *\* ** .. . \#
# *.*.\... *\  .#
#\* .  .  .. * \#
#** .  *. *\ \..#
#..   .\*\.**.**#
#*  **\*\ .*.*.\#
#.  ..  * *\  . #
#  \.*\ \.. .\.*#
#. .\\.* \. ..*.#
#.\...  \.\...* #
#. . ..\.  * .. #
# .   . *...* \.#
#. \**.***\.\ .\#
# ...\* . *.** .#
#*.   *  ...*\* #
#* . *\ . * .*..#
#* **.* \\. ..**#
#.... .   \    *#
#\...\\. \.* \*\#
#.    .*. *\....#
#.  .  *\\.* *. #
#\ . .... *\\*.*#
#..**\*.  ..***.#
#\ *.. ..\ .**\ #
#\*.*..*   .\\.\#
#..*.*\......\*.#
#* ...\ . \..** #
#\\** .  *..\. .#
#. .\ *......* *#
#\*  .**.\. \\*\#
# .    * .*\* . #
#. *.*.** . *.  #
#. . . \..*...*\#
# .\.. \.\ *.*\.#
#***. *...\*.\  #
#*...\ .\.***. .#
#**\*.. . *... *#
#*.*   ... .\*  #
#.*... \.\.\.\\.#
#\...*.** \..* *#
#..  .*.* . ** .#
#*\. *.*.  .. .*#
#... .\...\ **\.#
#    **.\...\.\ #
#*.*R*\. *  . ..#
#*  .*  *..\** *#
#....*\\\**.*\..#
# ..  .\ .. . ..#
#... .  .*\..*..#
#.  .* . ..\*. *#
#\  .\ \* . *\ *#
#.. *.*.\\ *. *.#
#..*.**  *\** . #
#..*... .. .. *.#
# \..*#*. ...*..#
#.#\*.L* *  .*  #
#*.*.\#**.#.*#**#
##*\*# ##*##*##.#
# ###    # #**..#
#           #.  #
#            ##.#
#################