#####################################################################################################################
#..*\**. *. ..  . ***.* *\*.. *... .. .*.\...*.  ..*. . **. \ *  .. .*\ . .....***..* *.***  **.. #*..*#            #
# .. *. \ *  *\ .*.** \** ..**.*...**\.\.  ***\ .  * \** **. *\ ..  *..*\ .   ... .* ..**\.*..* ** *.##             #
#  . ...*  ...**.. **\.*..* ..***.\*.  .\ ...* .\\ ..**  .**...\ *  * .. \. ***..***..*..*\.***  #**\##             #
#\.\*\.*  .\...\.***.*. ..\\.\.\.\.\*.  *. *\.*   *\*..  ..\. ..... **\  .. ...*.\ *.**...*.... . ***#\#            #
#\*..* . *... .   ... .\.\*\* * .*..... * ..*\.\ ..\*  \ *..\*.... .*. \*   .*\**\.* * .\..\. * .\.**# .#           #
#*\.*. * ....* .**  .\ .  .....\.    *. *.*  ***  **\\.*\.   .\ .  * *. *\   . .. .* . .*.* *.* \ ..*\  #           #
#\. ..*.   .*.*\... .***..* .\*\. *\..  . .  \*. \*\*.\....\.. *\ .\ \ .\.... \   .. .    ***.* \ . .*\..#          #
# .*\**..\\*.\.**   ...\*\*\* *....  *   . \. .* \.*\.. .**. .\**....\*   *\ .. .  *  \ .**\..*.      *##           #
# *..*.\\..**.\. . ****...\.. ..*. \ . ..* * \. * .\.\*\..  \  \    *.*  .\\.   \  \* . ...*\* .   \ *#             #
#*. *.. *  ... *..\...*. *..\ .* .*.\.* ...\ .**.\*.\ . .*. \ \.\  .\..* .  ...*..  *\..*\\  ....\.  ..#            #
#\*\.  *\. .\  . *.. \ \.   . . .   ....** .  .\...  ** **  .. *.. * \.\.** *.... . . *\. *...**\.\##. *#           #
#.. . .\.\*..   .    ... .  *.  ..  ..* \* .\ .*. .. *.\ \\. \.*.\..  \ * . ...*\.. . ... *..\ *. * **##            #
#.\ .*. .   . . .. * .*\\ ..... . *.\*.* *.**.\*... \.   \.* \   .\ *. .*.*. **..  *..* . **.... \*\#\ *#           #
#* . *. \ \ .  *\  . ...\.*.* .. \  *\*...**.\ *\.*. *\...*.\ .. * .*. .....*.\*  \. .\.\ .... *..* \# ##           #
#.\ \ \.....*.*\.*...*.\.*.\* .**  *...***.*.  ..  .*.  ..**  .. ....   . *..  .\..*. .. .*\ \..*\. .*.. #          #
#*.  .. \*\.\**      * .*  ...*.\.\.* *.** .    . \...**.*.. .\ .... ..**\*.\*.\.  .  *\. \....\...*  **.#          #
#*   *  .**\..* \  *\ \.* * .\.* \*\.*.***.  * \. ..  ... . *\*.*.*. .  **   * ..\... *.**. *..*\ \. \.\.# ####     #
#.*....*.\  ... * * *..  *.\ *  .\* .. . .* .* *\*.* . *..  . *. * *   ...\ ..*\..\*\ \ \.\  *.*.\ .\ \ *##**  #    #
#*. *\ *.*. *.*.\ .*     *   .\.\ .* *. *...*\ * *.*\. ..\.*.  * **\\*... *  *.. **.*. \.*.* ....  * *.## #** \.#   #
#**\  **.\. .*..*. ** ..*.. ..*\. .* ..\\.**... .*... \*\.*\\  .\** *..**.. **  *. .\.  \. .  .\.***\ .\*.*\*###    #
#.... ..  .*\\. ***.   *..\  \ .\**.. \...\**. ..\**\  ** .. .* .  *....*..*\* ..*.\\.  .*  .*   ....  .\ #.#       #
#..* .\.**...* ....*.*.* .... . .*..\ .\. .\*\..\.** .. *.\ *..... .**  .*.... *..**. . . *\. . \ * \\.   \#        #
#\.\    .\*\..\* . \ * .  \. *.....\.**. .**   \ ...* ..\.*....\.\  .**.*\...*... ... .*  .   ....\ .  . ..#        #
#. . * *  .  * .  *.*..\.*..\*\..\...**  \ .   ..*. *.  .  **\*... ..\.\*. *  \*       .. * **\ ...* * *  \#        #
#*\.  ...\\ *.*\.*\.***.*.\. . .\**  ...* \  . ...* ..  \*  .*\ **.    ..*.  *.* .  . .***.  ..\*..* *\.*###        #
#.**\. *. . * .  ...\.. .**\*  * .. **\ *.. \. **.. *...\..** .   .*..\.\.*\*. *\\ ... . \  . ...*.. **.**#*#       #
#*...   ..  .*...*.\   \ *...  * .\ *..***\\....*   ...\*. \.  .** \* *..\*... . ...\ ..*. \..\ *** *..**#\ #       #
#. *.*** *..\ *  ..****. \ ..\**\**\  ... *  \ *\*..*.\  .*.. .\..\.**  .. ... . .\. **.\  . ...\....\..*. **##     #
#**.\..**.*.*....* .***\ ...\ \ .*. *\.*...\*.. .. .\ *\*  . \\..*\.*.*  **\\..**. ...*.**  **.... ..*.*#.**#  #    #
# \**  .\.\  .\ *\. .**..  \... .   ..\.** *. *. .  . . *.. ... \*.  .*..... *..\..\ \. \.* *.\.*. \. .#*.\ #..*#   #
# ...*.*...*.* *.*. \*.   . * . \* *.\... ..*\** ...**   . \*\*. . *\ .**  *\*\ .  .\. *.*..\. .* *.  . .. .* * #   #
#.   ....\ ... \*..*.. ...\...*\.* *..      *\ *.. *..**\*.*. *. . **\ ...** \ . .. *. \.  .  **.*.  .. \ **.\#*#   #
# *.* ***\..  .**   \  .\\*\ *\  .***.*****\.. *\ ... *\.. *  **.. .\.\. ...   *..*\.* .* ... \.*..*\#.\.\*\   #    #
#* *  **\.   ...\.\.  .\.*.  .  .  .. ..*.*.** ..\ ..\**.*.\ *.**.\ **. . **. \.  .***.\*\    ..*.  .\*.*..#***#    #
#.... \..   . . .\  \. ...\\.***.  . ..\.\.*.* \*..*.*.\*.*...*...*\.\*.  .\... .\ ...*.  \.. \\...\ .. #   #\*.#   #
#*\.  .\... * .. *..*\* . *\\* *....   ** *.*  .**.. .*.*.*.* . \**  ... \  *.... ...\.  \. \..*...   *#...\# ###   #
#*..\ .   ..*.  *..*.  .*... . *\.*\..**. *\.. \.. *. ...*. *.* ... . \ .. ..\* .....* .\   .. .\.  \.*   ##.# * #  #
#.* *.******\*.... *  \ ..**\ *..*.*....*...* \..* *.  \.*. .\** .\ .. ..\ .  **\.** *  . ..\ .  \ #* .* ##  .L*.#  #
#.\ \ .**..***.\ . .  . ***\...**.. *\. ....\. * .** ..\    \ .*. .. * .* .  *.* . \*.*\ .* .  ......* .  #*\.\#. # #
#  ...   .  ..* . *.    ..*. . \*\. * ***\ \ \  .**\.  *\*\ .* ..   .   \..*** *.  *\..* \*.*  *\ ***.\.\..*\*.. .# #
#  .*\*.*. * ... .\* .* * *.*.\ .   ......... \. *\.*. .**.**.***   .  \.\ \\\ ..* .. .*.  **...* \*\ . * \..\ *##  #
#.* *.**    \..*  * * .**\.\\ . *   ..*.\ *\.\\.  * \..**\*\. .*. .\  . . ...*  \. . .*.. *. .* .  \....  . * # \## #
#\. .. .  .\.*\.\ . . ..*...   .*\* \\\.  .   .*.\.\*.\***\* \****.   .\*.  \* \..  \...\*..* . ......*.\*\ * \*.**##
#.\*.. .** . \* *. \.*\..\. ....*.**.... .\*..*  . .* ..\. * ...\*. \ \  .**.. .* *.** \ ..\*  *.  **** ... *\.#### #
#.*. * *.*.\. * *.  .\*. . \*\.*.  *. .   *..\.*. * .\  **. *.. **.\.*.   \\ . \..\..\.**\\* . \. .*\... \ ...# #   #
#*.* .....*.**..*.  ... *\* ..\.. *..*\..*. . *...\. ** \**.*\*\..\*.*.*\ .. *...*  .*.\.* .*  . * ..\.*..**.#.#*#  #
#\ \. \* ....*.**..*.....*.  *. *\.***.*\\ * . .* *\. .*.*..*.  .\*..* ..  . . . .* *.***.\\**\**.\...*.. ..   .*#  #
#\ .. \*  .  . .\ \....\   \*.*  * * ... .*. *.  .\. *. . .*..\. *.\*   \   ...   * ...*\.*.\. .. . \ \     ..*. ####
#  ...** .    \\ ..\\* \ .\.**...  .* *   .\..\.  .**.\..** .*\  ..*.\.* *.***.\.\*.* *\**.\* \ \.  .. *.. \* .* ..\#
#\   **.*..**.. ..\ \*.*.*  .\..\.* .\  ..\ * * * *.* \....* \. .  ..* . \*.**.. ..\.\* .. ...*. ..*.  .  .    # *###
#   .....   . ..\\.... **  ...\. .. \. . *.* .\**.* .  . .*\.\* ..  ...*.*.. ...\  ..\\***  .* \  *\ *# \.  \.#. #  #
#.*\.  *....  ..*.. \*\*.\.*  \  .. .*. .*\*. *\.\.\\     .* .**\     . \.*\..  ..* .\ ..*. .   .*.* .\ ...*#*\*#   #
# *.  *\.\ .\  .* *.*. .  .  . *  *\\*..**.. **.. ..    * \.\* **\. ..**.*\* ..*.**.\.*..\.*.**.\..*.**\*.\*.**.#   #
#.\  ..*\. *  . .\. *\ .*\. \ .\ \.**..**.*. *.    * *.* ... . ..    \ * \  \* . *.*. . ..  *** *. ..\*.. .**  .#   #
#  \  . .**\ .\*** *. \...*..***.. .*.*.* .. .\\.*.\ .*. .\.\.*.  .\.. *  .*....* ...****...... .   .*\* . \*  #    #
# .. *.\..... .\.\ *  . \**.** .\.. .*\ *...*.\ \* **.. ...** .* . *. .. . ***\*. \..\... *.\..* \. *\.* .. * ..#   #
#\.\ . ** .*..*.*  .  *\...\*   ***. ..*.. ..** \.****. ..*.   .** .\*\*. .... *\.. ..\..*  ..*..   .  * ..\ \ #    #
# . ..  *...*** .* .* \. \ *.\. . * .. *.\\ *.\*  **.\*.*....\. ..*.*  .   * \*..* .\\*  ..*. .. *.*  ..   ...*.#   #
#\...  \*..\**.... .. ..  .\.\.*... ** ..*.*. \*\. * .*\**\. \* .\.*.  *\.\... ..\ * * \.*.* ***.. **..*.* .*##*#   #
#*..** .\* *.*..** \.*.\\     .. . ...*\ .\ *....* .\\.*.*... ** .*.. *..  *\\  .  * **.  ** .... ..\..# .*.\# #    #
#..\.  .*  ...... *\.\.* *   \*.. .*\ .   .\..   .. *.\.\\..  ...   . ..\. * *.*. . ..***\*. ** *.*\*  ....##       #
#*... .\ ..\  .**..*\*** *. *..*.*...\ ..*\..*.*  .*.\.*  \  **. .. . *.* *.   ...*. ..\*..  ** * *. . *#.\#        #
#.\*.\. .\*. .... ...*\.\.. \**. . *....*.*\.. ..**.* .\*..\ .* .\..\ . *\.\*\ .*..*  ...\  \ * .\. **..#\#         #
#.  \ * *.\*  . *.**.*    * ..\* . \****. .. .. .*..  *\ .\..**  . **.\.\.\ .. ***. *\ *   R.\.. .*\.# \ #          #
#\* .\ ...*.\* \. *...   .\..*.*.  ....* .. .*\. .. * *** *..**.\.*.. ** \.\ ..*.** **\ \...*.*. ...*.\.#           #
#  . . *\..\.*...*.. * .\\.\.\ *\...   ..  . . .  \.*\. *\ .**.*..*...*. . .. \..*...***..\*.\..  *.  * #           #
#*.* .*..*.. *..*.  \  ..**. .\..\..\.\  * *\.*. \. ** .\ **.\..\ *. ***.\ .\*.   \. ** *\**.\ \  *\#*# *#          #
#..\  .*.*   . .\*\\.. * ..  . \ \*\.. .*. *.    . .*.  . . *..***** *..*. . .*..\*.* .\*\..\**.**.##*#\#           #
#***..*.*. *.  \ **   *.*\ .  \*... ..* . *** ..*** ..*..** *.**..   ..\.*.***. \..*.\..\ *\.\.\..#  # #            #
# \* ...*. .   .\*\  ....**\   *     \*....\*.* ... . . ..* ...***.  *\  . \..\* * .\** *   \.** \*#                #
#\ ..   \*..\  . \*.  .  .*  .\*  .. ...\.  **. * **.......\*\ *..\ *..*  . ... .*.. .. . \ ..**\#*#                #
#*. *..*.. ...*...*...  *\.   .*   *.\  **\.*.*...*...* * *...  ....  \.. \  **..\ ..*   * .\ \.# #                 #
#\..\** .*   \\*. .**\* .*\..* . \.... ...* ....  .** *... ..*. *... . .\* .\** **  *... \  .\  \#                  #
#*\. . \.*\\ *\.*. *....* .* .*  .*.. **.\. ..\*.  .*...*  . *\..\***..*.***\ . \..\**...... *#\ #                  #
#.  ...**..  \\.** *.  *..*....****** . .\.. *\.   *.\. . **.\..*....  .*. ...\..**... \\ *.**## #                  #
# *. \.\. .. .. .*\. *.   .*  \ *\\. **. .\*..*.   **** \ *...\....\. * .\.. \....*\..*\ ..*  # #                   #
#*. .* ** .* .**.\* ..\. ... *.*\..* . \..***.. *.\..*.  ...\. ..\**..* *.\ .  \  **\**..*\***\#                    #
#..\.  \.  .*.**** * . . \.*.*\*.*.. \ ..*\.  ..* . \ .   \ . .* ..*\ .** *   .  . * ....#.\*##                     #
#.\ . ...\. *.*..\ .\.*.   **.\** *  .\. .. \.**.*\ *. \ * *  *    .  .\ ..\..* ..\.\   * **.*#                     #
#..     ** \.*. ..*.  *\ *\.* *...*** ...* ..*.. .  \  .*. .\*. .**.   *\*..*  .\*** . .\*.\.## #                   #
#.\ ....*\ . ..*...** .*\\*\*\.\ *\ \\ ....  . \* .**\  .\ *.**...** * . .*.\ **.... * .  . .# #*#                  #
# .. .\..* * *\.\  *\*\**\..*.  *.  .\.  ... .*.. * .*   .*... . *.. * .  .*.. *.*.  *\ \**\...\.#                  #
#..*\**\ ...*..***. .**\.  \.\*\.\*. \.. *.\.*.*.\*.**\***.\*.\ .\ \.. *\    \*..*.\**.  ..\.\###                   #
#####################################################################################################################