################################################################################################################################################################################
#  #.. ** *. **.\.**.\\*** .\..    *.*. *** * \. .  ..*.  *.\ *. . *. ..*** **.*..\..\ .**..* ... .\**\...* ...**.*.. .* ..\.. *. .*  .\*  .. .\.*......   *..\*.\.\. ..*  .\ *#
###. .***\.\ *\\* .. * *.. * ...* * .*\.... *\**...** ..*.... . . ..\.    .  ...*\*. . ....\.*.  .*....\*.*.\ .\**. *  . \ \ *\*.\.*.   *..*.\ ..****.*   . .**\ .\ *\*\.\* ***#
# *\#####.  *. ..*. \\..\  \**...\*..\ .*  \*..*. \.\ **.. \. \  * ** . .. **\ ***\**..* \.* **\. *..\* \ \ \*. .**\* .. ..\ ..* **. .  ....\..*\*\ *.*....\\..* *.*  **\ \  *.#
####    # **.\   .**. . * .\*\ . ** * .*.\.. \..\ ..\. .**.\*  .**\ . \ \.*.*. ***..*. .  *..* ..\  * ..\*.  .** *.*\. \   . ..\.*\. . ****..*\..  ..\*.\..   .... \  \.\*\**. #
#       #...* .* ...  \.  *** .\.** **.  . *  .* *\..   .**  ***\\ *\ ......*.* .R\..**.\*.\*.\  . \\..**...* ... ..*.  . *..\.  * . * .... .* *  .  ** .\. .* **  ** * *.... *#
#       #**.#.  ***\*.   .*...**\*...*.** .*.*\.*.    *.**..***. *..  *\*  ***  .  *\ . *.  .*\..  *   ...\*.   . .*\.**. ..***  ..**.. ..\. .*\*.*\* .. . . ..\ ...* ...  * *.#
#        #*...\ . ...* .\  *\..* \.... .\ ....  ...* ***.** .*.....  .\.*. . .\. * ...*.* .*.   . .\.** *...**\  * **\ . * ..**\.. **.* . *. *.*. .\..*  *.. *..*  \***...\ *. #
#        #.**** *.\.  .\  ..* *.\\* .\..*.\    . .*  .*.\*  .\ **\.     .  * .**..* ..  ..\.* . .... .*...*.*\. .*\..****.. *.  ****. . *..  .**\..   *. *.. \..*.\ *  \ .  * *#
#         #\.. \ . .. *.\ .\. \  .\. . *. **\.***.* .*.* *\    .**. \**   * *...  \...  . *.*..* .*  *  ...*.**  \**\**.  .\. \*.**\ ....\..\ .*.  .\*...** * .\.*....** * \*. #
#        # **.\... *..\..\ *. \* \ ...*.*.\*.  ..\..\.*. ..  * \***..\.  . ..**.\. **.*\ \. *. . .*  .* * *...\   .\  *. .. *......*\*.\*  .*  .. . ..*\\.*.. *.. *\ **  .  .  #
#       ##.#.**.\. *.\.** ** .*\.   \**.*.\.**.  ...*    ... .\..\.*... *\  .. ..\ *\\..\  .. ** \*.  . . \   \.\  * . . . .*.     \  . *...*\*   *.. .  *..***  .\ \..   .* . #
#      #\*... .*  \**.** .\** ..  *\.... * .\.\ *.\.... ...*\* .\ .. ***\*..*\\*.. *\*\** ..\ *..** ***. . ***.   **.....\ ..\ **** **  \ \ .*  *\. \ .  ... \..  .  *.****  .*#
#       ##..#.. ........  *.\.* ... \ .*\**. . .*** . *\*. **. .* .\.. *. .*.*.. .*\ **.* *\. .  .** \*  .**.. \. .*\ .\..*... .\..**.\*.* *\. . . ..  .*.** .\   ****.*.... \.#
#         #*.*.* .\ .  .  \.. ...\. . *...\.  .* .*..*... * .  \* \. \*..    .\ . \ *.*.\ .**   **..\*. .**. .. \*...\.. *\   *\. *..**.* .** .   \ .   *..*.    ..\  ....\ * .#
#       ###\*.***  * ..  **  .  *.    .\ *..*. *  \  * *..\ **...*.\. *\\ ...*  \.  .\*.**.*. * .\ \*\*  **.**\ *.\..   .\*  *..\..**... ...\*.. \.***.\.* . *\ .\. *\..  *   \#
#      #**  .\**\  ..*  ...*. *..*..**\ ... . *.. \ .  . .. ...  ** . \ **  \. *.. .\  *.  \  *  *.*...***. \ . .. .  .**.\ *.*\.\ .\  .. \**.*  *\*. .* * **.\ \ \ *. *\...*..#
#      #\*##.*#\ .\\ ..*  .. \*...*.*\. **  * \  .  ..\..  .. *  ****\. .\\. \ \.*.*.. \. *.\ * *... .*.\*\..*   \*. *.*.*... *.*. . . .\.. . .\ ..*\  .\*. .**\ .. . \.\**..* #
#       #   *##  ...  *\  \ .. .***\*...*.  * . *  **.  \  .*.. ..\... .*..\ . .*\*\.\ .  .\. . * * .*\*. . .   *.. ... *.. .*. \*. \.   * * * ..\   *. *.*  . ... . ..\.. \.*.#
#     ####\.**...\\ \*\ \ ..*.\. .* . ..*....\*.*.*. *. .*  .  .   ..*.\. .  .  .*.  .* \**. ***. \    .. .\.* *****.*..*.** . *..*.* *.*\ .*\\* . * .* .***\.\....\* \..\ . . #
#    #*..\ #*..*\...\.*...* .**. \. *  \. .* ..  *.* ... . \* *\  . . *.\**   ..\. ..*.\.*.  .. \ . \* .*\     *.*.. *. *....\ .*  *..\.\.. ... ...  **\... *. .\   .*** *  .. #
#     #####...\.*.* *.*..*. \\.\*   *...\*\. \  ..****  ***.*.\** . * .\  ...**\*. ...\   ..*  ... *..\ * \ .***. . *. \.\.... \..  * . *. . \    . *\* *..*\. .\.*.**. **  **.#
#        #\ .#\.\.**.\  .. .. . .\ ..*.* *.*\..\  \***  ... .**..   . * .* .**..**  *.  \ .*\..*.  . .* .* .\. . *..\.\***.... ..***. \.\\..\.. . ..*.. ..... \. .. *.. ..\.\ .#
#         # #. ##\  **.. * * .  ...\.... *\.* ..** *.\ .. *...   *..   ..\.  . **. .**.*\.** *.  \.*. .\***.*\ *...... \.. ... *.**..*.*. *\.\. *\*...\.\ .*\\.  **..**\....*.*#
#        #.*\#\......\..**\. . \*\..** . ..  *. .*\.   \  .\ * .**\ \* .  *.*..**.. . *...** . *\..\ ** .*\ .*\.\.\**.\..  \ . .\* *\ *.*.\..**..*\.. .* * . ***  *....*.. \.\*#
#         #.# *. * \ .*\...\. ..*.\.\.  . . .*\.\...*..*. *.. \... \....*.\*\ *.  .*\ * \ *\.  .. \. .\ .... .  \......\*\ . *\  ..*  * **.**.. ** \..\*\. *\ ..***\ ..* **.* .#
#          # #.. . .. ...\... * .\ .***.* *  .*.   ** *.. *     *  *...\.. ..*... \**.\ . * *..  . \ . \ * . \..... ..********. \ .*.   *.\ . ..*.*.* *.*\* \\\  .\ . .* .*.**.#
#           #  *.*\.. *  .  .\..\*..\.* .*\..\.\.. *....  * .*.\\ \. . *  .* \ *. *\*.    . .  ..*..*.*\.*\ \.*   \**\*.. * .\ \\...... ...   .*.*.\...\*..\.  .* * \.*\.\**..*#
#            ##*.\*\  .*  ** ** ..\.. .**\..*.\ \  .. *** .\..  *  . .  . ..*.** ..*..     .   *\  \*....* ....\* .*..\.  .  **  **. * .** .\.  * \. *.*\*. .\**.\\. *\ . *... #
#           #* *\...\ .*\...**. . .*\  *.*.** *\  . *      ...\ . *. *.\  .*..*..\..**.**.   . .**.\..* \. \  *.* *.   * .**...*.*** . .*.  *.\*.* ***\..\* * *......\  **. *\.#
#           #\ *#.*\. *\..  *. .*.\..**\.* .  * * *\*. .    * ..**\**...* ... .  *.\...\  .....*\...* .  .  \...* .\ .*.\  . \..\ ..    . ... *.....\ ..\...... ..\ *  *.*\.** #
#            ## .#.**\.*..*\.\. . .* .\ *.... \.. \....\. .\**.\......*** . \ . ***  * .\    *  \   \ \.*\. . \*.    \.\.*\  .. .*. .\ \ ..\..\. .***.*** ..\...*\**. .. *. . .#
#             #\ .... ** ...*  *\. \    *. .\..\... .* .  .*....... ....**.  * .*..*...**. ..*  . .*  \ .    *. .    .\ ..**..*.***  *..*\. * . \\..*.*..  *..\ \*.... . *\.**.#
#              #..*\. .. **.. .\. *.* .**\\.\ *. .*  .*. .\    .\ \ .**\. .... *. ..**.*.... * .\ **.*.. ... *. \ .\.*.\ \.\  ....*..\.*. *\.   . .\**\ .\*. .  .... .* .*....\#
#             #\*.*.  ..* *.\..** .*. *.. * **..*.*..\..* .  * ..* ..\\*\.  *...*  ...\*\.   *\....  *     *.\* . ****  *.*.\ .\.**\..\.*.  \  .\\.  *.. ...**.  .  . .*.* \  *#
#              #.\#.\.*.#*\  \ ....*..\..\.\*.\..*.\.. ..  ..*  .\ .  . .***..* *  \. ..*  **..  .  . .   *\  ..\  *\\. . ***.\*.\  .\..*.  \ .* . .*\.**.*.**.* \  . ... . .\*#
#              ##*\ *\ .*.  \..*.\*.  *..\* .*..\\.*.\  ..***.  \ \.*  *.*. ..\..... .  *  .*\*  *\.. \   ** .*. . .*. . ..\.*\..*.*.  \  .\ . .  . .. .*\.... . *...\ *\ *. .*#
#             #.#.* * \*.\.\ . .*.. ...\. .. .  ..*.*..* \.*\ *....  *** . *. *....  ***...\.***..**..* *....\..    .*  . .* **  \.*  *.*.\ .\*\ . .*\ \.. .\  .\\  *.\...\** .#
#             # *.\#.. . . ..\. . ..\.* * \..\.* *.*.\ .*. * \.*..  .*****.* *.   *.**.\. *. ...\\.* *.. \  .  .....\*  .. * .*\..\*. .**    * *.. .\  .**\..*. .     . * ...*.#
#              ##.## .. ..\.#\*\ ..  ** .. .\ ** ... *  *  . .. ...***...**. .* **. \.   \.    *..*.\.*  . .* .. .*. \.* *.\  *.**.\.**.\  .*\...* *   ...*.*.\. ..*  *\..**.. #
#                ##\ #** *. ..\.***. .\ * .\*\..  ..\*\ .\..**.* .. .*.*.*.*  . ...* .  *. ***  .*.\*..*.*. . **  . .*\.\\. .. .*..  .*.. . ..\..*.\ ***\ *.... \ *.. . .*..\..#
#                 #*#.#\ ***\.  .**\.. ..*.*\*   ..   .\\.\.\....   *...\.*... *. . \ . *  *.  .*. *.. .. .***... *.   .....   \. *.\*\\  .* . *   *.*..   .  **..* .   .*. .**#
#                  ##  . . \.... .   \.* . .** *.* * .* .... \.**..*.... *.*.*. ..  \*.... .  .\.  ...***.\** *.\..*.\  .... .. .\..***..\..\..* . ..* \.* .\*.\   .*... .\ *.\#
#                  #*#*.*. ..*.  \ * .. .\. . ***.\* *.*. . \. **.\**\.. . .\** *.  .*\  *** .. . .  .... * \ \ .*.... .*.** \  . . .** ..  \\*. .  .. ...    .  .. *.* . . .  #
#                  # #*#.  \..     \ \.  .*. ** \**....\. .\ *\* *.*\  \.*.. \...\ .*. \ . * .\ *. .. .**..\. . *..\ . \*.** ..*.. \ * \ ..*.. \. \..  .*** ...*.\**.  *\*     #
#                  #..* .\\.\.*..*..\  ..****.* .*.. * . . . . \ ..\\*... **.. .\\.*\.*. .*.  .... * *\..*.* . \*\.. *... .**** .**    .** *... * \...*. \..\ .***.*\   .*.\  .#
#                  # ..  .  . \ . .  ...*.**.\.. * * .  .\ ..\. .*. *.  .*..\* .*.......*... .\*\  .*.   .*.* \...\ .  .* *.\.*\*.\*\ *      * ..\.\.*. ..\.* *..* *.\..\....  #
#                  #** *..* *   .\  . ... .  ... \*\   *\  *\  * .. .\. *  ..*\ ..\.*\..*\ \\. *. . *\...\..\.   .**..\ **..\**\. *** .. \*.\*. \ *  ..... *.\..*.*.*.\ ..*.\**#
#                   #*\ .\*#.\... .* .*\.\*** *  .*. *.*.  .\* .\  . .\.\.*.*\     ..   .* *. ...* ..*..\ .*.**..*.\ . .*.\ .**.  .\.\*\  . . ...*.**..**  . *  ... \.*. .\.. .#
#                  #.\. * ..\* *. .*\ ** ....*.*. .**. *..*.*\  \. .*..\. .. **  . *  .\..***.* .  ..**. . .*\\    .\....\.\...*\.* \...**.  .\\* .. *.*. .  .\ **\. .*\    ** #
#                  #\ *# .*# * #.\.\  .*   .. ..  ..    ..\..\. . \ \.**.*..  *. .\   .\**\. *.. ***  . * . .*. ..\*.\ *****.\*...\\.*.  ..\ *..   *  .*\**\* \ .... **.*  *.**#
#                  # *## .#\.*\\.  .\. * \. \\.. \.**  *.* .    \  ...\ * * . .\.... . .... ..*\..*.. *.\.  ..\*.*  .*..*..*...  \ * **  .....**. ...* *..\*... .*\. .* .* ..*\#
#                  #\# # *\.....*.  .* . . ..*\. . \ . *\*.\. .. ....* * ..\ *. .\.  \   .*.\.. . *. .\...   . . *.. **..*...* ....***. \. **. * \ ...\.   *..\..\..*.*\.*   \ #
#                   #   ##*# ....**. . . \*....*  \.** * ..*\. \  ..\.\.. .* .   *.* *  \... **. .\.\ **\****. . *\  \.**. .\.  . .* ..\.\..... .*\* . *\  .* * \  ** .  .\.\..#
#                       #* \*......***.*\. *. .**..*...***\..*    \ .*.*.*. \**\ .**  ..  . .***.*..***.   .*    . . . *\  . . * \.*....\**   .  * **  .    \*. ..  . *..\ .  .#
#                        #L#**\... \.\..  ..\. \.\..* .\... \.   *.. ..*   .* ...*..**.\. ..** *\*. *.*   *\ * *.*. \ .\*.  \** . *.\.    ..  *.*. *\ . .. ..*\.*.  *.*.\.. .  #
#                          #*..   .  *\  ***. .\*  *... . ** *.*..  *\.. * *\.*.    ..\  .*... .*. . *\.. .. .  .. \. ...*...*.  ... \  .. .*\. .\  .*  \\  ..*.*\. .\. *. .  \#
#                          ###.\. * ...*.\\.   .. **.. ..*\. **.  **\.*..* .**..  \   * *.** .. .** ... ... * \     .   \* *.** *.* .*.     ..\ .***.*\*.*.***\..* .  *.. .* *.#
#                         #.*\.# *.*\*\.  . *.. *  . \.\ .. *.\*\ *** .*..\ .\* *.  \ * *\..\**.... **\  \*.\ ..*. \*... **.\...\.\\...*... . *.*.\* .*\ .\****.\.\ *** *. * .\#
#                         #*.\.\ ***  \*.\*.*   *.. ..*\.  \\....**\.. *\ ..* ...*.  \* *  *...* \.... * \. .\. **..    *\....***  .\ \. .*...*\*..\. .* ..   ...   ....\*\.\..#
#                        #.*#....*.*.. *.... . ..*.  .\. *\..\. .**\ ...\  \... .* ..*\ ..\. *.* . *** .\* .* .  ***  .\*  .  ..*.\.  .\* . .*.\..\  * ...\ .\. .*...    .   . #
#                         ## #.* . .*.  .\*   .** . . .*  *.*.\. *.. *. ... \*.*  .. . \ . .*. *. \...***. \* * ...* .....**\ ... \\*  *.\.\..*    .*. \ *..\... ...  ...* .  *#
#                        # ## .. .... ..* .**. . * ..*\* *.\.*.*\***\ .\**   . **..*. .*   ...\.. . *.*.\...\.... .** \*   ...*.**.*. .\..\..*..** ..  ....      .\  *...* . ..#
#                       #.#\.#*  **.\  ..  .. * ..\ .*.*.*.* * .* .*. \ .....*..*. *\.*.. .... .  ..**. *.. . \*   ... * .*\* \* *\*.. ***.*\.  . .. \   *..\ .\** *..  .*.***\#
#                      #\ ## .*\*.*.\ * \* * \.  .....*  **....**   \.\*.*.*..**.\* * .\ ** \ *..   .. .. \  *.*. \.  ..*.* ...\ ....*\.*.... .\ \*   ...\ **.  . .\.  *\*\*.  #
#                       #.*. ** . *  ... .\.*.*** \. .**...* .\ ...  **.\...*.*.\..*. *\ .. ...*.  . . ..* . *.*\.. .*  .\.*\.. . ***   *..   \*\...** . . *.  \**.** .*..  *..#
#                       #\*.*.* \*\.*... **.\.. \\.*...**  ...*.*. ..*.. *\*\***.. .* * *\\*. .*  ** * \..* **.    . *\ .*..*. .\\  .\.  *. .*.. ....*\.\. * \ .\\.*.. .*\ .***#
#                      #..\ ..* . . ...   ...*\.....** .*.... ..\*  ** ....\*.*.*. \ \  . \* . . .   *..*   ..*.  .\.*.*... *\ * .* *.*.\.. ..*\  \. .* .     .\..\. * .......*#
#                       # . .*... *  \    *\ ..\  *\*....   .*\**.*.\\ ..*.*.**. .  . ..*..*....*\..\ ...\   \.\.  .\.*..***.*.* *...\*** \ *... ..* **\*   .**. *   * **. *.* #
#                       #*.  *\*. .* . . ..**..*\*...\**.* .\ *\..***  * . .*.**  *..*.**...  *\ *\.. . \.*  .\   ...\. . .* ..*.  .\ . *\..\. . *\**.. \ *.... .\  ** .. ...**#
#                        ##.**\.\ \..  .   *..* ..\ ***...  ... . **. \.. \.....\.. \* *..**. .*  . \.   .*..*. .\ *. .\*\ .  ..****\**. **\ ..\*.*.*. ..      *.  ..*\. * ..*.#
#                          ###...   *... . *.\.\. .*.*  *   .*\. **\  .  \.*.*\.**. .. ..*.\ . .\.  ..**... .** . ***\ .\... ...*.\. .* *\. .  .. *.*\ . .\ .. ..\ .* * \.*\.. #
#                           #.\* ##**.\.. *..\\. * **..*.\\*.*  \**. . ...*. ** *\*.  \.***  \*.   \..**\. \*..*. *...  .*  .*\ ***.\ *  . .\  . .\ .. \ ....* * .\ . **.\ .. .#
#                          ##...* *.. ** *.. * \ . ..* .** * *  . \ .*. . .\..\ .*\  .*\ ..\*...    * *.....*... **\  .\ .. ..* *.. * ...  \..\..\ ***.*  .*.. *...*  .... *  *#
#                         #... .* *. *.. **.\. .**.\ * \.. . \ *.. . . \   ..  .\ * \** ..\**.\. . . .*..\.***.\ *.. \ . *\.\.. . ..*..  .*   .\...\.\.*..**\*... .. .  ***.   #
#                          #.*. ####. *\..* *.  ..* *  \ .  \.* *..   ***.* \ *. \*\... \.*.\\  .\.*. .*.. . .*..* *\ .. \. .\\.\  *. .* .   *.. *..* \.*\.  **\*    \  .*..*\ #
#                           #\.\.#.*\*.\*..  ..\\*........* . .\.*...\.*.\.*.**.. . ..*... .  .\ ...*.*.. .  **.   .... *.\*  .\** ...**\ .... ....\. .*.*.\ ...\****.**.*.. . #
#                            #* *  .*#**..\\    \    \ .\*. *  \ .\\..\***.. .\*.  ** .  *..  .**...\.    *.\* .  \*. **.  ..\***.\ .\.\* .  *  ...* .. ..*.\.  *..\.*.\..***\.#
#                             #*##*\##\#\  ..* * .\*...  \.\.\*.  .*.\*.*..  ...*.\.\ . *..\.*... ...\.. ....* **  ...*.**\.*\...**. .* **\ .*\ .. .* * .\..*\ \. .. .*. . .* .#
#                              #  # # #. ..\*.  \.*.*.*.*.*..** *. .**. * .. \*.*     .*\... . .   \ .\  * **. .\..*\\. ....\* \...*...*..\**\.  \*   * \.. ..  ..*\...   . *  #
#                                  #  #\.    \...\.***.*.. **.\ .\.* .. .  . . .*..\***...**. . ..\\   *.. .*.. ..*...*\     . .\.. . \.   \******. \..\.  ..*\**\. ....   ..  #
#                                      #..\ *..* . *\**.  *.. . .\*.*  . . *  .*\ \ *...*.*.*\.*.\  .*\ \\*.**\.....\.*..***\   .**  .* .\*.***..*\*.*.* .. \.* *  .* *.    . .#
#                                      #.* #..#**.*.**\ .  . ** . *...\ .\.\ \.**...\* ..*. ..***.  ....* . .. *\*.. .*\***.  *.\...  ..\*..*...\.\* \\   .. *...**..   ...*#*.#
#                                       #*## \\ ..*. ...\. . .   .  .**\.*.*.*...  .\*\.\ *  \ \.* . *.*..   ..\.. . . *. *.*.   * \.\ ..\***.. ...... ..   .\ . ..  *.  **.\ ##
#                                       #.# \. #  . ...  .*.. .   .. \.* .. .. ...\\*** .....*.. ...\ ..\  *.\\*.* \   .* \ .**  ... ...\.\\. *  \ . \ \\\*\..\\ \.**.\ * .*#..#
#                                       #*##.. .*.. \.\ .*\*.*  .. \ *.. **.\ ..\*.*.\*\.  ... . *. *\*.. . .*..\*   ...* ..... *\ *    .\ *. \*.\.\ .**.. ** *. ...**..**\.#\ #
#                                        ##...  #*\.** *  .* . **.   .. . ...\*  .*\**..*..\ \ *... *..\.\*\ \.**.*   \.* ...\\ \ \. ...*.*.*..   .*.\*..  .. **  .  \.\#**\.*\#
#                                          # \*\.\\*....  .... .\.\. * . \.*.*\\ .* *\.** .....\.**  *   \.. .\.... .\  . .**.\. *.*\ *.**... .. * * .*\. \ * .\ .\ ..\*.\..\#*#
#                                          # #*# . *\**.* *.*\*...\ **. **.. . .. *.. **..\\.  . .  \*. *.\*.\*.  * . ** .\*...  ...\ . *.\*.*..**\.  .* \....\.#*..*  ...\.* .#
#                                          #..### .\*.**..*.  * ...\.*  . *  .\ ..\.\*.\ \ .  .  *.\. \.\ . \ .*. ..\*.**.*. .. *..\ .    .***.... . **.\ ... .\.***## \.* \.  #
#                                           # ..\.*...*.\* . *.***...*\ . . .** ....**.*. \  \***** *  *.*.*  *\...*.*  ..*.  ..\   *\.\.\***.*..* .....  .\*..* \ * \ .*#\ *###
#                                          #. *.   *\ \. * ... .*.* ..*   . * **... *.\*  \.  ...*..*.  . .. \..\**....* **.. *.  ..*.*. .**\\.  .   \ .*.*.**. \.*.*# \.#* .#\#
#                                           ###**..#.\. .. .\   \*.  **  ..**\..*.**.* . * \.\.. \.*\ .* \  ..\.  \   ....**. * \.   ***\ .\. . .* **.*.\*.\..*. ** ..*.##*.*\.#
#                                              #*#.. . *  *   * .**** .\. *.. ..*.*..*  ..\..      .**.*.  .. *. *  ....*\*.   . ..\  *..\ . *\ ** \*.\  .*\  .*.\    .. #####\#
#                                               # #\ \*.*.# . \  *.\\. .*\. *\..  .*\.**. .*\   . **.. .*\. .**.*.\*.  ..***\. .* ..\.  .. .... .\. ..*  *\. \ .\##.## ##     ##
#                                              #  #   # . .*.. **\ ..**   .\. **.*. \ .. ...**.\\..\. \... .**..\ .. .* *.\** ... .*.  \ \\ ***\*..\ \ ... \ .. #  #  #        #
#                                              #.** . . .*.*...#\.*.\ .\*   *\...*   *\*..*\* .* . \*..\.\. .....\.   \.\*.*.*\***.*...   \  ..**..*..* \.*..###               #
#                                               ###*##\.#.\.\.\#* ....*.   ..  \*.\. \**..\.\\ .....*.*..*. . ..  . .**\.....\.\*..*.   . . *.\..\...*. .#.#\..#               #
#                                                  # # # #. *\.*.\ .\ .*.*\ . *.\**  .**.\.... . .* **.\...\  *. * ....   \..*\.\* . . . \ *.\*  .* \ *\......* #              #
#                                                     #  # .\####.*\*\ * .*  * .       \. .\*.*...\.*.*. . .. ......*.  *. . *\...*.\     .* ..\  .\.#.. \.#\*#*#              #
#                                                         #*#..*.\.\.*\..  .*.*  .* . *. .. \*. *.* ..\.\*  . * . **.*\     .\.  ... .\..  .. *  .* ..*#\ # #.##               #
#                                                         #.# . ##* ..** *.....** .*\**.**.* \ ...*.\**...\ *..* .*\ **.** \..*.\** \ .\*** *.. \.*.#\ *#\# # #                #
################################################################################################################################################################################