######################
#. .\ .\.\*  *.  \.  #
#...***..**  .\\*\. .#
#**\*..*.** **  . .. #
#.**. .. . .......   #
#  ...\*.\ . .* *. **#
#*. .  . ..\ .   \*..#
#...*  \ .. ..*..... #
#.\ \*\...* * .  **\\#
#.. *\.... \\. \ * *.#
#  ...\    .. *.*..*\#
#.. *\* . . ..* .  ..#
# **\ \..\ . ..\.**.\#
#...*.*. **. . . ....#
#\ \* .. ..*\*.**\  *#
#.* **..  ....**  **.#
#*. .*.\****\ ... ..*#
#*\ .\*.\ **... . .. #
# *. ..... . ... *.\ #
# ****\  \ .\.  **.*.#
# ..*..  ....R. . \. #
#** * ***.*.\..  . . #
#*\.* \*.\..\ .  **..#
#. .**...\* *.*\ . .\#
# ...   *.\.. \  * * #
#.**..*\.. \\... ..* #
# ..\ *\  .... ... ..#
# \.. .*   . *  \* . #
# .*.****.\* **  .  .#
#* *\...\ .. .\.  \*.#
#. .. *..*.**  *.\.*.#
#.  \.* ......*. .**.#
#.. ...  \..\... .* .#
# * * .* . . *. .*.\ #
# *.\ .. \ . ** **..\#
#..* *. .. *.   .*   #
#**\*.*. .\ \.\  . \*#
#..*.\ \.   . *\ *.\.#
#\*\ .*.*..   .* ...*#
#*.. *.*..* ..\ \*..\#
#..\****. *. *. .\  .#
#.\.*....... ..**. * #
#\\ ***\ *.\* *.. .* #
# * .*\ . *.* .*.\.. #
#...* *..\***..  . ..#
#. \.\*\# .\..**\ *#\#
#\.. ...#\  *... ##**#
#**. *\##.** .#... ###
##* ..**#.*..  #**.# #
#*\  \.\*.##**##.#\.L#
###*\. .  *### #.*## #
#  #. ##.##    # #   #
#   ## # #      #    #
######################