###############################################################################################
#. .  **.*..\.*\. **.   .* .***\.*...  ..  ****...*.*.  . .**.*\* .  *.  . \**. ..\* * .  ...*#
#. \ \. ....*\..* \.* *. \.*\*  .. \.\... ..*..\ *\.. * * **  . .*.\*\\*\....*\** .....\\ ..\.#
#.*. .  \*\ . * *\.*... . *. . * *\* ...***\\.  ..* **\ . .. * * *  ....**.. ..*.  . * \*.* **#
#*.*  *\.  .  ..  .* .\ * * *\..* ..*.\ ..*..*...\. .. .*. .  *. ..  *..*\ \\. . *\...*..** . #
#* ****.***\.. * . *. *\*.. \ *.* .\ .* *\\..\* .. .*   *  . \ .  *  ...*... * *.   .*\.\.....#
#\*\  ..\. .* **  *......*\ *  \..***.  ****.* .  .    *.  *.* *.*.\ * ..** ..** *.\* \..\.**\#
# *..\.*.**.. .....\*  .**.  *..\*\ .  .*..**. \  . ***.. **    .* .** .  . \*..  .. . *. \.  #
# * .... .*..   .\. .. *. \.\..*...\.***.* ..\.\.  .\ .. * \* .\ \* ... . . .*.. \...\ *...  .#
#.*.*.   *.* *.   .\ ....  .* .   .* .\.....\  ..\  ..\ .* .. ***  .*.\ ... \.**..*.\. .  \  \#
#.... \\*..* . .*  *. *. ...*\   \..**. *. **.\ ... ..  *. *. *.\   *. ...\  .*.\ . **.  .\.. #
#  .*..... * \.*\  **.\.\*\*.*\  *\.** ..\ .*.  . .** *. *..\*.\*.\ \. **  ..*.*.\.**.\  *. *\#
#.  \ * ..** .\..* .*.*\..**....... . *** .\.*..   .* .\. * \. * .** .\.. . .. .....**   .**\\#
#\ *.*\.**\ *.... . *.. .  ..**.*\.   . . *....*  \*.\..  .*..*.. .\\   ***\*.*.* \ **\   ...*#
#*. ***.* . . **   ..  *. .. ...***. . *..\.\.. *.*.*.\. .**\. *\.\   * \**.. ..* \. ... **\\.#
# **..\  \. .*.. .* . . . .**\*...*.\ .....* ...... .***\*...*\...*. ** ....  ..**.. .*\*..\ *#
#*.* **  .. ..*.. .* ***  .\*.\  .*\.*..\. .    .*.  *....   \. \\ * *\...*\ **\..   *. ***  *#
#* . **..  \.....  . ..*..*.*..  \ ...\   .. **.   *\.*.\ ..*. *.**..\.*. .*.\.*..\*\.\ ..*\*.#
#\**  . .. ...**\.\  .*. .  .\\...  **..*\* ..*...\ .*. ***..  *.\..*  \.\*.* ..  .\...  .*..\#
# *. .*...\.  .... .. ...\.* .\.\. .\. .* **.  *\\.  ..*..*\ \ *.  .* \   \*\.*  *  * ..  .   #
# ...\...*** \. *\.*.*. ...*  *   **.\ .*\* . \. . .\.**\ **  .\ *  ... . \. .  **\ *.\.\*\. .#
#*\    \..** .. .*..\..** ..*\.\. .\\.* *......* \.**.\*..   *...*...\.  *..  *\.*.\\.**.*   .#
#.. \*.** .*  *..  .*\.*\. *......   .\. \.\   .\..\.... ...**.*\.**\ .  .*. *.  .\.\*..\.* .*#
# .\..\.\.*.\....   ..  .**..* **\.. .*. . *\**\.\* * .. **  .*** .\.  .*... ***  * . . ..*  .#
# \.**..  .. \*.* . .* * *. .*.\ . ....\ *\.  ...\. ..\ \  **. . ... .* . .. * .  .  *\ **. *\#
#.**.. *\.*\\**.. *\ **.... **..* .... .***\**    *.*..*. ..*\.\ \  * \   \ ..*\ .  * \* *....#
#.. *.*.*. ** ..  *  .\ .\* . * * \.*. *.*..**** ****.* *. **. .* *..\*.*\. .  \..\**\ . \**\ #
#.  .** .*.... . * ..* \... * \ . *\   .**. ..** *\ .*.**...*\**....  \*\*  \ *  .   *\ ..** \#
#\*..*.* . .. .. ..\ . ..*.* .* \*\* *\.\...\ .* ..*\. \.   ...* *.\.\.. .*..*... ..\.\.  .\..#
# \  *.*  ..  *.  .. \.  \.* ..  .. \...*.  .  .. * . \ * \  . * ....* **\\*. \ ....  .   *. .#
#*.. ... . .*** ..*\..* \.*.*.\.**. ..  .*** . \ ..* . .* .***.. * . *\.. \.\  .. **.     *   #
#\ \\ ***.   .\*..*   \.. . . .*..\. * *...\ \. . ...\..\ .* .  \ \**..*.**\. **... \\*.... . #
#...\.. *\* \ \**... \ * **.. *..* . . \. . \... .. **.\ * \\*.\.....\..*.\.. .*. \  *.\  .\**#
# .. .* .*.\ \.\.*.\  **\.. .*.*  .. . *.**\....*.\ ....  .. ..*.* . *...  * \ \...\ . .\ .  .#
#\... \.... ..     .*.*.* .\..\  .*.\\*.\..\.\ \..   .**  . .\*. ..*...\  .*..\..* .\   .  \..#
# . ...*\ \ ** . .*\*\ .\.. *. * \.**\*. *\* ...* *. ..* *  * .. * \..*.*  *\.*.\  *. **.    .#
# .* * \ *.. *    . .... * .. .**. .*\..\..* \.. *.**.\  **.. \ *.\. .. .. .**. . .\  .*. .*. #
#*.. . .*..* * ****   ..... .\ . *.\.**\**.*\ ..*.\. . ..*.* *.\. .   \.\ \ .**  . . *\**\. .\#
#.*  ...*...\  ...\*....\ \..**.....\.. **.\ * *.  .\..*\*\.\.****  \... .  ..**.  . ...** .\.#
#.... \ \***** *  *..*\..** \ ..\. . *.**.  . ..* *.....*.* .\*...* .   \ **  .\.. .**..\.  . #
#  ..   ...**.. * .*** .\..  ...  ** .. ** *..*...*.\.* *   *. ..**.  .\ ..*    ... .  \  .** #
#.** ...  . *\*..  .*. ** * ..**..*..*. ... **.\.*.   .\*    * * \\ *.\ \. . .**\. \... . **..#
# .*.*.. * *\.*.. *..*\*. ..* \ \ ....  ... ... ..*. *.*.  .** .*\.\..**.  .*\*.\ * .*   *\. *#
# \..\   *  ..... .*...* .  .*.. *\ *. .\ *.** .*.\\.\.\.**\..*.*. \* \*. . * . . .  .*  .***.#
#\..\.  .. * .**   .*. .*..  \.. .**\ \**\**.*\ . *...\.*. .*\. * .*.*\...\.. .*. . *...\.*.*.#
#.  *.*  .\.**\. .  .\  . .  .   .**..\**. . .*\.\. .. *.*....*.** ....*\.*. *..  \.*..*. *  .#
# .*. \   .* ...**..\*\ ..* .*  * .  *..\.\* *... ...\.*.* \....\.\.*\ .* * *.... ..\..* \*.* #
# **\. *..\  \. *....** .\\ .. *\ \ *.**.  .. ..\ *\*..\**.. .* *\  . * ...\*..  . **\*  . \..#
# .\*\ .*..\*  ..*  .\..*.*\. \.* .  ...  *  ..*....**  *. .. ***. ..\** \*..*. \* ..*...**. .#
#* .*  *\.**..   .. \  * * .\\ *.  ..*.*...**. .* ...\. . ..* ..\ \*. ..  \\\ * ...**..\  . ..#
#*  ...\ *\. ...\. .\. . *\..  *\...***. **.\..*..\*\. ..\.  .. ...*.   \. .\. * .\*. *. .    #
#**.**. *   *\.\  . .***. .\*\\.*. \..*\*\..  *.\.* . .*** \ ****...*\*. . .   . .*.\\..\  \* #
#.\ *.**.   \..\ *\ .\. .  *. \*.  . .**. * .*.*. *  .\ ..*. . .*.. .*.** *\  ** *\  \  .**.* #
#.**.\..\. \ ..*.*. * .   **\    \..**.. .. ..\. .***. . \..   *  . * * \\..  \.*\. .. . .*.*\#
#. **.*. \*.. .\..* .. .**....*...* *.   *..  . \.* *\*.\ .**.**   *.*\  .. **.*\. .*..****.. #
#\....**..  ..\. ..  .  .***..**.*..*\ *..\. *. . *\ ..*   ..\ .. .\.. . \* *.... ******.*\.. #
#. . \ .*.** \. .\ .*.\*..   ... .  ***..\.\\.*.. .. *\.\.  *.*.*..* . *\*.  . \ .\..\. .**.. #
#.. **  . \.\..** \...  *..*  .  *  ..*.\..** ...*.\ *. .*\  *\... .\. . .\  *\\.****\. *\.   #
#..*\**  .*.* ...\..\.. \  .... * \***. .. \..\*\**... *.\.....*\*...*\. .**.\**.\.\\ .*.\ .**#
#... *\. .*.*.\*. .*    *.   ..\. *...* ***.  *\.**\** .  \**\ . ..\.\ **\*\. *.. *\.\*\*.  . #
#*\*.* *. ...*.*.\ .  **...**\  .\** .. .....* .*.**\. ... .*...*\. \*...*.**\. ... ... .\.  .#
#.. \ .\ . . ... *.  *\.\\ ..*\**...\*  **.*.\.\ *..*   . \   ..\.*  .\  ...*..\.. **. \..  * #
#  *.\   **\.*.   *...  .. \....\*. \*\ .*\.\ *\  \*  ...*  . .\.*.    ..** .**..... .\ .\. * #
#\.\.*\*\..* *.. .*..\.*.   .*   \ *\*  \.....\* .\.. .  .* \\  *. ... **...\.*\ *\.** .*  .\ #
#. **...* *. .*\.*.****..\.* .\*.*** . \***.**.*. .    *..*\ .* * .  .\.. . . \ ...\.\ \*\\ *.#
#\ *.. .  . ..   . . ..\*.\.* .. ***.*. *   *...**.. * .. *.*  .\\. .\.\ .  .* ** .....*..... #
#... **..* .*   **.  ...*. ..\ \*..  *.. ** **\.\.     .\\**. ** .\.\.. .\. *\...** .**.. \* *#
# .\ * . *\.. ....*. *...***  *\.** **\ ***. *. .  **. *** *\*.*  .\ \. ...... \**..\ .* *..*\#
#\ **.\  ... *\*  * .. . .**\*.\ *.**...\*.  .   *\\.* . .\  * .*   ...   *\..***\.*.* . . *\ #
#  ..   ***...* .* \* .*. ..***.**  .*\\.*  . * .\.* .* ...*.** .\*. . .... . .\ .*.**.\. * \.#
#*. * . * .  ..*.*... .* .  .\\. .\ .\.*\* . ..\ .  * . *  * ..  .  .*. .*\   .  \**.*. .. \  #
#.  * **\ . . \....* . .\ ...*\*. *.\..\ . . **\* .\...**  *\.  . ..*  .\* ..* .*. *\.*\..*. *#
#.\   **...\*  *.* *  **. . *.*. ** .\*.* .\ ** .. .*\**..**.. * .\ \.*\ \ \.\.. *..  .** .* *#
#\ .  .*.. ...\... ..... .  * \. .\* *...... .. . .\..*.* .\\*.*  . .\.. .. . .\....\....*\ \*#
#.*.*.. .\ * * .*. \* **.\..* \.\  ...\\ .  .**..  .. .\.*..  .. *.\ .* *\. .**.\****.*\* *  .#
#.*\ ..\..\* .  ***\. .....     *\.....*  ..\. . *  .\** \ *.. \....\ .*.*  **\ **.*. .\..  .\#
# **  *\ ..  \ ..*.**.* .*.. .**. .  .... .*\*   . *.\*.* \.  \.\**  ..*\..  . ...** *    .\..#
#.*\. *. \ *   .\.*.. \ ..\  .\*.*\ .***.* .   \.* ..*.*. . .*.* .  .. .* *\\.\.  .. \*.* .***#
#\..\ \. **.*.\*.*.*.*.\.* .   .*. .* *. .*.. *  .\ . .. .. ..\.*R...\.\***.. . ..\*..\.** ..*#
#\.* \.*.\.\*..*.\ ... .  **** \  . . **..* * . . .***\* .  *... .\... .\    *. *\*   *** .. .#
#  ** \.*\. *.*.  ...*\ ... *  * . ...\*\. .\....\ .\ ..   .. . ..**\ *\*..  *.\.*.*.... .*\. #
# ... * ..\ ..\. . . . ..* .\.\*.\.\.*. .\  .. \.*. .*.*.. .  * .\.*.* .*.  . . ..*.*. *. * *.#
# . \.** \.*\..\. \. .*.*..*.\  .. *.**. *.\ .. **\**...*.\*.   \  . *  *\ .   .\ . ..*.\ \ . #
#\   ..   * *\ *...  \*.. **. *  . * .\  \* ..\ **..* *  ..\.*\** . .* ..  .\ * * \..  \* . ..#
#...* *...*..\... .*... .\  .\** .* .*\..**. \**.*....*.\ \.\ *..* ***   . .. . . . **\ ***.*.#
#  ....\  .\ *\ \.\** *  **   ..**..\.*\.. **..**\..* .*...  .  *.  **\.. ..\ *. .*  . .\.*\..#
#*. *  *.\*.*.. ...*.*\...* *.\..**  \..*\. .\... .\*... .*..*  . \ *...***  *\..\. .*.\. .. .#
#*. . ** \... . .* .\* ...\**.. *  \.*\  . ..\.......*  .* \ . \. .\.** . \* *** .\ * ..**..\ #
#\\*. *.. ** *. *  .  *\. ...*  . .* . **. . ..  .  ..\. .  .. .. ...\..\ .   ..  . *  ... .. #
#. . ..\.  *\... .*.* \ ..\ .*\ \ .*\. *.**. .* . *.    *\.*.*.. **\**  .\ **.. .   \.** .* ..#
# .*\.  *. *.** . *** .   * **.****\.*.  .*....  .*\ . *.* **. \\....* .. .\.\* \  .. ..  **. #
# \.. . ...**.*.*.*.* .** .*.  *..\*\.  ..*.  .*\  ***...* .*.*.\ .. *. \\** *.   \**  . .... #
#*\ ..... *\.*..* **   .*. . . . * .* .\  ** ****. **\ ..*  .. .* .*. .* .*. .\... *..*.. *. *#
# *.\ .\..\*.. *.*.\ .. ..\\.\   .\. . .....\. \*.*...*\.* ***.\ **.***\..*.  **.. .* .*.*....#
#..*\ *..*..*. ...\ *\. ... \\... *.* . *.**. *.  .*.*.* * .   ..*. .  ...\*  **.. *.\..*. *\*#
#\*..  ..\  ..* *.*.. .  \ ..** \* ... ..\ .*. \ . ..*.. . . .   .\  ** \  * ..\**** **\ *. .\#
#.\.\**.*.*.     \.\*\* \.   .*\...\*\ *..\.**\.\..**. .*.**  *.* .  .***\  ..****\. ..**. .  #
#*.\*....*.\ .*...* .. \. *..*..   .\*.. ** ***. * . ..*.*  **.*.  ..  .\  * ..\*\. .***.*\   #
#*...\.\\..  **.\.   \\..\* \... .* .**..\. . .*\***.. ..*.. .\* . .*  *.  .*  ....*.*\.*. *\*#
#.\ \ . ** ....*.. ... \**\. ..\ .. . \*..\ .. . *..*  . *. * . .* *.. **.. ..\  *\...*\. *\.*#
#\ ...\* .\\ \   *.*.\.  *. \ .**\* ...* *.* . **.*.\. \.  .* .* . *.* ..\\**   *..\***.. ...\#
#*\. * \* .\ . .**..  * *.  .\  *.**   ..* .  .*...** ..\*. * *.\*\\*\ \\ \*..*.**.\*.. .  \. #
#..*.\* .   . .*.\ * \..\.*  .... *.... ..*. . *.*\*  .. ** . * .**\**\.\. ..** .*\*.*.*.\ .\ #
#  \..\.  . .*    . .***\.* *\**\ .* *\*\* .* . ..*..\*\ ***\ *  .....\.\*\ *.. *.*. .... .** #
#.*  **. .*..* .\*..***.* .*.. \. *...\. ....*  \.\.** **.....*.  . .. *....**. \*. *. **.. \*#
#.*\ .. \...*.  ***\**\ .  .. *  .. *\ .\ *.   .\. *..**....\\*  *.\.* *..  *..\... .** .\  . #
#\. \..\ \.\**. .*. * **..*  .. ..*...\....\**.\.* .\* .* ..*..*...**\  . . .\ .**\  *..  *\  #
# .. \ **  .\\....*. ..*..*   .* ..* *..\* ..** ....*.*\...*\.\* .*\* ....\ .*\ *.*. .\\\.\  .#
#  *. ..... .*.. ...\ *\. * *\.** .*\.* ..\*...*\*.*... .*.\.*\** .*..*\.  . ...\*. *  \* .  *#
#. ..*   * ..... .*  **.* .*. . ** *. .\* .\  *. ...**..***\ *\...   ...  .*  . . .*\* ...  *.#
#*. . *  *  . *\ .. .*..*  .   ...*... . .* **  **.\...** .*.* \\.\*. \* \.. .**.. .***  .....#
#...  . *. .  ** \.* .  . ..\.\.* ...**.  ..*.  \.*  *\ .\ .*\*\.*.*. .*...* \.\*.. *...* *\.*#
#**\.\  ..  *  .. *.\.\ . **   \.\. ...\...\.   ..* ....*.*.**.* .\.* ...\..*. *.. \\  .* \ .\#
#.\.\.*\ * **.  \..**   *\*..  *\   .  *\* .... ..* *. ....*\* ..**.* .. *.... **  .. **... ..#
#.. \.  ** ..*. \.\..  .. *.*  *. ..  \*..   \\*..*.\*..\.* \* .*...*. .\.***\*.* * \..\ * **.#
#\* .* .*  **. ...    .  .. * *.* ****.\\  ... .\.*. .***** ....* * . .\.***. .  \. *.  .***.\#
#..\..\*\  ..*\ .  ..  .* *.. ..**\.....\\ * .  ... *.\\ .\*  * *\..* \.  *...**..  .***\*...*#
#*  .  \   .\. .\ ..**\\.\.... . *** ..\.* **. **  *.  . * * ..*.* .\ *  \.\. \. **\.    ...\*#
#...\  \    * * ** \\ . *. .. . *\.* ** .. .\ **\. ....\*. ** *  .  *** \.\..  . *\ **\\.. *..#
#\.**  . *....** .*.. ....*  \ .\.\. ...  .*. ..\*. *.\ \. \..\*\.\. .. .*   **  ..*\... * .\.#
#. \.\ * **. .*\.*\..\ ...\..\  * ..\*. .\.  . . .\ ..** *.  *.. * \  .*\..\ ..\. * ***\ ..*. #
#*. ** .*\.   .  ...* .*\ .*\**. .\ .*. *.. ..\ \*.* .\* *..\* .     .\..*\    . .** ...  .*. #
#.* ****.\\*\ \* .\.* **\. * ....**. \... * .\ *...\\  . ...**   .***  .\ .*   .  *...     *..#
#*. *.\*\.*.*.* *  .. .* \...\*\  \\ .  \ . . ..* ..\.  *......  ...\**** *.* .\ \..  * .\.\.\#
#......*. .*.\ .. *   *\. . **. \   * .  ***.\ \..\..\ .*. . **.  \* *..\ ...* .*. . *. *. .**#
# *. .\..  .\*..**.\.\*   \*... . *.. *.*....   *   \ *....  .. \ \.  . ... *.\. * *...*..\ .\#
#.\ *  .*..  .. .\.*\ *..*..   . .** \..*\..*\ .\\* ..* . . **.\..    \* .....*. ..*.\ ..  .*.#
#**.   *.   *.*.\. . **.*  ..***.**..  \.*  \.*\ *.\* . * \*** .*. \...    *. \ \*..    **  ..#
#**.. *. *.*..* *.   *  ... \. * *\  .\..  .*  ..\ .* .*.   \ *.*.\*\.. *.*..*\\.... .\.*. *\*#
#**.. .\ .\* *\  .*.\. ...* ..*.\*\\. .... . \.  .  . . \.\\..* *..*.\*.\ \.... . ..** ..\... #
#*.  . * \*..\ *.\...*.. .*\. ...** \.*.\..** *\ .. \.*. .    .\ .*.  .* ..  *..\ . ..\**.*\  #
# . *. . ... . \  .\ *. \....\.*    ...**  . *.*.*.* * *\.\* \\.  .. * *\ . .\. ..\   **   . *#
#.  . ... .... .\**. .\ ..*\ *  .* .**.***  \*** .\.*\..* .*\ .. \**.* . ..* .    .\ **..\*.. #
#..*  *..*.... ....   *.. .**.\ *..\.\.*.*.. *\.****.* ... \  \*\... .*  ..*. *.. .*\.. .  . .#
#**\* ..\. . .. *..*\.\*\ *\.. \.*\.* *.... \.*\**.**.  *. . *..    .**. \.....* \   .\  \. ..#
#.\.**.. \. .*\*\.**. .*.\. .**  .. ...**..*\...\. .* ***\* *. .. ****** .\**..* ..*. . *..* *#
# *\*..\ ... ... \* . *. *\***.\* * .*.\ \ .*\... . .*\.\*.... \*\**..*.\. *.*... *\.\*.....*.#
#\*****.  .  *..   ..\..*. *..\.\ *\* **\. \. . \***.. *..      .*.\*  .\* *** ** . * ...*.*. #
#*.. \*.*.*  *..**** ..... .\\ *. *     ..*\ .  ..\  .*. \* . .. ...\   \\ .*. . .  . .*\**.* #
# *\.*.\.  * . **\...\\* \  . *\  .**.* .*\ \*.  * .**\ .\.\.*\. *\*.**. \.  *. . .*\* .  ..  #
# ....*  .*..  .. \ \  * ...\\*  ....\. **.\...  ** .*  \  * **  ...*.** \  *..\ .....\ .  \.*#
#\ **.. . ..*. \** ...** *...*.\..** . ...\* *   .\ ..\ . .. *. *.. .\*. ..*. ... *\  ..*. ..\#
#  ... \*\.\* . ..**.\\.\.\*.  .*..... .*...... ..*....    **. .**\*\.*   \\*  ..*..***..   **#
#.. *  ...**.\ .\.\** \  * \\**\*.....*.*.\ .\ *. \* *   \.\**  .** * * .\.*.. \ **\. .*..\ *\#
#.. \*... .\ .   *.......\.*\..  \...*... *. . . \ \ **..  .****..  . .\.* *.. .\..   ...  *. #
# .*..\. **.*... .\.\  \.  ... .*..* . **..***  \....\.. ..\.  **\ ..*...  ..**.*** .* * *\ ..#
#**..*..\ *.. .  ..\...**.*..\  .* ..  .  *....... \\.\ \. ..\ *..\*..   .    ..\  ..\**. *   #
#\*. *. \** *.*  .*..*\..*. \..\..\*.\  * \   ..\....**.. \**.*\.. .*  .\*. . .*  \***.. ..\.*#
# \.   ..\. . .   *.*.*. .. .\* \.*.*.  . .\*  \   * *.*   *.\...*..** ***  .**\  .*\*.\ *\ .*#
# . *.  * .*.** **  .   ..*\. ..\.* . . . *\. ..*.\. \.. **.....\ \*\ ....**.. *.  **\\*  *.*.#
#\*..\ \\ ....\ . .  .......\ . .\. \  **.*. \. ..*\.   .***\ \..  .  . \..\..*.*.\ *.\...* . #
#*.*..\*\.*.*..**.\\.    .\.  *\ . *   .****..... * . .\...*....*.  **\*.**...\..\ *..  ..*.\.#
#\*..\  \ *.* .\*  .*.. ..*  \*** * .  \....*\   .   *... ...* \..**.. . .\\**.*.. *.**\ ....*#
#. ...  \...*.***  *..  ..*   .. .**.\. .*\.\.\  *\.\*.. .* *\..*. * ....*..\*     **\....   \#
# .* ..*.... ***...*..\ *\...*  **\.. . .***.  *.**\..* *.*.#*.\ *\*. .. . . .\ *.*.\ . *\ **.#
#  **. *.****** \**. ..   ** *.*.\.. **. *.. .. .. * .. ....\.. .. . .\ ..* \ .  .**  ..** \..#
# \.\*...*..\\. .    ** *.\**.....\ *. **.* . \. ***   .\*\ **\.\   * .*.\*..*.   *\    *.\. \#
#\ \.**. \ \ . .  .  *   ...*\   .  ..... .. .\ ....\*.* . *... ..\*. .\. \*   .**.**..*\  .. #
#** *\ ..   ..\. **...   \*. .. ..\\*. **.*\...#* . .  \  .* #...*..*.  . .* . **. .\ \.  .*. #
#..\.* \..\. *.**. * ...... .  * ***  *.* . *.*....*  * .*.\ ..  .. .*****  .  **.**  .*  *.* #
#  **   . .  . **  . * ..**\*\..*.**  ...  ..\**.  ..**. \.  *\  ** .\ \....\ ..#\..  ..**. .\#
#.\ *  .\*. .  .**.\ *\ \.\.. . *\...\.\  \*\..**\**..\.* .*..*. **\\..... \ *\\**. *#* *\.  *#
#.* . *\*.\\ .....*.*..*  .\ \**.. .*.*...*..\ **.*.... . **.  \ *.*.#.*\**. .#. * \ \#.#. * .#
#..#.\. *..*..**.\* ** .   .*.\ * * . *\.\*. .*..*##*  .\ ..\.*  .*..\ .*..*.*...\* .\#** .\ *#
#      \.\\*.*. .*. .\ ***  *. .. .  *  ..#..*#.*** * *..  \.#..  *.##.##. ..\ #.#   .***.##  #
# *  .* *..\*. . .**  *  . . .\  * . \  **\* \#..** \.*. \.## ### * # ###.  .** \ \ . ..*   #*#
#.\. **.* ...*.  .** .*.\\...*..**.\..\\.* \.#..\*. ## .###    #.*#\\##*.*#...* .   .*#\  \ # #
## \ ..*.*\.*.. .*.........\ *   . *\ *.*.\# *\.##*# #*   #     ## ## #\# .*.\. ## . .###*...*#
#*\# * \..  \. *. ..\  \ \ ##. #*.*.# \\.*.. * *.##   #..#             # #.###*.## ###  #*##\*#
#*.\#*\#. \* *\*. . .*. .##  # .*  *##...**\\# ##      ##                 #   # # #      # #.##
##  **.\ . *.. .\. .*#   #    ##.  # #\. ##* ##                                #            # #
#\.  . #  .\ ..***...\.*##     #.\*# #.*# #\#                                                 #
## ...*#.*#.  .*..\ ###\*\#     ##.#  #.#  #                                                  #
##\##.## .\\..*\\#.**.#.##        #   # #                                                     #
# # # *#\##\** .##\####*#              #                                                      #
#   #.\##  ## #\ #***# #                                                                      #
#   # #      L# # ###                                                                         #
#    #        #\#                                                                             #
###############################################################################################