######################################################################################################################################
#       #.#### \#*# ***.*.... *.\.........\. .  *.* *  ** ....*\*  \.*  \ .**..*.\.*. \*.  .\..**.*  . * \** .*\ \** \\ .*...  \ ..*.#
#      # ...\.....*.*   \.\*\ .\*  \.. \ ... * .\   . ..*\ .. ****  ..\... ..\\. **\ . .*..\...*.  *.\* * ..*... *.**\*. **... .. .. #
#     #  .* ..** *\.* *. \ .* \*.  ... .* *.    ** \*  .\  *  . .. *  .\.*\.\ *. *.\..  *  *. ...\..   ... \ *. .  .\ ..*. .*\*.\\. .#
#      ###.   \..\ ..*** * ** ..*\* **\ *\  * . .. ...*.**.\ \..\ ..    .  *.*  .\   .\ **\.*.* ..\* *.   ..\\* ... . ...* .*.*.\*.\ #
#     L##.\.  #.\*.*\**.** .*\**.*. \.. ...  * .*\ *    \*\*...\ **...\ ...\  .    \  .  \.\.. . . .\...  .*.... . . *.***\..*.  .*..#
#    #*******..  * ....\**. . . .* .. .** *. .**.  ...\. ......* .* \ .**  .  . \.*..*. ...* *.. \*.\ . .\..* * . * \.. \. \... *...*#
#     ###..*.\  *. *. ..... .**\.*..*  \.\.*\..*.\.\.\. \..*\. .  . .  *...\.*.. ..**.\.*.\. . \\... .* ** \... .*.\ .* .*  ..\*..** #
#     #.\* **  \. .\  *. .. .*..\ ***. ... .  .**.  .*\ .*\ . .\.* **  .*.\..*\   *.   .\*    . *. .*\. *..  *. *.\  \.  *\***.......#
#      ### *.   *.\.  .\. *\  ... . ..\... *  .... \. *\ . *\ .. . .**. *\.*  *\\..\.**  *\ \. *.\\ .*. *..\..\*..\.\.... ...*\.\  * #
#       #*.* . .. . **\ *. . .*  . ..... **..*.*.*  \.*.\ .. *  .. . \ *.  .\ *  \*  ...  ...\  .\  *. ** ..*\  .\.**.  . * \.. * \.\#
#       #... \  \. \\. *.\. .*.   .*  \....   \* .\  ... . \ . \.\  . .*  **...*...  ..    .\. *.....*...\\..*. .**\* .. *.*.*.....\ #
#        ###\#*  .*. . .. **....  *\. **.     * ...\..*. \****.. . *\ ...*..* *..*\.\\\*...  ..*  . **  ..  *\..\*. ..*..\   ...*.*. #
#         #*..*** \.. *.. .  .\. .. \.**. \**..\*. *..*.\ .\.\ ..  \.* **\ .* .  \..*  .* *.***\... ..* .* .* \ .. .  ..* **. ... \ *#
#         #** *#\*..\  *  . ..*  .\*...* \...\    .****.  * . . *....* .* \\. . *.\..\*.. .  .\*. \ *. . .\ .\  ..* .\..*.\.*. .*..\.#
#         ##  .\....*\\.  * \... .** **.\.  ...   ..*** \*.\    ..* \.. .. ** *.\**.. . \. *.**.... .*  .\***.  * . *. ** .* *. .\  .#
#        # *. \.*..\ .... .*..\    *** \\. .. .**\ ..*\*\   .* .* \...* *. .\ . * . * ...\.***... \ .* .*..\.*.*. *..\... ....  \ *.*#
#        ##....* *  \*. \  . \*..\. .*\..* ..**.\.   \.  .** * *. .*  .**.*  \  \  \.   .  . *.\\  .*.. *   ..\.* *  * ..\ ** .\..*.\#
#    # ##\.** \...** *.\.** .. *....**..\*\ *..*..\.\ ..\ ..\R.. .**.  .*** .....* .\.*.\.\  .*..\\...  **\.. ** **.*.  . . .   *.. .#
#   #*#.*  ..\. . *......*  *\\.*.... .*. **.\\. . * .* ... *\.\.\ .. .\*.*  *. .\...\*... .....\....*  ..* . .. .. ...\. .\. \ . .* #
#   #.\.***... ....   .*\.\*..    .\....* \*  *\ .**\..*...\  \ ...  ..  *\ ..**.  **.*.*\.*.. .*. *...\ **. .... ..  \**.* * .** .. #
#  #*#. .... \ ***..* ....* .  .\ **..*.. . .. ..\ .*  * * .\. \.* *..\ *  ..\.\ .\* .***\*..  .. \.***. ... * **  ..*.*..* ***\\ . \#
#  #.\ *  #. .\. . .*... ..*** *.\. * ..****   *.. *. *.*. *. \ .**\  * . *.**   *.. *.*. ....\ \ . ....*.  *.  \ .** .. \. ...  .**\#
#   #\. ..*. **..   .. *\.*  .\.  *..*..\.*.  *.* ...... .  . .\** * .*.\ . ..\ . \. . ..* \ . . ..\.  .. .**.**. *.. *...*\ . . *\*.#
#  ##* **.\ .*.\\*.* ..\ *.**.\ .  ..\* .***..*.*.* \.**\**\  . .*...\.\   . *.* ...  \.\. *.    *. .***  **...    .****\.\ **..*..* #
# # * .*.**. .*..\*...*.*\..\.. ..  * .... \* ..*... ***.\* **.*   * ** . *..*\..\ *.  .*      . ..  ...\. \ . .\*\ .\ * .*\ \. ..*\*#
# # . *.... .**\*.* . ..  *\*..  * *..*.\..\ .  . **. .**..\* . . .*\\.*\**.\... . .\.  **\. \.  ..\.\ .....*   *.*\... *.*  .\ * .  #
# #*  *\ **\\..*** *\  ..*\..*  .. .\\*\**\.***\ * *....*.. .....\...*. *\**\.\  * ..\* ... . .\.**.\..*\** ...  **..  \*..\ ...*...*#
##\  *\. \. . ...* .      ***.   \ \.\.*.. \..**   ** **.  .*.* .** *** .\*..\ ... ..*.\. . *..*  .**.. **.  *\*.. *\.*.*   .*   .  .#
# ### *...* .  ....  *\.   **\  .. * * .*.*.\.\.   *\\.*..\.* .. *...*.   *.*... *.  \* \.. .***.\ ..*  *\\ *....   \ ..*.*.*. *. \*.#
##.\.**\.\  *.. *.  *. .. ..**.*. .. ** ..\.  .   ..*.*.\*..  * .. *..  **. . .* .\ .*.* .* * .\ .. \..... ... ***. .. .......\.....\#
##***..... *\  . . * .*\   .*  . *.* ...*..**.**\*\*. \ *\* .*  . . ..  .* *\\..\*.  *\**** .*.. .   . *\.* *. *.\. . . * \ \ . \ *\.#
##*.*..\. **\.* *..* .  .*.\.**.\..\*\... \.. .*.* .. .\..*.\**.. ..\* *\   .* ....\ * .*.. *. *. **\  **  ...... \  ..*.  ... * *\.*#
##.\ ... ...**.** ..\\ *..\* *\ ..* *.. \ .** \. *\\\  *..*\\.****.. *.*.. \ ..*\ ..... .*.*. \. .*.*. .. *  \* \.......*.  .. * . *.#
### #...*.\#..*.\.\. . .\* .*.. \ .*\.. * ..**..\\* .\*.  ..\.\..*.. ....\*. ***..*  *\.\.*.  ..\.. . .** .*...\*\  \*\ ... *  *    .#
#   . \..\   *.\... *. ** ..\ *. *.* .\  .*...\ .... *....   \  \....   **.. *.. *. ...*. **\. . ...*. ..\ . .* \..*..\ \ .** \.\. \.#
###.. ..* \.  \. * ...*.*.    ....*.\.**. . .  \.  * \.\* .*\. .  \....*.\. \* **.    .** ....  *.**...*\*..\ *\..\\\.... **...**. .*#
#  # \. *  .* *\.*. ...\*. ..* **\.\...***.*  *..\ .****. \*. *. ..*.   .....  .\  \ ..*... . .* ..**\\ ** * .. \ . .*\.  .*.*.* * .\#
# #\...\*. ...*. \ *\ *..  **.* .. **  * .\***. .*  .*\ . *\*.. \ .* .*. \. * . * *.**\ .*.\  **\  .. **.... .*\ *  .\.  .*.\.\\***\ #
# #...\..  \.. \ . \**.*. .*.*.\  \*.  *\...*..\.  **.\  ..*.\  .*.*.*. ..*..**.. .*.*..**.... \.*\..*.* ...*\..*  **.\ \ .* *.* ** .#
#  # \. \....*\... .**.. .* .*.* .. ...* * *.*.*.\...   *****.*\ **  \* *\..\.\*  ***..\...\*.*. . \..\. * *.. .*..***. *....*\*.\\. #
#   ##.\....*. ..*. ..\ ..\* ...\*.  \* *..*....* * .*.* \ .. .  \* \  .*. \*. .  \ ..\\.*\.. .    .*.  ** . \ *.. *..  . . .. .\... #
#   #*.* \. .\.*\.. . \* \*.  ** .*. \*...** *\ * *    * *.*.. *\. *.\* \\. .... *\*\ ***.. \* \*\.*\  **. * ..*.\ \*.\*\ **\.. .*...#
######################################################################################################################################