#####
#.L##
#.R*#
#\.*#
#. .#
# .*#
# \.#
#\* #
#...#
#*.*#
#.**#
#...#
# **#
# \.#
#.*.#
#*\*#
#####