##########
##.** **##
#  *.\#\##
#\**   # #
#..   .# #
# .. *.# #
#.   ##  #
#**  # # #
#* ...#.##
#. *...\.#
#. \.*R###
#\.. .. ##
#\  **L# #
#* ##*#  #
##########