#############################################################################################################################################################################
#*..***...*.\* .   *  \ ...*.\..\. ..\** \\.\ \ *.\.\  *.\....**.*.\ .*.\\ ...**\*   ..  *.*.*.*.\ *\ *.\  .*\.\ . .\ *\ **.***.\**   ..  .. *  . . \ \#                    #
#*. .*\.. * \.\.* .**.* ....*  \  . ***.\   ........ ..\.... .\.  ** *\ **  * ....  *..*..**\. *. **.  *..**. ***\.....*.**.*. ....\*\   \.\**\..  \# *.#  ##               #
#..*** *\ ... .*.  \..\... \. ...*\...*..*  .\ .\*  .*..  .\   . *\. .*.*.. .*.  * .\ \.* .*   *\.\.   .. .*  ..*. .\...*.**.. * ..\. .\*..**.*   * . **###**#              #
#.\\.*\.*. .*  \.*. \ **  .. *. \..* *  \.\**\*. \.  ...\     . .** \*\*.. . ...\.*..  *. \. *\... *.     ..* ...\.**.\....*\**.*..*.*. ..*.. .*.*\ * #..*.\#               #
#*..\..*.. .\.*. . ..  .*\ *\.... \*   ...*.  .  * \..* ..  .. . . *...**\. **. . .. .*. .. \.  .*..\.*. **\\ .*.* ...*    .. . .\ *  ** *. \.*.**\ *. #\ .#                #
# \ . *.. *      *.*\.* . \..* .*.\ *\...* .*.. .\ .  .  .  .. .  ...\ *.. \.*.*\.. *.\ *  ..* .*.***\.\ *.**... ...\ ..*..* \*\.* *\..**  \.*. **. . *.* #                 #
#*.. .  . \ . .**.*\  . .\.. \.*****.\ * . \..**.  \*\.    .  .*.\ ... *.*.. *.*  \ .  \.*\**. *.**.\ .\....\  **.*.. **\*\.. ....*\    *\ . .. ..\..*#\*#                  #
###.  ..\.   \..\.*\ .\  *\. . .***\ *..* ... ..\...**.** .*.\ . \ *.*..\*. \*** *..** .**...* ..*.. .**. \... ..*..\. * *. \  \* .*.* ..   .  .* .  **. \##                #
#\*.*. *.*. *.*\*. .  .\ . .\.* .\.. . . . .\*.*.*.\ .**..\..*  . ....\ .. ....* .* .**...\ .\.. .    ..  .*\ **   \. \. .* * . .* *..* .  . \\*.    *.  ##*#               #
#*.**.*..\..\**.. . . ......... .***\\.. .\  .*. .. \*.\ * \.* **.*\.  \ . *..\...  ...*.\.*\... ..\*\* *\*\. .*\ *.    * \.\\ *.***.\.. ..\   *\*\.   \....#               #
#* .\..... ...\  * .****  ..*.*.*\..    * .   ..* \* \. .\.* .**. *...*..*.  \    .*\.   *\..  *. *\\..**.* . *\....* **   *.. . *...*\  *.*. ..*.* *.\.*.# ##              #
#\ \...* . \..   .\ \.....\ *.*\ ....* *.. ... *. .**...*...  .*.\. ..*  . .*.  .. . * . .*\..* ..* \ . *\.. *. .* *....  .\*..* ..*..*.. *.*...  *.* .* \##* # # ##        #
#....\** ....*  . \..*. \ .   .. *..*. .\ .     \.\.... .\ * * \\..*.*\.\***.  ..\ .*\*  .* ****.*\ .   .*\ .\.. \..**. .\. ..... \  .\...**.. *..... * * .\..##\#. #       #
#* *\ *** *  . . . *.\ \.\ \. \\*\ ..*  \ .*.. *  ......* . \. ...*. ...**.** .  \. * .  **\...*.* . ... .  . *..*\\..   .*\. *\\ .*\*    *.*.   **.. .*  \#**#..***#       #
#.\.. .\.*\*\  \*. .*.\*. *.\ . *.\\.\ *.*.\*  . *\.  **..\  . *.** ..*  ..*  . .*. \   ..*.\  ..\ *\ . *.  * ..* .***..*\..*.*.     \... \**.\. ..*\* . \...*.. *. .#      #
#   *   ..*. .\ **\ .  *. .\ .\*.  ..* . . ....* ..\. .. . \ * \..  ..*  * . \* \*\..  . \.***.\ *.**\ .\.\ .**. .**.. .*. ***.\ *.* . .*\.....\*..**.  . .*\# # .#\#       #
# . *  *\ . *\. *\ .... \.\ \ .*....*.*\ . \**\... .. .\. .. .. . \ \ ..  * * .\ ..  .\  . . .*  .* *\. * * .\.   *.*.  .\***\  .*...  .***.   ....* .\ *.  . .\.* .##      #
#*  .*.  *\.*** .. *   ..  * .  **. . .... .**.  .. \.**. . .   ****..**. .*.  . .* *.* * . .***.\*.*  ***..\*. ...\. **\.\.*    *.**.....\  \.* ..\* .*....  *.# * .*#     #
#\.  *\ ..*  *. \  . ..*. *. . ..** ...   .. .. . **... .***.  *** *\ .*. *.*.* \ .*\.. . ...\.\ ..*...\... ..\\...\.***. ...\  ..\ ..*..   **..  ... *. .\..  .  .. ##     #
#.. \.*. ..\   .. . **\**. *.  \ .. .  .*.. \. .... ..*..... **.\\.\ *\ *..**..  ..* ..\.*.* ....  * .\.*.\*..  \.*  *.* ..* \.  *..  .*..  ***\*\. ..\*..   . *\. \ **#    #
#.  .. * **\ * *  . .*\*.* ..*\.\*. ..**.*. .   \ \ . **\ .* .\.* ..\.  .* *.   * \  *.* ** ..   .*.*.**..**  *  .. \. **.\.*.*** . \ *  .* \....  . ..*.*.\ .*.  *.*##     #
#. \ *..*... \ .\.. \..*..\     ..\ * .\ *.....*. . \.....*.*...    .. \ * * .  .\.\   . *.*.. \* **.*..**.. .. . .. *  *\..**..\ *  *\ . .\ *.*. .*  *. .*  *.***..#       #
#.***\* *.*    ...   .... .*  . *. ..  . .    *.*  *. . . \. .. ..**\.   .    . \.*\ *...*.. *..  *..\ .*.  *\.*\ ..**\ **.  \*  *..\  *. * *...  ..**\...*\*.***. ..#      #
#*.*. . *.**. . .   *** .**.*\  * **.   \ .  \.*\.*.*..\*.. * . *\*.* .** .. * .* . ..  ...  * .\.*\.....  .\*.\  * \ .* **.*. *\*\   .. ..*.. ***.... . *.*\.. .\. *L      #
#. *.. . .*.\..\   .\..\ *. \*  .\.  \\ .*** . ..\.*.*  *. ...  ..  .. .. *\.*\ ..**. *.\*  ... . .  .*  ..\\***. ...  ..* . .**.\*\  \...*.. .\*.*. . **\..#. . .\.##      #
#*.\.\.  ..  *... * ***... .\\.* *   . \. * ** * * . .\ *.. . .\*...*  .\..* ....\ *.\* .*..*    \*.*.*.*..**** *.**..*.*.\   *..**. *.* \* *..*. * \ ..*  \ \ .*\* **#     #
#*\.   *. . . \\* *** . .\. .  .**.*..  *....\.* \..   .....*....**..   **....\..*.. .\ * .\.. \  .* .\..*.\.. *.*..\ ..*\* .***.  \ *\*\ . .\..\\.  \** \. **. .*\*. #     #
#.*. ..*\  ..\ *. .**..  .\...**.  . ..**.\  *** **..\..*.  *\\..\. . * .\  *.. *\  . ***\  *\..*\..\.**\ *  .*. *.*.**\*.*..*..  **\..\.**. ..\*\   .. . . .*...* .  #     #
# . **.  *\***..*.* .*   \. **.\ ... *\** . ..*. .. *. \. ..\.. * *  .*.   * ..\    .*.\*  .\  \ .* ....  * * .. . .... \..\..\. **\***...*** ...  *\ \. . *\*\.*\****\#    #
#..\.\. *..*.*.*. . \.** ..*.\..*  ***.*..  \. . ...* . .\.. *.\.. \*\.* .*.. ..  * **.*\ . *.\.......\. \..*..\**  **  .\ . \ .  ** *. **... \..  *...  . .*..\*  *...#    #
# .\ *.** ......**...*..*  *. .  .*.\\.  \...  **\.*..**** . . **\ ** **    .\ *  . \* *..*  . *\.\ .* *\.*\..  \\  .\. . *.\..\ ... *.\*.**.\.* \.**\ .. **\ \*. \.## #    #
# .*. ...  .*.*\   **. **\ \*. .\ .\ \.* . ...\.... .\\.....   *. \*.\ .  .*.*\*...\ .\  .**** . * ..\.. *.   *.\..*\\.. **\ *..*\  *\.. **..**.**  . ..****\ ..*\.#*##     #
#\*  .* *...  ...**.* *..  .. .\..\.*..  \*.*\*     *...\..\.\ .*\. .. .\* \...* .*..* .* ..\.\**.\.\.\  \. . \...\*. *. **.\.*.. . *.   ..R .\**.*   *  \.. \.  * *.#      #
#..*. ..  .\.*\...* .\..**.  \ \ * ..* .*.** .. **.*\.. .*..  . .**      .\.\**.* . ..  \  \.*.... ...\.    * .*.**\ \.*.\ ***..\ * . *. . .\*\*\.\ ***\\ \.  ..    #       #
#\ .     \. .*.*. .*  *\.\. . *\** \    ***.\**.. *... .\..\  *.**.\. *.** * ....\*   . * .. .***  **.*  .***. * .\\.   .*   .**\.*.\ \ . * .**\  \\*\\*.....* #\*##        #
#* *.* *. .   .*.* * .**\. *\...** ..\. ...* .*\ .\ \.. ..\ *.. .......\\. \ *.\.*..*. .\ *\  ..\  .*.. *.*..*\.. ..*.  *.\.*.**.\\*..  ..  \.\*\**.*   .\ .\. \.*#         #
#**.*.\.*..*.*** ...\..... . *  \*\* ..  ....*. *\*. ..**.\*.**  *. .*\ . ...**...  .\ . ..*.* ..** * * *** .\*  .\ .  *.. .*\...* .*.*. \ \   *\..*.. ** .*.* .\*#         #
#..\.\.\.  .*..*\*.  .\* ** *..*...**   *\.\**\. \. * .\. *.*   *. *\..*.*\ ..*\.\. ..*.** ***. ..*.* .  ***\** ..*\ . \*.*.** \*. **\.\  *   *..\.\* ... .. .. .##         #
#    .\*.. * **\ .  \... .. ....*.\ ...**....\ . ..*.**.*\  *\.\..    ...*.*. **.  ** ...**.**.\**.*.\ ..... .*. .**..\.* ......* * .* *...* ...\   * .*  ..  * *\*#        #
#**\ \ .\..* \*.. * .\.  . ..*\.*.* .. ..   .  .*.*..*.* *  *. *   .\ .\.. .*.  . * \.**..\**.\**\ *\.*  ..  *\  ..\..*\...*.......  . .. *\. . .*  \ .. .* *. .*#  #       #
# *\*. *.. .*.\.**.\ .*..  \ .  .\\*\..**.*  * \.* .*..*\.\. .*.*.. *.***.\*...\    .* . \.\ **\.. .\ .\ *   .**... .\*..  .*\\*.*\  .\ ..... *. ... *....  ...*#\.\*#      #
#. .*  .* \   * **   *\**.****.\ **.*\\*.*   . * * ...***.**\** .   . .*\   \*....\* .* *.\. ..  .*   *. .. * *.  ..*.. .*. .\.*.*.. .  .* *. .*\  ..*\ * .  ..*# .*#       #
#*   . **..*\. * .. *.***.*.\.*..\..*. ...\\ \ \*\ .\  \\ . \\..\*   . **. \..*.*....*. .    .. . ..*****..*  \    . \ .  * *. .*. \.\\*.\ \ .*\.  \... .*.*.* ..\...##     #
# . *.. ..\*.\..**.  .**.\.*. . ......\ \..\.. .**. .*  *.. *.\.* *. \ *.*  \\..\..\ . ..   .*   ..*.....\ .  .\**.\*.*.\*****.\.**. \...   .*..*\* *  *.  . .  * .  *\#    #
#*.**..*\ **\  ..*..* *.\*.. .  .   *\* . *. .   .. \.*.\....\ *. \.**\\.. *.\..*\\.\.*  .   .\ .. *. \\*.* .\\ ..*. **.*...*.. *  \ . *\.** .* . .\..  . .* .  .  *###     #
#.\.\ ...*****\ **.* *.* .*.*. ...\*. .*\ \.   ..\.*..  * .. . ..*\.\.*..    . *\* \\...*  \.  \  **\\ ** ... .\...\ .*  ...*. *...**  \ *.. \. \ .. . .  ...*.     *.#     #
#\ .. *  . . ***\..\.*** ..*  . ..*.   . *  *.** **. *\  *  .* \.\   ..**. .*  .\.\.*...\.*. ... **... .   * .  ..\.\.*.***... *  \.\   ... ...* .\** .** ** * * . .*.#     #
#**\.\ .   *.*\..\.*.**..  \.\ *  . **\.*\ ..*.....*\* \.* ...   *\ .*\.*  *. .. ..*. *  ..\ .. ..* \\  ***. ..\*. *  *  .\ .\.*  . *.* *.*.  ..*...  \.. ...\ *  *.*#      #
#.\  ..**\ .*...\ .**.. * ..*.....*...\.*...*\\*. ***\.    *  ** \   **...*\ .....\*\ .*\. . \.***...*.*\..* *...  *.**..*..\..\ **..**\.... *\ *.... *** \*\ ..\**## ### # #
# .. .**.* .\.  .*\ \\\ .\ *. ..  *..*.*\\.\\.\  *..\*.*..\.. .  . **.\**...  * *.*.   ...*\* * .**\..*.*.*\ **\ . \ ..* ... *. ..\***...\* ... * .\..\ .  .. . *#.### ..#*##
# \   ..\.*..*..    .*. .. ..  *  . .***.\ \ . **.* *  .\ .. * . **\*.*.**.\.....* *  ..\.. *\.  . .\.. *...**..  ...*****\.*\. **.*.\.\ ..  .\.*  *****.. .**  .**.* .  ..##
# . .\ **.. .. .     .\ \...\\ .\*\*\\* *.. * * \.\..*.\*....* ....*.* *.**** . \* . \. .. .. ..\...  \.  .  .. *  *. .\ .  .   .\**\ . .\  .*    **\..\.* *\..#.\.\ **#*\\##
# * .\..** .**.\..*.\....   .* .  *. *. \..\\ \ *..**..*\ \... *....\.   **...**. . *.. .* \\ * .... *.**\* \.*\. *. * ..***. *\ ..\ *.*  .*.*. . . *.\.*. . * * *\ ..* .## #
#  **  *.\ *.\  \\* ..\  .* .. \..*   * .. *\.. ..\.*\.*.*   \ * ..*.. .\.*.\ *.*. ... .*\.  \.\.*\...  ..... .\*   *...  *....   **   .\.*.*...  .\*.  .. *\. .* .*   .\#  #
#..\*. .\*..*. .... \\.\* **.. \. . \ \*..\  .\ \.. . ..*\.*. .\ *.\*.....\* ** *** *\ ..   *  . . *\    .***. *..* *..* .  * **..\.**. *\. .. *...  \ *.* ..**..\*\**.\*.###
#..**  . . .*.\*.\. .  *. *.. \*.*\ ......* .\* ..\.*  . *.*.\ . .*.\...*\..*...* *.****.  *.***. *\**...*.\.  *\..\.\ \ ** ..*. .*\.\. *...**..\. .\\.* .\* .*.* .**..**.\ #
#\ .  .\ \ *.  *..\   \* .*  .**....   *\ *.\.  ..  .** .* ..* *.\. *  ... **.* ..**\.**.  \.\.\**\ *\  ..  .  ** .      ..  \* .*.**.. ..\..* .. \..  .**..\\..*\..*.#*#..##
# ***    ..*....*..  *.  .*.\*.*.* \. \.* . ..\.**. *** ... **.. *.*\ .*.\*\...*\*.. *\..  .    \. .  .. .\* \\* .. . ...*. *.. ...*\*. * .* .. * ..\  ....*. * \.*. **. ## #
#\*. ** .*\..\ ... \   . * *.** .** * .\. ***.* .\\.*.\. \ \.\.  . ... . *.* \.\*.**\*..*.\.\** .\. ..****.*.. *.**. * *.*.*.. \..** .  .*.**\  .  *.\.   .. .. .**.\**.#   #
#.* .*..*.....\*  \  *. *..\\*.. *.\....\ *.*\*.*..** *\. . **  .*\.\ ..\.\*\...\**\*.*..** *... .* *\*\.*. .. \ \.**\ * .* \ *.\*.*.. \*\**\ **..**.* \* . .* ...*..\.  #  #
#############################################################################################################################################################################