###################################################
#. . *\ * .... * . .*.* \   ..* . **.\\ .\*.. .**\#
#\  .*  .* .. .*\*\ **....*   . . *\ .    ... ...*#
# .\..*\.. *.*..**\*.\*\  ..**..*..      \\.   * .#
#.  .**.....*\.\....\ . *    ** *.  \ \  **\   *\.#
#    ..***. .  * .\ .. *   *\ .*....*\.* .... \. *#
#\.*.\ \...\ ... ..\ \  *..***....* \. \*\ .\\   .#
#.*\.* *. . * \\ \ * .*.*..   . .*\*.* .\ .   ...*#
#** .\*. .** ......\* . * *.  ** ....   *.. .\**..#
#... *\   .\ .* ...*.* *\*. ....\ . *.\ *.. . ..**#
# \...*....* *.. *.*\  . ..\*... .  ..*\... * .*..#
# \...\ .*.*\...*.*. * .* . . \ ..*\ ..*   .* * *.#
#.. *  . .*     **\ ..**** .* .*\ . .  **   .   .\#
# . . .*\ .. \...\. \ .  \\*.  ..  *.\*.... * ..* #
#      .*. . \.\** *.  * * *\ \. * . ..\. .***.\\.#
#  *.  *...  .. .... . . . ** .\ . *\..*\  ...*.  #
#\ . **..\..*  *\ *\*.. * \.. *.  *.*.**... \ .*. #
#..*..* .*. .... . *. *..*..*...\...\. \. .\.\ . *#
#*..\ *\.. \  *.*  \. \ \. ...*\.  ** ..**. .*. ..#
#* .**.*\.* ** \ \*.***. \\* .. *\ *..   \   .*. .#
#.*.\ \\. .  .*.\.\*\...\....* *. .*..*. ...* .  .#
# .*... *  .. *  **.*.. ***.** \**..**.\***.*..   #
#. **\ .**... .*\..*\......**.*. * . ..* .*.*.\   #
#  \..\  . \*.* .  \...*   *. ** . . \.**.*..*.*..#
#\*. \ ** .*.\..\.\ \   .*  \.. .\.  .*.\...\ ..  #
#.. * .. .* ...\  * \*\  ..  * ****.\****.* ..* \.#
#.\... .. .  *\ . ...\* *.  ..*..*   .\*..   *. . #
#..\  .  .. .\.*.\ . ...\  . .*  . .  ..\.\ \.*  .#
#*  . .....*\.** .*\..  .   .**.*.. \*\ ** \  ..  #
#\ .\\...*.* \..\   .*.*.\..*..*\.\..\*.*.\.\ .  \#
#*.. .*. \*.. *  ..\. ..\..*.** *\.  \..\...*.*.\.#
# .\...**... .. * .** \*. *\\ .*.**.... . .*\.. * #
# ..**\*. .  ....* .. ..\.*.. ..*\..    . *\.. *.*#
#*.. **\. *..\  *.. . .....\**.*.*\.  * **\. *..\.#
#.*  ...*.*.*.  .\  . ..* *****.*\.*  .*\. . .\ .\#
#.\\.. *  ..*  * ...*..\  .*\..... \....*.. *..*.*#
#* .* ** ..\..*\ \.\. . \* ..   .\.. * .***\* *. \#
#..*. * . . \.**.  *..  .. * . .. . \*  **..*\*.  #
#. **\*. .... ...  .*\. *.\.\..*.*...\**.\ ....** #
#\... .. *. *..\*..\..* ..  .\*  * *. * .   .**\..#
#  . .  .....*\..*.*\*\.. .*...\.. **.\ .*** .*.*.#
# *..\ *  *. .. .\ * . *\ \.\*   *\.*\* .*.. *.\* #
# ... .. . . .\** \...... .*** *.\.\**.  *  *\*.*\#
#.*...*\*.... .  ..\..* ... .. . . ...  *.**. *.* #
#... .. #\ .\**  *\..\*    .  *\. **....\.**..*. \#
# *.  ..*  **.*  ..\ *. *\*. .**   ..   .\* . ....#
#*..\..\ .*.. . \ \.\.*.  . .\ . **.. . \ *.*  * *#
#** .\\*\*\...    .*. .\.\  . . ..\*    ..\ .#**..#
#*  *. . *\.*\ \ *. .* . *\*. . * .* .*.. #* \*\. #
#*.\.. ** *.*. *..\. *   \ *\*..\.. *.**. #*.* * *#
##* *.... .. ..   *..*\\ . ..*.*  ..**#.#* \....\\#
##**. \.     .* .*\ ***. ... ...*.\ ..*\#.# .. # *#
# #.\.\ *.**. ** .. .\. *  . .\  *# .  *#.*.#.*..*#
##** *.   \* **\\ .\.*. .. *. ..*.... .\.\.. .# ..#
# ## \.\ .**. ..* *\*\. \...  * .*. ** \..#\..\.###
##.* .\. * *..... .* * . ..   ..R  .\.. ..###\# .##
# #.  *... .... \... .\*. . *.*\# .. .\.##  #*### #
# #. *\.\..  **\ # \...*  .....*\ *.  # #    #    #
###*\.* ** . .#.#*..*..#    .\ .   *#*.\*#        #
#**\#.. **.   .  ....\.*..*.. * ..\# ## #         #
#*\*\ \ \** *.*....*.*... **. .#\##    #          #
#*##*\####. . \*..#.##*\#..  #.. #                #
## #*#   #*\..\.## #.\.  . * \# .*#               #
#   #     #\ . .*\##*. .. ####.*#\#               #
#          #  * ### *.   \#  #*# #                #
#          #*.*# # **#L .#   #.#                  #
#          #  .#  ### #\\#    #                   #
#           #\#        ##                         #
#           # \#                                  #
#           #*#                                   #
###################################################