#############################################################################################################################################################
# .\*.** \. \ .*.\. .\. ** .\...\. ..**.\  *. ..   .  . .\ .\...\ *. *\..\  ..\.* . *.   \.* *.  .*..\ ..*\.*. .*.#... * \# ..**.*# #.# #  #                #
#*..**.\...  *\. .* * * *.  .* .*    **\*  **\*.\.. ***\..***..  \.....  *. .. \.\*... .  *..*. *\*...** *  \.. \  .  . *.. \..* ## #\# #.#                 #
#\.*. ...***.*. \  *\. *\*\.*. ... ..\.* .\.\.*. *\ . \.\ . **\.\.   \. * \..\  \...   . ...*** .***\ *. ** .* . . *.  ..#**.\ *..\## ##*\ #                #
#..\.  .*\...*.\.\*. ...** **\**\  .* .\.  .  *.*  \.. *..\.\...* ..  . .*.\ *\..   \.. .\ ....\\....\ **\. ** .*  *\.. **\.*\... .*.*   ** #               #
#.\.\ **.. \  **. ..... *.\ .. ... .*\.\.*  .***.   * .. \. **..**   . \ . .*.*\ *. *\*  ..**.* * . \. * * ....* .*.* *\*\.*..*.\....\\* #**#               #
# ....*\.*. . .* **\* *... .\  ..    . .   .\.*.*...\  . .\ **..* . ..*.      ..**. *\** **.**\ *  * . .\. \ \.. \.*  .* . *\**. .\.\. .\#**\#              #
#.**\ *  .     . .*.*  .  ... .\.\.\ **. ..   * .  .  .\  * \\**.. *.\.**.\*. * ***.. .. ..*.*  * **\    .\ .... ..\ *.\.. .*.\*    ..*  .**###             #
#.\**....*\.\.\*.   *\*. *  * **  *. *.. *.* *.\ *\*\ .*. . . .\ . .    * *. \* .. **.\.\  \\  \. .**. *.\*.*.\* \.**. . .  .*.\*  *.*\.  ..*\.#            #
# .. \ .. * . *. .* *..  .*\ \.*.**. .\** *. \   \**.. ..\**.* .  ...\.\.\  .\.\*. .*.* ....\ \ .\.*\..\**. **..   \*\.\* ** .  *.*. .* .**#*.#             #
#   ** .\ . * .*  .\. *\ .\**. ... * ...**.***. ..\.*\   .*\..\.  *\.. .. \..  .\\*.*.*** . *\.\. .** .*.    **. *..\* .*\.*  .*. .*.  . \.*##              #
#\. .. *   \*. .\*.  . *   * ..*\.....*\...*\*.*\.. .. *.\* .   * *  ....  *  .** .. *. .* \\.. *    *.*.*  *\\.*... ..\.* *.. *.* .  . . ##\*#             #
#*.*. *.  \..*\ ...* * *.. * \ .*. .... *\ .***  *. . ..* *..\.*.\*\. *. .  *...... ..  ....*\. \ . .... \. * ...**. *\*.* *. .* **.\ \**..##*#             #
#.\..\*.\* *\* ...\*. *. \  .. ***.\*.*.*....\..*  .\\.\  .  . . *.. * . .*  * \ .\ **\. ** * . .* . \*\ .*   **     *.\*. *. .. *.*. \**\*# \*#            #
#\..* *\*.\**..\  *\ .*\ ... **\.*  . \  . ..**.\  *..  * . .. \..   *.\. .     * . *. ..*...*....  *. .  \ . ...  ... *..* *.*  ..* \..\ .. *.#            #
#*.*.\ *** *\. .  ..\ . \ .\ .*.\ *** .\*...*\.\**. * . .  \**..\\\.*.  ... .**\. \..*\*.*\ \\.\  \...*.\\.* * . .*.\.* *.** *.. *\.* \...*\...*#  #        #
#..*.... *.*   ..\.\..   ... ....\*. * *   ..\...***  .\ \  .*.** . *.\..  \*.\.*..**.  *.. **   *...*.*. .. ..*..* *..*. \  * .*.*.*\ *\**.\**.###.L       #
# .*\.  \ **...* ..*\ \.  *..\**.**\.*..   ..\* \..*.. ....*..*..\*.. ..**  .\  ....*\ .*  . .**..**..**\ **.. .  . .**.*. ..*. . *..* *  * .. *#.# ##      #
#  **...*  **.\*\.\..*. *\..*******. ..   . \*\  ..*.\...  ..*.      .\.. .\ ...  *\.. *.\  .. ..**   ..\... * ..\ .*.***.*   .......*\ .\  #  #*.*\..#     #
#*\.*.. * *.**  .  . . ... *..*.. *...*\.\. .**.\ **.   * .* .*.\ *.\*.  . . ** *\.***\  * .*\* ..\ \ .. .***..  *..* ...*. ....\\.  .  .. \  . *\.###      #
# *\..  \ . ..  \* . * \ ..*\\.*.. \* *..\...\*** \**   *.\ \ .  .\**.\ ...* *.\*.  .*  \*\ . ..\ *...* .... .. *..*.   \.. .*. .*\ **.. * . . #.#..#       #
#. .****  ..* .* **\. ..**.* .**.\ ...*\  ..* .\.\    \ ..  .\\* * .*\\.\ **.* \. . *. ..*.\ \ \*.   .\ . *\ *\.*. . \ *.  . \*   . .* *** .. \*.#*\*#      #
# ..*.\..  \.......   **...* \.** .\..\.**\*    \..  . .*... **... .*. .  \*.. .  *.*** ..**. . .* . * . ..*\*  *  .*.* .*.*.\.. \.\*......\ ..\\\###       #
#\.\ * *\ *. .***.  *.*\.\.* .  .\  \ .**. *\.\ .*.*    .*.   ..\   \  .. *. .\** .\..... \.. * \.* \...\*  .. **\*\. .\ . \   **. .*\\ *.\* *.*.#          #
# \....*\ . ..* . .*.\** .*..**  \...* *\ .\.....*. \..* * .\  \ *.*. * **\.  . *\ * .*\ *..\ ...*\ *..*...*.\*. ... *  *. \.. *\  \* *.*.   \ *.####       #
#.*.* . *.. . . *\..\..*...*\..  . \ * .***.***  .\ .* . .  . *.\*.. \.*.**\. .\ **.* *..*  *.*..\.\*...*\ ** \  \*... \.*.*.  ... ..   .*.* ..\..   #      #
#*.\*\..*... .  ..*\.\**   ..\ *  ..*.  .. .\\  .. *.\ * *\....**.  . \*\..*. **  .*.\*. .. \ .*\*.. *.... .\ .**\.** \.*. * *\  .* \ *... \  *. .  *#      #
#* **.* .     . * **..\...* .. . * .*.\ * .  .*.. \.*. ..   \**..*.\ \\. . \ . *  *. *.* **    *. ..**\   ..*  ..   ** .**     \. *. * .\  .\  *  . #       #
#. ..\. \**     .*.....*.*.\..** .\ .. \ *..\\.*   \* .****......  *  .\....\.*. . * *\.*.** . *\.*\..  *  . *.  \. *.\ \*.. ...*.*. \ .  .. . . *  #       #
#.  .*. ..**\ .* .. \    . ..*\ *.. *   .\ ..*..  *.. \*.*** \.* *.... .* *      .\**..... . . * *\. \  .** .\...\. .\. ...\ *\\  .*     ..\..\**...###  #  #
# .\.*\\*..*...\\.* *\*.******  .*\.. \      ..\ .*\ **. ..\ .\.. .*... .\.. *.. \**. .*. .  .* \*. .\***   ***\ ..*  ....\  *\..  * \. ** .\  . *. .*.##*# #
#*. .  \**..* ...\**.**\....\.*\.*  . .....*  *\.*..\*.. . .*  **....**  *   \*...\** .. \..\ *.\.    **.\.*.*.  .\* *.*  .\ . . **.\.. *.  ..**. *..#.#.. ##
#.\ . \.*..***.......**   . *.    * *.\  *\  *....... .. \  . .\*.\\ .   .   ..   *\  *. \ ....\  *. .  ...\ *\.\. * . .*.*.*.. . .\ .* .* *  *.\.*.*..\...##
# . *..**.* ..\* . ..\  . *.*.** .. . *\**..\*. ** *.. \*  .\*\..** . .\.**** .*  . *.\. .*\ \* .. *. .. . . * \ .. . \*.\.....  * * *.* ..* .. . .\.\*#\# ##
# .* \  .  .    . *.  ** . \ .*\*.*\.*.. *..*.\ ..    \ *.*. .*.\ * **** *.\*\.     * . . . ...\** .**\*.\. *.. . .*  ..**  \. .\.  *\*.* .*\ . * *  .*\ .# #
#**. ... ..\. . *.. ..*. .*.\ *..*. *. . .*\.\.*\*\**......\* .* \* .*** ..**.*\  .*\* .  .. ..*.\\...***.*....*.*..*  *.. *.*    . \ .\. ...  ..  * .#.#.*##
#*\.\  . \\    *\ *   ...\\ **.* \. .*.\\.**. *.\. *\  . .\ .. . .. **\  .\.**..\\ *** *\ *..\..*...  . . ..  .\*  .. *.*.   ***.*. .. .* ..\.\\.\.\###.### #
#* **\. ..* **..* .  \*. \*...\.*  *. . .....*. .* .*. *\.* * **. * .**. .***\ *..\...*.. .*... *.*.. . \.   .   ..* .\*.*...*.*.*.*. *.*\.***#* *\*. ..#   #
#  ...**.\.*.\ * *..*.. \..\. *\....* ..  . .. .. . . *..  .**...*..\.. .*...*..* *  ***\. . .. .\.\\\     .. . . .. **\....*...\. ***\..\.\.\. .#. *.##    #
#* .\\* . \*. *..  **\ .. ... . ..  *    **\   *\* *  \ . * .*.\.   .\*.. *. ..\ ..\*. \.\  * * .  ... . *\*.. *\ *  \.*.*.*..     .\. . ....  .  *.##      #
#. \.*..  ... \  *  .**  .  ...**\.* *. \.\*..   .*   .**.*.*. .\  ...\ *.*   .*.\.* . .    . ** ..* . * \.. *... \ .  \.*.. .  . \.\..\ *  ...\ \#.#       #
#*.. .  ..* *.*. . *.\.  \ * *...\*. *.\.  \* \. ..\** . .. ** **.*..**.* ....**\*  .... \     .*. * \..  .  . ..*...    .  . *. .**.*.**. . **### **#      #
#**  \  ...*. .* ...*.*...*.\. ..... *. .*\ ***. \ * .*     .*\*... \*. .\*.\  * .. ** .*\..*.. . \* .\. *.\ \  *..\*.***.\.**..  .\....\.***.\*.\###       #
# \  * \  .****. ..*.*.. .*.\**.**\.\ * *   *\.. .*\.\*.*.. *\ . *..\..*.*.. .*. ..*\  ..*. *.   *\..\ \   \*..\.. * ...*..\\.*\.** *..\........*##         #
#. *..  . .*.*.*..*.\.* \*.. ..... ..*. .. ...   \  \ . .*.\. *\*..    *\..*.*.     ..\\..*..*   ..\\*\.. . \*.  \ .*.*\*  .. ..*...\.\ \*.*.\.... #        #
# *..  \  .. .\.\ \\.\..   .  .*  .  .\.. **  ..\  ...* .*\.......*. **.*  * **... .** .  *.\. . .* .\* .  . *.**..\...*  \ **\ .*\ * *.** .*.\* *.##       #
# .\.**.\.\ ... \..*\* **.. ...  . .  *   ..  *..\ *.\.\..\ \.* .\.\ ....\.\*...*\..*..  .*\. \ *\. *\ . ..  *\.*.**\..*.\.***.**  *\ . .*\.\. . . .\#  #   #
#.\ \... .. *\ . * *...\.\*. .\ . .*  .\ ...... ...*.  . .  .\... ***  .\ *.**.**\ \..\*\*.   .*\*  \*. **.  \..  \.** .**.*.**. . .*...* .\ . .. . ..##.#  #
#* . *.. ** \*.. ...*. .\ ** .. ..*.\..*  .* .. \*...  *.*\  *  *\..   *  ...*. *  .   *\.. .. *..**.*  **\ \  .\..*\****. .*.\ ..\**.  . ...*..\ . *..\*#  #
#*   . . .*\. *.  ....* *....   *.... .. **..  \***..\..  *\.\.\.  *  ** .  .. *.  ****.**. \  .\..\.   .. * .. . \.. \*. * *.\. .....\.  \ ..  . . ###  #  #
#. ..  . ..**. ***  ..\.**.\   .\.   * * \. .\ \* \...    .. \.. .\.  *\  *\.*\...***.*\..  .*.\. ..* . *\ .  .*\. ..*.* **.*\*\.\. *.**    .\ * .#\#  ##   #
#.*. .  \*. * \.   \ \...*\   * .   **.*.  ***...\. .   *\.* * .*.\* *\\ ..**.\ .*...\*.\. .* ..*\  **. \***\ . .*\ ..**\....**.  *..\**.  .\ .\.##\#       #
# .* .*... ..  *.\.  \  * *   . *.\\.\ \.  ..\ *..*.\..\.. . .  ......*  *  * ..\*\...* *. . * * .      .**..  .  *  ..* **. ..   . .* * **.*....*\*#       #
#.\*  ...*\    ....\...*.\... .**..  .  ... ..*. * .. . . *\ .\ .*..\.. ..  .  \*.*.*.* *.*\.\ ..\   **\. .\  * *\. .  ** \** **.. .\***  * . .\*...#       #
# *.  \ \*..  \*. .*   .  * ...*\. *   .  ** **. .  \.. .*  .*.**. .*.*.*.\..  .\.* .\\*.. *.*\..\*.\...   ..*. \.. \ .\.* .. ...  **.*. \..*\ . .. #       #
#**. *   .**. ..** . \...\..\\.. \*.*\.*  .**.\ . ...\*  * .\.*..\ \...**. .*.\* \*\ ..... .\\  \ ...*\...*.. **...*..***   .. .\.\ .*   . .\*...  **#      #
#*...... \.*.** . ***..\      \  .*.\* .* *.***\ * . .. *. .**.\\..\.   * \.. .\. ...* *\.*\  *.* .\..*.. ..\*..*  .*\..\ .*\ . . \.\*. ** \.*.\..\*\*#     #
#*. .*.\  *. ..\....* \.. *.. . .. * ...* .\  *. ..* *.**\.  .\.\  **... *\.\.\  .*\.. .**.*  .\.\*...\*\ .*... .   .*. *.*..  ..  \ .**.* .*\.* .  .\.#    #
#*\...   ....*\* ...\ ...*\ ..\ \. ..\ \.\*.*\.. ... . \....    ......\  ..*  *.**.*  ...*.. ...  . ..*** ..  *.. **    .\.\. . *  . . .*.* .*..\..* .*#    #
#...*. .* * *  .* ..\**. *.*  * ..    *.. .*..\   .  **..  \\**. *.\ **.*  \. .....* . * ...\   .*  .*. . *\.*\.. ..*\.\*  *  .*.  *\* *\ .*\.\** *# .\#    #
#...\.\\... . . \..* .*..*\..* ** ... .\. \.\   *.* ..  * ...**\\... . *..*..\\*\ .   .\.  \. .. .***..*. \   *..  ...**.*\*.* ..  \ . .....*\#** ##  #     #
#* ..**\ \ .** .. .. *..*..  * .\.*... *.\...\  ..* \ \. ....**.  **.  .\.*\ * * .  ...   \  *   ..*.  .** ..\..... *... .\. **.\ ...**.. \ .. ..\..\####   #
#*   *. ..*..*\..\ .***.*\..\.\ . ..\ .. * * .*\ ** . .*.\  .*\..**.*\.**\.*  *..\ *...\ * . ..... .* *  *.***\..   *. *\.\......  .  .\...*.*.* .*.**...#  #
#.* .\* .*.*.* **..\*....  *. \.*.  \.\\* \**.*  *.  .... .\*. \ .* .* * *  ** \ \... *  .* ..\.  . \.\*. \*..*\..  ***....... *  \*\.\.\* *...  *...*. *#  #
#\*.\  .. \**\.. \* .\ .* *. \  **\.*\ ..  \...  \*.  \*** .* *.......\.  .\*.\.\.\..\.** . **\ ..**. .*. ...\..*. .. \   .\.  .*  ..\ .* \..  * \* *.**#   #
#..  **. *.*\   *...  ..\ ..\*. ..\  . .\**..  \ *.. ...*\. . *\. .\ ...* .*.. \ ***.. .   ...\*** .* *.*.      \*. ...* .*..  .**\   ..\ .  *.\  *..*.*#####
#.\*.*  \*.*.\  \..\...\ . .*. *.\*.\.* * \   * . *\   *. .. *..\   *\*\. *  ..*** *.\   **\ . .. *\. **.*. \* .\.*. .* . . .* . \. .   .\  ....\.. #.*.#.. #
#.. ** . ***.** ....\  .... .\*..* .  ... ......*.\*.***\ .. *.* * .. .. **.\....\*\.   .*... *.  .*.   \. ..*\..**.* .. ..** ** **\ \. .  .. ** *....\...###
#. *.*  .*... * \ \ .** *.**\. **.\ .. .*\.*.** .. .*.\* \   ..*\*\*..  **.*  *\....  . ... *..   .*\.* ..*..*  *.*\***    ....* .   .....*.*. . \... . .\ ##
#..\*\ ... * *. .....\. *.\*. \**.*.  . ** ..**. .*..  ** .\.  **..\ .* \*.*. ..   .*\*\..  ...\\. . .\*   * . .\ *\*..  .\.*\ .** .\. *\. **\*... .. * .*# #
#...  .  \*\*.*   .*.  .....*..\*.**.*  .\ *\***. .\\  ..*. \ \...*. * ..*   . .\*\.. ..**    **     \..\  \...\*\.**..*. *\ *.  * .*.\.. .\.*\.*..\*..\ \*##
# \ *.... \..     *....*.. \. *.. ..\.\* .* *.....\.. *.\.*...*... . ...\.   ** ...\ \  .\   **.\ .*\.\*..\  *.\   *\.*.\ \  . \ .\\.*..* ..... .  ..*.#*## #
#  ..**  .    **  \*\**.*** *.. *. *.**\   ..*..     . .**.*. .\..   ..\* .*...\*.*.*.*.*.  .* .\.\. *.*..* \* . . *..\\.*. ****.    \*  \ **..* . \.#\\*#  #
#\*...** .. ..*. * ... .**.\* *.\  .*\. ... *.*..  ..* *. **\.  \.*\\***. ..**. .\...\. *. . ..* ..* **. * \.* \   \.  . .. *\ \ ..*\.* \ *... . ...* **#   #
# ..\*\. . ** . *\ ....**.* * ..*\\\..*.\\.\\ .*    .*\*\...\.... ....*.\* **.  . \**\  ... * .\..\ ..  .* * ..* *..*\  \* .* . *\ **\*\*.\**  *..*...##    #
#. ....*  *..*. .*.\.*\*\   .* *..\.... ..* . * ..*\ . *** .***   .*.  ... .**\   .*....* *.. . . .\   \*\     *.\ ..*. ..  .  \.**    .\...*  \....\#      #
#*..**.** .\ \ \.... \ .\  \ .*.\*  \  \ * .*.. \*.*   ...  ..\\* *.** . . ..* *....*  \*.*. \. ** *.\*.*.*...*. ..\\...\  .* .\ *. *....\ *  ** .\. #      #
#.\*.*\...   .. *.\.\..*.\..\. . **\.. .\***.   ...* ...* *\.\ \*.*.\\   *..**.\.** .*\. .. . *\..  . .* .*\.. * ..* .. *...* *. ....\ ...\\.*\ \.. ##      #
#..  . . .. ...*.\ . ..*.  .* .  ..... \ .*.\.*.     ..\  ..\  ..*   *\* . ..\ **\.*\...  \\ **    ..**.\ .\*.....*\ *\*.*...\*..\*   .*\.*.**.\. .*. ###   #
#  . .* \.\**.\ ..  *\ * *\ * .* \. *\\.. \*.** ...  * *.*.  .*...\*\ ... \*.*..*....* \.\.  \*\..\ . ***.\\\. \ ..   .\*..  .. . .**. ***..#. .\ ...#  *#  #
# .** **...  . \  *  ..*\..**.....\ *    . . *.. . .\. ..\*\  \\* ....\.  .* ....*..\\ .  **\ .. ...  ..*.* ... * .*.. *..  .\* .\**.. .**.. .. . \.\# .\ # #
#* . .*\* \. .  *.... \*  **    *\ .*.\ \* * \..\\. \.....\.\*.*\\ . *.. \ .  *\ .*** . ...*.*..**..* \\* ..*.\ ......*. .  . . *...\.. **. **   \.  .*#*#  #
#..  *\....* . *. *\* ..\\ *.       . \ ..**..\. .* . .\ ...*. .    *.*...* ..*  \. .  .. *.\.\*.*. .**. \*\.*..** *.*....\\  *... .** .\.*..\. \.#\*...#*# #
#.*\  . .  .*. * **\*\.*\ .\*.. *****...*.*\ **  *.\ . .** ** \\ *\* ..   **  . . .\*..   *.*\ .*\   .*  **. \\. .*. ..\*.* ....** .* .  \. .#  . * ***...\##
#\.*.  . .....*.\***. ... ** .** *...\* *\. ...\ . . ..**.**.*  .* *.. *.* **.  ..* ..  *..*.* .. *......*.*   * *\.. \.*.\ \**\..  . \.\* .\  .\ . ...#.## #
#  *\*\  .\.  *.*..* ..*  .\* \. *...\*\*.\*\*.** *  .\...\.** . ..**. .*.\.*.. \..*\.  **....  * * * ..*\. *.\.     *......  .*..\  ** .\ .. .\.#*\* . #   #
#. . .. \ .. ..*.  . .\.\\  * .  .. .**....**.  .\.* . . *\ \. *.*.*.**........  * .\   *.\ .*. .*. *..\. ...* \ *.*\...***.  *.**..\.#  . * * ..\*.####    #
#...*..*. .\. \* \.*.... \.\. .*.\ *  .\.\*.***.  \   * *..* .\ .* *\*.** .* ** *****.\*.* . \ \*.*. *  \ * *\.\**\.*.  *.. .\. . .\..\.*\ \..    .*\#      #
#*. .*.* .*\  .. .\.*..\. . .\*.* .* *. ..**....\...\..*. .*.\.\ \ \...\ \ *..*..*.\. ..*.  .\ ..\*\  \*.  **. * .. ...\..\ \ \ * *.**. .     *. *\..#      #
#*..\.\. ..\ . *\ ...  **  **..\.. .\\. .\* .*.\.** * ** *.. .**.\ *. *..  * \***.*..\  ***.  *** *.* **\. .\. . .*\ ...*.   . *.*. . ...*.\ ** #**\#       #
#\.*. . ***.\..*... \*..   . .*\.\    \\ .*  \ . .\.. .  ..\. .\..  \..\\  . .\*\..\*.  *.\\**\*..*.. ** .*..  *\.. .*.  ..  \*\*\ ...  . ...\* ...*#       #
#..\**  *..  ..... *    *.**.*.  .* .\  *.*..\...**** .*. *  . .**\ **\.*  * **.*.*.*\ .\.. .. .* \   .. \  .* *.\ . .*.  . ***\* . ..  * *  ***... #       #
#*. *. *.\* ***\.. *  . ......* .\*\. **. . .*. ..\**\\.  \.. .*.*.  ***..\.. .*. * \*\**\. *  .. .****... \* .*.* **. * *.****.\. . *.\. ..\.\.\.##\###    #
#.*. *  *...\ \**  *\  .*\.\.    ....*..     \*. \ ..*  ** *.  *....*.**** .  .*\....*****...\ *. \..*  . **.  .\.  * .. *.\.**\  .. *.* * *.*.*.*..*\**#   #
#**  *... .. \ .. \*\.**  **. *.... ..**... ...*. .  .  **.* ...  ...*.. *  ..\.***\  \*..  . .. ..\ *\. ..\ .\. .\. .  .***\ ..* .\*. \ .  *. *.*. *...#   #
#*.....\*. *..   *.. \ . .*.* *.\ \\.**.*.** \.. .*\.... .*.* *.*. \*\** * .. . ..*.*..*. .\*.**.\.  . .\*\**..*. .*.*....*...* *. .. ..  .*\\ *\.*..**#    #
#*\...***\.*. *\ \     ..\. *  .. .*.\... ..\.. *...* \. ***..* .*\ *.*. . ***  ... *.*.. * .... ..\\ . *.*..\. .\ * .\..\. *.*** *\.*...   .. **..* *#.##  #
#.* *\\**** ..* ...  *...  .***  *. . . .\\*. * . ***.\*.\... *.** *.*.** ..\.***.... **. *.\. .  .\ ...*.\* * ..**.. .**...*.**. \*.. . *\  \ \.* ** * *.# #
#\.\. ...*  ..\. .**. . *.*\..   .\.*. . ..   ** ...*. * *.* \*..*\*\.\*.*** .\\.\* .**\ .... \.  .* *. \*..  .***...\ .. *.*  * \.* \\. . ...\ \*\.**.*##  #
#\. \. *..\* .* \ ....**\*..*\    . .  .*.. **\.\..*...**.**\ *\ *.*..\ .... *..\.  ***.  * .\.  \.* . .  . *\*.\...* *.  . \**\.. .*.* *\..\ \.#. *\#\.*#  #
#..\.. \.\..  ... * \**\*.* *... *  \. \. \ .**.. \.** \. .*..\* *.. \.*\ ..\*** ..\*.  \.\ *..  ***\  ** . . .\*.*\**\. \ .*.... \**** *.\*.\* * ..**#\#   #
#\.. \ .\.\.\   .*.*.*.** .*.*. .**\.. ..  *...** .**..  .*. . *...*\. .. \**\**\  *.    *.*\**\...* ... \  *.  . *. **..\  **.*.\ *...  ...* #.#**#\##.#   #
# \*..*. \.**.* * **.\.\. .*...  .\      ...\. .*.. ... . *  ..\ ..*.*** * . .* *\** \.\..*.\..*\ *.* .\* .  ..\*..*.*... .\.**\. . .\  **..* *# *##*# #    #
#\.**..  .\.*..*...\. . **.*.**. \.*.*\\.* * *....*. \*  \   \.**. .*\..*..\.*. *.......   .  .* ..****. .* .\*.*...  .*\.*...\.**. \.. ...* .*.  # . #     #
#.*.\   * . ** . \*** *.\ .. \ *\*..*..*\* .*. \  . ..*\..* * \\.*.\*.. ..\... ..* *  \*. . .*\* \.\..*..\ . ..\**.* \ ....*\ . \*.\ \. ***. .. .\####      #
#. \. **.\. ... \.\  *.. *. ..*\*  *.*....*\.. . . \ * *  . *\. *. .* ***..\   .\. \ \** .*. .**..* .. \ .   ** \*......  .*. * .*. \.** **### ...*#        #
# \.*.** .   .\* *.\\* \  \\.*.*  * .\\..  .\ .*\*\ **   \. .*.\.. .*.**\.* .\.*.* ...... **....\ \ \*\ .\ *\*. ..*.\*.   * . .  .   *..*.. #****##         #
# \\*  \.. *.\ *.. .... **..\..* .. .* *..\.  .\ *.\.  . .  *...*...  . .****..*.. .  . . *. ...  ...*    *.**  .   . .. *.\*\. * \*.\. .    .*.\#          #
#\ ..* ...\.  \.\.* ..\  . * \.\ \ * *.. .....*. ..*. .**. ..*\.**.\....*...*  .\   .*\.. .. *..\   **..* **...* *..**.**. .\   .**. . . .. .*...#          #
#.  .. . .* ** .*.* *\*. \*\..* .... .  \*.. *. \ .\  \.. ..**. .\   . . *.*..*..\\ \..*\  . . ..... **** *.\* * *..*.   \..... ...*.\ **.. #\.#*#          #
#.\..*.*  . .. .  **.***\..*..*   *\.  . \.\.*\*....* \     *\ \*.*  ..   ...\... ...... .    . **..  ..*  * *.*  . .. .*. .*  .\ .*.. ..## ## .#           #
#  *..*  .* \  * \ * .... .*..  *\.. \ *\  *.. *...\.* . .   ...*.... *\.*....***\..* *.  **\. **..  *\ .\ . . *.*\..\  . *.  \*...\.*..* ##  #\#           #
#\ ***. \**.  ** . ....\.\ .\ ....**   *  *....* .. \\ \....**. .* *  *\ ...\ ..\.\ *\ *.\.\.**. .. *... ...* .\*.\*..  *\. *. .. .* *\ *.\#   #            #
# .*.. ...\ \\.\..*.*** *  *.\.* ..* \.*\ ***\*. \\ . \ *. . *     . **.*.. * *..   **..     \...*\\..*\. \     \......... ..\ \.    #* ##.#                #
#*.   \   . .*.. \  *.*\..\.*.**\. **. .\ .\ ..\**.\  . \ \. .. ..*..** \.* . * *. ..*.\*..*.... * .. \ ... ...\.\ . ..\ ..**** \.\ ..*..## #               #
# \ *.  **.\.* * . ..\.*..*. .*.\ *..* \*. ..\. *.** .*..      \** .***\.. .*\. .    \** .\* *\ .\. * *   . *  .  . * .*.****.. ... ..\    #*##             #
#....\. *.  ***..  *\\ .  .** .\.\.\ . .** ..**.. *.\ .  * .\\   . ***\*.. \\ \ . .\* \. . ....  ** * . .*\. .\.\\ .* \ .** .\** .\*.. .  . **\#            #
#.  * *.*.*\.*.\  .*.\*.*   \. ...*  .* .... .... ** **.*\ . ...\. ... ** . ...\ .* \....   . ..  . . * *.*.. .** . . .*. **   . ..*\  \*..####             #
#   **.  .   *.**  .*.. ...*...**.* . ***.*. ..  ...  .*..   \ .. .*  \..  . **..\........\  .. *  *\**** \*...\.\.\**...*.* *  *..\ \ ##\#                 #
#\ *..*\.*. *.*** . .*\***\..   *\   ..*\ *  ... .**  *\.. .   .*\.*. ...***...*..  *   *.  *  ...\*.\*.* *.*... . ...\    ..**..*..\.#  #                  #
#  \  * *\ *..\.*   \ .\ .. *..*  ...  . . .* \..\ *.\* . **.. ..*\...\*\.*\.....\.\. *\ *\.\... \ ... *.\. .* .**.*\. .  *.*.*  #  #*#                     #
# .....  * .*\* ..  \*\.*\* *..  * ***..  *.**.**.\ . .....*\*\ *. **.*. ...\.*.**. **   .*  .**.. *.*  *.\..\****.*..* .*.*\.. ..*.#.#                     #
#\*.  .* *\.. . \**  **\.....***.\..*.. .\.... .\ .... * .\  **.\.. . \ .\.\. . .*. .*\  *..  .\.**. ***.    \.*..\. .. \*...*\  ### #                      #
#   *  ...*.\.* .... .*..  .. .**  ..  .. * .** ...\ .*.\. . \.... ..   ..* ..*.*. ...*\***\**  **. .\... .*.**  ..   *\.......*..#                         #
# .****.  \ **\*\ .. **.\\  \ **.\ **\ . ..\.\ *  .   .* *.  ..* **\. . .\..*....*  *....... .* \. * .\..*.*..\..... .*.*.    ##*#                          #
#\\.. ..*. *. . .*\ ..   .\.\... \. .  . * *  ..  .. . . *  *\.. ***...*.*..\*   \ .. ..  .\* .\...*. ** ...\* * \ . \.*.*.#. # #                           #
# . .  \*\  *  . \* * * *. . *\.*..  \ *...\.... . \ \.. .  \ .*.. .   . .* .\   ..**.\*\  . . ..**.  *.  ....* *\  ..\. ....\#                             #
# *.\ ..* .\.. ...\ \ *..\ .**.*..* *.\. *.  . . ..*. .*.  *..****\ ..\.  *..  ..  . ....\.\.\\*. . *....*.*   ...*.  .. *..###                             #
# .\*      ...  \*......\   .* .**.\.   *.*.  . .\.. . ..\** \  *.  ..*.\\.  .. *\. .. ..\***\*.. R\....\.\. * ** *.. *\\.\### #                            #
#. .*.  \.\ .   .*.* . *..*\ .  *.    \ . . . . .. .\. .  *... *. \ .\ .    *\ *.*.* \ *.*.*\.*.\   *.* #..\*\  ***.\...\   **\#                            #
#*.\.  * *.. *\.\ \..  \****  . * ..  . .  . *.\ ***.  .*\..*  ....  *..\*. .**..*.*....***\...*\.**.*.* \.\...* .\. .\ *.  ###                             #
#.. * .*...*... .  .* \  .*..**. . * .  *.\. * ****.*. .*.\ ** ...*.*.*.**.*.***\*.\*.\**\\* . . \*..... ...  *.*  .\.* *.  ###                             #
#... . **\  *..*.*. . . . .* .\.\..  . .\   ....***..\ .\.*.**.. **... ....\ ... .***.* *  \.  * .\. \..  \ . *\*.\   #\..\*..\#                            #
#\   *..* *.  **..\.   ..*. * .\.  ..*.*.. \.\ ....\**. . .\..\.*.* .*\*.  *.  *\\*\..**\.*.. \.*.*  .\*  . **.*.  .\.*.#*.*#*#                             #
#* .\. *\... . .\.\*...   *. \..*    ..*.\  .* ..*****..... ..*\. . \.**.\....* * ..*\ .\*.  *. . . **.*.*...*#..  *.** #####.#                             #
#.*. .**   . .  .\.\ .*.*\.. . ..*...** * .*...  .\.* \ *   * **\*    .\*.\*\ .* \.. .  \.* .\*.  ..   .*. .\.  #**#\**.#    #                              #
#.* ... .*\** ..\. ..**\.**\... .*.* .* \*... \**** .  \ .. .\*. *  ..\.\. . * .*   \  .. ... **\   .\... * *#.. *.##.##                                    #
#. ...\. \*.\  * \... . *\*.**..\**.* . .. ** . ..   .  . .   *.....* *\ .  .* *\.     .*..*\.\ *.   . ..*.#** . *\..#                                      #
#... .. ..\.** . .* \ . *\.*.*.\.*...**. ....\.\.\.**\  \. *.\ \. **  ..* ....... **.\  **\.*..*\.  . **.#\  * * . ##                                       #
#*     *  \...\  .* *.\ **.. *\.   *.*. \  .**.  .  . ... .... . *\. . **   *.*. .*.\ ....  *..*\*\**...**.\#.*.*  #                                        #
#\ * * .\ .*\\ *\** \ . ..\ *. **\\..*. *\  . .   .*** ..**\   .*.\.  ...\ \ *...  *.\** .\*\ ..\.*..\  .** . ..\ *#                                        #
# ..**  * *. .\\  . .... \. *.\** * \ *.\ .*\ *\*..**..  **.\.  \ .\   .*....*\.\.\. ..\. ....\ \..* \* *.. ##***##                                         #
#\ *\*  .**    .* .. .. .....*\ .\* * .. .**  . ..\. . *\. *. .*\* * *. ...* ..  .*. *\*  *.\* .*. .  \*#\\*#..##                                           #
#**. .   .\.*\.****..*\ ***.. ..***.  \. . .  .  ..\*\ \.* ..\ . \ *.. *\.\. **\  * *. ...\*.* *.#** . .*.## ##                                             #
# *.\*..  .. * *.*** .** .. .* .  . ..*\ .\*.\ *\.*.*.  *... *.. *.\ \... *. \  *.\*...\* ..\.... .*** #.#                                                  #
#  . . **\.\\.*\ .... .. .\ *. ..* .\..*. ..**..*.*..*  . \.**. *.. * ..\.....\.*.*. . .. ..* **#\ *#. ##                                                   #
# *.\  ** . . *.*\.   *.. **.*\**.. \* . . *** ....*.\*.\ \.. \ ..**... *.*  .*\* .  .\  \ \#\.\###\\.#                                                     #
#  **. .. *.\**..# *... *. *   . . ..*...*. .**\...* ... . . . \.. ..*\.*    \ .. .. ...  . .. ..#..*#                                                      #
#* ....  \.*.#.*#\\. .*.*.  *\ . \ .  .*.. . *  ***. .   .   \.  . .**..**. *...\ .. . . .\.* .#**###                                                       #
# **\ .* *\.....\ *  *.\. ... *   \  *.*    .\ ...**\* \ . . .\ \.**..**\   .  \. *\    \.####*##\#                                                         #
#####*\#\##* ..*#*\ *.  \ .*\ .\*\ *.... *\ .***\ *.*.*.* \*. .*.\\***.\.\ *\**\\*\#\*.  #    # # #                                                         #
#############################################################################################################################################################