###################################################################################
#\ * .. .  .* ....  **..  *.\** . .. * * *. ...*.... .\. .. ...*.  *.*  *   *.. . #
#.*\.  *\ \ *\     ..\   **.*.*  * .\..... \ ...... ...   * . ..\*.** \.* **.. . \#
# *..\.* * *\ *.**   .      .*\  ** . * \ .. .\   *. *  *  *   \.  .. ... ..  *. .#
#*\ .\. .  .. .\.***.  ... \*.**\\*. * ...* ..**\ .*    .*.\.\* \. ..   .*\.**.. *#
#\.\ *.  *\*.*\ .\*.*.. .  ...*.....**.  \*.*\...**...*..\ . .*...  .    .. .\* . #
# \* .*   *. *...*..\ . ..* ***\* \\. * *\**.  \.*... ..   . \* .  **.  . .\..*  *#
#\ . \*   *  .*.*\ \. . *. *.**..* *\.*.\.* . .  **. **  . *\ **  .*** \\ \ . ** \#
# ....* ........*...**...*.*..\*.*..*..*.*\.*\* ..*..\. .\ \ .\.\*\ ......\.****\.#
#.  *\*.  ... *..\..***..\.* *.**.\..  *.**.\ . .\. *  *. *.\*.*..  \ .*. .*....*.#
# *.** *\  . ****  .*\..* ..** ...*.* *\  .*. *..*.*..\ *.  \.* *  \...*....*\****#
# \** ..  *  *\ *. .*** .\  \ *  \**\.*.  ..*\..*\ *......   .***\* \  . **..*\.**#
#  *.. ..  . .***  ..**\  .* *. *\..  **\.\ .*..**.*   .***** .*. .... ..*. \ .\..#
#... . * .* . . *\  *.\ \. . .*..**...\. * . . \*.*.*   ***..*. .    \\. .\ ..*\ *#
#. .* *   ... . * * .*.* * \* .  \. ...* . . . ..*...**\*\.\.....\*.\...\   . . ..#
# .*. *...   * \....**..*. .\ .  .*  \ \ \ *.. .\.**\.\  . *. * \*.. **...\.... ..#
# ..*  ..**..\.*. *.* * .* **   . \.  ..\.*\*.  * .*  ...*\\. \.. . .** ... \*...\#
#. .. ..* .* .*.....\ ** .*... .\  \ *. *\ .**.\   ..... ..  .. . . \.*. *\  .. . #
#. .  ..***..  *\ *... *\ ***. ..  . .  \   ..* \ . *....\  \ ** .  **.\**... \ .\#
#.  \  .\.*.* ..* \. . . *..*  **\ .. ...  .\ .\  . * .**..  ..  \  ..*.\\.\. * * #
#   . *   .  . ..*.\* .\..  * .*\ *** .  *.\ .  .**.* . \.  * . * .*\..\.*.. *.\ .#
#**.* **  \ ... .. .*. *.\* * ...\.*\. .....    *.\    .*  ..  *\  **.* .*   *..  #
#...*..\  *.. *.. *\.. **. .  *    .*  *\ ...*\... . *\*** .*..*.*..*..\ *.\.. *. #
# \ .* .... *.... * .\....****.* .* ***. *.*.. . **\.\.***\.. ****.*\.\**.*..\..\*#
# ..   \  *  . . \.\ *...  *.    **  ..\*\..**\ * .. . ..*  . \.\..*..... .*.. *..#
#   \.  .\   .  .   .***.*\. \. .  *..\*.* **.*....* \   .\  .* .**.\**\  \. * * *#
# ....* .. * *... ....* ** *** . \ *.*.. *.\. **\...* * *\**\\. . .**.*..*.****.*.#
#.** \.. .*. . *** *.*........ .* .. .  *.*. **.. * ..\.. .. * ..  ..**.*.....*.* #
#*  \.. .*** *..*.*. *    \ \*  .*\  .\ **\  \**  .\.* * . \... .*\  .*\..  \\\..*#
#..\. .  .*. .****..... * \. *.***... .*.*\.  .\**\..* .  ..\ . \.\\..\* \*. . **.#
#\..\*..**\ \..* .\.. ..* ...\ .....*  ..** **\*.*. *\\* **.\*\..*.\*.......\ ..\.#
# .  .* ... ..*. . . ..\* *  **  *\..\  .**...***\.*. *.\ \*.. ..**..* .*\. ...\. #
#   **... *\ ..\.. .* \ .*. \.   *.\.   \ ...\*.\.\. **. ..*.. **...*\.*. .*.*. \ #
#.*\.\  * \ ..**..  .\. *\  ..  **.*. **. .  ...** * ..\** *  ...*.\. ..   . . \\ #
#\*. * .* . . . .  \..\..*.*. ..\.*..*.\..   \**..**.\ *  *.. *.   *\...*\ .\    .#
#*. **. . .  *..\*  *..\.. \.  .*..*\* * .*. .\.*..** .\ .* * ..\ *..   \** .*. .\#
#..**  \  **...\**. . ..*.*.\  ..* . ..*\..  *..*..**...***.*     \.. .* *.\ * \ *#
#. ** *  * . . .*.\.* ** *.\.**. .   \\ .\ *\.**.....\*\. * .  ... \ ..*\.. .  .*.#
#*\.  **\.  . ***.  * .. ....*.  \***....\  ....\ \.\ *.\ \.*.   . .\ \.. ... *..\#
# .* \*** **  ...  .. .\. .. . . .\.*. . . .. *.\.*.. . **  . \*.*. ... \ ..*\*.\ #
#  .   *\ .* . * . \*  *..*\..\ \  \\. . * ** ...\ *\*\*\*** ..  .  \ \\* **\*\*\ #
#..  .\.. *. ....  .. ... \..\.\. .* \.*** **...\.*. ......**...  *...  . *. . ..\#
#*. \.*..*. \* .\ . . .**\ \..**..*\..  *\ **.  *\.* * .\ * ....\...* \. .....* .\#
#..*.*.\.*** ..\.  .   .\. ..*. *\*.*. ..  \***..  **. ..  ...* . *.\... **\*.. **#
# **\*\*. *.*.\.*. ..\.*   ****\\.. **\*\**\..*\   ..\ *\.*.*.* *.* . . \.**..  **#
#*. ..\ *.*\. . *  ** *...**.\.\.*\....**..... ..*.*. .**...... . .*\*  *.\. .  ..#
#.   \ *. * \.  .  .* .*\ ... *. *.  . .  ** ..***.. . ..*  .** .\*.** .. . ..  \.#
#****. **..  \ \*\ \..\.. **   **.*.  *. \****  \*     **.  .*. ... .*.   \ ...\..#
# *.*..*..\    \..* .\.*   . .*.*..*\ . \ \.*\.\ *  **...*.  .\... .*.*.*\.  .\ *\#
#\.*.\...*  .*\.**.\.** . . .** . \.\ *.. . . .. .\ **.*...\  .*.* .**.  .** .. *.#
#. .  * .*  *.. **\*.*. R...*..*\ \ . .*  . *. *. *\.*. \  .*.*.*. ..*..\ ...  ..\#
# .... \  . .**..*. . \. \ *** \.\.  .\**. ....**..*\.*\..  . ***.*...\..\ . \..  #
#.\ * . * \...*  \ \ ...*\.\.*..  .*. .*..* *. . . *.\. *\ \***\**.  ..\\.. ..  . #
# . .*  . .. \*.. . ..*..**. .. .* .* ....\.*....  ..**..**.**.\.\..  \ ... .\\ .\#
#\..\..*.  * ...  .\  .*.\*. * \ *. . **.\*.*.. . * \  .*.*\.\    \ .\. **..**. .\#
#.*\ \ * ....  * ..*  \.* ..\. . *..* \*.**.   **\.  \.*.*.  . * \...* *\.....*...#
#.\* .**.\..\.*.** * \ *.. .*..*.*\ *\   ...  *.. . *  .*.\.* .*. .\* .*.  *. . **#
#\ .. ..*   .*. *..\* *.*.. *\..\*  *..\.\\ \ ..\*\ *.*..\.*..***\  ..... ..\.**..#
#.***   \.*. *\ .  .*.*.**  ***  . *.* *\ ..*.. ...\..**\   .\..*.\.**  ...*.*.* .#
#\..*. * *..\*.* **\**...*  \..\.\.. . *.\  .**.   . ..\.\*** *.. *.\. ..*\  *.**\#
#.... .*.***..*.. . .. \**..* \..** *  .*..\ .\  ***  .*   ....\\.*\*  ..*.    . *#
#..\ .*\ **.*. .  *\.. ..   .*..*.\.\  .\.   . ..*..   **.\.\...*\. *.. \. . .* \.#
#*   .* *..  \.*  ...\*..*  *\* .*. *.   *....\**\    ..* . .\**. ...*\  **\ *\.. #
#\ . ..**\ *..*\ . . ** .*.\.*.*.*...*..\...*\ ..\*.\ * *\ \. \. \..\.** ... *....#
#*  .***.  .. ..  .....**.\ ...* .*  .*.*\ ..*.\ * .  \*\ *\.*.*. .\. .\.  * .*\  #
#\.... .* .  \**. \. ...*\..*\\...... .\.* *\.\*\. ...* \..*.\*.\ **\*  . \ \ .*..#
# * .\....    *. . \.. \*.\.\.**  \*\.\.*. .* *..*. \ .. **.... .**\..* .... .* *.#
# .\\ *.  ... ..   .*. .*\. *..  *. . .\.. *** \ \.\..\ \..**.. ..* .*..*.* .\. ..#
#  *. *. .   .\ *.\ .*... * .\  ....  \.\\* .**  ***.. ..**..... *.  . ***\.\  .\.#
#\*.***...\   .\..*. ..*  . *.\. . .\.*\. .. .*.\.. .    .\ .*.  .* .......\.\\ ..#
#*\ .**....*.**  .. .*...  ** * ..... . *..*.\.\*  **..     *.** \.\\ ...* . ..  .#
# .  ..\.... *.\*.*.\.** . .\*.  *\.   . \ ..  .\ **.*.\    .**.  .  \. ..\*. *..*#
#\.*   * ... **.  *. .*..*. *... * **\*\ *..*\.  .*..\...   .*.*.\ .....  .*.. . .#
#*\.\... \* *.. ..\**\*. .*.. *.\.\.  \.*** **  . *\..   .. ..*.. * \\**\  .. * *.#
#.*.*\ \**.** .\ ..** *.*.\  ..*\* **....*.  \.*\  *\  .\.\** \.\ *.. ...   .*.. *#
#  *\.\  * ..\**...\*.*..\.\* *... ..*..\.   .\ ..*  ..**.*.*\.. .. ..**..  .* ...#
# ... .  \. .*.\.\*.*\\.. * *..\ *..\.  .    ..\* *.*.*..  *..   **.*\  \. \.*\*.\#
#.**. .   .\. .   ...*\ .***..   **\.  .* . **\ \  *......*\**\  . ...*...*.**..* #
#..*.  .....***. ***\* \...*  \ *\.*.**.* \**\ ...\.. .*. . .. . *\.**\. \.*.\*.**#
#.    \* \..*\.. . ..  .*     ****.\*...*.**\.  ***..* **..   *..\...*.* \.  .....#
#*  **.*.\ *\**  ..\  \..  . * ..***. *\* *.*.**.*\**\*****..... *.  .***.*. \ .\.#
#.\ .*.* . . *** .*.. .  .  *. *..*.  ...*.*\.* .**\ \\  .** *\ \.\ \ ..***\ ..*.*#
# ...**.*\ *. ..*\...* **.\ .* * .**   \.*\.**\  ..... .. .*.\**.*....\. .*   **.*#
# ...\.\**.  \* *\ \.*.*.**.*....\\. *...\. .. .\\ * ..* \*  *.\*... . .. \.*.*.**#
#.  . **.*    . * . *.\. .  * .*.\\*** \..\ **  .\*\*. *. .. .*.*\  *.*  .......*.#
# .***.  * .*.* .  .*\* . \.. .* ..\..\ *.  ** ..*.**   .\\..\* .*\ ..\  **\....*.#
# .*.. * . \  . .*\ . ... .**.*.   .   \.*. .. .\.\...*.*   . *  .*\ ...*. \\.....#
#   **\.\. ** .  \** *.*  \..**. *.\.\ .\.\. *.\ *. .\.**.....*\.\.* \... .*. *..*#
# . . . .\ ...*.\.**\. *  .\.**\   ...* ..  .\  ..\\  \*.  \ *..** \....      .. .#
# \. . *.  .\.....*.*  *** *\... . **\.   .*\..*...   ..\... . ..\ .  *\.  .. .. *#
#.*** .... .*\*  \.*\  **. .. .*\*.\.. . \..*  .***\ *  . .  \ *. .  *\  .\ .\.  .#
#*. *   *\*..      . .. ..* .  . *.\.. *.     *\**..\.. .   *\*... **\*  ..*...*..#
#. *.   ..*.  ..   .*\ * *..*  *.* . * \  .\ *. * * *.**\. .\..\. ...  * *.. .....#
#*\.. *....*.\  * **\**.* * * ***    ..     . ..\ \*  .*  .\*    \ .\..***    ..  #
#\.* *..*.\**.\.  **. . .*. \. *.  \  *\*. *** ..*..\...\ ..*\*  .*.*..\...*\*   .#
#*   . *.. ..\     *\.   .*.  ...\.   .  .  *\* ..* *\ ...**.   . .\. . . .*...*.\#
#*\.*.\. \ .* * .*\   *\. .  . . *.*.*. **. *.. \....*  \.*.\ . \*\.\*.  .\**...\\#
# *. *. . .*.\ . .\ *.* \  ***  .*  .\ ...*** *\*.   * \ *.*.\.. .** .. *  .*. .  #
#.\*\.*..  .    ****..*..\.*.*\* .**\  .  ..\.. *\...*\..\**. ... .\.... \* .   **#
# *  \\*.  .\. .*. *  .*  .\ ...*\. . *\* \.... .*  .* *\.**\*. \*\.**.  .. .  *\ #
#.* .. .* \...****   .*.**..**\.*.  \ ** . .**.  .   . \.***.  *.***  ..** .. \*. #
#..\.\. ..  . .* \. ..  \*  *.\....\. **.. *. \    \ *. \.\*...  .*.. \*. . \..* .#
#  . . **. *   **.\  ..*..\..** .  .. *.  ..\ \ *  . *  .\.*.\\  *... .**....\ \  #
#.*  ..*. ..\***.. *... .  .*.  .  .\..*.*   ....\..**\\*...* .. ..\   .* * .*  .*#
#*. .**\ \   .**.  **...*\.\.. ..**.*.*. *. \ .\. .* \ ..\.*.   . .  * *. . \..*. #
#\* .\ .. .**...   ... ****.**.\  \...**\ *... ..  *\. *..\\***\..*\ . \. . .* ..*#
# .\  .. .\**.\**. *......\...  \.. *..** *  *    **. ...\.  ..*.\. \ ... . ..*. *#
#. *.\.** *..**.*.*..\*.*.  *\* .\ .\.* *.  . \.*..\*   ..\ ..*..    ...\. .  ....#
#\.* **.. . . \ **   .*.**\.***.\   .***.. . \ \..\.\ \ .\..  .\* .    .. ...** ..#
#* .**..**\.*\ . ... . .. . ...* .*. *\ * *\. ..    . . \*  *.\.* . ..    ..\.. *.#
#*. ...*\..*...  \ ..  \**.***.. ..**.\.\* ***....\  *...  .. *** *  \ \.  .*  \.\#
#. \.*..*\ .  ** .*  ......*.\*.\ ...  \.*...**. .\  \.***\  *\ *   ........ . ...#
#. *\ * .*.*  *.\ .*.*\.   ....*. .*..*. .*\ .*  *..\  .\.\. *\\.\**\*.* ..*.*. . #
#*... .\ . .  ...**\ *.\.*  . \. ..\ .....**  * \.\..* .   **..\ ..*...*\.\  .  . #
# **..   *  \* \\* ....* ...\ .*.\. .\ .....\*. .*  *.   * .. \... .** .    .* *.*#
#\....  *.\*\*.* . . .\**.*     . \ *. *. *  ... . .*. ..\.**  *\.* .  ** ..\.***.#
#\* *\. .*..*...    **.*.**\.. \*\...... ..*. \. *   .\ . .* ...  ....  .   ..\.* #
# * .  \**.\* \. *\..\.*\*. \ . . \...  .\ \  . **. ..*   *.  *.*.. .  ** *.\ .*.\#
#\. .... *..* ...**. ..  ..... * *.*\ .\.# ..\ * .*\  ..  .\  * *.....**.\.*.\*** #
#  \.\\. *. \  *.\ .. .   .*\  . \**.. . .   * ...*..*.. .   \*\*.*\..\..  *\* #.*#
# *.*.  ..* \. *.. .  . .**#.*... *\.    **.** *. .*..* \.*.\** ..*.  . *. .*. .*.#
#.\...  **\ .* \   **.* .\*. .\*  **. .  ... *\. .... . .*   .*.* *  \.**...\ \ . #
#*.\  \..... . .*.**.**.\. .*\*.. \..\*. ....\.\ \**   *.* . *. *\..   ... \. ##  #
#\.... \ ...  \ . .\..*\.\. . *.    \ *.*. \  .**\.. . ..*.\..  . \ .\ \ .... ##\.#
#*\*  \ . .   . \ ..*. * ...*..  ..*.\  *    \*\*\  * **.*  \*.... ..  .  **..*.###
#* ..* \ . *.*..**. . *.*\ .**\   \ **.*  .  * *. .. *\     .\* \.  .*\*. . *.##  #
#. \ *..*  .* **.*.  *.*... *..\ .. .**.\\. ..\.  **\..\ *\..  .#. **  .* . . *#  #
# \  .\..*.\.*\.\..\.  *.*.. * *.* .\. \..  # .*. .\ \ . ..* .....  *\**. .. \#   #
#*.\. .\ .** *. * . *\ .**.***\ \\ \*.*...\.. \**..**  *. .. *\*.  .*..**\ .*.*#  #
#\**. *.  .* .* . ..  . ..*....*\ . #** ###..#.#** .\ \. .\*..# ..  .  \.*  .**#  #
# .. *.\ \ .*.. .  . *. .\.* \..##\\**...##* .*\..**.#.*. .*  *#.. #.    .**..#   #
#..\..   .* *\**..*. .*.   .\   ....* \###***#\* .*..  . \ . \.\. #*\ *.*.*.##    #
#*\. ##.#  .* *\  .*. . #\  . \.**\*\.#   ### #* #. # ..*.\   *#.\#\.#*\ ..\#     #
#*\ .\#..  . .\  *\#.\ *. \ ....\*#\*\#      #.\#.\*.## #*.  *.*  #*\#.*.\ .#     #
#.  . *...\..   **.  .* \...*.*. ##.##       #*#..*.  ##..#.\.# #*  ##.# .*#      #
#*\.*##. ..*#L** *\*  **..**...  ##.#        #.#.# *\#  #.#### # ##.# ##\.#       #
#.#.##. \. #  #\*.###*\..* .*  *\ \ #         # #..##    #         #    ##        #
# ##  ##**#   #   #  #*.* .\. \.##* #           #\ #                              #
# #     # .#  #. #    #** **.  \# ##            ##*.#                             #
##      #\#    ##     #\*.  #. #               #*. #                              #
#        #           #\.\. *###                 #\#                               #
#                     #**#\.#                    #                                #
#                    #\\*.. .#                                                    #
#                   #**.. ..\#                                                    #
#                   #*.#*####                                                     #
#                    #* * \#                                                      #
#                     ###*#                                                       #
###################################################################################