################################################################################################################
#                                                 ###.\.\.   .\ .   .\ ** ..* .\ *.   .. .*\.**..**.*.**.**.  *#
#                                              ###\\# \# *  *.*.*...* .*\\**.\.* *..\*    * *\***.\.*. \ ... **#
#                                         ## ##\ *.* #\  .\..** .* *   ..\*..\ ..*  *\ .    . .**\  .  .  *...*#
#                                        #\*# . ##\* *...  ..*.*.\ .*\****. *..\ **\*  \....*\.**.....** *..\*.#
#                                        #*...   \ \*. .*.  \** * * .... ...*.   * *. *.\* .\*..* . ***. **  . #
#                                        #.*.**  .*.*\  ..\*.*. ...  ...***. *** . . ...*.   .\*.\ ** \ .\.****#
#                                         ## *.\\*\* *...**. ...*.. .\*****.\*.\    ** * *.  . . .*** . ..* ..\#
#                                        # #\...\.*.*..*.. ..  *..*\*..*\..... . *\ \* .\.**. ..**..\  . *\ \..#
#                                      ##.# ## #.#**.*..\*\\.  *\..*.\.*\.*\*\.. .\.*.\ * ..  . ..  *.*...**.  #
#                                     #..*#### *\....* *#*. ...\*..*.   ..*..  .\ ***  .\.   .  ** \.*..  *.  *#
#                                      #.   *.#\.  \ . *..\  .\.*. .  .** ..\. \.....  .  \* . .*.   ... ***\*\#
#                                     #.* *\*.#. . .  \**\ . *..\  *.***\ . .*\...*. .* *.*. ...***.* *...*  \.#
#                                     # . \*.*.*..\ .* *....*. ...*. .*** .  * * *.. * \.*.*.. . *\ .  \. \\ . #
#                               ######.*.. * . *.*  ** \..\  **  ..\**.*. ** \.. *   . .. .*.** ..*\...\    .\.#
#                              #..  . **#  *. \. *  \**. **..\\..\ **  .. *\ \      . . * *.....*.\ \.*.*  * . #
#                             # *     #**#\.* .  .*. *. . . \.    **\* **  . . \.\.. *.\*.*...*** .\.\\ . *.**\#
#                             #.\* .\* #..  ..\* \ ..\..*\ .. ***...  \ .. .*  .  *  \ .***\ *..  .*.. *  \*..*#
#                             #\#*\\ #**.* .* .* . .\ \.** *\\**.\ .. .. .**.** ...*\...\ .*\.. .*..* **\.  . .#
#                       ###### *. . ..\..*   .* .*.  \.*.* .*.*. ..*.*....\* ..... *.\ *.   .*...*   .... \ . *#
#                      #*\ .*.\.*.  \* *.#. \ .   .\   . .\ .\... .......*...  .\* ..\.**... *..*..   .*..*    #
#                       #\##\**....**...    *#* . \. *. ****. **\.** *. . **. .   *.*. .. . .  ****\*\ *.*.*** #
#                        ##* .#.\**\ .\.*\*. .. \.*.\.. .*...***  ..*.    ..*..**.\ .\... \ . **.\*.   **.**\.\#
#                         #* ..\*** .\* ... \*  . ....\ *\...\*  *.  *.... *.* *\  \. .** .. ... *.* * *.* ***.#
#                         #*..#*.\.*...  .  ..  . * ..*\\ .  *  \..\ **   *. . .. *.\*\*.. \.*\* . .. \ .* .*\\#
#                         #*..#.*.***.  .*. .  .*\.   ... **..\...  *....*\*\*\**......*..\.\. ..  . . *\..**..#
#                    ##   #  ...\*..#..  *..\ .  *\ **  . .....*  \\.* \ .\..* . .\  ..\. . *.**  . . \* *...* #
#                  ##\.# ###. \  .\ ..\\..*.  ..\.**.\ * .   .. .* . ... ... *\***.* * . . .*.\...   ..*\* . . #
#                 #   ###* ..*.*.*... \   ..*. \ .**....  .\    **.   . .* * * ..... .. .\.\\.** \.*..\.** ... #
#                 #. ** #*.  .\ \.****...*\* .*. \..\* \ ***. ..*.    .... .*\ .**. *.\...*.  .  . ..***** \. *#
#                 # .#.\ . . ...*.\*.\ ..*.. * .*.\  ... ... *  *\. \\.... \*..*\   ... **.   .*  \. \ *.. .***#
#               ###  . . \    ..* *....    \ .\\.\ .***\.*. ...*..* ..  * .*.  *  .. .. \..*. *.* .\ ... *\ .**#
#              #.\... **.. .\\.*\ ...  .** *  .\.  *.*  ...\* \..    . *. \.\ .***   .\..\ * \ .* \.  \.*.*.*..#
#               #.\.\. *\..*.\\**\  .\***.. ........\\\. \*\..*   ...\ .. * .   \*.* .... *  .\*. ..*..** \*.  #
#                ####.*..* .**  . .\* *\....\.*.\ *.  .*... *.  .  ...\ .\ * *\..\** .\ *.      . *.** \* .. \.#
#                  # *\.**. ..**.  ..* *\.\ * *. ...**\..  *.. \ \ ***. *. \   *.*...* **..\ \ **.* .. *.\*\.. #
#                  #.\# **\. \.... \ .**.*. .  .. * ..  .\*. .\*...  *.  **\\*.... *...\..  ....***\*. . .* . .#
#                ##  **  ..*.*  *..*... \...  *.\.**.** . . .***.** . *...\ .. ..*.. \...****  *.\... . .*..**.#
#               #. * *#...** \.*..**. *\ .   **.\ ..\...*.*  *.. .  . *.* .....*.\ ... \. \... ...**.  . *  .\*#
#         #    #*.**.*..... ** **   *.\* .* ..*\**\*. \ ..*\****.. .*.** ... . *.*.. *  .\ * *..\ *... ..****..#
#      # #*#####*.** ..\... .*\.*.\ .** * .  .*......    \ ....* *..\.*    *.... . \....  .\ .***.\ *.. **. ***#
#     # ##* *\ #.**.**.*\... ..\. . \.. * \*  .**\* . \ *.*  .**... \ .**.\*. * *.  .\*** **\ ****.\*\. .. ...*#
#     # *.\#.* .**.*\...\. \.*.   .*.. **\  ....**.*. .   .\. **.\.. .*\..*.  .*.* .*.\.\\...\...**.* *\ . \. \#
######.#\\ .. ***\ *... ** *. *.\... **..** **...  *. .*\*..  ..   *.*... .* .\*..  *. ****\*  .\..**... .\...*#
#\**. .* .    .\*  .\# . * .. . \ .*\\.. *.\\* ...*\\. ... . * *.**\ ..\.\*. \****\\.  *... .  ..*.***\  ....*.#
######\ .* **.\* \.   *\ .\ *\* . .\...\** *   \ .......\ .  . \..\.* **.* . .\.*.  .\*...* * .\....\*  *..... #
#   #.*..*\..*..\*\ ..*. ...\.\ ....\. ... .** \..   \**..*  \*  * ..*..**\ . * .*.\\..\.*.\*\..**\ ...**  .\  #
#   ##\#.*.  . .*.*.  .\. *  *\** *\  .     .*  .*\.  .\. . . . *  . . .\ *** .* \ **    *..*.* ... ..*\..    \#
#  #.#. .   \  *. ...\. *....\.*... .\  .. *  .*.*\ \. .* .\ .\.    .. ...*\*\  .. .. **... .*. .  **\. .\.\.**#
#  #\ . . . #*...**\.. *.**. \*  *. ** \.  * .*.\\.*.*.*\ \\.\.  ...*.. * ...* *. .**....\.\*   . *.** . .. \..#
#   ##.  .. .*... .* **.\ .. ..\. \ ..\.**   .  .*\  * ...*.\ *\. .*.\\\*  ..**\*.\ *.  **\.  *. ... ..\     .*#
#    #*   *. ...\ .* .. *  ...   \     ... ..... .* ..* *\..  . .* ...***..  .\* \ *\\ \**.\.*   .. .\. \...*.*#
#     # ** * .*..* .**\ ...  **\ .\ .*.  *\.** .  .. ..* .*   . *.\  *\.. ..\*..\* .  . *.\. **..*. . . . \*..\#
#      #..*.  \**.  .\** ***\*..*  *..* .. *.\ *\. \*  *  .*\. **..*\..**.\.*.  . .    .. .* . ... \.\. * .\* .#
#      #*\.*\*. \.    ..*.\....   . \. \ ..\ \..*   . \ ...*.  *..\.  ...** .. * .*\.  * .**\.*..*\.\ \ . .*.  #
#       ##\\*.\*. \.*\ .\.... * . *\ * .. .** .**...*  .\.\ *. .\. . \  .\...**..... *..  ..  .* **\ *..\  *\**#
#    ####.... .*. .*   * *  . .\ \*      ..\.. *. ***** .  \..\    *\.*.* **.*.\  * \ ..  * * *. \ *.*\ .. \**.#
#   #*.  \*\   ..*.**. \ * *..  . **.* . *.**.* . *..*.\. \.**\.. .*\ * .\*.*..*.*. .  \*.*.. ** .*. .*.    .. #
#   ###\...#.*.\*.  ****.*\.\..\ *. .*. .*..* .\ ..\ . ...* *\ *... *...* . *. *..*  \ .*\. .... *.\..**.** .  #
#  #** . #....*\   * ..*.**.  .*.**. .**. \ .  . \\. .. .*. . .*.* ..* \*..*** . *.. *.*.**.. * **..  . .* .\ \#
#   #*#L . *.. *.*. * \.*.** . .*..* . .\ ..\**...\ . . .****. **.   .\ . \*..\. .* ...\ .**. *\. .* .*  . . *.#
#   #*# #\*.** \... ... ..* .  *.**. .  ..*\*.*.*..*.\ \. **.  **\*.\* . **.\ *.  .*.  *.*.*\ ... *. ..*.   *. #
#    # ##*# *...*.. *..* .*  .*..*. *  .  .*\.* *\ *\. . ..\*.*\..... .. .\. ** .  \  **\  ....*..*\ * .  *.*.*#
#     #  ## .\...***. .. .*.*..* ..*. * *. .*\.....\..  . *..\. .\..*.   ..*\. **.\.  *.*.\*.* **\.*.    ** **.#
#     #\  . *..\. ...# .*.. . * ...* .*.* . \\\. ... * . *.\..* \.  *. \* ..* ..  ...*  ... \.**. **   \.. ...\#
#      # #  \.**..     ..* \**. . .. **.. *.. \*. .* .. **   .  \ . ..\*.\ \.*... * \.*.   \ \*.  .**    *.*. .#
#      #.#*. \.. . *\. \*\..*. . .**.*.. .\ .\...*... . ..* . .*\* *\  . .*  ***....*.. ..*.*.** \ ... .......\#
#      #\..*\..  *  \.* .. ..   . . ..*\.*.\.. *\. .*. .  ...*  *. *.  .\.*. \ **...* \ * ** \ ...\ .** * \. \ #
#     #\*\..\\ . .\.\*.   ..\.*.* . .*. *.  . *\ *\**..*\*.\\. \.***\.    ** **.\ * .*...\.... . . * .. *\.\  *#
#      #.\**.  *...\...*.\**.....*.. ** ** .*.\**.*. \*.* * \.*..* . .  .\..\.\  *. \*\...*\\. \*** **...*...*.#
#     #* #*.\*.. *\  \ . ..  *....  ..\*\* \*     *. ...  *.  *..**\.*  ***  *... *  *.*. .* *\..**\*..\  *. \.#
#     #. .*. .*. \.**. . ....***.*..*.. **.. \.*\ .*.\ \.*\ .****.**\* .*.\.**\.* .\ . \ ..*\*. ...*** ..\.*..*#
#     #\.\..     . ..\ ....**......  *  \.. *. \. *. ..\*.* ...\. .   .   * ..*.  \..*. .. * *.\   ** *  * .*\.#
#      #*#  ..\# *.**. .*\..*.*\*.. ..*\. ..\ *\ **\* \ *....  ..\.\ .\..\..* . \\ *\\.\* . .* .. . *.* \.*.. .#
#      #. \* *..*.*..* \.**\. ..* \**.**\*... *.**. . ..\**.\  .* . \ \* .**....*.*.* **.   ... ****.** ..   .\#
#      #*.\*.#\ .**.*  \ ..*\   ..... .\ .\ \. *.. *. ***.. ..*   . .  ....**.\.. *.. .\*. *  .**\\* \.\.\*\*..#
#       #.*\. . ...\** ..\\*.  *.   .  . . .**\..  .\ .*\.*\  *..*  \\*\*\ .. . . .\*\   ..\  .*.   ..*. ** \ .#
#        ##...*  *\..\.*  * \\* \    *\\\** .\\..\. . . . . .....**.*\\**** \...  . *.* . .. \*.  ****..* .. \\#
#        #* *#*. \  *.*** \* .. .  *...  .*.*. . ... * \\  * ..*..*    *...   \. .**\* *  ** . *. ....  *.*.\\.#
#        # \ .#**..*\ **. .*.\.* *.... ..*\. .*  **.*\.*.\. \  *. * .......  .. **\* .  *.*\.  *\*.*. .\*.*.*.\#
#         ##*.\\. .. \.*\ .    . .*   *\ ...\ *..... .  \*.*\ ..\ .. *.  .. \.* . ***   .*....\.*\ . . *. \..\.#
#           #. *.#\*....  ...**.. .* *.*  * * .*\.***. ...*.*.\   \  .. .*.\*.. .\\.\** ..  **... . .**.. **\ .#
#          #**\...\.     ..* *.*  *.*...*  .. \*.*. .\  . .*... .\ ***\ *\..*. *.* .\*..* . ...      .\    .*\.#
#           ##*.\.*.*.\. \ * .\.* \ \  ...\.\..*.*** ..  *...**\.. \.. ..\ ..* . .* \.* *.  *\. .\**.\  *  \..*#
#             ##.** \\.\** .  ..**..  \*.  \*.*.*...\*****..*..*..  . . \**.*.    \  .**.. .\  ..*..**\.*  .. .#
#               #\.. .. .*.*.*.\* \ \\..   *.\. *.*..*..*  ** ...  ..\ . **....**\**.....*.\ *  .*....*\.\ . .*#
#             ##*\.  .\ **\*    ... .*.* \*.*.  **.**. ..\ *  .... ..*. .....\ ... *.*.  .\ . ..*   *.*... .\  #
#            #*..*\* .. ...*** *. ......*.\**   **\.. .**.\ .*.*\ .\..*. .\*.*** *\.*.*..*\**  **.. *\*  **. ..#
#             #\.* .  *.  *.... * \  .. *\ ...\. ...\ *.* *.*\*   *  *.  * .*\.*.* *    .....  .** ...*.*...  .#
#             #. .  *\.**\.\.*..\.\ .*.*.**..*...     ..*  ....* *.***.\ .*.....*. .\.\  .* \.  \.. . ...*...*.#
#             # **. .. ***** \. *. .*...\.. *..\..*\.  *.\   *\*.*\..*  .  *.  .\**\*..*\*. .  ***.\.\..\.\ *\ #
#            # .*.  \.   .\*  .\**  .. *  *. ... *.* . * *\ .*.*.\..*.  . *\.  .\.. \.*\ *.  **.\.\.**\ . \**\ #
#             #. *.\ . *.. . . *\* .  *  \.   ** \** \..*..\*. .  *.*.\. ..* .  *.*   .  .*...***\. *. **...\  #
#              ####\*. \**.\ * *. *\.\.**.\ **\ \...* . .* .\.   ..**.*   \..\.\**. . ... ...*\*.*.\.** . *.. *#
#                  ##.* ..  .. *.*....*....*.*. .*.*\ \. ..**\*. *... .   .*.. ***..\ . ...  .*.*.*****\ .*\ *.#
#                  #\ *.\*\* *.\. .   . \* \*. .*..**. \ *..\*.* . .*..   . ** .*. ...\. \  .\.   ..*..\ . .*. #
#                #### # .. .\. *   . * ....   . ..\ *. . .* ..**\ . . .**.....    ...*.\ .\ .**.*..   ..*\*.. *#
#               #. .. . ... ..\.\.*..* \.*..\**\ \\  ..*. ..  ** *.\ ..*.. .*.\..\.* .\.* .*\*. ** .**.\.** .**#
#               #.. ***\\*\\*\*.*. \**\*** .. \.\.  ..*.... .\.. ....*...\  *\.\.. . *. \.*. . .\* \.... *. \.*#
#              #* ..*. .*.....**.\.. ..... ..\*..* . . . .\\.. *\ \* . .  \... * *.*.*\ .\.*\  **.\. ... * **  #
#               ## .\  .*..\ \..\ .\. .\.   . . ..  .  . ..*.   . .* *\  ...\ .*  * **  *. *. \*. . * *...... .#
#                 #.#  . ..\.** .   \.\..*      * .  **  *.*\*.  **....* .. * \. . \...\\*\ * ****\*.\.*..\.  .#
#                #...\*  .*... \   ....* .*\  *** *.**.. **\ ..  \ .**     * .**   *.  **\. * .\  ..\.\  \.\*. #
#                # . \  .*.\ **. **  \ .  ..* * . . .\*  \. *. \*.  .\ . .*..\.\**..*  ... ..\......  *. .\*.*.#
#                 #  #.# ... \. **  . .*.....**.*. *  *.\.  .  .\..*.* .* .*\** .\ ..\*.***\*\*\ . .\ *.....  .#
#                 #  *\*.  *  . \..   \* ...*.. . .. .  .  .* .\.\\. *\..    .*\ .... **.*.**.\  *\*  ..* \ \ .#
#               ###* .*.  \.  *..\   ..*.\. .. ..  .  *\.. *.  .. .\ ..   * .** ..\ ***\.  ..\  *\.. * ..*.  *.#
#              #*...\ **. .  *..\   *\ *\..  \ ***.* \.*** *.\*. ...*   * ..**.   ..  * \..**. * .\ .   .\.  **#
#              #* .\*.\.*.  .   **.... ..\ .\ ..* . \ .**.\.\.\ \.. *\ ** *\. .R \\.***.* .\   .   * ***.\ . *\#
#              ##  *\.*..\.*\ * . *\.\ .\. .*   . . ..\.\   *\.*... ** .. .   .* .\ .\*. .\ ....*.\*\*.. .  .*.#
#             #.#\ ..  \*.\.*.* . ***.\..\  .**.* .  * *\  ..*.*..\*.* . .. .. .  .\ ...* *.  .\..*... *\ .. . #
#             #.. #\ ..#*\  . .* \**.\*. **.\..\ .*  ..*\ . *  *.  **. .* ** .  ..\.\ . . \\. \. .\*  \*.*.   .#
#              #\ \.*\ ** *\ ..   .**...\..*.**..\ \.*...**..*.. ..*.\.. *.* .***...**   ..\\ .  \ .   \\*.\.**#
#               #*. .*\*... . *\ *****... *. .\* .\ ..\. *\*.*\.. *. .  ..... * * .\...*  \.*   ..*. *  .*.. \.#
#              #.**  \  .  . ...\* \*.  \ * .\..**...   .*.. .*.\ . ....\*\..   * ** .**.\.***.\**\  .\*\.  ...#
#              #**. .. . ***\.\*.*...*.\..*  .*\...     ..**. .\.\* .* \*.\.\. .. ..*.\* . .. * .  ..  . ...*\*#
#               ###   \  .*.*. .\.\.**.\****.*.. \*.*. \ .... *. * ...  \..\ \ .... .* *. .. \.. .  .... .  * .#
#                #\ .\.  ** \    \  \*\ \.    *...\ * .. .\ ...*...\.*\..  . .**\ \ \.\. ..\\.**\ *. .   \* .  #
#                # .#* . ****  \ \.*. . .  . *.  .. *  *. .* * ***. .   ..    .. .\ .  .*  * ... *.  *.   *\.. #
#                 ##\*##* ...\*.  ** ... .*   *\** \** .\ \   .\..*  **. ...* . .. . . \. *.  .\*. ..*  *..  \ #
#                   #####** #..*.   ..\   .** .  *...\.*  \.*. .. ...*.* **..\* \\ .   ..*. *..*.* ***.*. *  .*#
#                    # \*.. .\ .. .   ...\*\.  *.*\*..*.  \ . . .. . *...*\ . .***.. *\.\  *\* \.*.\.*. .\. .  #
#                    #\..\ \ *.** .. . *..   .*.\ ..\*...\...      *   .... *.*.*.* *. *.. .**\... .*.*..    \*#
#                   #.. *... .*.#.\  .*. ..\*\. * * *..** .*     **. * \.* *.. ..*. .\ ..  .\.* \ .\\.*\ . .*.*#
#                    ##\#*  *\.**#*  *..  \.****. *..  ..\.....\.\..    .*  .**  *\.***\ .*\*\.*.* ..*. . .\...#
#                      #** *.  .**\. \\.. * ..*.  .\ .\    .\** *.\ .   .    .*.***\ . **.\***.**  * .* .....\.#
#                       ##.*\.##..   * .\.\*.\. *.*.... \  ....*. \ .* .*. .  .. ...*..\*. ... \. .**..* \\  *\#
#                         ###.**. \  .\ ***#   *. ....  .*.* .*... .*\. . \*  *...... ** ...* ... \.. *.\... * #
#                           #.\*.. .     ..  *.**\ \* .\ .*    ..\ .*... *.. *..** *  .. *\.\..  *.\ ..\.*.\.* #
#                           ## \ * *...* ..**.* . *.*. . .** *   .  .  ** .\..*....*.  ...   .\  \.  .\**.*. *.#
#                          #* **.  . *.*  ..*** .*** *\**  \ \.  *.*..*** .   .* . .* *  ..***. *...\.**\\.*\.*#
#                           ##*.#..\.. *.\. .**.  .***...*\..\.*....\ ...* .*.\.. *.\ **\ *... *.\*.**.  *..  .#
#                            #** \\...**\*\.\*.* . ....*\. .. .  * .  .  . ..\.\*. ....*  .  ..*. .\.\  *..*\*.#
#                             #\ .*\..\ #* . . .. ***.** .  ...\ . *. *.\ .\  \.*.\  .*. ..*\..*  .*.. .\*.. ..#
#                              ##\.  . ..\.  .**.\.**  *  ** \**  *\\.* .. .* .  \.* ...\**.. \.  * *\   **.*  #
#                               #..#. .#* * # ... \.. ....\.. .*.\\.  *.* .\..*  * .*  .* * *\.** *.* .*.\.*\ .#
#                               # *\.*...\\..*.\ # .** *\.*\   .. \.  ...\.**\* \ *.*.* .*\    .*.\. .. .. .  .#
#                                ####\. ***.*##.   *.\  * \**. \**....  ..* .**\...\. .  .. ...*.\   **\*  .\.*#
#                                    #..... # #*.**. \  . .*  *. ..* *.  .\ \.**\. .. ..\. .*  .. ** \.*.\.* \.#
#                                     # .*.\# #*.#.  *.\.  . * . * \.*.*\  ..\ *\\ . . *. *\  .. .*.*  **..*...#
#                                      # .##   ##. #...  .*.*\.. .*.\ \ .  ...*  . . **.\.*. *.\* .  *...\*. * #
#                                       ##      #.... ... . \.\*... *.*.  \.* ..\ . ***.  ..\...*\...*....*... #
#                                               #* ..\* \.  .*. .*\\   ** . \  ... .\*.  \ \  *\.\ *  \  *.*** #
#                                                #*. ..  **\**  *.......\  ..  *\. *.  \ * . *.. *.* . ..*...* #
#                                                #. . \*. *.....* * .*.** .  *** \ *  ...*   .* .\ *.*.\  . ..\#
#                                                #\  \*.  .  .. ... ...\\ .*  .. . . * .**\ ..\   .*  .. * \.**#
#                                                # \ .\..  .     *.**.*.  .. \.\ \   *\... ..*.* **.*.. .\\ ...#
#                                                #** ..\.  . *#\ \ .*\  *.. ..*\.***.*.   .\..*......\\.* *.*  #
#                                                 #\#\\.  .\.*.. ..*..\ *....*.  \.*\*  \.*   . \ \\*   .\..*..#
#                                                #... ** * ..* .. ...\**..*. . . ..*..**..*. .*\.\  . **\ .*\.*#
#                                                #*.* *. .. ..*  .\. *.\...* \..   ...*\.*...\...\  * ..  ....*#
#                                                 #\* ..  *\* .. .* .\ . \ \ ..\**\*..*. . ...\.  .\ ...   *. .#
#                                                  ### \.\*#\.* . .* . .\... \. .  ** **.\..\*.  **\* *  *.... #
#                                                     # .  ## \# ..\  *\  . .\ . .. \ *  .   .... . .\.  .***#*#
#                                                     #*..*# ## ..*.  * ...\. *.  \ . .. \.*..  .*     .*\. * ##
#                                                      ##.*.#  ##.**..*.\ *\*  * * .\.  ...  ... *\.* ...\ ...*#
#                                                        ###   #*.#*.\..   **.   .  *\ .\.\ . \  *. *. ...*.\..#
#                                                             # .  . ....  * .#   *..*..*. .. . . . *.  .. \. ##
#                                                              #  . #.. *. *   \...\*.  .*   .. * ..\#.*.*   *##
#                                                               # ***# .*\*.****.\*. .**...*. .**... ##.**\.## #
#                                                                ##*. \ \.... #*.#.*.*\#  ..\ \.*.. *.#.*.**  ##
################################################################################################################