#############################################################################################################################
#. . \  .  * .* .*.. .  \..\..*  . *\\.\ .* *. * * *. *... \.\. .*  \ ...\**.** .*\ #                                       #
#.   .*.  **.  * *. ..*\  ** ..\. .* *. \..*.  \\*** .\.** \..*.*\ \.  . ..\...# ..  # #  #                                 #
#*.*\ ....*.* \ .** .*\ * **\.**.. ..\ . \ .**** \.. **..*.* *..\   *\.\ . *. \  *. . #.L#*#                                #
#.\.*.\*\..**\ . **\ .....*.   \.  ***. . \ ....*...*.*.\. *... .*.... .\  .\.   ... \#\.#..#   #                           #
#\* ..*.. .* .  **. \*\  ...  ...........\ * .  . *..*.\* ...\* .*.. *  ..\..\ ..\ #*##.\..\## #\#                          #
#***\...  *   .. ..\.*.\   . . \ * . .\.* ... *..\*...\*\  .\ .. \* \   * . .*.  .**\. *#\#.**##.\#                         #
#\\.* .* *.. ..\ .\.\  **. .** ..*.\**\* *..\..* .*.* ***\  .*\.. *..* ..   **.\..\.  *\ .*...##*#                          #
#.. *. \\.** .... . ..*.**.*.\**  \***.\*.  .  .\  .. ...*  .*..*..*   . .  ... *..\ *......# *.. #  #                      #
# \..  . ..*.*\.* *.  **..\**..*\* .*..*\..**.* .\  .\ *\ . ...****..*\.\ ***... \  \..*\\   *.\ ####\#                     #
#*.*  .   ..*. \*  .**\. \..\. \.\...\   \.\.*.*. ..*..* *\. .\**..\ .  ..**. *\*. * *.* ..  *\  .. .*\#                    #
#.*.. ***\*..* .\ ..*.**.      . \* \...*...*\..\. .***. *.* *.*.. *  .  ***  ....  ..**\\*.** .#*.  *#  ##                 #
# . .. \...\.*.* *. . *\    *\*.  .***\.\.  ..**.  *...**  . * ... *..\.*... .. . .   *...\..\*\. \** *##*\#                #
# ... \  .* .\ *   \*\ .*.. *..*..\*.. *  *.* ..   ***..    .. ..\ .    . . .*.\*. * *\ .\**\.  \..\#  ....\#               #
#\ . *..  .\ .*.** *. .*.    *\*** **. .  . ..\.*.*.* \\***. *. \ ...\ . *.* *** * .** . *.*... .. **...# **#               #
#.\ ...*.*.*. ....*. \..\. ***. .. .*.* .*. *.*** . . .....* *.\*.. **.....*\*.*... .... ....*.. . .*. \# ..#               #
#. *.*. .*..\.\**\....* *.\.\.\. *\ \.. \ \ ..... .** ..* .*..  ..\.**  * ** *..   *  .   **.. \. .*....\.* #               #
#. .....  *.** .. .*\ . .**** .\ .* ..\.*...** ... **   ..**\.*.\  \...*.\.\ .*\**\..\..***.*\\. * .\ . **.*#               #
#. \* ..*.. ..  .* ... .**.* \... .*..\\. ....  ..*.\.\.. .**** ....** . .     .*.***.......  .  .\\ .. \.. *#              #
#. .... * *\...*.\ *..\ \* **.\    .\.*.* **\.\   .\**.*   .. .*. **.*. .*. * *\. *\*\*\. .\*. .\ .*\ ..\*. *#              #
#**...*.**.. .***. .**.*  .*..* * .*..\*\..... ..  .. .\*.. \ \\  \ ...  \* . ***..\* .   *..*\ *. .*..\..*  #              #
#\. .*\ . \. \.\.\  .. . **.*.. ..\.   .*.\ \  ... \*\.****.\\..\\. *. .\ . .... **.R.  ...\... .* ****#*.. . # #           #
#    *. ... *    *.\.*\ ...*. * \.. *\ ..* ..   .* .\*\ \.***  ....\.. . \ \ ... ***..\*.\\*\*\.***\* ... .. .##\#          #
#**.\*..  . ..**...***.*.\*. \...* .*..*\****...\. * .\** ..*.*  \*. ...\ ..\  . \..  ... *.***... *.  *.  #** . #          #
#. *. .  **.**.\  * *\.\ .\ ..*. . ...   ....*\ *. ..*...   .*.....  *\.. . .  ...\.\*.  .**.***** \ **.*#*\.*.*\#          #
#*....  . \***..***.**..   *  .. ...\...   .*..*.\\\.* .\..**. ..*\..**.*. .* *  ..* .* . *  ....*.. \..* ..*#*##           #
#.*.. .*  . \.* ...... ...*.* .* * **\\*.\ * . .*.*. .**..*\...* * * *.\*.  . .\*.* .*.  .\.\**\.. \ . *\ * ...#            #
#\*..*\..\*.\ \ .\*\ . .\ . *.\.\.*.*. .  . ***.***\    .\..*. .\* .. . .*..*    *...*\* . .*.**.\*..**** .* .\#            #
#*.**...\* ... .  \.*.**.\**.  .*  *.**  . ...\..*\*.  *.**\. .... \* .... **  *\.\... *.***.. *.*** .\..  \.* #            #
#...*.. **. .\ .\. **... . *.   ** \*. .  \.  **.*.. \.*\.*. .\ \.. \  **\  .\** \.  \.\*.\* \ *****.  \\   ## #            #
#\*....  *.* . ..*.. .\ \*..*..*.**.. ...\ .**.** .* . .  .*...  .\.\* *...\ .*\..\***..**...* *..*..* *. **.\ #            #
#*.\.*..\*   *.\.*\..**\ .  .*\.*. .. ..\.* .*\.  *.\* .*.*.  \ * .. *.. \*.. \. .*.*\  ...\...\.**.*.*...*.*. #            #
#*. ..  .*.*.*.   . ... .. ..*. *..  . .  .  *..* \...    .\.  **. .\..\  *.*\.*.*. *.\ **  .. .*.  **. **. \.*#            #
#. . ..\*... **\.**** **  .**..\.. \.* \.... * \.  ***  \ \.*.*...* . . ..*.\.**....*\. ..  \.*..* * .....* #*.#            #
#.* \* .\.  *\ . \*.*  . * .\.* *.*  . .\..*..\. \\..**..\.*.* .\..\*\*.\ **. *. . ...\** .  .. .\.*.  * ..\# *#            #
#*.. .\..*.***.*  .*  .\..\***.  \ ** *\..**... ..\**..   \...  . . ..\* .*.\*.  *.**..*. .\ \ *\\......\*.*# *#            #
#\  .***.*....\.\.**\ ...   ..*.* * . *. .*.   **..*.* *. .***\ * * \  .\ *... ..***.....   * \\.**.   .#.\*\##             #
#*.. .*\\ * .  **. \.**.\..**\. ...*.**.  . .*.*. **. ... \***... \. *\.**.\ * .*.   * *.\... \..*.*   .*\.#*#              #
#.*   .  .... .*\.... ... .*. *..  \**\. ..\.**\.\    .\\\.\* .  ..\ * **.\ ... .. .*\.*.*.   . .  *\ .#*.*.#               #
# . . * ...*\ .\ . *..*\ *.**. *.*..*. *\ *..\   .\..* .... *\* ... .* .**   \..   *. ..\.. ..* \\..*.. .*..#               #
#...*.\ .** * . . .** ..*.*\...\ **..*\. *.*** .**** .   \ \.*\*... ..\**  *..** * ..\*  ** *\. ..   *\..\..*####           #
#*.*.  * .*\  \\* .*.  \. ..* .  ...*.*...*..\. ..**...*     . .** * .* *\.. **.*  * .\...*.*  \.*\ **..     **  #          #
#  .. \** .. .. **\....\*  \*  .. **.*. *.  \  .  .*\  .\*. .*.\ .** **   **...*. .. \..* .*\ \. ..**** ..* ..\ ##          #
#*   ... . **.  *.***.   **\*.* ...  .. .\  .** \.\ .\ ** *\ .\.  .*\..\  **\. \*\ *..\..*....\*.\ ** .*.*     #.*#       ###
#*. .\.*.  .\**.\* .. . .. .*..  \***..*. *  ... \**.. *. .  ** *. .  *..****   ** . .****.***.. ...* \... .* *..\####  ##.\#
#*.* . *.. \. .... *.. ..  .**.......  * \.  .\ *...\ .\ \*.  .***.*. .\ ..*.*. ..    .\..*.**  ..*\.*. ..  .  #\ *\.*##...##
#. * *..** \    .\*.\\.* **.*. .\ ......*. .  \*.   .*    ..*. . ..*...*\..*.\*  .* .\...*\...*\ *.  . .*\ ..*. . ** .#*.## #
#.*. **\ *  .. .\ . *\** .*..*   .. .*\ *.* .* * *** *. .. ..\.*****...*..*\ .. ....* .**.*. **. .\*  . . .. *\*. *#\..*#   #
#\**\.*.*..  * .. *...**. .  \   .  .\. .*.*   \ . .\*\.** .    .*.\**.. *.*..\\. . .  .\ .   **..*  *  ..  \.*..*..\ *.#   #
#*.\. ...\**.* *\\.\.\..\  .\..\. ** . *.\ .\ .  *  * .\. \*..*.** .** \  **..  ...  . .\ *\.*\.*.* \*.\ *\\. .\\ #*.###    #
#.\.*. * .*..* *   * .. .. *  ..* *....***.   .  * .* .  \. * \.\.*... \ *.. ..*\ .*..\.. ....  . \ ..*.*.. .\. . .**#      #
#* .....** . * *  \****. *.\.\ \. .\.\* . ..\  *.\ . . ......*.\.*\*. \. .\\..*\. *..**......\ *..  \....\** \.  *#.##      #
#. ..   .* . ..*. ..***** **. \. *\ .*\**\ *. ..\.\*\**..*  **. **.. * ...* \\.. **...*. ** .*\. . . ..*.*  .\.  .\ *.#     #
#\ *\.*.*. \.  . .\..\. * \.\ .  ... **.\.\. \.*  *  .. **.*..* ..* .. .\*.\*....  * ..\ *.*\.. *...*  ***** ..* *####      #
#*.. .*\.*    .* * . . . \* .\.\.*\\   .. .   *...*     *.\.\  . **  .\..* *** \ *\. .. ..*\ *.*..*   \\** #  .\ .*\#       #
#*.\ \*.**\.* ..\ **\ .* ..\. \* *.*\..**  . .   .\* .  .***. .\ ..* *.. ..\\*..*.* . ...*\* \ .. ..... .*.. .* * ##        #
#\   .*\ *. * *\.*.. . *.. *. .. .\  .\.* .\ *.*.*..\*..*. .\. .*\.\* . **.  .. *.. \ ..**...  *.. \*  ..*..  * \.#         #
#.*.. *  ..*.*...\  .**\. ..\    *. .\ .**..*. .** ..* *\*. .*. \...*. *. ..*.\ .*  .\ ...*    . **\.*.**. \* *..**#        #
#*\ . \   *. \. \ .. *\.*. . *.    .\ \.. .\... .\.\. *. .*\*. \\..*.*\  ..** ... ..\ \*...  .  *..*.**...*.. . #*.\#       #
#*.*. * \.***.* .*  .*  ..**.*..  .. ..* .*.\ \. **..*\.... .*.. .. \ .*.**... .   * ...** \*   **. \**. *   *.\.  ##       #
#. ...\ ...* ..  .*\.***\. *.\  ..*\  .  ...* .. \.... * ..... ***\. ...... *.\*\ **.\ *..* . ..\**\...*.*\  ***..   #      #
#**\.*\***\.* . **. .* . \\. . *** * **.  . .\**. \*\. .\.*\.*.**.* .\   ..**\.*...\*.*  *\... *.* .**.. .#.#**\ **\\ #     #
#############################################################################################################################