####################################################################################################################################################################################################
#\...  .* ** .*.\..\. \. .. .  \   **.. .* *...***..  **\.\ .. . \.*\ . \.  .\.\..  . ..    . ***\  **.*\ .*... \* .**..***..*  .*\. *  .* * .* \. .*.*  *\ . *.*\.**\. \ .*.* .* .. . .  \ .*.. .*#
##*#*.#.*.*.  \ *.\ . .. * .\ **.  *.  *..... \*. .   *. \* .. *\.*. \\.  *\**\**   ..* .\  *.* ..\ *.*.***.*. .. . * \... .  * ...* .\. . *..*  .. *.....* ..*\*. .. .\ \.....***.  . .. ..\. *\..#
# ##.##.*... *....   . * *.*..\ .\.\ .  . *****   \*  .\ ..*.**..\. \.\* \.*.\..**\ .... *.*...*\ ..* ....\...**.   .. *\.. \.\.\  *\.* *\..***\\\. **  \ \ * .\ *.*\* .\.\. *\.\.. \. *..\*....  .#
#   ##. ... *.*  ....\.... ..* .   *\  ...**  .***** \ ...*\...*  ..... .. ** . **...... ..**. .  ...\\   ..* . *.   *... *. \ ...... *. *   ... *. .. . .\.\ * ..*.*. * *.. *.*.\* .\ .*\.*.*.\ * #
#   ##  ..\ .** ..\.\* \ . .\.\.  \ .   *\*.  .  *.  ....\.. .** *  \* *.. ..\  ..\\  *.  *..\*..*.  *. * . *   .** \\\*.*..\ **.\   .*\ ...*.. .\...*. . . * .\ *.. \**.. * .  .**.. * .....*  ***#
#  # #.\\ *....\.** ....\.*\. .. ...\.*. * \* . ..*  *..* .  \ . . \ .**.*.   . .* .\.*.* ....\ *.\ \.  *\... .*  ..*..*. *\.**  . .**\*.  . \*\ . . *. \ \*. .*.*.. .\.*\.* ..* *. ** .\ . * * .\.#
#  #  ....\**   ..*.   *****.. *   * *.\.* R. . ** *\..*.  . .\  .  .***.. *   . .  .\. \*\ \\ .\   ...**.\ *\  \* *\**\ \. ...*  * ..*...* ....\   * *.\*. ..*\..**  ..\ .*   .  . .\.*.*\*.*\*...#
# # . ..*\ .\ \*  .   **\*.  ..*.*\.   * .. \*. * .\*.****...*..*...\... .  .  *\ .. ...... ...*. .  \ .. .* * ... .*...   . . *..\ *. \ .\   \\  \ * . \.* *.*.*\*. \ ..  \ .\ *.. ** ... .   *.* #
##*\.*.\..*....*..**\... *.** .*  .. *\**.  .. .\ ...\*.*.*. \.*.. . * \.* .  \.*. *..\  *\... \*.  ..\ \*.. *\  ** . .\ ..\**... *.*  *.   * *\. ...  \.\.\. .\\.... .* *   ..\*.* .\  . .  * .\.\#
##\#\.** .\**. *\..*** ..**.\   . * \.\ .\.  *. *. *..........*.     . **.. \.\ .* ..\.* ...\.\.\\ **.  .\.  **  *. .  .*.\.**\*. * *  .*  ..* .*\..*..**.\ * .. ...\****. ..*\.*.. ...\ .*\***..  #
# ###\*\  . .... . .. . ..*.* .  ... \ .  . *.\*.   . . \*\***\.. .. \ .*  *.    .\*  ***.\ .. *. \..  ..*\  ..\ * .*** *\. ...*\ . .*..* *\.\* ..\.\.\. \...* ...    *... *\ * .. * .*. .  .\* .. #
# # .... #.* .*\*.*. ..\ .* . .*. *\. .. .***\ .\. *.\. ..*\...  \.  . * .*..\*.\ ...\.  ..*\ .** *. *\*\.  .  .*...*. * .*\ .....   . \ \.   .  *.** .\  .*..* .\**.*. .  .*....  .***..*.* **  . #
##.*L.\\ ..* \.\. .*..*   . .\* * \.\\. .**.* ..***.. * *.*. *****..*...\*.\..*.* .  .*\\*.**. .. ...*  .* .*.. ..\\..*.*\. ... *.*.*  .   \\  \*. *. .*. *\  .\** . * \*\* \. \.* *.**.\. ..*.   *#
# #***    \*. . \*.**\\*    **\\..    **.*...   ..\ ..\*..*.*\.\.   . * ..* \ . * * .*\    * ..  **.**\*...\* . .  . \. .*\.*\ .\*.*\**.  *.\. . *. *     ..\ *.*..   * **   ....*..\*\ . . *. *  *#
#  #... . .  . *....\....  * .. .*  .*.**. .*.  * . * *.....\. .  .  **...\ . *.**.  **.\*..*\. \** .*\..  .* .  .. .   \.* . .**...  . \..**\\.\    \..\. ***\..*\ ..\*.. *.. *\. * **\.  .. .\.**#
# #*\.* \\.  *...*\...*\*. \\  . .\* ..* * .\* .. . *\*.\.  \.\   \*.\. \.  .*\ *..\*..* .*.. \ .\  \.... . .   ... .* . ...*\.*...\*** .....* \.* ... .. *.*...*. ..\.\* ...\\. .\..***\ **\..* **#
# #.###* *\  *.  ..**.... \* \*.*.\** *.*.\. .\*..**. *.. *\.\ \.  *.\***\ *.\**.  * .*.* \*. \*...* ** \. *. .*.    *.** **..\. . . .*  ..*.*. *\* .\.\.*.*.*  .* .**\*....*.   .  \.*.* **..** ..#
####################################################################################################################################################################################################