####################################################################################################################################################
#*\.\**...*.  . . .. . . .*. . \.\* * . \ ....    . *  .*.* *.  .. .\...\.\  .\*\ \*.\.**...  *.  *    *.... \.*. ..*.*.  *  .\.#\.*. ## #         #
#* *\R.  .*\..*..* . *  ..\   *.*   \** .*.. ..\. *.\ *\* . .*  *\ . ** *\  \*.*.*.. .**.\  . .\  *\.*.. .*\*. \ \.*..\ . .**.* *.*.* #. #         #
# \* .   *....*\*\   ... \**..\ .*\. ..* .\*  .**** ..* *   *\ *\*.. *\ .  *.*.**. . .\*  \ * .....  \ .. . .*\*.... \*.**\..\*.*\#.#.*..#         #
#\ *    **   ..*..\*\   **\.. *  ...  .*. .  *.\.*.. **.** ...  *. .*\*.  .  .*...  *. . .\. ***.*.  .*  .  ....*.*..*  .* *\*.\**. * . #          #
#  . \ .*\ .. *.. . ** . .  .\.    * . .\..**.*.**.  .. .*\. *...\   .. *.* . .  . \  ..\ ..\**.*\.. ....**. * . ***.. ***\  .\#.*.*** #           #
# .* .* .. .. . * *.* . \***.*..*...   .  ...\\..\.* *  **  .\.*\   **.\. ..\    .. *.*...   .*\    *   *.. \   ****..**...*... \..\..\####        #
#**.  . ... \ .* ..** **..**.*  .* . .**.* * .\ .  \.\.*\*  ...*.**\..*.*.*** .* ***. .  .*  **..**.\. .. . ...\\\..* ..*.**** \.\. \  #.*.#       #
#**  .\.. .*\   . \.\\ *\ .* . ...\\*.\...*...*****....\.*  \.  ... ...*.*\ ..\* .*\*\  .*. ..\ . . ..**\. . ...*. *. **.*.\\.*.\.\ \.#\ .#        #
#\. .. ...\.. . * .   *.*. . ****\  .\*.\..\****.\*.  *. \. .* .\.  *\\...\. \.* ** . .\ .*. .  * .. ***.*.\.\ .*. *\.*...*..*\\**  #\.**.#        #
#.***\ ... *\   .   *** *.   .. ..\ \..*.** *\.. . . *...... ..   *...\  .*  .\.*. *\*.*\ ..* . .* *....**.\* *.. .* \\.\*.\....*.\.\ #   #        #
#....\**.* ** . *   .*. **  .\* *.*.*.* . .\***.\    ..\*... . ..\. .  \ .. \. **..* ..* \.\..   * \* .*\. ..**..**.\ .\ ...  .*..  . ..   #       #
# .. \.\*  .\*.\. ..\ *\*\. ...  .  **..\. ...* ..*.. *\*..* *\ .. ... .*. . ..*. *\.\.\ .. \\*.*.* *.  *** ..\  *..* *.\...  ** \.. ..\. *.#      #
#\  \.. .  \*..**. .* ....  .* ...* \.\ *.\ . .\....\ . \*.. .   .. ..*.\*\.. \.. .*    . *\...  * **.. . *  .. *.**..** ****..  . \*.\. #..#      #
#  *  *\\.*..**.\\.....*\ .. .* .....*.*\*.*...*\*.* . \.\**  \**.\** . ...\*...\ *.. .*  ..\ .  . **\.\..*\* * \..  *.*......\  . .**.\.*##       #
#***\.\   **..\..\ . *\..\ .*.\ \\..\... ... .*..* ***.  *..    *\. .* *\ * .\*  *   . *.   *.\**...\ .  \  .\.*. *. *** *. .** *\ \*.\  *.#       #
#\*. * \\.  * *..*.\  ** * *  .\.  .*\ *  .  \.* .*...\. ..\ . *\**. *.\ **  ...*. *. .*\    .... . .  **..*\. .\ . *\\...\  .. ..* **.**# *#      #
# .* .*\.....\.* * *..*..**. .. *****.*..\.....  ..\.\ .. .  *\**.* ... .\.**\ \.*.*..\ * .. .. \   * ...\ .    .** .   *\.*..*. **\ . .*..#       #
#  .**\*\  \ .\  .*.  *  *.\    *\..*\.. ..\. *.. \.\ .*\*. ........ .*  *\ \. ..\ *.   .* \   \...\.*\**.\.. .*.*.. \..* .\\.. *  ***..#.#        #
# . *.*. .*..**.  *  *. \*   .**. .. *\ ****. * .  *.*..*  *.*\*\*.  . .*** . . * .. \ . ..  *. *.\.******.  .\. ** \..\.\.\ \*... *.*.# L         #
#\.*\** .*.\\. \ .. **. .**.\ .. ...\. ..  .\*.  ..*\ . .*. .** .*...\.\\\..*.\ * *... * . ...  . *.**.\..  *\** *...\*.. \.*..* \.*.** #.#        #
#\ .**.*.. . \ .\.  .*  ..*..**. *.\ . .*.  ... \..* *..\**  *  *  ..    .*\....\..**.\**.  \ . \* \  ..*  .. *\ ..*..**\\.*.\ ** *. .*. \##       #
#* .*.* *... *** .\.**.*.. * *** ...\*.\.*..  .*..    .\ ...\..\*\.\.\**.\. **..**\..  \... *...*** **\ .**** .* **..\ . *..  .*\ .\...*.  *#      #
#   *.**..\\.*.*. .\...\  **...      .\*  \  \.**\** * ..  .**\ . .**... .   .. .**..** \\.....\*\. .\.*\.\..*.  .\.  * \*.  .**.  \. ** ###*#     #
#   \... . . .... . .. .*..\..  \ * . *. *...  \...*\*..*\ *.** .. ..**\ \ * .\.\\.* ..\  \.. *  . \.*\..\.\. .. *    . ....*... . .\.#**\#.\*#    #
# ...**\.*\..*. \  *.***..\..**\ .\*\..  .....\.  .. ..\.  .. *.* .\ \.. .\. *. .\.**   ..*.. . \**.*..   \ . . .\. **\  \ \*.\ . . .  #* * *.#    #
#.\.\.*.* .**. * \. * *\.****.\*...* .  \ **\.....\.*\**..* * * ..**.\* .\.\ \ *..**. \.  *\ \.  **..\ .\ ** * \*  ...  .\. \*.**\.. .\*.#..*.\##  #
# \*.. .*\.*.  *.   \ ..*..  *.. * *.\....**.* *\  \*..**..\* *  *..  *.  .*.. *\.\ ...*..**. . .*.*\. ..... . *. . ..*.. **........*... *. ..* *###
#*......*. . ...  *..   . .* .  \\..* * .\ .\..***. .\ .\.   *. \* *.*.*\. ..*\.*.*.  * . \..\*. .\.*.*. \  *. ...\    *.\...* * .\     ..*.\.*# *\#
#**....*\. * .\. \. *\\.*  . *  ...\.\.  .  *  ..***  .*.   ..    \.*.*.*..\.  .*****..*\.* .. \..  .*\..*\..\. \  *\ .. .*. . . .** .\ *.\..\*#####
#.\ \.\* ..**\.*.*. ..\\. .\..*  *.   . .   .**   *..*  ..***.\  ..*.*.*. *. \.*  * *..  .**\ **. * .\*.....* .  \ * *. .*\..*...* .. . \..   *#   #
#....\*..  ..*..**\* *  \ *.. . .\.\   *\ . .*.\.*.\.. \*.*. .*. *\* **.. ...*. . ..\*.\.*\. .*\. *  *.*.\  *. **  .. . .  * \.  *\ ...\.\###\#    #
#.*  .\ *   *..*..*\ .**.\*\ .\**.. ...... . ..*.\\ *.\...**. .\ ...  . \*.* *\.   *.. . .  ...* \*  .*.**\ . * \ . * **. ..*..*..  *  **.#  #     #
#\..* .*. * .\*.\\.. . *   *\*... *\...\.  ..... **    *\.*..\....  *.  .  *\*. . **.*.*\**  \ . ....\* *..*\ ..  * . \.*.. .*...* *  \ . #        #
#*...\.* .*\\ .*  \ *...***.*.*\\*\ ..  * .*  .\.. \..\ .*... * .  . .*. . *.*.**\...*..*...\. .  .*. ..\*\ ..**.*. ...*.   ..  ..**.... *#        #
#. **. * ....* .\*....*...**...  *.\ * \.  ..*\..\. ...* . ...***. .**.\. .  *\*\*...***. * ..     . .\ ..   *..**.\..*.\*.\ .*\  ..\  \ .\#       #
#..*....\*.*.*  *..\ .\...\..**... \..*.\ **.*. ***   *.  *  ..*\ *\...** \ ...**.\  ..**.\* \  .\*.. .\.. . **.\.   \  ...\..  \.   .*.  *#       #
#. .**  .*\\*\ .. *. .. .\.  *   *. \*. ** .  *..*. \... .*\ *..*.... \..    . .*.. .\*..\ * .\ . .*\*..  .....**   .**    **. *\ ..\.. ..#        #
#.\ \*  .  *. .* **\.*.* ..\... ..  .*..*.*  **  .*\...* . . ..\.. *.**.  *.* **.  . *** *....* \ * *  \   ..\\..  .*...\*\\** \. .\.#*..#         #
#. .\. *. ... . ..\* \..*\\. .*\  **.\.. *. *\. * .*....  .\ *.* . \ ..  ..  *..*.**.. * *. . *..\. . \.. .  * .\.*\..\.*   *.   .*. ..*.#         #
#***. . *\ **.  . . \...*.\ * .*...\..... ..*  ..\..  .\\.. .\ .\\*  *. . *. ..*.***** ..\.. . .*.. .. . .*.**.. ..  \. **.....*.* #. \##          #
#. . * *\\...*.. *  . \  *  ..*.. *.. .* * ... .\ * ...  .\***.  *.\.*. ****.  ..\  .  ** *.   .\ *. .  ...*....  ..\. *.. *\*.... .\ # #          #
#*.* .*...*\.* .\ ... . **\.\   **.. . .*..   *\*.*** ..\  ..\.*....*..**\* . *.\ ... \...    * **.\  *\ * \ \.\..*..* .**\... \**\  .*. #         #
#.\. \*  * * \ .*  .*.\ * *..\..\ ** .\.\*\ **... * .  \ **. *..*\  ...\  *\\.\ * * ..  .* . ...*.. . . ..*. **. .***.  ..*... .\*\ #####          #
# .  .*.\...\*.*... .  ..***. .   \.\... . .\*...\**.\\ *. .  .**..  . *.. ...*..*     . \ ** **. *..   **. . \....**.\ * .. . *.#\#               #
#. *.\*. *.*..*  .\.. *...*.. ..\ .*.*** **...\\*. ** .. . *\.*...**\\.... .\.. \.\*    .  **\.**  *.*..\* \ .*. \...*\.. .     \\ .#              #
#. * ... . .***. **  .*** ... . . .....\*..   *\.*  ...***\.* . ..\\ *.. **  .*\*. ...*\ \ ...*... . ... *  *.*.....**.*.   *.*. .* ##             #
#  .. ..  **...**...\. .*   .\. .\.. **..\.**...*.  * \...  * *. . \...  *.*  ..*.****.. .**\  . *  .\  ....  .  .\ * ** . \  .#\ * .*#            #
#*....*   ..*. \  *  \.**  ..  .    ..\... *** *.* .... \...**..... *.  ..  .  ..\***** .*.\.  .**\.\.\ **.. * .. . ..*.  .    .**\..#             #
#**..  . \. \.*.. ..\. \ \ *. *\  ..\ *.* .*** ..\ **\ ..\..*.*  ** . ..\. .\.*  ..** ** ..  *.\*.** *. \ .\.*\  *\..*. \.*.\ \*#** .#             #
# .\.  ..  \. ..  .**.. \.\*.\*  .* . **. . .**.   ...**....*.*\ ****\*..  *  \ *.**. ..**. .*..* ...\. \ ....  ...* *. ...*.*#\* #.##             #
#*.. .     ..*.\.\*.\.*.\**  .* * .   * .* * ** \*. ...*  *.\*. \  .. .  .*.*\.*.*... \.\**....\..**.. . ....****  . .*  \ *.*#.*  .**#            #
#.* . . .* \\.\*    .*\\.*...\. .  * *. ..  .*   \\**. ...*   *.\ *  ..\\*** * \*  .*.*.*.\  ... \.*   \ .* * *  *  *.\\ *\..\\..***##             #
#**.\*\*. \.\.***\\*   ***.*.***.\ ***..*...**  *.**. **.*.*.*... . * * *..*  \..** *\...*.  . \. ** .\. .*. .\   . ..\.. . *\.*..**#              #
#*. .\ .   .\.. .\.. * *.. .*\..\* ..*..\*. .* . \.\  **..*\.*\  . ...\ ..\..\.* \. \ *\*..*.\. .   \ **\...\...\. *   . .* *. #*.. #              #
# .\* .. ..*\.*.   \\*.* *\ ..* *\  *.  ..    .   *\. .*\.....\*... **. *** *. . **   .*.*\..   **\\* *.*. **\  .  .... ..  ... .*\.*#             #
#\\**.\..\*. . .. * \.\  ...  ..\.\  \*.  ...*. *\ *.. *  *.  .. . *\..*..\ \   \ .. \.\... \* \.*..*..**. *   *\.  *.*  . .*..\. .*.\#            #
#. ...\ .*...\. \ *\. . .*\  ....*.\ \ . .\  *. \* \. \.**.*  * ** *. *.*.* .*\..\.*.\..**. ..  \** ....*  .\.  *\ .*\. * ..* \..  .##             #
#. * . * \*..*\. ..\ ****.....**\.** .\* * . ..*. *   .  *\*\ *...* *\*\*...** ****.  *..* \.  * .  **.*..  *. *.\.*   *   \.  \..*..#             #
#*.\. * ...**. *..*  \**.*.\ *.. . *  * * . .*..\*.*    *.*. .. \ ...** *.\ \..**.\. ...* .* \..*\.\...** *\\... . *..\.\ *..*\....*.#             #
#\....*.*\..\.* .\ .\.\..\ *\  .*..***  . \* *** * ..\ *.*  *.  . **** *...*.* *  .*.  .*. .\    .\. ..\... ..  .**..\.* *....*  .\*#              #
#**..\..* **.\. . .\. .\*...  *\ ...\...\...\....\\ ..**.. \.  .\.\** ...* *...\ \ .\  \. .   . \    ..*. \   ** ... . .**.. *.\  *..#             #
#\....\ ** *\* .**    . ..\ . \*\ \  .\. \...** *.\.*\...*.\ ..\ .. . \ . ..*.\.. .\. *...\..\ \* .\**\\*... * ***.*\*..\.*\ \\*....#              #
#. . .  ** ... ...*.  * .\* . *.**. * . . **.*.\.\ .*. .  .*.*\*. *. ..*.  .. ... ***. *\    ...*\ **. \*.. . . \.\...* .* .. ...#. \#             #
#\*\ *  ..  . *.. \  *.*\** .. ....\.\    ..\.**..\.*\\* \ .. *.  .. *....\.\..*.*.  \*\.\.\ *.  .*\.*..*.\* .*..*..  . ..\.... \.\*.#             #
#**\ \ .  \ \. .\ .\...*..\***\.\\*...  *\    \ ***\**.. \ .. *.\.\.   ***..* **\\*** *.. ..... \ .*\ .*.  .*.\.\.\...* *.*\  . ..\##              #
# .*. ** *.*.**. *\  *\.*. .*.** .* . * .* *\\. .***..* \     *\   *....  \ ***.\ ..* ....   \*..*..   .**...\. ***.\.\*. . ..\..\#                #
#  .*..\ *\. *. \.* ...* \ *\ ..  *\* .. .*.. *  ***\ . .  .  .  ..\  \  *. *...*\. .**\..*.*.\...*\*. *..*. * \..**.*  * .. ...*.##               #
#*  *. .\..  \.\. .  *\ * ..** * \...**.*.\ *.*   \* . *.   .   *\  . .*.*.\.\*.. * .\   .\....   *..\*  . .*... *... . .. *. #..*  #              #
#* \\. .  ** .. ***\ *..** *.**. . . ...\ .\* .*.* . .   ..\ ..** ** .. *  * .*.... ....    *.***..*.*  .** ..*. * ..*\ * \. ..\ .##               #
#. . \..  *\* .\....\ *.*\ *..*  * . \ \*.  \ \***. .  ***.. \*.. \ .\  * *\   ..* .**    \**  .... .  .**.\ ...\***\.*.*...*\ * .#                #
# \\.. ..\*..* . *.\ *.\**..\ * .\..\. .\.*..* . .*   *\.\* ...*.* .*\.*.  ..*\*..  *..*. . ...\*\.\  \ ...*.**..  ..\ .* \## . ##                 #
#* .*.\  .* ..** .\ ..**..\*.*\     * ..... .**.\.  ...  . . * .**\ . \.*.*\*...* .*. ...    ..*..\.....\ .* ..  *\. ..\..*.#\\#                   #
#\. .  .. .\..\.. ..\**.*.\  ..*\.**.\*. * *  *... .\\ .\ ..*.  .**  .    .. .**...\.*.\ \\    \* .  \.\    ...* *. **..# * # #                    #
#\. .  \. **  *. .* ..  .\.* \ * ..*  .*.* *.**.** ..*.*.\. \*. .... .*\  .\....*... * *. ..  *..*. \.  * .. *.*..\....\* \# #                     #
#*\  **.  .\*\.  \ .. ......   *  ..*.**.\ \ **\.. .\. .* .\. .. *\  **  **  ..** ** * ..  .\ *.\. .. . *   .*\... .*.. . #                        #
#**.**.\ ....* .....*\**. .. *.. ..\.*\*\. \ \*..*.. .* *..*\ .*\.*\*..\ **\*.\*\... ..*.. *\ *.\*. \ * .\ . \ \..\ .\.###                         #
#\*  *.**.** ..\.*  \.*\ ***  .\\..***. . ..*..* *...\* .*\.*.***  .*  **. \.* .. .  .** \.**.. .* .* .* .\**\*.*   *#*.#                          #
# .\ . .. **.*  ...* ....\*.\   .\ *\***. \\   * .\   * .   .*.. *\ ..**.  **..* * . **. .*  \.\ .* . *..* .. .\. *\# ##                           #
#.**..\ *.*.*. ..\**\   . .*... .  ..**....*. ..\..*.*...\..*. ..*... *  * *..\..*\....   \  . *....\*\**. . .*.#* #                               #
#\....* *.\ . \...***  \ .*..\.    . ** .\..*.. \ .\.*.\..*. .. .*.* .*  \ ..**. . *\**\  .. *. \ .\*..\*\.\ *.. # #                               #
# .\.\.... .. ...*\ . ..* . *        *. *  . ..  **.*..\ *..*\\.   . ..*..   ...  ..*****..\**. .. * .. .*.# . #  .#                               #
#*. \. *.  .. .\\   *  *.. *.. *** *..*\.   *.\.....* .\* .*.\.. \  *.*. .*\*.\\\*\*...\. \..\..*  \\*  .. .*  * .#                                #
#.\..     \ .**\.  .. *.*\** \ \**\.  *.. * * \ **.* \. .  .**\*\. .\.\*\*. ... .* *  . \...... .\..*  *  .*\ .#\ #                                #
#... .. .**...\. .**. .*. .**.\ *.  . * \*. .\  .***  . ..**..\* . \*.*.\\ \.\*. .\. \*\ *  ..*. .  *  . .... \#.  #                               #
#. *\.*\.*. .***.*.* ..\ . \.*.*....*.* .\*\**.**.\..*\ .\.\\ ..   \**. . \.*.. *  ....\*\ ..\. **. .* . . \.*..  #                                #
# .. .   **.\\.\ .*\  .*.  *** ..\* \*. \ \.** *. ** * \\.  **  .*..*   . . * *.*  .. .....\*..*. *\..\*\  . \#####                                #
#  .* .*. .*  \*.**  *...*....\ *..\... .\....\ * .*.  .. *..*\. .*.\    *\ . . .  **.*.\. *..\.**..*.*...* \#\## .#                               #
# .\  *...*. * \ .   *  ... \ ***  *\..**   .* ..* .. .*.  * \*....*. \. \* .* \ *  . **..\.\*..*.\ .\..*\. .* .#  #                               #
#. *.*\***.*..  .****\*\*....***.\*****  .*\..*\.. *.*\..\ ...\ .** *..\ .. .\ . . . ... *.. .* **.\  \**. *..  .\*#                               #
# *. \ \ . . \.. \.\*. \.*.\*\ \ *   . *... \\.**.*\** **.\. ** ...  .* ** . ...\  *..\*... * .*.\. ** *.. . **..*.#                               #
#.. ..  *\..  . *.* . *.*.. .  .** .** .  .  *..*\....*.. ***. . \.. \**...*\ * \.*. ....\.***\. .**...\*\.\ \.#\.#                                #
# *  . *\ * .**** .*\..*..   .*\.  * .\.\*\...\ \* .* **. \* .\ *.\..**\.*\*. *\ .*..\ .*.*.* ..**..\*  .* * *...*.#                               #
#\* *...**\ .*...  .  .*\  . \* *\*  ..*....\*.....**.*.    .\. * . \*. ....****.\*  \.**. .*..** ..\ *.\.  .....***#                              #
#** * . **.  \*\ .* \ *   . ...*.* \ *...\*.*...\***...  *.\**.*...*.   . .*\*\.* .**. *.* *.*\..*  .\\.*\ \.\*...##                               #
####################################################################################################################################################