################################################################################
#..  \*.  ** .*.\..* *\.* . ...   .  ...*.** *..* *. .* ***. ...*\  \  \   \.**#
#*..\..  ... \.*.\.......* *..   *\* .  ..\**.  *.* \** ..*  .*\.    *.**. .*.*#
#\* .  \.  ..  ...*\ \ * ..\*  \ * *..\. ***.*. \.** ..*. *\ ..*. \  . *\ .. ..#
#.  *. .* . \* \\\.  ....\ ... *** ..\.*.\\..  .***.\.\..\ **\*\  . .**..*  . .#
#.\.*. \* .\. .  .*.. ..\.\* *\**. .\*.\ . ..   ...**.*.\.\*.**.. ....\ *\...  #
# . . . .  *.\ .  .*. *.  .*.. .**. *....  *\  *.. ...  *  ..*. ..*\  *.\.*.  .#
#\ .\.\.\..\.*..*  *...  . .  . .. **** *. *\ *..\ . \ **    .*.* .  \ *.*.   *#
#.  ..*\*.\ *.**. ..*..\.* *\.  *..\*\* .. **.... **. \.. . .**. .** .\..* **..#
# **.*. .*.. ...*.**\  * . .\ \**. .\ . \ .\  .  .** *  * *. *.*\* *\.**.. . *\#
#\..  .\. *. *\ .\*. * . .  ***..\ ..\  . **  *  .\...\.\...* .*.  . ..\. *\**.#
# .**..  .. .. \..* ..\  *...****..*.   .*\ . **\* . **....*.** \..  ** .\. .\*#
#.*.* ..*. . . .**\   *. * .*.\..*.. *\*\... .**.**   *   \\..** *.\*..*..* *..#
#\*\*..*..*. .  *\..\*...\  \*. \.**.*.  * .  **.... .\. *..* ....*   \.. ..*. #
#.*. ....\...*.....\*..\ * .**\ .\. .\. ** \.*\.  *  \*  *\. \ \ *.***  \.****.#
#.*. * **.*.*.*   \..    . .*....  *\*. ***.*. **.\ \** *. .. * *\.**.  *.*.**.#
#.. .* .* . ...\ \.\ **\* ..***\*....*...**.  *  ........\..\.\ .*.\* *  .* .* #
#...\. . \       ...\** \**.*** .  \.. .\.\ * . .* **.*.. .\... \***.*.** . . .#
#\ .**\. . .. ..   ..*.*.*\..  *..\ *. \* *\*  * \*\ *\.\.*. \....*....* . . \*#
#. *.*..\*   *..    .. ..   \**...*\.....*  **\..  *.*  .  .*.\..*...*.\  .*\..#
#...*\  .*.* .* .  .  * .*\*.*.  *.\\.**\.\ *. * .*.. \* *. *  * .. *. *...*.* #
#.  . **\.**  .  .\.  * . *.*\.. \  .\.. \*\*\ . *.*.*.. .\\....**  .*..* **..*#
#\  .*.   .*.. *. . . ..\*.\.*\... .    . . ..* .\.\...   .    ....*..\....*. .#
#..  ..    ..\. *\ ...  ...*.*   \ * ****.** *..\ ....\ .  .*.  \*  . ..*\..\.*#
#      *\ ...\..  .\*  .. .\ . \*... .... ..\. .*..*  . . .*.  ....  \ ..*.**..#
# ..*. .*. ..*..*.  .\*\  *\.. .*.. \ .    * \.....*     . .* *.**.\*.*.. \.\. #
#*...** .* . .  ..*...* *  .\.  ... . .  .*\ .\.  ...\.** **. .\.... \.  ..*. .#
# . * **\* \*  \. .***.*.*.\*  *.. . .* **.* *.. ..*.*..* .*.\ .*.*\ ..\.*.\* .#
#     .**.  ...*\ *..**.\.*.*\.\ *. * ...  \ *  \ *\\.*.\ ..   *\...\.* .*.*..*#
# *. .**.   .\ *. *  ....**..   .\ .* \.\  ..\..* *.**.  .. * **.* *. .. \.*\ .#
#\..**.**  * ....  * \   \**.\ \  *   ..\*.*\ ...***... \.. *.. **** .\... .   #
#**...  .*\.\.  \ .*     **...  . .* *  *.*.*.... .. \* .*..\*...**\  ***..\. .#
#\.    **.. * .  ... *\ ***.\  **... . . .*\**.. *.* . .\ .\.*. * *.. ....  ***#
#.  ..*...\ ..** .**. ** *.*..**.****\.*. * ......*.\*  .* **.... ...    \. . *#
#* ..\. . ..\*.*.\*.*  * *.\\ .....\\ *. .***\ .*.. *\ **\ . \ * ** .  *.*\* * #
#. \.  ..**. ...\*\ ... \..*\....**.***\  ...  \* \..  .*\**\  . \.   * *... . #
#\.\.  . . **. *  .. .\*....* *.*.. ...  \*.*.*.  \ .. **...*.\ *.  .**\*.\  ..#
#. .*\ * ***\ .*..*..\..*.. . \*..*\* * . .   ***. ..\  .\.\.* *...\ .\ ** * * #
#*.*.... ***.* *. ****  ..*. ...\..*\.. * \ . **..* ..\   ** * ** ....\ ....***#
#\*.**  .*...*.    .**.** *.* *  . .  ...* **...\ ..    *. *... .**. .. .. **\.#
# \..*\ .* ...  ..*. . \* ...**.\ .\ .** . \.    **\****.**.*\..*.* ..* .*\*.* #
#*.\.\  **  \ * *..   ..\.   .....  .  \.**.. . *\. ..**. .\   .\... *.*.. *\. #
#. .\.\**.*..*\ .    *....    *.\.. ... *\.  *.\.\ *.*\.**\.\.\\.  **. .*.*. \.#
# \ \ .\.*. ** .. * .\.  *.  ..***\  * \\ .*.....  .  **\..* .*.\*\.\   \*  .\*#
# *\ . . .*    *.\..\ *. \   .*.*.   . .*\** *.* * *   *  *.*\. *.. \**\*.  *..#
#.. *.*\*.\.\  .**....***.\  *. .*.*.*.*. .*..*. .\.   \ ...\***\* ...  .**. * #
#\* ..*.*  *.   ...\ \.\. ..\.*.\\ .** ...\.\  .\ ..\.**.* . . . .. . \...*.\.\#
# .....\.... .. **.... . \.\.**.. *  * *  .*.**.\..\***  ...\..\  *.*\.\..*\.. #
# *..*.*\..* \\**.\.* \... *. **  **\ .. .\*..\*.\\.\. .     *** ..** ..\.  ...#
#\.*\\ .**.*  \...  . ... *\.* \ ..\* * \*. .... * .* .* .  \.*.* *.  . .   .\.#
#*..* ..*..\ ...      . ..\* . .\   .\.\  * .*..\.  * .*.. \ *.\*.\.    **.  . #
#..  ..*.\.*.* \   *\.   **.    **\.   .\*.**.* .*..*.*.* *.......**.*  .*  \* #
# *.\...*\ . * .. .....  *\*\  *.** ... *..\.\. * .\* .\**.* .** ..*.*.  * ... #
# .**  ..... .\*.\ *\\.  . .*.\. ...*. *\. *.*  ** .\* ......**......*...* *\*.#
#. . ..  \. *....  \..\* .  .*.    .. .*  ** .*... * .\**\ \*..\. \... *\. ....#
# * \...  . \.....\...\  *..*\..\.*\\  .. \...*. * \. *.\ ..* . .  . .** ..\. *#
#.. ...*.*.  \ . .. .    .  *\   .*.. .. *.*  \  **. ...* .\..\* \ . \**..\.\..#
#*.. ...*.\ * ...*\.  * *\ .  *\*   .. **.\.\. ...*...* *.  *   * .*\*.*. .* \.#
#.  \..*.\ .\..\  . .. ..*     .\ .. .* . .**\ .*.\.* * .\. *  * \  **... *... #
#** . .. . *. \.*\.\ *.* *   \.  .* .*.\ . *. *.... ..\.*\\..\ .   ... * *.\  .#
#\**\*\..*\. \..\**    . **\**\.*\.  *..* ..\\..*.*\\  \ . ...\*...* **. .  * *#
#* **.  \...\.\ **. *. *..*....\***\*. ..** .*. . .... ..  *   *.\.. .... *\* *#
#* ..*.\....\\....\ \. \.*.\.\ ..* .*\ \..  *.    .. .\ *\...  .\.  *.. . . * \#
#   ...   *  **    ..*  .**\**\  * .. *.**.*. . . . ..  .  .   .. **...\ . .\. #
#\**.. .  \ \ ..* * ** **..\*.  *... ..**\.. .*. . * ..* \ *.* .. .  \ \*\. .  #
# .\   ...  . *\* * .. ... ...  \.. ** ...\*.\.\*.\.\ ..\ *.***.\*.  .  .   ...#
#*  **. .  .*.*.* *.*.. *.. .  .*\.*..   *\.* * ...\   ***  ...\*.\\.\.**.. .*.#
#. .*.*   **.\**.\...   .\*.\.. .*****..***.  .  \ * *.*.  .*.** *.\  * .**... #
#*\*.\.* \.....* . *.  ..** *\.  ...*.**\ **. ... \*.*.***\.*.. *...  . .\.  .\#
#.*.** \  .\ **.*  . .\ .. \*       .*..*.\****  * \.**.\ . \.\..* \.\*.\ .. **#
#.**.\ ***.\. \ *  .*. .*  *..**.. .*...*..**\.*\\.. *\*...  ...* .. *.* \ \.\.#
#.\  .*\ . .*\..*  .  *..**\. ..* . \.*\.*..\ ..*.*\\....* .**.\.*\.. ..*\*.  .#
#..**.**.\.*. .* \.* \.*.\\.\** *.*. ... *.  \   *.\.\      *\* *. ..*    \* *.#
#  *. ..*. * .\..  \  .\\.\\ **** . . .\..* *. . ...* \* . . ** *.\* .\ ..*.\ *#
# .***\* ..*.*... ...*..\\**.\**.    .*  .*... .*.\ .*.\.*. ...*.  ....**. \*..#
# ***. . *.*\**. \. *** * ***. *...**\. .. . . *.**   .  **  \* .. .\*\*\..**.*#
#....  *.... *.. ... ....*....\*\*..\*\.*\ *   .*.*.. \\***  .. *.\ *...*\...\*#
#..\* \*..* .  ...* *\   .\..** ...\ \ . *\.  *.* .*...\... .\*\*. .\ \ *. .* *#
# \.... .*... \ ..*....** .\.*\.  ****..\*.  .. *    . ** **..* ..\ . . *  *  *#
#.\*. .. *\ \**\**\  *.*..*  . . \\. .*\ *.\...* .*.... \ * . . *    . .*\.* *\#
#\ .* \ \..**.\........*.*.\\*   *.\ *...\\* .*..  .*.** *. *.\*..\   * ..\. .*#
#*..* . *  .\.* .*..   . ..* .* *.\.*.. \..*... *  . .* .\.*  .  . *  . .**\. .#
#\. .. *..* .*\*.\*.  R .* .. . .\ **. *  *.  ...\\ ...* .\ ..* **.*\ * \..  .*#
#\... \.\..  .*..\*.\.**\. \   .* ...**..**\. . .**.  \\.* **  **.***\. .**\\ *#
#\.. .... * . ..\*.. . \ \..\*\...   ..\\.\ .*\.*.\.  . ..**. . ***\.\. .***\..#
#* ..*. \. . **.*.   .\.* .\.*.  .*. \... ..*. ..*.\* .. **.  *.... \*.* .*..*.#
#\. \.. .*\. ..*****. ...* .... \. * *\...\.**   ...*\ ....\ ...   .*. .* .**.\#
#   *.\.*. . *. ..*\. * \.**\...* .*..\. .*..*\*\ *. .  \.*\ . ...*\.** . *....#
#**.** *. .\ .. \.\*. .\.\..**.\.\ ..\. *... \ .. \.\.  .\..* . .*..*.\\ . . . #
#. .****.*\.\ . ...\   ...\...  . .*\**\**  * .  *.\ *.\ \***... \....\. .   . #
#.*\. .\ .* *.*  . .. *.... ..\**\.\* .\*\.\.\.... *.*. ....\ .\* *  *..*...** #
#\ *\....\.*.*\.  **. \*..... ..\. ...  .*. .*  . *.*.\ .**\*.*...\ .*\.*.*\*. #
#.*.  . *  . ....*\.... ..*.\  .\   \ .\ *.\*\.\.\.\.  .* ...*.\ .*. .* .*\ .\.#
# *.. * .*.\. *  \..   . . *.\. .*  .* ..\*  *..*. *  .\* *..\..\ *.* ..\. .*..#
#* **\* **...**.  ..*.*\.\*\.* .\*\*.*.* *. ...* * \..\*\ .* ***.*....\** \..\ #
#.. \ \*\  ....\ **\..*. .\ ..*. . * * ..\  . ** *\.\  \*  \\.*\..*\.**\* .\\..#
#\ .. ... .**  *  ..\. ..  .\.  .*...  .* .*.\.\ . * *...\*..*. *    ....**.\. #
#* .\\*. .*\.  \ .*\* \.*  .. ..   . * \*\ . ***...* ..... ***\.* .*.*.. *..*\.#
#*\. **  ...   .. \.*..\*\.*  * . \. .*.*. *\..... **....*\*... . ***.* *  .. *#
#.* *\ . .  .*..  . .   .  *.*\ \*\..\.....*. ...  .. **.* \ .*.*...**..\  .**.#
#\**. ** *. .. .**. *\ .*.** .. **.* * \*.\.   \*** .....\\. *\.*** *** .*  .. #
# *\.\. .*..* \ .   .** **...\*.*...\* ...* . *.* .  . .\.* \.  .** \   \...**.#
#\.. ..*.** .\ ....*  *\**.\... . *\ . *\.**. \.\*  . * . . .\.  .....\.  ...\ #
#.**. .. .\*.  . *.*  *  *.... *\.\.  *...* .  * . ..*.\.* \.. .*.\.\*..*  *. .#
# **.*\..* **.. *.\**.. *  .\*\ .**. .\ .*.. . ***  *.\. .\ .*. *\.\  .\  ...\*#
# *\.... . .\*  .\**.** \*  *** ... ... *\.\.  .**   .*   .. **..*.* .**....*. #
#.* .\.\   ........\.*\ .*  \. .\.\.**  . ..* .\ **\***\  . . ...*.\. * .....* #
#   \*..*\. \ . \*.**.  \.**... *.*  ..\ . \. \*.\..*.*..\ . . . *.**\.. *  *. #
#. *****.* \.. \.* * . *\ *.... ..* .* ..* .* .*. ****...*. * .** .\\ **\.\ . *#
#\ *\...*\.. .*\.** *. *.  .\ .   . \.*.*.\..* . .\ . ** \  . *.. * .**   . ** #
#.*.*   \. .\**.. .*..\.  ..  .  *..*\.\. ..*.\.\*  *\....  *.  * .* .* *. *.\ #
#..  ..*.*\..  *  *.*   . ..\\ .**\\\**.   *...\ .  * ***\  *. .*  ..* *..*.\. #
#.** *.* .**\ *. ..\\.**\** ....* \. .. *...*..***\\. ***.\*.*\ .   *..  .**. *#
# .*\. ...*.**\..*.*\**.... * . * .\. *.*.* *. ... \.* .\.. . \.*  \....* \. *.#
#\ *.*. .\.*.*.\.* ......\ .. ...\\ . \ **  \. * * . *..* *.*\....*  .*\.... \.#
#.*.\.*   \* . ..*   \.* .*.\.\ **\**....\.\\.. *.\... *\ \..*.\ . ..** ..  .\ #
# \*  ..\   **..   **. .  .*.* . . ..\*.***. *..* * *  .**..\*.*.   ...\.** * .#
#  * * ..\. \ ..  **\**..  .*..     \ .**..   \ **..\ *... ... .*.*.. .  .*** *#
#**. .*    .**  \.*. ...\ *. ..* \.\*.. *.\* . .\.*\ ..\.\.. . . ..... **\. *\.#
#.*  ......\.... . ..  .* . * .. ..*. *..... \ ***.\*.*.*.  ..... ***.\*.*. . \#
#*\ .\ .  ..\.*.. *  **\. . *.*** *.*.*.\*.....**.  *.  . \\..*..*..***.\..**..#
#*..**.*. ...**\ ........  *....* .. *.  ..*.. ..*\*\. * ..\ *   . *\.\\* ***.*#
#.   ..\.    *.. . .\ \  .\ ..\.*\ * ..\\ .*\.  *.**. *.* .. \\*  \..\...\..\*.#
#. .*. * ....\*...\  . .\**.\   \ \.\ **..\. . ** ..*.*.. *. .... ...**\ * *..*#
#. ..*\...**..**.  \.. *. ***..    \. ..* **..*... .***.. *.\ *\ * ... ** \\.*.#
#*.. .\.****.*\. . .. .\ ..*. *  *. . .***..*    .\. ..  .*.   ..**.*\*.*\.. . #
#..* .\ ....\.\  **.\ \.*\ . \* *..\ **...... \.  .  *...*\..*.\***.\..*..* .. #
#  ..\.* * .  ..\* **  \ .\. .\ *.\....*\*\*.. .\ .* .   .. ..\.\..   ... .\..*#
#*\. . .\\.****.* .   *   \ *  \*  .*  . .  . ...   **.*.  .\***...  .  ***.*.\#
#\..* * ..\ .\*.. .*\\*** ...\\. **.. *.     \.*. .*. *..*\. *\* .  *.  *. ** *#
# *\....\....\ *.  \ *. .  .\.  *.*.\ *\ .   ... . .*  . . . \ .\  \..* . **.\*#
#**.*\..*. ...*.*... \.   *.* * . .****...*\ ..     ..*** **....* ....... ...  #
#...\. *. .*.. ** . *   *.... .   ...* .\..   . *\ ...\.. .* .\.\. *\.  .. \. *#
#*\   .*\**\* \.  .*. .\*  *\. ** *. \ ..* \ *.*.*..  \.*\** **.... .** ...   .#
#. \.* ..*.\.\  *. \ .\*.\*.*  .**.*\ \ *. ..*\.** ....*......**.*\ .\. *. \**.#
#*.***  .* .  .\*  * * . .*\\ ..*. ** \... . *.*.\  ..**.  ...\...  **. . .*.\\#
#..... .\. **  ..\ \*.   .*  .*.\**.**.** *..** \.   *  * .*\\*.* *\..*    ... #
#. \.\ .* .#\..*\..... .. .  *.*..* \. *. *.* .. **.  \.. ..  .*. **. *. *.  ..#
# *.  ..... *. *... *..   \....\. .*..\. **.. \ . \  \.*\..*.. \\\*\ *.  ..**\.#
#*.\.*..*** .*\. .*.*** *\ \. * ..     * *.  ..* .. . . ** *\...*.*\ .* .***\*\#
#.  **.*.**#\ *..*\*..*****.\  .\.*  **\ \.  .*.*..\.*.*\..\*\..*.. *  *..\*.  #
#  .* #*..\.**... .\  *\**. .**. \* ...  . ....\. . .*\.* .... ..\ ... *....*.*#
## *.# \**.#.*.\..#*#.\.*\..  .  ... .  *  ***..* .\ *... \  \ .\.*  *   .\.. .#
##\#.#. ...\.\. **.# .*...\*  * \ \* .* .  ..*\..*\.#\* * .***. .\.*.\#....* .\#
## .\# .*\ # ##\.*##.**. *.. \. .. ..  *    . . ...\..*. *\*.\.\  \.. .\..*.*. #
# ##****. # #  ###  ##.*.* . \** \ *. .. .* *\. *....*..\.*.\ \.    \ *#.*.\.. #
#   ##\# #           #. \*.. ...\. .*.. * \..  .*. *.*. .\.** *\.*\.. ...** **\#
#     ## #           #. \.. .   .*  * .*.\.....\ \..**.*\  ...\..\.\ \* *..* \.#
#       #            # \ #..  . .. ..  ..\***.**\.. .* .*.*.\**\\*..  .\**#.\.\#
#                     #*. *. *\ .\.   .*.*\*.\..***  .....\..*. #\.\.\. *. #\**#
#                      #*###\* # \*#** \ ... .\.***. *\ *.   .  ##** *\*.*.** .#
#                     #...\**#.\#.. **\. .*#.\ .*..\ .. *  ..  .**..*\*. .* . \#
#                      ## * *.*# .\#\* \* ...\.*.**.. *.*.  \*\ \ . *.. . .# *##
#                        #\#*#*. .\..*\..* #* .. . \.*  *.\ #*# * *..##  .*.## #
#                         # ##.# ##\*#*.*.. .\..*   ..... #.*. # .** \#   ....##
#                            #.\ * ### #\ .#. . .*.  .\.\ \...##.##.\.* \#.#. ##
#                             ## *#  # ##### \#* .*\\***#.##\**#L#* *####. *## #
#                              #\#   #*#    # \\  # ..*\. ##*.#   ##\#   ###   #
#                               #     #      ##*. * . \.*\ ###      #          #
#                                              #*  *.\  . *#                   #
#                                               #.\*.*.##.#                    #
#                                                ##.#*\# #                     #
#                                                 # ###                        #
#                                                 #\#                          #
################################################################################