######################################################################################################################################################################
#   # . *\\ . .*** *\ *.*.. ..... .... *\.\\** * \*..\.... ..*.*.* .\. .....  \..... \*..*\  *.  . *  .* .*..\ *..**  .\*. * .*.**..* *  \. *.*.  . .\##\***.*#  ### #
#   #....  ..*....\. .* ..\ . .\* * \* . .. .\. \...\. \ ..  .\. .. *. *.   *..\ \  *.\ *\. *..\ \ ... *.** ..  . \* . .***   ..*.\\.  \..* *.**\ ** .* #*#. .# #  *##
#  #. *\\...****...*. *   ..****\.. **.  \..*\..* * * *...\\  . ..* **..\.\ .*....  . \*\..*.. \ .\..  * \\*.*..***.* \ .\.  \...**..*.*. *..\.. \ \\ *...\ *\*#\*## #
#   #.#* .* ....\.*..*\\* **\*... * .\ . **... \ .* \ \   .  . . .  *.  *... . \* *.  \*.*   \\.\  .\ .  . **\*\**\.. .  ... *.  .*\ . * ***..\. .*..\#\\ *....#..#  #
#    ##**\. *...  \*.*... * ..*\    *\** \.*.\ .. . .. \.. .  \..*  ...\\\ \* . \ .\* ..\.  *.**   \. .\..  . \.*.  .\ .* .**\.\. .. * ..*.. .. \...*.\.\*. .. *\.#  #
#   ##.\.. \* ...  \ .*..\    . .\.** ..\ .*.*** * .*.    *\ ...\**.   ..  .*\. . .*\*.\. \.. .*.  *.\ .. . * .*.\. . .  * *..**  \ .*.. . .\ *...**. \    ... *..*###
#  #*\.#\.  ..\ .\ . .*\... .* . * ..* *\* .*\*. . *.**.****\.. ..* . \  ...\..*  ***\  *.**.**.* .. .   **    . . ... .** .. \*. .  * ..     \*.\.. \.\ \**.*. ..*.*#
#   ## ..*.\ *... .\.*\ .* . *  \  *\..***.\.**  ...***...*.*..*\**.* **   \\.**. .\* \* .***.*** *..*.  ..*  **     .**.*\ *.\.*..* . ..  *.*..  \.\..*....\. *..* .#
#   # *.*\...*\. .\* ** ..  *\.* \.      *\*.*..*  .. .* .. ..*.*.*..  *.*.\ ..*\...* .. ***.*..**.*    .\...  .. \.* . \   . *..\ \..    .*... \    \..... .  .\. ###
#  # *.. .**.. * * ..*\ ... \...**  .\.*.*\**.* **  *\ .*.  . .** . .* *.. \.. .. . .  ..\. *. .  *.  .\ **\...*\..\.**\. ..  *  .\\ *. .\\*.\. ...\*.*\. *.**....\# #
#  # *.\.\*\ *.\ ** *. *\.\ . .\.*\. .\* .*\. . \  .. \.*.  .\*.*.  \....  .* **    .   * . . \  . *\ .  .\ * \..\.*..\ .. \*  * \*.\  ..*.. *   . **.* *...* . # ## #
#   ##. . \ .* .\\... .*.     *  .    *. . \ .* ... .*     * .*.. .    \*.\ *.**\.*.    ..\. .  \ \.*. *..  .   \ *\\* *.*......** .*.*\ . . *.   .\...\..\  ..\.\ .##
#    # #*.....  ...*\. \. .* *.  \.\ ... .. ..*\ .. ***.  * ...\**\**. \. .\*.*  ....* *. *.  *..\.*.....* *  *\... *.\. .*\.  \** **...   . .***.  .\.  *#.*. . ### #
#     ###..    * \ . .* \.*. \*.\ . *.\\*  ..\.*.**\ . .* *   . .\  .**.**\*..\*\ *\**.\ \.*\.\. **  ....* . \.*..* .     .****..  *** *\ *.\....\.\  *.*.  \*****.# #
#    ##*. ..\*.\... \.*. *.*  .  . *.\..* *..  ...\ ....*..   .  .*.  ..\...\* \. .** *. .... .*.\\.\.\* ... . .  * .  .. *\..\*\\.** . *.*    .  ..*** . * .. \# #  #
#   #\##.#  .***\***.\. *. ... ....*\ .*. .**. . ..  *\ ....* ... .. .*..**\..  . * .* .   *\. .*... \ ...\.   * ..*\.. *\\*.. .   ..  *..   ..* .\  .. *\.#\* # #   #
#  #\*\*.  ... .*.*   **..\. * *.\ *.*.  \..* . .. \.*. . ..*.**\   ***  *. * ***.  .*.\   *   * * . .... . \ *. .*.* .*.* **\  . *. \..*   *.*.. . .* .*\*  ..#     #
#####\#....\.  *..\ .*\*.***  *..*\**..*.\ \. ***.*. ***. \* * .*.. ..* . . ....*.***. ..   .* \***.. **  . .\  \*.\.\ .*. * .*.. . \   * \ *\*  ..\*..*\.*  *\*#    #
#*.*\.*   \.. *.. \ ...  .. . \* . .*.*\*....**.*\.** **. . \.* \ . *\.** .\ \ ..*....  *\.  .\ **.* *   ..\.. ..\.* **..\*\  .**....\*. .\....     * *** ..\ ##     #
##.   #\... \ ..*...   .*.. . .... *.\.\*\  . . . \*. .. **.    .  .  ..... .. \ ..* * \.** . *.... ..\ .   \.\* *. . ..\ . .\ ..**.* .**. \   .\ \*\.\.\.***. #     #
# ####* .* .. . . *...  ..**\ *. ... . . * . .. \ ..  ...\..*  * .*..    ....*\ *  . .***.\ .  .\..\ *    ** \ \.\. * .\*    . ..*.\*\*..*..  ..** .*.\ .....#\##    #
#   #..\   \.* \ ..    .***...\. . * \. ...\  .**. *  .    .**.*.\ \*. * ...*.*** \ * *.**.. * . . .\.     .  \. .*..*  .**.  .\..*.* * *****.\**. *.* . \.\\* #*#   #
#    ###...* \ .\ * .\  *.\  . *. *\.. *\\.**. .*  **  * **... \. **. .\. *.***.*.\*. .\ ..\** ..* *. .   \\.*.  \.**.   ...\*\ .. ** \..\ \\.\*.\*.*.*  \ . .*** #  #
#     #******.. *.**     .*. * **\........**.* \*\.* * .*.\ .\.. \..*  ....\ \.*.*..*.\.  **...    .\ .\* .\. * ..*. *\..** .. **...  .. . *****  ..* \\..*.. ##.#   #
#    ##*.\.*....*.*..\\.. .  * ... ** *** \  .**\* *\. .*  \.*\ \ *.\.*\*  . . .\*.*.*.. *\*\. . .  .\ *.\.\* .\ \. *..  .. *.... *.\ \.. .**.......  . **.\ . #*#   #
#   #.*.\ .#..\.*\. * * .* * .*  \\..** *...*\.* . . .\..*  \  .* . * ..*.  \ .\* *.*. . .*.**\  * .. *..  **. .. *\*.\.**.*.. *  . ..* * .**. *\. **  .... * *##    #
#    ##*#\.* . ..  *... *.*.* \.... ...* \.** .**..* *\ *\.     \.\.*. \. .*. ...\.\.*. . ***.*  .* .*.*\\.* ....  ..*.*...*\  . * .**..\*  ... .\.*. *\*##\.\*\#    #
#    #.\....  \ **\..* *.\. . . . \ *\ . .*\  **....... .\*. .* *\*.*.\ *  ***.*..** ..    .*.*.\ * ...*.. *.\ .\.*.\ \..  .***\.\ *...*... . .**. .  .**.#.*##*#    #
#     #\ .#\ .  \..* ..\** \*\ . ..  .* ..*.\.\..  \  . \...** .  .*.*. ..*.*. . .\.\** **..  **. \**..*. *.*..   .. .    . ....*** *\.**\*.*\*.*  *#.\  .** *##     #
#      #  .*..**..\.\ *..*\ *..     **.\...* ..*\ *.**..\.**.\  *\*.. \*  ..* *.  .. *. *. . *.*\ ....\. *.*  \ *. ..\* .* .*.. .*..** ..**\.*.*. **\  . * .*#       #
#       #*\#. . \.. *..*\. .  * \.  .. .*.* .\\..\ ..\.\..\. . .. . *... * ...*.   *..*.**.* *..*..\.. . ...*.\ .  .\..* * *\.\*.. ..\.*..   *\...* .  *..\##        #
#        ##.... .* **..**   ..\.  .  ..* .*  ..*\*\* . * .. \..  .. \\   . .*.*. .\\  ***.* .. ..\..*..*.*. . *. .. .  . . .** .\*  ***.*..\*..**.*. * ....##        #
#        #\ \.*.*\ .\* .....\ .*.\.   *.  *.*. ...\.. ....* .\.\**.\ .**..\...\ \*.*.*..* * *\ ...\  *\* .. . . ***..\ \*\.*..  .. .*\.  * .**. .**..\ *#* . #       #
#         ##.*\. #.#.*  . . .\.\.  \* .. .* .*** \**..   *. * **\.**\ \.\ *. . .*..**. .. . ... .... . \.   \.*..\ . * .*** ..*.\.\..  .. **.\.. ***..\\ .  #        #
#        ##.*.*.# *  #  * ..\. . ....  \*\  **.  ..\ ..* .\***.*.*\.  . *.. *.\ .\ *..\*\.   *\\ \*. \...*\..\. ..*.\.  \*.\.\. \   . . .  .\*\ * .* * .. \ *##      #
#       #.  . .\\ . . * \.*.**.. ..\ .\ *.*\. *  .  .  .**..\*\.\. *****.. .*\ \. ..*\...**  . . . ..   .** .. . \.*..\.*\..\*\ **.* * *\** **. .  . *    # **.#     #
#       #**.# ** .\.  . ... \. *  \* \* ....\.\ *\*..\  ***\*..\*  \....*. *....*\ ***.* .*\\*\..* .\ *...*\..  \.*...*\ .\ \....  * * **.. ..#\   *.*\ #.  .\#      #
#        ##.#\*#   . .   **\*...\*.. **\*.    .**.\*......*...* ** . \ .*    .***.**.\.*.* . \ .*. **   .\\.\  *.  . ..*.* .   *. .\.\**** *. .. \*### .# .###       #
#         #\..### . *.*....\.**.*..\.. ..\ **...**.* .*. *. ..* ...*\ .\.\*....*.. \.*.\.\* * ...*  *\ *.. \ ..\ .   . . *...*.*. \ \*. .*.\..*\.#.. .##. #          #
#          ##*...     . .  .\. ... **.  . . **  .. .\ *  .*.*..** .* . .\**.\  \   .*.*.* *\.  *\ ***.....\... .**..\  * .* ***....  .   * .....*. * .*#.#           #
#          #.*###\ *  *\.\*..*\  ..* *.\ . ..*..**\ * *\. . . .. .   \. **...\.. .  *  ..*\.\ .. .\.*.   .  \\.***..*\*.* ***\ \   . *.*.\  \*\*\*  ..##\#           #
#           ##\.* .\ *.. .**.\*.**..\.\.\\. ..\ *\ \**..\. \..* \.. \.\**...*. *\  .* \ \.. ... ...*.\* . *. *..*. \. *.  ....   .. .. \*.  .. #*#. *.# #            #
#             #.# \ *\. * ..*..*.. *..*.  \ **. *. ..\..  \.. .\ .  **...** ** ......*.* \ . .*. . \ .   *.**\.   *..** .*.*\ .\*.* ***..\.\**.*. # \  #             #
#            #.***.***..* *.*..\.\.* ****.\\ **  .\..**. * \ ..  *\.*\*.\\..\.\**** ** *.. .* . .* ..\.\*\ .  .. .*..\ . .       \. ..*.*.* . .  .#*###              #
#             #..  #\.\ *** ...* ..\..   .   \*\...\\**  ...\. . .**\ \ .*.*.*.\\ * ....*.*.*\..*.  *....*    .**...\ .\..  * * * . *\ .....*. . *\.  #              #
#            #**. *#.  *.*#. .* . ..  *\. ..  \...*.  .**.\**.*\. **.*. ..\.* \...  .   ......\.. .\ .  . ..* ..*..***. *  .... * ...*.*..* \.*#### * .#             #
#             # *###*.*. ... ..   .\.  **** * ..*** .. .*.*\... \ ..*. * *.*\ .*.. .\.\. *..  .* .\  \ \. .*  ..*  .\ .\.*.\  \...*. .*.  *. \ .\.# ***#             #
#             # #   # ** .** .* \. **\. .\*. .. *\*\.*.\.*.*\*\. ..\.. \..\..*.. * \***\ .***\.\\.. .**\* * . .\. .\.\*....  ..\. **. .   *  *...*\ \.#              #
#              #   #\* ..* . .** *.*\.*\* *..\*.* \ ..  *\*.. .*\ .*.*.*. *. .  **\ *\*.  ***. ..   \.**... *. *. ...* *\.  . .   * \ ...*.. .   *.\###              #
#                  #\\*\*\ * .*.#.**...***** .*..\ *   ..*.\*.. *  \*..*\ . *.. .\*. **\ .    *.\  ......  .* * ..* *.\. *...*  **.*... *.   . *\.*. .\#             #
#                   #. *.*..*.#\*  * . .....  * *. ... **.. . *\. *\.**.*  .*.\*  *\..*.  .\* . .\. *   \ . . *.\ ... ......\.*. . *. . . * *.*\* .\ ##              #
#                    #..*.#.#\.*.  *\ *..  * \..*.. .\.. * *  *.\*\ .\..\.\.\ .*\*.*.**.  ...\     ...\*    * . ..\. ..\.*.\\..*. **.*. ..\.. \ .\###                #
#                     #\#. # .*\ . \  *.*. .\.*..   * *\   * *\. ... ..  *..\ .\.*.\....\ \.....\..  .*..\* *  \\.*\ .  \.*..\ .* \.**\*..*.\..   #                  #
#                     #**   *.\  \\.**..* . . *. *..  **\..* .*..*. \ ..*.  .* *.**  *   \.*. *  .\*.*. *.. .  .\\..   . \..**  .\. .\**...\.* \ *.#                 #
#                      #*....# \. * *..*.. ...*  *....\*. \. *. . *.... ...\*\. *...*.\    .* \.  *...* .* .*. *.**\..**... \.. *\.. \*.     *.\.  .##               #
#                       #*. \.*.**.  \*  * \.\.. * ..**.**. \ ..  \\  \*.   *\ \*.\ **  *\. ..  .\.*. . \**.*. * \.....* \. .*\.*.*  .\*..** \\. .  .*#              #
#                    ### *...   . ... . \**.\*  ... \.*..*   . \*   ..*..*\ .*  *.*.*..*.*\  **\..*. *  .... ..*...* *  *.  *.\ . . \.* .\.\ .* * .*\\.#             #
#                   #.\ .*  \ .\. *#.*.*.   ..**..   .\*.** ... *..   *.\.   *\ *\.... .  *R \\.*.*\.\* \ ..* *...   ..*..\ \..    .... \*   .  .*.**##              #
#                    # \  \....#  *....     \.*.  .*  *.*.* *.\..\*.  .**  *.*. * * *.\. **..*..*.***..\ ..*. .   \.\\* * *   *.\ \ * ...*.. * . #*.#                #
#                     ## . \  .\**..   **.   ..   .. \. *.* ..\*  *\.*.** *\  . ..*.\. . .*\.*. .....*.   **.   .. ..   ..  \.. \...\*\*  .\ **#.**#                 #
#                    ##. \#\.*..*.*\ *...\ **\ \.. \\  .***  . ....**\**\  .  ..\.\  .\ * .. .\.*...*.\. . **.*  \* * . .*.*\  \..  .* \#\.*.#**##\#                 #
#                   #*\*\ ..**  .*.*\.  . *....\ *  .. ..\..  ..\  ..* . ... .\ .\.     \  \ * \.*...*.*.. *. .*\*..**\. .    *.\ ....*.\ *... \..L                  #
#                    #*.  .\....*.\.*  **\ ..*. .* . *\*..*   .*.  .... .*.*.*.***..\**.\.  .. . .*.** .. .\ .***..\*. . *. .*.. .. * *##..    . #                   #
#                    #.* ....\  .*...*.*\*.... *.. . .... ** ***. .*.**...***\*.\.. ...*.*.\\..\  . *..**.*.  .*.\. . ***\***..\  .\. ..# ....#**.#                  #
#                    # *.\ .  .* .*. .* .*#.*  \  \\.  .\ .. *** . * ..\*\.*\.*    **....* *..\.\   .*\*\..* *.**\ ** *.*.\ . ..\..* . . ######\\.#                  #
#                    #\*#.. .\*.*\*\*\ .\.*.     .* . \ .\.*.*.*..\*  . \.*.*\**.**..\  ..\.*.* ..*.**.\.***.\.*\..***\*. .. *****. . \ .*#   #.*#                   #
#                   ##*.#....*.\.*...**..*.. .    *\...**..\   .  ..   . .. *.....*\.... .  .**.**\.\.  \.** * .*\*.***.. . .*.\.*....*  #     #\#                   #
#                  #*..**\ ##.# ***. .\.*..  .\\*..   \*.  * \  \..*.*. *  ..\    *.*\* .\.\*.*... .\  ...*. .\.\ * .**\ .  *** .* \*. *#       #                    #
#                  #.# .*# # #\..#. \.***.  ...*. *.  .....\ .. .. *. \ .*.*        *...\*.*.*\ *.* . *. \*.* .  *.*\..**.*..\\*.***.* #.#                           #
#                   # ### #   #.*.  .*.\ *...*\..***  .\** .   .**..*. .*\.  \. \ .*..* .\***.* *.\.\** *.**\  .*\..*\* ..*  .*\*.#* ...* #                          #
######################################################################################################################################################################