############################################################################################################################
#                                 #.. \.#  .\ .\..\.**.. #*  .\. .*. . ...* .\.\..\  * *  \ .\ **\ ...\*. *.. \.\.\****\*. #
#                                 #\*.#**\*  ...*\\ *.*....*  .\. .*** *... \. ...*.*..  \..*  ...* \...  . ....** *\***..*#
#                                #  . #*##...* *\.\ \.. .* * .*   \ .. \. \. .*....*\ **.   * .*\*.   * .. \*  ..*\*.**.* .#
#                                 #*  \ #* \....*.*  \*  .*.*\   \**....  . ... * *. *..*.\..*****  ..*..\ .  *.... . .    #
#                                  #.. *\*  ... * .* .\  *.\. * .... * *.* .\ *.\ .* .. **.\*.\..  .*..**.\  ... *.*. . * .#
#                                 #.. .\\.\. \. . *    .*..*  ... .*..\. .\\. .*\..*\ *...  *.*  * \..  .*. * \. .\.. * \  #
#                               ## # . .*** *.  *  *** *. ** *.*.\ .. .* \ ..  \ .\.. .    ..** ..  ** .*....    *     .*  #
#                              #. #\. * \*. **\... ...\.*.*   .*... * *..\. **..  \ .. *\.*. . *\  ** .*..**..****  * . . .#
#                     ###    ##\\ ##*\....* **. ... * . * *.\ .***\.*.*.*.* .. ***. * * * .. *.\.  **.*\\ .\.*.*..  . . . .#
#                    #\.*####  .#..\*.  \\.\.* .\*\\. \ . \ . \.* ... .*.. *.\*.*.*..\...\ \ . *..\**.*.    .*.*.\  \ \*.  #
#                     #.# *\## .. *..\.. .* ..*.  . . \. *    *..   ...*. *  ..*.\.*\*.. .*  . .. **\  .\ \.\....** .*.. .*#
#                    # .#\. *\..#  \  . \*.  *....**. ..* \**\*\*... .... **. \.. *..*.\ .\ *   \.**...\ . .. . .\. .. \ *.#
#                    #\ ..**. .  ...\ . ..\.\....** .\  ...*. . ..*.  .\**\.*  *.*.**... .  *\* * \ .* .**.\  *\**   ...***#
#                     ##*#*  ..\.      ... ....  \.\..*   **\* . \....*.\..\* ..\.*\***\.*  . .\.  **.  .\.*. . .* \ **\ *.#
#                      #\#*..#   ...... *.\  \. ..*.*..*  .*..* *.*.. ...  ..  .**....*... *.  .*\.*.**    .\**... ..*.   *#
#                      # .#... ...\ *\  .  \   **.\..  ..\*. . ** .. .* \\*   .\.  \. *\**..*\\...\. \ .\.   \  .\ *... . .#
#                  ####..**\* .\**..\.    . .  ....* .* ..*\   ..\. \.*. .. *   * * * . *.. .*\*..** .\\.  . ....*\* * ...\#
#              ## # .*.*..\\.  .*.\ .  *   . *\..  .. . ..  .**..*  ..**\. *.. *\ .\**  **.\ .*.. * * **\ .. .*..\.. .\. *.#
#             #.*#\  *\.*.*.*.. . .\*  *. ...\ .\ .. *   ***.....*\.. \** *.\**\  . *. ..*\*\.\ *..*.\***.*\\...\.. \.  ..*#
#            #**..   ..   ** **.* . .**...\**.  .*. .* .**\ ...*\.* \. .  . **. .. .**.*.\*\.\ .* *..*.\.   .* . .  .*.* \*#
#           #*.\#.... .\   ..#..*.*\.\.\...... .\..**..\.  *.\.. ** ..*.\ .* * **\. *. * \. \. .. .*..*.*  **.  .* *\..*.*.#
#           ##.* \ * .\.*    ..* *.  ... *....\  **.. .. . ...*..\.\     .  *  *\. \ \*. .\\. .  \\. . \. .*.*.\.\ .  .\*..#
#          #*.*\..*. .* . **   .*. \*.\  *\\  .\.\. .*\ * *.*\.*\   .  \  ..*  .. ...***\  .\* \ .*..*.  \.  .*  ....*. .  #
#           ## ##..*\*...*.**  ..*\..*\..   ..  .*.* *.\. .*...*...*.\*...*   **.\  \. ..\ ...*. **\...\**.\. ....*  .. **.#
#           # \##***  \. . ..  * ..*.  .. .*\.**.    *. .. *\..*\.*.*.*\ ...**.\***...  \  . *..  .. . ...**\  *. *  \* ..*#
#          # #* **\\ ..\..** ...\.\.\  . . *. .* . .*.\   *\. \.   *  \.\ * **.   * *.\\ \*\.\**. ..  .\ ..***\*  .*\.*  *.#
#         # # .*\. . * \ ** *.* .**.* \ \  *  *..**.*...  .*... .*..**\.*\.*.*\**.* ..* . . . .*.. \ ... \ *\.**  .. ..   .#
#         #\##*.... *..*.\..* .\*** .* \. ..\ . *. .**.. *\*  *\ \.**\. .*...\..*  .  *...  . ..****\*. \\ .. ....*.   \   #
#         #*# # * .* \ .*....\* ..*.*. \\.       *. ..*. . ..***\\.*... *   *   . ..  . *\*.  . . \.*.. .*.  .*.... *\   . #
#        #**.##\. \ .\.  .*   . .\.....*. * ..\.\ ...*..\ \*.\...**.*\..\.\..  \ ..  . .*\.*.\  ..\**.* .   \..**\ ..  \...#
#        #\#*.#  * .* .*...*\*. ..\\  .****    .*.\ *..* ....... *.... \ . *. .   ....*\...*.\. ...*... . ...... . .  .. ..#
#        #. ..  ...    \*\ . . ***...* **\.   \* .  .* ...\.\*...* *\     .** *     ... *.***. .. ....\ ** ** .* \ *.\.* * #
#        #.*\ **.*\.\...**.\ ..****. \.**.\ ...\.. **. . ......*.  ..**.*.**\ ..***  .*...*\.***\*\  ..*. ....\*\  \ .\*\. #
#         #.#*.**\ ..\  .\*  ..\.\*.\  .. . ***..**. \. ** .   \ ***.*\.*. **.\ . * ... *..*.\ *..     .   .\* *.* .\  .. *#
#         #\.. *..* ..    . \ .*..\*.\.   .*.**\.*. * \..*.*....\*..*.* \ *\*.. .**  . .\  .\.\.. \.. .* *\ ... . .\. . *..#
#         #*  ..\.*\*\*.. .. * .***. .*..\ * .. .....*.* . . . * *   .*.*..*.  *\..\.\...   .* *. . *.. ..  .\.\.\ *. .\\ *#
#          # \.. \  ..* \. ..* **.. *  *\***.    .*. ...  \*\.\*... \ ...\*\*    ..*\ \***\  .. *.* .  *.\*\.. . . *\.\ * .#
#          #\.\*  *\ *.*    \. *..*.**...*\..   .\.\.\. \ . .\\*.. ..*.\\.... .**R\*.  .**** *  *..* * \ *.*  . **..\ * **\#
#         # * *\. \.\. * \  **\*.\.*. ** \*\* ....*.  ..  * \ *..\. *. *.\ ***. ..** *.*.\*.*\.\.\.  *   * \.\. *. *..  ...#
#          ###\.. .***.     .*. . \   ... *.* *  ..*...* *.\.\\  **.\. **.\.**.* .\.** ..\...  \.*\. ....*\.\*  .*.. \..\* #
#          # .  *.\ \*\.*..*  .*\** . *\*\... \*.*. .\...\*..* .....*\.. .  ....*..\.....*.\ \..\.. . \\.\.\ .. ..    *\ ..#
#        ## .  . . .....\. . *  ...\ .*  . *.\..  *  **.*.. ..\.\.*..* .*\ *  * ..  *\* *.. ...\ ** *..... *..*.  . *.\* .\#
#       #*## *\ \  ..* .  . **\* \ .* ..*\ *\*\  .  \* \.**    \..\**.\.. \.\..\.*....... .  \ **.\* *\..* **.*. *...***   #
#      #**.\  .. \.. ..  **\.* *. . . * * .\ *.\.  . *   .*  \\ .  ..\.*\..  \ .****...\ .\.\ \*.* ...* **.....*.* ***..  *#
#       #.# . .  . \...  \.\. \.  .\* .** . .* .   ..*  * *.\.. .\**  \*. .   . .*.     \*. ....*.**   ...*.\ *.\. *.\*....#
#   ####...  .**. *.*..**.\* \..  **\.*.* \*\  .*\.**. . * .*.\   **.. .. * . *\ .* . *.\. * *  .\\.   ** .**\ .** \*..*   #
#  #..    *.*\#. ..\.* ...**.\  **\.**.\.*.*..*....*... *.. **. . ..  \ . .* **..\. **.**  .*..*\ .\. *.\ **\..*..*. .\ *  #
#  #\ \#    .\ \*....*  ...*\*.* . *** ...\ * . . *.** *.\* .*.\  * . .***...*. *.*.*\..**.....*.\ **...   ..  .  *** .* *\#
#   #*  **  . . .*   *\  **.*  . .. ...\ .. *.\..\. .*\.  .  .. \....\...***\...*  .. * .*.*. \. *  ..\..* *\*. .\.\.\ .\.*#
# #L..\. ***\..**.\**..  ...\\.*\.   ..  *  .** .*  **. \. .* ** *.*. *.. ..\ *   *  ..*.. *\ . .*.. ** *.*.*\..*.* . \.*..#
## .## . .*......  .. *.* *..*.* . .**** .\* *** .. .\. ..    *  ..*...\ . . ** \.*....*  . . \. . \ .. ..**...***. .*.\...#
# \*.*#  \.. \\\  ...** . ** .*. \* \.*.**..\...**. *.*   *.*. .\ ..\. **. ..*.\ ....  . .\..\.*. ... ** *..\..*\*.\... *.*#
###**.*\ *.  .. .*.** **.... \*.\.*.  ....*..*.*. . ....\..***.  \** ..\   *. . **.*. *...*. *\.. *.. .  .**\ ..\ ..*\*.\..#
# ##.\. ..* *\.  ..*  ...* . .*.......**.** .*. *..*  \*  .  .. * *.   ..**\.\.*. .*\.*\  .\ \.\.**..\ .. *. .\. .* *.. ..\#
##..*\. .*..**\  ...   *.. .  .**..   *\ \. .. *\ .... . . . ...*. ..    .. \  .\  *.\. **. \  ..\.*\...*...  \.. * . *  .*#
# # *  ****\.* .*. *.* \\\.**  *... . ...  . .  **  .* .  .*.* .*\.  .*\  *..\\  \ ...*...* .*  * ...*. .  **. **\**. * .**#
# #*.**..\.\*. * .*...*  **.* . .\. .*\ **.*.. .... *..\*\**.*\ .*.* ...*\.   * * .*.\. ...    \. *\  ****\.. .\..  ....\.*#
#  #.\ * #**. .\*. .**.*.\... . **   **.**.\    .\.\*.*.. \.....\**. * ..*** ** .....   ..\.  .. \...\*.*.*. *.*.*  ...\.*.#
#   #..### . ***.*  .\ *.  ... *.       ..* .. \.*..\  . ..* .\\....*.  \*\. .*\* .*  . \..** ... * ..*. .****.. .  \ .*.* #
#    #....... *.\.... **. \.\ *..  .. \ .*    *. .** **  *  ...*\ .*. * . .   .**\ .  .   ..  * ...  \.*. ..\..  * ..* ..* #
#   #** * ###*\ ***   ..  .\** .. ***..\.. \.*.** .*. .. .**\*\*  .** ..*.  .\... \.*\. .*. \.. *. .*.*.*\ \.*\.*\. \. .*. #
#    #####  #. .  ..*. ..* * . .. .****.* . \. .. ... . ***...*. . .... .. * \.*. . ..  ...... ...*\.... .  \ . .  *. *\. *#
#      #   \ ..#\ . .  \.  . \\ **  * *..*. \.. .  *     .\.*\.*  *. \.. *\\\ .\...  .*.*. * ... \.*  .* ..*\.\.*. ..*\  ..#
#       #* .\\.     ..   * * . .*.* .\.* .    ..  .\ .\... \.* .  ... ....  .\ .    *...**   \ * * *.\*.. ...* .**\. . *.**#
#       #.\\ **... . . *. .*\.*...*.*.*\   .* . *\ \*   *\ .  **.\. \\.. .\.**\**.*...  ... .... .*.  * .\*. ** *\..***.\*.#
#      #.*. \...* **..\**...*.. ...\  .*.*. .\ .. *.**. .. \*  **\  . ..   \*...\*.*. .* .\.* *  . *  *\\ .**..\. \.*. \.**#
#       ##*\ \  .*\..***... ..*.*.  *  . ..\  *..........\..  \.. .\*\  . \...*.*. *.*.\...\. \.\  * *.. *. \ \*   ..  .. \#
#       #\#*.... . \..\.\.\..\.*.\* * .    **. \\.\...  \ \  \   . .* *.\*.*\*\*.\ .*.*  .. . .* ....*\ ..*.. ..**. * *\.. #
#       #***. .\.\ .\ * ...** .\*...** ***\.. ..* \.*.  .\ .. \.\ *..*\. .  ***.. \\. . **\.  .\. .\*. .\.* .. *.*\** *  **#
#      # #.... .*  \  * **.***. \ *. . ..** .*  *...*. .\.  \ .. **. .. . .*.*...\**  *.*. . *    *..*  *** .. . ..*  * .*.#
#      #***..\. . ..**.. .*.*. \.\.* . * ..  * \*. *.***..\*.*.. .. *\.  \..\ . ..**.*** * * \ *.... *.*\.\.    *\\.*\.\\.\#
#     #\ . *.*\* *\\.**. ** *.. .*.* *   * * .* .*..\...   ***.\. .\..\ *.** ... \.. ..\\. \ . . \ *  ...\. . *.*.*...*    #
#     #*\  * .* .. * .....\  .\  .*\  *.\*  ..\  \\ *. . *.\..*  . *    .\ *.   .*.*..   . *.    .*. .\ *\*..* ... . ..   .#
#      #* .#*.** * .\..\*   \***  * .*.  * .. *\\....\  ...**. .*\***. ..  **..\\*..*\  .**.  *. ...* . *...\.. \   .  \.. #
#       # .*.... ..*  **\  . . ** *\**\.\. * . . *\.  \. *\.\.  ..*.*  .. *\.... . . .\.** *.**.. . \\*..\  *.\ . . ..** ..#
#       #  .  * **..  .*  * *\...*. ...\   \ *...*.* * ..  .*.\. .. *..**.\.  .  \.\* ...  .\.\***\\. .**** ..*\.*\*.*..\. #
#      ##.*  . .** *\.\. \*.\.\.* **.\*. .* ..\..\ * ..** \ .*   **.. *.\*. .. \... * ...** *.*.*.* ..\* .*  *\.*..*.. \  .#
#     #.. .  \.*.\..\ *\\... .* ***.* *.....    *..\.. .. .  **.  ..*\**..*\*. ..*  *\.\**..\.... ...*...*.\..  *  ..*  * *#
#     #.#*.. ##\*#\*\ . ***** ** . *.*.  ** ..*.*. .. \*.* *\..*. *.\.\. .. .. ..* *.* **.   .*.***\\.**.*..\.. .*. . *** .#
#      ##*#.##\ # #*  *. ..\. ...\ .\.*.* *.\..*****.\ ..\*. . **....* ..\ .*\*\.. **\\**\.   ...*  \...  . .  *.\ . ..** .#
#        # # #.\ *\.. .*.*. ..**\ \.*\ .. * . .*. ... \..*..**.\**.**.. . . **\ . .....* .*..\*\  .*.*\ .\\ *.... \*\...*. #
#            #\#*.#* \ . . * .** .... *\   * *\\ *.  ... .*.. . .*.*.*.*.** * .* ..**.\..*.*.*..\.*\**. * ..***.*..*. . .. #
#             ##*\#* .  .  .\ .* ..  *. * *.\.\..\* * .. \*. \* \.* .\..\ * .  .\ \.. * *...\..** .*.*\..*....**\*.* \.  \ #
#              #\  .  *  \.*. *\..*\.\ *..**.  \**. ****. .*..\...* *. *.*.   .. .. * \ \ .\..*.*\.. ..  ..\ .\.*. .  ** ..#
#             #**##.\.#\ . .\  . . .* .*.\ .\.\\..   ... ****  \..*\... ***. *...\ *\ ***\*.  .*.  . *.*.  ** .\.\ *.*..  \#
#            #.*.  # . *\*.***\\ .  ... ...\ .*..*  **\ .\..\ *. .*\  . .\.. \ *....*  *.\*.. ..* .  .\.*.*.\ *.***....\***#
#            #\* .\   \ *.***.  *\.   **..\***.**... .*\..    .\.*\..*.   * \ *.*.\ .\**\..  .\*... ....\ .\..* *.**\*  *\*#
#             #*#.. *..*\\ ..  .. *.*. *. .    ..\. .\.**..\ . .*.. ..\.. .\.*.\.. . .**.. . .**  .*\**  .\.* *.\..\ **.\..#
#             #*#.#\..*  \     \ *  .*    *\.** .. *.\*...* *\  . **\.  ..**. .. **\. ..\ *   * *.** . *   \* .* \.\..\. *.#
#              ##.* **....***  * . .\****.*\ .. ..*.*.**.\.\. **\   *. *\ ..  ..*\ ....* .*.*\* *..**...\. \. *  *\..\.\.*.#
#                #.\**#\ .*. \.  *. . .\..*. * \ *.\..\*\ *..*.*.**.*...  *.\.\.*..  **.* *.*.* .. . .*.    ..\ *.. \ \ .  #
#               #.*#.#. *\.\ \ *..\. ****.*.        \ *.......  ... .*....* *  ****.**... ..\.*.  **. ..\ *\.*  ... ...* .*#
#                ## # ###*  *...*  . *\. *... .. *.\ .** *..\.*....*... *\. . *..  *. \ .*    *\ *.*    .**. \*\  .*.   . .#
#                     #\.\  ..\..\.  ..   ..\**. .. \ ** **. .* .. *    .  . .. .\.....  .*\*....... *  .*.*..**\. .\* ..  #
#                     #*##.* .  *.*    *. *\*\\.\..  *...\\*.*..\*..   .* * **.... \*\.*\ * .**\.\\ .    *\..\.. .*.*...***#
#                      #\* .***\ ..*.*. ***. .\* .**\\*  .*.. .*. ... .  *. *.  \  *.. .\*.. .**   ..... *   ..\ .*.. * .  #
#                       #.. **\ **\.**\\\.* .  \... ***.\* .*..* ..**\.*..\ .. .\  * .*.** \  .*\***\ *\. \.\. *. .\***.*. #
#                      #\ . . .....*   . ...     .*\ ... .. **.*\.*.* \. ...\.\* . *  .\..\.. \.....\*..**..   . *\ *.**. .#
#                       ##.*  ....**  .   **..* .*\ *  . *\***\   .*...* *..   .  *\.  *.\ .. ...\ \ . .... *..  \* .\.. * #
#                        #*#\  . \** \.   *****.*  *** \*\ .. .\* *.*..\*.\.\\ . * * \..   \....*.. .  *.****  .      *  .\#
#                       #*..  . *.*.*...*\.**\*.\\.*..  ..*\ *. . . * . . * .*.  ..\  .. ..  .. ..\  \.. . .\    .  .*  ***#
#                        ##* \.*. **.   *.. .*.  .\*.\*  *\... ... *..  .***... \ *  .*\***  .\ *..\...\.\\*.*..* *. . .***#
#                         #*\#\.....**\ ** .*.  * *.\..\...*\. *\* *\. *.\*\ \. \ *..**\*.\*\ *.\*..* **. ..\   .  ****\ ..#
############################################################################################################################