#######################################################################################################################################
#\... *. *\.*\  ...*\  .*..*** .. \. .**. . ... *\.  * .*  .\ *\    . * .   . ...\..*\ *.* . * ..#\ .*  *. #.*#### .#                 #
# *#\ .. .* ..   *.. .\ \.\.   ... .*.*.  .  **.. \\\* \.  ..*.  .***.*   *.\ **\*...**...  .*\**.  ..\ .  ##*#..#*#                  #
# *.*.\.  *  . .\.  .\ *.. .*.*.\ **. **\   ...  \ ...*. .  *.* *.***\.\ ..\. .**.* \.\*.. .   . *. \**. \ **\ *.#*.#                 #
#\.* . ..*.\. . .**.* .\*\ .... \ **\* .* * \......* \**.\ *.** **\... . .    ... *.. ** .. . ***\  *.*... #\ ...**.##                #
#.\*\ .... .  *\  .\.\*.  \. .\. .*. ..*.. .\. .** * ...\. *** **.*.\.*..\.\ ** **.\ *\*\  .* . *.... . .*  .* . .#* .##              #
#. .   .\. *\..**. . *. . .* *\      \**\ *.. * .\...\\  * **.\.\ .....\ *..... *** ...*  \ . ... * \.*\.* ***...**\.*..#             #
# \** ..* .*   ** **.**.* \*. .\*... ...  .\*\*.*..** ..*..\.\. .\ *  . ..\  \\ . . . .. *** . *.**..*.* ..* . .\*\ ..*\#             #
#... *..   **.\..*\.**.*  .*.\.*  ** . .\ *.... ..  .*\.   .\  **.\.**   . * .*..\..\. . ***\..**.. * *.* \.\*. .  *..* #             #
#**  **\...*.... ...**..  *  . *.....\*\. .***\.* .*.. *.. .*.\..... *   ...*\ \.** ...\* .  .**.. \.*. \ .   \*.. . *##              #
#.\\ .*  ..* *  .  .*.... \.*  *** \ .*  *.. * .*\ ... .    .**\.*\*.*. .\ **.\.*.\..**.. ... ..*\.. ..** .   .*\.    ####            #
#*. \.\ ....*.\  ** . \* .. . *\..   *.* .*\ \ .. \* * *.* \***.*. . *.. ... \ ..\ .\*... .*. \*.* *.. .*  ... .. ..*.#  .#           #
#*  * .\*.\*.... \  *. \*..** ... . \*..\ *..\ .   .*. * .  .** ....\... .*\..* . * ...  **. ...* ...*  .\..\***  *\.###..#           #
#. \  \.**.. . ..** ****.\ ..\...**\.**. .*  .  \*.... **..** .. \*..* .  **.\.  *.*. .\ *\  . \. *.   .*** * **...#  *  \#           #
#. ..\  .. \. **  ....\.* .*\  \.. .\    \.* .. *\  .*. .. *.\\  .***.\    .*    **..*.. . .  \......*  *.. .\**\ \#. .\.##  #        #
# .* *.. ..*\ ..***...\.*.*...\. *.*\ ....  . . . \.\...* **..*  .. . *. . *.  ...**.**  .   .***\..\\..\*.. . .....\*. ..*##\#       #
#* ..*.*...*   *.\.\.   . . *  .\**.... . \.. \  * .*  \.. .**...\. \ \ \.**..\* \..\.*\.*** *.\.*\. **\\..\*\.   .\\.\  \\ *.#       #
#.*. .*\ ..*    *\**  . \ *.*.*.\..*...\**.\**.. .\ .\*.\ \... *.  .  .*...\.* *\. .  **.\ *  . .\.. .*.. * . *\.\ *.. *.*\.*.*#      #
#\*.. .*.  ** .*.**\..\ .*...***.\ .\   ...*.\ *\\*  **\*. *** ..   .*** **.\.*.\  ..\* ....*  ...\ . . .    *.*  \*.* \**  ###       #
#... * *\**.. ..\*** *.* **. \..*.**  *..  * ..\  . \ . .\*..*. \. \*** .. \*.\. .\  *. *  .* . *..**\* \   *\..*\*..  .*. *#         #
#.  .*. .*\. \....** . . *.. . \*\.*. ..  **. * ..\ ..*.\ . *..** .  *.*  \*. **  ** .\*  .*\*\ *... *. . \\.  *.*\..\*** \## #       #
#   \ *. **\  \  * .\*. \* . * ..* . \.* * .** .. \.. .\   ..* *  *.*.*. . .\ *\ *.*\. ..*  ..  ... \.\ *  .** ..*  \..#. .**#\#      #
#   . **. .  *.  \  .... \ .*.*  .\* ... .*\.\ *. \.. ....\.\.*....\ **\*.  .  * \    . .\.. ....\**  ..*.*\..*.... .  . ...\#.#      #
# \ * ..\  . .*.****  *   * .**\ \.. **  \.*  .*  . .. ... \. \.*.\..\.\.**.\..*   * .. . .. *\...*\ . \.*. .*....\ ..*.\*.\ *.#      #
#   .**\..*. ....*.. *..\.\ ...  ......\**... .* ....*. . .* .  .* ** ..*.\.. ..\.*\ .*  *.. . . .*. . \..\.***\*.. ....\..\. ###     #
#   *..\**.. \*.\.*...* .***..  *  *   ..\ .***\ ****..* .  *.\ **... . . . ..*  *.....\   \. .  ..*.\..*. ......\*. ..\* ..\ * *#    #
#. **.* .*   .*  ..*..* \.*. * . *  \.  *..  .* . \.*. .   *. *..\  *.*..\ *\  **.**  \..**.  * . ***  . .. \..\  *.*\\  ***.  *# #   #
#\ .*\. ** \  ..*\ . .\..*.* *\  ..*. \ *    .*.   \     \ *.\.** .*. * \*...*.*.*. .*..\ \***\** .* .. \.. . .*.\*..*..**.\ .* \ #   #
#\****\ ... \**   .**.\.\. ..*.    .  .\\   .*\. .\.*\*... .. **\.*.. . .. \ * ..*  ** ..*.\.*  . *.\*.* \.*..*..*  ***\*.* *** # *# ##
#....\.   ...\*\*\ ....*. .**..  . . .* ..  *** .\*.... .*.*.**.**.. ..\...****.*.*..  ... *.. \. *...*. *  .\.* **\**. . \ **.\ *# #\#
#\.\.*\* .** *..\**   *  . *..\\*\.. \   * ....\  \  .. *. .  \ *.  * ..* .*\.*.*\. ..*  *...\ . \ * *\. .   *.**. ..* .\ ..*..#\.*##*#
#\* \.* **.* .**....**.\* *.*.*.*  . .* \.. \ . * .*.  \.  .* .*\ .\.*.*\\.\ .. *    **.*.*. *. .. \ . .\....*\.\*\.\.\.** .\   .\...*#
#... *...... . *\.**.\ \ *\.* ..* **\*.. .\  .*... ..* .  .*  **..* \ **..  . . * .  .. ..**\*. \.* .  *.*  *** ..**.  *.* *  .. \.***#
# ..... * ** ...  \... * . .. ...* **. **\\..*.. \.***  * ** . ..*.  ...   .\ *\.  ....*.\ ..\** *      ...*. *\ \***..\\  . \ * #\* *#
#\   \  .\..* *\  .. *\.*.\*... *. ..  . \.**\ .**.*.* \..\*\... *.*\..\ * ...\**..  ...*  .....**.\*  .\*\ ..*. *...*..**..*. ..\..\*#
#..  .\.*.. *.....\    . ..*...*..*  .\... *.. \.. *\.*.   .* * ..*.. ..*. *.*..**\.  \ *....* \.. *\\ .*. *. . .*.. * \*.* *#.. *# *.#
#\*...*\ *\ .**... ** *  \*. . .* *.  . .*\.. ..*\*\..\  \.. .. *\.*.   \. \ . \...  ..\..*. *\. * .. \**.\ .\**.*  * .. *.**..\ .**\##
# \.\....** ..* .* .* .** *\   *. *.*.*   **\  *... ** *.. ** * \.. *  * \..\ .* *.....* .**.*. . **   ... .\..  . \  *\**...  ** . .##
#. . .*. *. *\. .. \.   .\..\*.\*..*\**.\ ... .. ****. ..\**..\\.*\ *\*.  \*  **.\....\.. .\*.\  .*.  * ... *.. ..\. .\..\  . *.*  # ##
#  .\ ** \....  .  . .* .**.   . * *. .. .\  * ...*\ **\ .*.*\  ..**.*.  ...  ...*..\.*  *....  **..*\*.**. *....*. \. \.* ..\. .\  \ #
#.* .\*\...\.**   ..\ \. .****  \. ..   \.*....*  .*  *.*..* .**...*\**.\..*  *\.\*** *.\. *\*.\...\.*. \.*\*   ..*.......\.*.  \..####
# *.*.*  \  .. *  .** .\*\. *.  * \***.\.. .. **  \. * ..\*.*..****...* * .**.\ \  . .\ .. * **...* ...*\ .*.*.*  * \ \  \..*\  ** .# #
#\. .....  .  ..\ *\. .. .\ ..\ .\ ***\ \. **.*.  .*\.. *.. *\ *\.* .*  * *..*.\. **.*.**..\ .. .\.   **.* **.\.**.  *....\.*** *#\# ##
#** ** *\ .*..\**.*..**** .  *** * ..*  . ..*..\.  *  *... \*.*.* . .*\.\.\..\. ..R*.*..**..\  . ...*... ***.......* .  .\ *.*.**## \.#
#*.*\. ...*. ..*.*.  ...*  * ...\.. ..  .   . *.* *\* .. .  . ...*   * .*...     ......*..*..  *. *..\ .*....**\..*.\\.\.  \.  *.\ *#*#
#. * *.* *.\.. .... .  .\* *. * .\  *  ... **...*\\.. ** *.  \ . ..\.\  * *... .. . .* .\ ..*  *  . \.* .*.*....* * . *.\ .. .\.   \..#
# .*.  *.*\.*\* *\.\ .\ ... *...**. . .\*.   ..\... \**. .  *.\..** \*  .****. *.\. \.. . .*. *.   *...\*. \ *..\ .\. .*..  .* *\.*.*\#
#  .**..\.. ..*.   . .*. ..  ** *.\  \.  \..* . ....\*. *\. **..*.. .   \...*\.*\*.*... \  *\ \ ***.*.. .*\* .*.\..   .\.\*\.. .\. **\#
#\*.**.**   \*.   \  \.*    ...**.* ..  . . \\..*.* *.* **.*.. *.  . **   * \. . . ....\.\..*. *.....\.*  .*. ..**.* * .*.***. .. ..\##
#.\ .****\ * .* .\..\.*..\*.**... *.. .*  .*.*\.* .  *.*.*  .\ *.**\*.* .*\ ..\\* *.*..*..*\..** .  ..*. .\.*\ .** * .  .\ . .**\*\. *#
# .* .  .. .* . .*  ..*...\..*..* .... .\...\   *\ . .** .*. ....\.\.*.  .  * .\\\.....\* .. *..      *.\..\..\..* *  *  \.\\\**. *.###
#* ..* \..* ***...   ..** . *..*.*\.*\.* *.. \.\ . *.\*** .  *.     .*. .\ ...*... ...\.* **\.\ .* ** . .*\..\... ..*\*.*\  ...**.....#
#\ *. ...**.*.*.\ \**. .* ..\*\\*. *. **.*. \ .*\*.*   \.\  ..*. * **\* ..*   .  ..\  *  \..\* \..*\*.  .* .*. *\.\. .\  .***.... ...*#
#.\  ...\.* ..  **. ... .*\  . **\*\  *.. . .  * .**\   .**.. *\ . ..** * .\.*.*. . .*.... * \.*..\.  .  * *  \**. .. .*\ .    .#*.. .#
#  * *  .** \.. .. . .  .**\   ..\.. .*.* . . .....\* \.*.. ......\..\. **\ *.*\ * ** *.\ .**..\  ** \.* \...*.*\* **..** . *.  .\*\  #
#\*  \** ...*.*.*\* ..\*..*  ..      *.***\* .. ....\*.\. \ ...*. .*.\.*. ...*.* * ....**  ..*   . .....  **\...* \.. .**\  ...*. ###*#
#*\ \...* \\. *.*.* ..*.*..  *.. **..* *\. .**.\  ... ... . .*\.. *.. *...   . *.* .* * \.  *. .****\***.\. .  \.*  *.***. .\.*.####*.#
#**  *.\.*\ ..\   ... . **  *.  .*****. *. ...\. *\*\  .....\.  .* .*.*****.. . ..  ..* . \**.\*\.\.\*.**. . .*\**.*.... *. * **...####
#\*.. ..*.*.\ .... \  * ...\**.  *.  .. .* \*.*.*..... ..\ \..\**** .*. .*.. \..    . .**.. .   . \    \....*\**..\.*\.**   ##..#.#.# #
#  .*  .* .. **.*  .* \ * . .  \....*..\ .\.\....****   .* .  . *.**. * ..*.\... \\   .*..\\* .* .. * \  *\    *\\. .....* .##.\ * .# #
# . ..*\.\   . \... .*... .   \...*.*.* **..  .\ ...  .. .\*  .....\.\...**\** \  . \  ..\.. **\  *... *.**\.\*.  .*   *\\#.## . * \###
#*  . .. *.* . .**\*.   ...... \*\* . ..*.. \*...  . * *   *...  . **.*.... *.   ..* .*. .\  ..   *.   *.\.   .....    ...**#### *.. .#
#.....*\.*\..\ *.  *.. *\*.\ * ..** .\... ...\* \* *....*.\  ...**\.\*.*\. .* \ \. .*\.\. .   * *.*  *... ***.*. ***     ... *.#.###L##
#..*\.\  ... *. *.. .  \*\ ... *. ****  \*..\** ..**\\ *.\***   *.\*.. .* .**  .. . *..***** \*\...\**\ ..**.  \ ..* * .**\..*# #     #
#.\...*.   \** ..  .. . .  ..* *.*.\..  .. .**\  ... ..* .. *\ .. ***\  *.. \ \.\\\*  * \*.. .. . ....*..\...\*... * . .\.*  #        #
#  **\.\ . ..*\ .\.******.  .. ..... \  .\  .*.\  *\  .* ....\  \ . .*..  .. ..... .*..*.\*. .\...\*\..* ..... .  .  .* * .. #        #
#.**. *.  .  * \ *.**** *  .   * . ..\ *\.  \ .\... .. * ..  .\ .\ **.    .*\ \*\\******\ .   . \ . .*.*.\..* . ..\\*\.**  .*##       #
#..\. ..\**.**  .*... *\.* .\ ..\ .*  *.*.. ******.\. .. \. ....* \ *.\. ... *..*\ ..**. .* *.*..*.  **. *\*\\ ..\ ...*..\#..  #      #
#  \ .  .....  \ . .*\.*.  *\.\\ .*..**..  **.\*.\.\.   \. * .. .*. * . *\   * *\*. * ..*.\ .*\  . ..\.* . **. *  . *.*\  . *..#      #
#  . \ \.*.\ **..*\* . ..\ ..*..\.. *...*******\.*.  *......  .\ .\..  .**.  * * .  *  .*..  .* .*  *. .*...*\ . *. .* ..\. **#       #
#  *  *.   .*.*  .*.**.*\.  \. \* .\..\*. \*..\..**  ..\  \ \. .\ *.  . .\.. *...**\.  *. \*.*\*   **\.**.\ . .\\.*\ . *..  .#        #
# ...* .   *.\  ..* .\ \.\***\ *.  .*\ \   . *.  ..\ .. ..  **  *.*   * ...* .* ..... \*\\.*.\ *.  \.. \...** . .\\.***.*. \..#       #
#.*.*\**.*\.\...  .. *. .**.. .*.\* *...  *\\ ... \.***\* . ..*.. * ....\.*.*.\\*\*.... . .**...\ *\..\ * *..*....*.*** . .# #        #
#.  *.\.*.. *   ..\... .. .     ..* . .. . . ..\* . ...\* \.. * * . \.* . ....*** .. \ .\** ..\ ..* \.* ..*.  .\\.....*.* # * #       #
#.  .* ...*\.\ **. *..* \.  .\..  . \ .\*  * ** * .\ .  * **   .*    *. .\.*\ ..*\.*..* ....* **.\.  ..   .\\*\**\ .* ..*..\.#        #
#\.. \  .... . \.   .*...... . *.  .*..*.\..\.. .*.  .*.\..*\.\ ..* *.. \. ..\ ..**. .\. *\ .\ *\.*.*. . *. .\*\.*.*.  *.. * .#       #
#.* .. .. *..\ ..***..*..\* .\*\\*. ** \..*. ** ...* .   . ..\*. \***\....* ..  ..\*.\  ..*\.*... ...**.*\.. . ..*     ..# ..\#       #
#*  ..*\ .* .* \ ..\*.\ . .\..  *..*.\ .\*.*. . .**.* \ **. ..* ...*. *  **.. * *... *  . *.\..*\.*  *\ *..\.*   . . . ..\.\ #        #
#.**\.   .. .* * \**. .  . *  . \   . *.....\ .  *.*.. *..  *.. ..\.\ .*.  .. .* ..  \\ \   *.\.  .... . .**.\ .\  .* *. .#. .#       #
# \.  *.  . *..* ..... ..\..*\.. \. .*\.*.   \ ..* **  .\* .\.. .*....\.. \.*\\* .\***.*. \ ..*\...\.\   \.*.*\.   *.\#\  \ .\#       #
#*  . .** **.\ . \*. .*.   **.\*  .* .     *\..\..  .   ..  .  *..*** ..  ..\*...  \.\..\ \***   * .*.   .\...  \ ..#.** #.\##        #
#\** . ..*\*  * *..** ..  .*\\ . \.*.\.  ****. *.. .***     \..\ ...\.**   .**.*.   *\ * .\.*.   \ \* **..  .\. . ..  ..\###          #
# *\.*.\*... \. * . . .* * *.  ..   ..** **....\ *  .. .*...   .  .  *..  .**.\*\. .\ \*\.. .*\ *..**... *.   ..\..*. .##             #
#. *\.  * ** *.\. ..\...*.  \   \ \.\**  .. \ \. .\..\ .\. * *\ \*.  .\* * .\  * .*   .  *.***. \.*.* \.*  .    . \.  \####           #
#..\*. .\ *...*\ *. .  .**.\ **. ...  *  .**. .\.*.  .. .** .....* .*\  ..  *\*\ *. *.\*.\. ..\ . .** ...   .*.. ..**. .*.*#          #
#. .*.*. ..  **  \.  **...**.. .\* .\ **.**.* **..\ *** .. .\***\*  ...  \ ***.*** \ .*.*   .  .  \.* . . *... **...*\.* ..\#         #
#*  * ..** .....*  * *..  ...  .*. .* *.   \.*..\   ....  \* .**. *  .  ......* * \. .. *\..   ....*\  .  **  . .*\ *\  . ##          #
#....\* *\ . . .. .\*..*\. .\ **..\\* \*.   *.  .* \. \ *.\*\....\***.\...      .*   **   .. *.*\ *\..* . **.  * .  .   * .#          #
#.  **.*.* ...\.** . *.*. . \..\...\.\ *  *..* .*.*...  . ...* *  ... .* \ ... **..* *\. . .. .. .*.  .   ** . *  *  *.\. #           #
#.. ..\**.  . *\..  .*\\*.\** ..\\\. ... ..*. \  ...\.. .* *\. * *    .\.\ *.* *.\. .. \ **\ * .*..\ \.\*.*\  **.*. ...\\#            #
#*  .... \ ***...  .*.*  .  .\ * .*   . .**. *..*.  ..\  . .\* . .  ..   .*.\. *..... ..\.****\ ..* .\ .. .  *.\ *.*    #.#           #
#.**.. \   *.**  .* *.. . .  . \**. ....\  *\*.\*  .\ *   \ .\ ***. .  \ .* .. .  .    *  **\ *.*.. .*\\ *.\*.**.*...**\  #           #
#*** \.*\\*\*..*  *..  **.   **..* .*\. *\\*..***** . *..*.\.* .****.**. ..   * . . ..   **\.....   *. . \.\*..\   *\##.*#            #
#.\ *  .*  .*\ .  .*. **.*.   * ...\..\.***.. .\**\.*... .*. .   .*******\*  .* \ ...  . *..  *\ ..*...\..\ **  ***.. *\#             #
# ..* *.*\  *.*.\. *.\* *..   .. *.**. .... * * .*.\..\...**\ **. *.*\..\\\ \     .. . ...*\*...**..   *.\.*..  . ... .#              #
###.  **.*\**\*\  .\.*.***  .. .\....**.* **....*.*. ...\*  \ . ..**\. \* \...  \    .** *..***...\. ..\  .. .\* .** ##               #
#..*. * * **.. ......***.. \* \ *.*\ .***\... \**..\*.  ..\. **.\.*..  .. .\  .*.\* . .*...*  .* *  * *.*..* .*.....\#                #
#. *..*\  . .   .\.  .*.*.\.**..* .  \.\. \.\ *. * *.\   *.* * .... . \..\*. . .*.\ * **    . *..*\*\.\..# #**.\. .##                 #
#. .*..\. *.*.*. . *.....\  ..\*.   . \.* .**  \.. *. .....*..\. * *...\*.\ * *\\ *.*.**. ** ..*...* * *..\* ** \#*\ #                #
#..\. * ..\. . .\ *\  \\.* *\ ...\*  **.* \.. ....\ *.. \*.. \.* .\.  *.**. . .   **.*. . .  * \ ..*.. .*.#### #.*#* #                #
#  ** . .. .*     ..*\..*.*\      .   .*.\ .\   \...*..*..*..  *.**.\..\..  .*  .  .\* ...  \.   \*.   \.*\.# \# # ##                 #
#\. . . .*.**.**.  \.\.*. *   .\  *... ...  . *.. *  . *.* *.... ..\. \...*. .  . * *.. \... *.*. * .**.**#*##*##                     #
#.. ..\. .... *.. .... ....   \*.*.* . \  *\*.* . *. . . ..\.**.  ** .. * ... ...*** . *.. \ .. . * \.\. .#*###                       #
#*     .* \  ...  \.  \  ..  \ ...**   . .*.\*\ ..**\*. \\ *...*\. .*.   \.\ * ..**..***.   ...\.\.\. .\.*.*..#                       #
#*. ..* . .  \.\ *.. * .* . *.*. *\..* .  .... * .**..*.. \ \.*\.* .*.****..\. \. . .**.  \   .. ....  * ##\*.#                       #
##\   . . \ \  *\.. .   .*.**..* .  *\.  .. ..*.* *..   .\.   \. \.\. \**  * \ *.  .*..  *... **   . .     ###                        #
##\..\ .  .... *.. .*. ....**..* \. .... .\*.\* *   \.**\.   .....* *  ..*.. .** .*.**\\. .. *.. *\..*  #\##                          #
# ..   *\*\......* *. .*.* .\* .\.\ ..** *\*....*.**.  .\..   **. *.  \... .\.\*  ..\*. \  . .*  \... *.#*#*#                         #
# \.\.* .** \. \.\.\ . ***. .*.*\  *.  .*. *.\ .  **\...  ...*.. ..*\ . *\. *..\.......*.**.. . .*..\  *.. *\#                        #
###\  ..\\.  \ . .**.*\..** .. **.**  .. .* .*\. .. .\. \.  .. *** **.    .*.. .\*\  ..*  ..\  *\. **  ** ##.#                        #
# #.#*   \.*..  . \. *  ... *  . .\.\ *\    .. *.\. *. .*..   .\. . *.\...*. * \ . . ...* \.  *..*..*\ \##  #                         #
#  #..  \.*. ..* . *\.\ * \.*.* . .   . . .*  .. \.*. \ \ . .. .*   \..\\*.  . ..\ *. * . *\...*.*.*....*#                            #
#   #..##.#. ...**\.. *.*\.*.*.***.. *\**.*.\..*\. . **.* ..   .. .\**.*..   .  ..***\*\...* .\.*\...*.\.#                            #
#   #  # ###\* *...  ... *.***.\** * *.*\\. .* .\ .\ . \.* . *\**.\. \.  . *** * .\.*\.**.\.\ .*... ..##*#                            #
#    ##\## ##  *.* ..\..***.\.  . . *\\ *   *.. \. * \ .**\. \*\  . \*..\*..*\ .\.* ...**.*  ...##.###  #                             #
#     #.#*\...*.... \  .\.*. *.\ ....***.\ .\.\.\. *  . \*... ..  *. *  . *...* . . .* ..\.  *.*###                                   #
#     #\ .*. *.*.\ ..** ...*  ** \..**\ *.*  **.. .\*\.  .*..\   *...*.**.. *\...**  \*\..* .*\** #                                   #
#      #.\..*\ **.\ \.\*.\ .\  .\. *\*... * *.*..\. *   ***\*  .\. **. ..#*..* .\ .\ *\. .**\ ##*#                                    #
#       #*###**.  . \*.*** * .*\. \.\.  *.. ...*.* .*\  .\. * .  \ *.. \.. . . \... *\** .#*. ##.#                                    #
#        ##\ ..  . **\..\  \ \\*. \..   ... .\..*.*..... . *  .\*... *\ . ** .*.. . . .  \\*.#  #                                     #
#         ##. . \....\  *. .. .\ ..*  \ *.. *\ * ...\*.\.*\*.* *.\..\.. .\.. ..\*.\* ..*..\# #                                        #
#        #\.*.  .** ..\***..\ .**.*\****..\ .. \.. \ ** *..*   .\**.\  \..* \* ..  . .\ \.. *#                                        #
#         ## .#.\   . **.\..\  .* * .**...\ ...**  **.*.*.**  \*.*\  * .*.. .*\*.  ..  *  \ #                                         #
#           #*.. . *  . . \ . \*. .\ * *.  .** *.* *  \ ..**\*.*.  .* *\\. \*. .*.*#.**#.*#**#                                        #
#           #.... .. \...* #\.\..  * *\...  **.. * *  .\..*\ \*#....*.##.** **.*\  \...# ##*#                                         #
#           #**\.*.*.##**#..*.* ..\.......\ ...* .*.* * . *#\#..... * \\\** *#*.*#. \**##  #                                          #
#            # ## ***# #.*#\.* \*\.  .. *.   .. * .\... . # #.* .**##.# \*.....*# ### ..*#                                            #
#         #### .#.#.**# .\*.\.*..*.  *  .  **\.***\*  .*\.#  ##.*..##.#### \##..#    # ##                                             #
#        #**** ##*###\###.## ##...* \. . * *.  ...#*. *\##    #.#\*# #    ##\\ #     # #                                              #
#         ####* \.# #.*##*\.**\ **.*   .*\ . *\  *\*.*.#       # ##         ##\#      #                                               #
#            #*#. #  ## # \*#*\*..  .\* . ...**... ##.#                       #                                                       #
#             # ##       # \ * ..# .*. .#..***\ \*.# #                                                                                #
#                        #*. \*   #  ####\*#.... *#                                                                                   #
#                         ###*\ \**# \ #\ #..*#* \#                                                                                   #
#                           #*#*..#\*## # #### #\#                                                                                    #
#                           #.\#\# ##    #     #*#                                                                                    #
#                           #*# #               #                                                                                     #
#######################################################################################################################################