#########################################################
# ...*. .*...*..\  *\.. *\.* \*..\.***..  \*..* .*.* *.\#
#\ . **. . .  \.  ..*\.*\*... **..*... .. .\.*.  **.\\\.#
#..*  .  *    ** ** **...*.**... .. .\ .*  *.**   .*.. .#
#*\... ***.*.\.\. .*.**.\.*\.*. .*..*. ** \. .\*.**...\*#
#.    ..\**\.  .. *\ .*. .* *  *.. *\  . *.\.\.\.*.\\. .#
#. *\ \**..* .. .*\* ..\ *\.\  *.*\..*\*.***  .*.*\ ..  #
#\.R*...*.. \ .**.... \** . .  *.**  . .**.* ..*.. .*. *#
#..\.*\.\ \*...***...\.. .\ *.\.  *  .* .\.\... **. \ ..#
#*.. \.*\ .**.....   . . \*.. \ . . * .*.*   ..  .  .. *#
#... .\ .  *..* ..*  ..\ .. .*. *...*\ .*.  ... .* *. *.#
# . ** \.. \  .*.\.*\ *..*.. .**.*. ..*.*. *...*....\..*#
#*.\.\. ... * \*..**. ..\.*   *. .*  .\.*\ *.\*.\.\...\*#
#**. . \  .*. .* \....* .** ... ..* .*.***..\.*...**\**.#
#***\. .\. ...*. .\..*.  *..\**. *.. \ *.. .  ** *.** ..#
# .. .  .....\.. ... *.  .*\...*.*\ ..* .\.  ..*...**   #
#.. \* .*  ....\*.** \ . .. . \. .. . .\..  .. .*\ ...*.#
#.  \* .\ \ .  ... * . .\ .. ..*. ...\   . *\* \*.*.\ . #
#.  **\ *.\.  * ** \ .*... * . * \  .. ..**. ..**\.\** .#
#*. .* \..*  *.*. *. *   \**\.......\*..*...\  *..  \.. #
#\ .*.  .*. *..\*.\  . .\..\.\..*.   \. \ .\.. *.\ .  *.#
# .\*..\*.\.*.* \.  .\ ...* . **..*..*\....*\. . *\* ..*#
#  .. . \*  .\*..\*\*   .   \ .**  *.*.*. .\ * . . .  .*#
#**\.  ...  * ..*.\.  * * .\ * *.. ..* *...  .\*\.  . *.#
#*..*   *  ...  .. .*..* ..*..\.*.* *..** ..*     ** *. #
#..*\. \* *\ \..* . ***   . .. *.***.  .*.  **.   .* . .#
#  * .*.**  . .*** .\  .*.*\ . . *....*.\..*.***  .*.. \#
#.*\.\. \ .. .*.\.\.*.* *.\  *\. *\ ...*  .... . *. * . #
#**. * . ..*   ..\.**.. . .**.    .  **\.* *... *\* .  .#
#..* ..*...*..\  * *. .**. \. *. ..*..**.. * *..\ ..* **#
#.*... **  .  *.\\*.* ...*.. .*... **. \ **..**.  . . \.#
#.... *..*\. .. . \*.*\*. \ * . ***..*\ ..\....**. .*\ .#
#.**\ \.  ... **   .*..*  .... \\.* ..* . ..  .\...*...*#
#..*...*.* .  \.  * .... ... .  \ . \ . \ * ***.\  .*\ .#
#*\..\.. .  * .. .* **\.\* \ .\*..*\..**..\ ..\  ..\.** #
#.*..  .*\.\.\.. *.\.\*..  \.... ..*.\.    \\..\*..*. . #
#\. ..  .  .* ..\..** \.*.*...*  .*. .  \*\.*  *.* .....#
#..* **.   *.. \ .  *\**\.\..**\* *. *. . . . \. ..  * .#
#\.\.  .  .*   ..*\.....* ** ****** *.\ .  ..**\**..\. *#
#**.. * .*\..*\** ..\\.*.*.......\*\*.  ..\...**..  .\\.#
#*\.* ..*.  *\..* .*  .*.  \  \*\*\ *. *  .* .**  *.* * #
#*.**  * *..\.. . .* . .. ..*  ... .. \  . .*... .\ .\. #
#.*\**   .\.... *..  ..*\. *. \     . . . . \*** .*.   *#
#\.*.... \....  .. . \ ..\ ..\...... * \.* .***.. **\.. #
#*... ..   \ *    * .*.**.  **..\* .\. \**  .\*\ *.* *\ #
#...\ .*.\*. \. *.** *  *  ....  ..*\***\.\ *..  \...\**#
# .  .*\ ..*.. ...**..*\.\ . .    ..*\ ..**....*.. \    #
# .\*..\**..\.. .\.   *** .  *.\ .. ..*.\*.  . .** ***\.#
#\  .   .* \..*  *..\*.\.. .*....  \* . ..  \. ..* *\..*#
#. \ ***. . * * *.\.. . ..* .  *..\.*   .* * * \** . ...#
#.. .. * . \.  .\.  * * .\....\  ** ..*. **\**\.\..*\   #
#\ .\*.***.  *.\.*  .* \.  \.....\* . .. .\* ** * ****. #
#* ..*\. \ . ...* .\*.  .. .  .\. *   . ... . ...*...*. #
#\. **..\.  .* ..\ .**...\  \... .. .\*\\ ... *..\. * . #
#.  .\ \..* .*  \.  *.\ \.**.  \  ..  ..\\ \ ...* \\ .\ #
#* . . .*...*.\*.*.\ .*  .* .. .. *\*.  \*\.   *. .*.***#
#.. .\.*.. \... ..    ..\ * .... .* \. * . ***.. *  *..*#
#* \*  ...\.  .\   . \\** . * *\. . .. .*  ...\ \**\*   #
#*...*  .. ..  .\ \. ...*. **\. **.\..\   \. ..\..* .* *#
#..         **.*. ..*.  ..*.\.\... .\*.\ *. *.  . \  ...#
#.\.\*\ . . ..\.* *....*. . .*....\. ..\.\  .. ...\ .*  #
#. ..\. * *** * . * \  .*.\.*..*.**.. \*.\\. *\*\ .*\  .#
#**  . .**.*\.....*..  ..*   *..\*..* .*\..*...*\*\.*  *#
#* .\.\..****\  .* .**\. . \ \*. . .* *   *\.*\. .. .*\.#
#\  . *...* *  **.*.*\. .\ *. .*  .. * \.\\ ..*\\\* ...*#
#***\*\*.\..*.*** .\. *  ..... . *  *\.\*.. .\ *.  .   \#
#\   ..* *  *  **...\ .\*.\* \ .*.  \.\...*.**\.*.**\  *#
#**\. .*.*..*. *..  *.*\ .*...\ ..* **.. *....* *\.\... #
#..**\ *. *....*..... *\\ .*\ *  ** ...  ..**\**.*. *.* #
#.*\ ....\.*.\ *   . \.* ....\ .* .*..**.* \.... \...*..#
#\.. . *. .\ *\  \* *. *.. *.*.*. *\**.. * .***\ .*..* .#
#**\.*.\.\*. *    .  \*\*\.. *\.. *...** **..*.*.*. ... #
#.\  . ..*..**  **  **..* .  \.   **.\.  *\... *.\...*..#
#..*  \ **. .. \.* \ .\*.* *\..\*.* *  .*\   ..*.** \.. #
#*\.\..*.. * \.. \*. \.\***. *.*.**  ....  *..\..*.. *..#
#... . \ **. ..\ .. .. *..*\ .\* ** *  \\ .\.   .. * \.\#
# .. .*  ... \  .....\.\*.. \*.\  * .     . ...   .. *\.#
#.** ...  \* . \* .  . .\   .** ..*.. \* * .**.  \.*\.*\#
#\ * \ .*\****. **. * .*.... .\  ... *...*.\.   \.*\****#
#.*.\ . . ** * *.. \.*.. **..\* *  \...  . .* . .. *.\..#
#\* ** *  .....\. .* \.* ..*\.\\*\.*.\\. *.\*. \..*..   #
#.*.\. *.**.\ .... **.*. *.** *.\ .* *\.. **.\ .\ ... .\#
#\**.*\*... ...*\. . **.*.* . . **\   ..\*\.*.* *..\ ...#
#..* *\*  ..  .\* *.\...*.. *.. . **\ *. . .\ *   .    *#
#*. \*\*.\    *.. ....*\.*\\..\.*\.. **\  ..*\.*\ ** \ *#
#\. .  . *..*.***    . .\*   \....  \*...  **...\*.* .\.#
#.**\* ..**\.*.**..*\**..* *\.\** ....* \   .\. *.*** . #
#  . *  \.*.\. .*\ \... *... *.*.**\  *...** **.. ..*...#
#*   *  .. \  ....     *.....* .   .* \  *..\.*.\  . *. #
#..\ . *. *.**\    *. *..* .\.\*. . .\\\..* *****\ *.. \#
#*    \. .\..**\   *.\.*   . \ .... *.\ .\.\...*\..\ . .#
#. *.*  \... . .. \*\. * \..*.*** *  *.. .\**\ .** . * .#
#* . . ...\.  .*.\...\.  .\ .... *...*.*\  ... \**   .  #
#*\ *\*  . \..**.. . .\*\. . \*\. .* *  * ****. \... .  #
#..*.**\\  .*.\.\  **. ..   *..* .*.\.\ .*\.*.* ..\**. \#
#... *.*  **.* .**.\.** * **.. ..\*. *.\*\*..*.* .*.*\..#
# . *..** \. .  ..... . . .***.*\.*\*. ***. *.\. *. ..*\#
#.**\* .\ . .   *\..\* .. ..*\.*  .**** .. .\.*\ \\*\. .#
#.....   * ...\.\  ...*\.\... . \*..*\.. \ * *......   .#
#**  \. *. \. \ ... ...  .**....*. ..  .** .\ *  ***  * #
#*.. .\.\*.* . ..* \ *. ...\. .**\ ..* \.\ \. . * *.*\ .#
#*. .* \\ .. \ *\....\*.* *\. .\*. * .*.  \ \ ..* .  . *#
#.\..\....\. .*.. \ ... .    **. \*. . \ . .*\ *. ..\ \ #
#.  \ *  **   . *\. .\ **\*..*\\. *\. ..* .. *..  . ** *#
#. . .*....\.*. . ** .*....**  \ .\*.* .\.\.   *\ \ *.**#
# .  .\  *\.....* .*..\ *\*.*\...*.\*..  ...  ...   ..*.#
# \.. .\.\ *... ..**  . \ *   \ .\\..* \ ..*.*    *  .\ #
#\. **. .. .* ***\.\* . ... ...\ . \.\  ...\** \... \.. #
#.   .  . .*\. **.*..*..\.*\..* * .   *   ...**  \.\.. *#
# .*\.. \* ... *\*.*\ *\.... *\   . * . . .. ..  * \ ...#
#*.\. \   .   \......*\.. *. ...\. .\\ **...  .*.  .*\..#
#*..   .\ . \** * . .**...* .\... ......*.. \\*. * **.\.#
#*...\.\ ..\ ..* *  \ .\ ...\.\ .* *  .*\..* .\..*. ..**#
#*\.*. *.  *\ ****  .\.\* *\.*..*.\\   ...***   \ .* ***#
#.*... ***.*..*..*.  .**\  .    . *\\**  ...\**.* ..\*.*#
# *.\***\.\.* . ...\ \*.*  .****.\.....*.. ....**\ ** ..#
# \..*...  * ..* .*..*. * \ ....* *. . \..  .**.*\..\.\.#
#   \.*...\   ** ..***\.\* **.\.* **..* .\.\.\\..**\.\. #
#* \ .*..\\.\ .. .\... .\. . .\ . .\  *...*.** .*.\*..**#
#**.\..\.... .*   \. * ..*..\*. .. *. *    \*.**..* .\..#
#*. . \.\.  ..*.*..\ .**..\..  * *.*\ .  \  * ....*\** *#
#*.  *. .\ *.*\*\ \.\..  *. ..\**........ .\* . *.**.* .#
#*...... *.... .. ...\. ..* .\..... . ..*.*** .\.\*. .  #
#***.* .*. .. .\. .*.***. *  ...\\..   ... ...  *..** .*#
#*\...\..  .\.***.\. \..* \ *  ..*. .*..*\**   * \*....*#
#.*\*\**. . .*..**.. .*.\* *..\..\..** *** . ** ..* .\ .#
#.\*\* * .\..\. ...**\.* *\.\.**  .\*.* **.*... \** .   #
#....\ .  .    ..\....** ****.**.*..***.*\ *.. . *\ \ \*#
#. * .. \\..* ..*.\ .*...*..\\ **. \*   \.*..  *\.   ...#
#\.*. .*.***. .....  **\...  \*.. * . .*\*. .\ ..* . .*\#
# .* * \.*.   *...* *... \.*\.. \.\ ..*\ .\*\ *.\*. . ..#
#\***. ...**. . .\*  .*.*.** .**.  **..*   *.. .* *.. *\#
#***.. \ *.* *\. **   ** .*.. .. *\.**\*\...*.\*  \  \*.#
#****\...* . .   .. .**.. .\.*  .\         *.*\\......* #
#.. .     . *. *\*. ..\.  . .. *. .  *\.***.*.. .\* \\**#
#.*...* . .\.\.\. * .. . .  ...\  *..\ *.**.*.*.*.*...\.#
#*.  . *. .   .. .*\**. .*\\ .*   .. \...**\ .  ...  *.*#
#\*   \.*\.*...\. .....\ .*\*.   *\. . . . \.*   ...***\#
#.  .. .   . *   ..\..**.*...  ..*..\\..* ...\ ..  \.   #
#..  .**..\*... .**.. \.*\\* ...***. .\..\* .*.*...   ..#
#***. *\...*   . .*...* . \* .\*\ \   *.  .\*. * *.* . .#
#\.** ..**.*.* . *.*   *\. . \. *.  *.\. .* .* * ...\*  #
#   **  **.*\.. ..\.\ \\.\..* \.\ \.\\ . .*  *\.\.. ... #
#\\**. .\.   ..  \..*..*. .....*.*....  ... *. \..\.*\**#
#.*..*\ *.\*.  . .\ ......\  .\.* *....**\. *.*.. \ ....#
# . \.....  ... ..*.* ..     **** .**  .*.* ..* . \.\ **#
#  *  *..\\  ..\.\* .*.*  ..\****\*..\*   ..... . . . ..#
#.    *  .. *\ **\.  *. .. . .*.* **\..**. . .\ \....\..#
#. *.\.  ...* *\ .  ...*  \.. .  *\..\..\ *** ... *   * #
#\ .. \*..**. *.*\   ...**..* *....\..*   .\.. .  .\ *. #
#* *.. \.\* \ .* .. \  \.**..\*..* *..*.*\**  ..*   .*.*#
#..\ * .*  .   .*\ \*.\* \* .** ..*\ * *..*..  *...*\.* #
#*.*\.. .\..\ ...*...\ **.* *.\ .\\. ..\. *  *. .. **..*#
#.   .  .*\\ *  *.**.  .*..* **.* .\\\*. \.*\. .*\..  ..#
#*. \..\***..*.... . .\*.. .\..\*..*.    ... *\.\*\\\*  #
#**\. ..*. \\.\*\  .* *. * .* . ..*.\ .**..\*.*.  * \.*.#
#.**  \.   . . * *.*\  *\.\.*\  .*. ..\.\ *.\.* \* \..\*#
#\.*\. .  **  .*\* .. ***.. *. **.  *. . **.. *\\* . * .#
#  .  .\ *** ..  .\ ...\. ***.***\ *..*..\   *\. .\* .  #
#.  *  .\....  ..*..*. ..  .. . . \......*..\*.\  ..  *.#
#.*.*  .. * * .     ..* .*.*..   .....\ ...  ..*...  .*.#
#** ..\ . \*    .. .  .. * . .\**.  .  ..\ . *  **  * .*#
#\ *...\. ....* *\ *.\   .*\ ***.* ..  * .. * \... **.. #
#  \ . .  *\ ** . .**** *..  *\ .*. **\**\.    ... ....*#
#.\ *. *\\...\...... . ..* ...**. .*  .*.*..\..*\ *   \*#
#.. *..\*. .. *.****  .*\.* .*..*.\ .. *\..\.  .  .... .#
#.\.**.*.. *  \*..\*..\*.*** .\.. .*\**.*  ..  *.*   \*\#
# * **** ...\. . \ \. .\*.\ * .**.\**..*...*..**..... \*#
#....*.   ..  .\*..  .. .\* ..\\.  .. ..*.*  .**\** *.*.#
#\*..*.\.  . \  *.. \.* \.\ \  .  ..*. .**.*\..  .* . \*#
#....... *... . .\.\.***..* .\* .. **   . .. *. . .   .*#
#* ..* ..*.\   . .***..*...***.  \ \*.* ...* \. *. . .**#
# ..\.  \. .* .\** .  *...\  *. *. .\ . *\\. ...***.\ ..#
#  .. .* .*.. \*..\** *. ..\ .*.*\.  \  .*..  \.\ ...*  #
#....\ ** .** ... * \ **..\..* .. .....*.*\.    .* \   .#
#\   . ..  ..**.  .  ..*.*.*.*\ .\.\.... \ *.  ... .#...#
#. *\. **  .\***** .*..*\.* .*.\\*\.*  .\.\**. .**  #  ##
#\ . ***. .\  .\.**.\.\. ****\*. \**. **.*.*** \.\ # .# #
#*\*. .*\.*..*.*.\.\* ***\. *.\.\ .  ** .* ..*.*.\ .\.# #
#  **\..*.\*.\\\. .. .....*\\.*...*.\.\* ..*.\\.* . * # #
#. ...\*.\.\\.* . \\ \  . *\*\.*.    *.**\.\  .* . #*# ##
#\..* ..* *..\.*. ..\..* \*.* \*\. .\*..*...   \ .#   #*#
#*.. #. .\ \*\**  .\. *.\...*\.* *. . ..\.\.\\ .\***. . #
#.*\.*. \#*..**.* \.\ \. \ *\.*. ****  ** *  . .*. \#*. #
#*\ .\*##.**\*..\*.* \\**. \  \.***.\*.\\..*.\.  .#.**\.#
#\..  # # *....*\. * . *.*. *. *.** *.\.. #. .*......*L #
#.\....##*\\ * \. ...*.#*##.* .*...* * #\ *..   .\ \ *#*#
###.*.#  #. ..##*..*\#\ .##.. \*.#.*..*. \*\ *. .* .*# ##
#  ##*#  # .#**##  \.#*#\  .#  #\**\*.\** *...#**#* #   #
#  # *\#  #\### #.*.. *###\**#\# ...##.*.*. .*##*##\#   #
#   ###    #    # *  \#  #.*\#\#*\\\**\.#.#  *# #  #    #
#               #*  ##    ### # ####\#*.## #.#          #
#               #*. #               # ##    #           #
#                #\#                                    #
#########################################################