########################################################################################################################################################################
# \ *. .**.*.  *    . .*\..  ... . .*. ..\. .. \*..*****.** \ . .\.*.. ..... . * .  .\  ... \.  * *. *. .\* ***.* ..\...\....*\\*\ **......\**\ * .\ .\.#*#            #
#. ***.\ ..*\ *.  . ** * ** *.* * .*\  \.. * \\..*..\.\***..   \ * *.\..***  .* .*\. *\.**.*.  .. *   .* *...*\..**\ \ \* .  **.. .** .\..* ...# .*\ .  . #            #
# \ *. . ...*  \ \..   .* .**\.*..\. .. ..... *\*\*\..**.  .** *. \ \.  *.*  ..   **\. ..\*\* \  \.    * ... .* .*\. *  * *.\.\*\  *. *\ \..**** ** \ \ .#             #
#.  .\*.. .**.*.*.* ..\.. .\...*.        *.  \.\. *.* .*  * ...\ . ..*. .. .*\  .*..*\*.*.  ... \ .*..*....   ....*\.. ..\.\ *.*****.\...  \.\.\.\*  .. \ # #          #
#* . *\...*.\*  .*.. *.* \ *.\ ...*..  .*\ . .  \.  *. \. .*  . . .*...     .  *..\\*..*. ....\ . .  \.\ \.. ....\.**\.*...   ..\..**. ** ..*.\** ..**\\####\##        #
#.*.* . .*.\*\..* *. . **\ .\.\.  .\..\ *.\.. *\.*.... . *..** . . .*\    \**... *.***. .* ..*\   **  *** \. ** *.\*..*..   \.\  **...**\*\\.  .... ...\. *.\. #       #
#\*.*\  ... ..\ ..**.\..\  \*.*.  .**. .*.*..*..**\. .* *.  ..\. \  .**  . .*..   \..\**.**.\*  .  .\****\.* ** ***\ .*\   .......*.  .\..*.\\. .*\ *.. * *..##        #
#**...\. *. .\ . \ ..*\. .... ..\** .\* .*.* ....*.**.* .**. \**. .* *. \*  *\  \. *.\ \\.\*.\ * . *..*.*  \ ..\ .\ ..\* \..\.*\ ...*\*\ .  .\   **..**..\#*#          #
#**  \*..\ \**.. .\ *. . . .. ..*.\ .*. **** .*... ...*  *. *.\..* .*.. .  R   .\   \  ... .** . .*.\.*..\.\* *    . **\\*.\  ..  ..\*\*.**\ .\\ \*\.**#*###           #
#.. * ... ..* .\***.*... * .. . .  .* ***.*.... .*.\ .**..* *  *.   . .. *\..\**.* .. .**.* **. \**.* *     **.*..\. .** .*.* .. .  *.*.\***\ ***..\*.* . .#           #
#. .... \*...\\..*\.*..**.*....* **\.*\*\\** \ . .. *\*.. .\.  ..  \. .  \ \ * ..*\.\...*   **..*...*\\\*. .*..**.*.\ .*... * ..  ...*\  \ .* ..***\. *\.*.#           #
#\ .. *\*. .. .....* \\.. ..\. .\.*.\...\ *.\... .\ *. ..**.. *\   ..  ..*... \ \*....\ . ..\\  .* *..  .*  \.*.*\... *.   .\  .*.... . *.**.. \  ...\#***.#           #
#*  .\.. * **. * \.\ . \ \.\* *.*.*.*. .*.** *.\. * *. \*.****..*. *\ .  .   *.  *.\.\.*\.\ *.. * *.* *.*\ *.*..* .  ..*..\...\ ..\. \* * .\  .\  *.. .\.######        #
#..  . * *  . \.*.**. *. .*.. ..*\ ...*.* . .*  ...\*.\. .*. .. .\ .*\..* .*\. .*.* \\..*.. ...*. *.**.\.\*.*.. **\*\ *\* * ... ..**.....\...*\. \* \  \.##..\ #       #
#*. *\ ..*\. . ..*..*   .\.*..    .   ...**.*.\* * .*\....*...   .*.\*.\.. *.** ..\.    *.   * . .* ...*.\.  . *\\ ..*.  .*\..\ ... *. .\*   ***. \..* * \#\.#*#       #
# **    .*  \*   *...\ .. *\ .. ..   . .\*..\ ***.   .***.\*...\*...*\ *  ..*.. *.*. *.. . .*\. . *\.**. *  .... .\*.**\* ..*. .\.... *  . **.\.\.\....*  \.**.\###    #
#***. **\\.\ .** .\....*  .*  **\.*\.\* *. .*...   .. ..*.... *...\.....\..\. *.. ***  ..* ..\ .*.* *\  ..*..* * **\*.\*.* *. .  \. \ .\\  . ** .    . * \*.*.... .#   #
#\.\\\.\\ *..**..\ *.  .\\\...\.. . . . *..\ \ *\*\ .*. * *. .\  ......  *\.\.\.***...\ *. *.*..**\ ..\. \*\ . * .*. .. .  .\ .\..*\. ..*..  .. \ ..  .\..*\..  .** #  #
#* * .. . \.  .**. \*. \ .. ...*...* *.  \.\ ...* .  *\.. .  ...   .\ .*.*..* .\.\.\\.*.\.*..\ \.... ..**. . \.. \.*  *\ .* .\\.  .*. *..*\.\*.. . \..   .#.*.... \.#  #
#. .*.  * \.* .*......\..\\   ...\.. ***..*. .* .\.\ **...    *.  \.   . .\..\. *.*   ..** .** * *.\. \..  .*. .\. *. . . . ... ....  \ *** .*..**..  \*. *. ..\.\.*#  #
#\\ . .\*. * . \.*\*... *...\* \     *. *..  \.  . **.*.*\.  \..\*  *\*     *   * .\. .**.\ *. .*\.*    *. *.*.. .... \ \  * *..\* .\.\ ..***.\ ...  * *\*\#\ \* #*#   #
#. . .\**...\**   .*\.\\..\. .*  *\....*. . .. **.**.\*.*.*...  *.*\. . . **.  *..    *.. . .\  .* \\** .. *.. ..*.\* ...*. *..***.......**\\ .. .* .* .  ..*.   **\#  #
#*.*.  .\..  .*\.\.*...*\****.. **\  .\.* *\**... ..\.. .\. ..\.*..***\.* .* . \ \ .  .. * **.*\.* ...* .**\...... ..\  .\. *. ...****\ ....\. \ \.\*..  \.**\.\#\  #  #
# *. \  *.* * *   *\..\. \**. **.** *  .... .* *\. .. \  *  ...\. *\.. .. .. ... ..* **..\  .*\ * \  *\.*\  \*.*. *\ .. .*\.\.*\ .\*\. .**.    .  * ..\ *. \.. * .* #  #
#\* *.***\.*.\***\* *...\.. *.*.*.. *..\   . ... .. * .*** .   * *. * **    .  \.*..*.\.**.* ..*   ...  ***. .\.... .  .  . .\..  ... *\.*. .\** **  .. *.* \.   .# *###
#  .. \.**.. * .*.. . . . \\..* *  *..\ \.* * . .*    . *\.*  ...\ *\ .\..*..\.*\. . \ *..** . .\* * ... **.  . \ .*. **.  ..*.. *\.  .. \ \ ..... \ *. . .\.  . *...**#
#\.  .  .  .*.**** . * .  .  ...\.*..\ ..\.\.   *\.*.*\*\. ..    \.\..* ..\  .*.. *\ .\*..*.. \..  ..\\.\..* *\ ...*\ **..*. .\ .\  *\. .**\. * \... ....\\ * *  *\.*.##
#. \\   ***..\*\.*.* * \   \ .\ ..* *.\*.. .*.. .*\.*.*..  .*. ** *   ...  \ \ *\*.**\*\ ..    .\ .\ ... . \ * .. .   ...\\ .  .. *.....**. .**  **. *...   ...\**..## #
#....**.. ..\ . \.**. \**... .* .*.\.. .\   ..\ ** *.*** **. .*.\ .*.*\* . .  **...*.. .\. ..** .*. \  \.\  \.\. \  *.\.*. .\.    *. .\ *..\***\*\*  ...*\.. *\ \.\*#  #
# *. ..  .. \.. .\  .***\.\*. .... . .\. .  *\ ..* .. \....*\*.... . .. .***  ..*  *.  .. .  .*  .... .*   .  .** .\..  . .. *... *\.\*..*   *\.*.\. *.\#*  .* ##*##   #
# . * .. *.*.  *\ * **... *.** . .\\ *..   .**.....*  **.  .*...   .\** . .* .*.. ..*..\ .*.\ *\    ...**\. * .\.\. *\.. **...* \  * ..\*\*\** *.\  . *\****.. .*#     #
# . . *  **   * *\* ** .. *\..**.....*\  \. ..  \. . *.   *..**.\..  *\\  ..\*... \..\. \.* *.. . * .*.....\*  .*.**\ * \*...**\  \.\. ..    \ ...\. \  . .*. \*.#     #
#** \.. \. \*** ... ..*.* .. ...** \ ..  * *.\ .*.*  \    .* .*.***  . . . .*. .*.\.\. ..\\ .***  * . *.*\ *..*\.\.*.\.\. *.* *** .*. \\. .. ..* **.. #\ *.. . \ #     #
# .*.* *. *..*...\... \...*.*   .\.\*.\.*.\.\  \.   ...\.. .*..* .* .   *.*.*.**..* ... ...*. .   *...*\.***.**.\.*  ...  \*  .*.. . *.. .*\*   ...  *.*###*\.\.#      #
#...*  ...**..\  **.\ . . *\. * \ * ..  .. . . .\ \  . .* * .*.*.\.*.\ **.*  \*.\*.\ .\.\....***. .*. ..*.. \*\.**. . .**  .\..*.\.  \. .*....* #...\###  #..##.#      #
#...* . *..**\  .\.\....  *.. ..... *. * ** ...*.\.* \.*. *. *.*.. .* ....*  ..  .* . .*. .**..\*. . ..\  ... .\.*  .. ....*. .\ **.\*.. . *.  .* .*.#     #\.L#       #
# ** .. \ \..* . .   .*\* ...  .   ..\ ....   . \ *... *.\ .  \.*    *  .*.* *\**\.  ... \...***. \*  \.*.**\. .\. . .. * .*.*\.\... .. *\ * *  \ \.* #     ##         #
#\..  **.. .. *\ .  * \. ..*. .*..  *.*.* *  .  .*. * ...\..*..\*\.... *  .. *. .. .** .. \ .\****\..\  . .* .  **\ .    .  .*  \  .. *. \ *.\..#..\.\*#               #
#   ...*  * ....  \ *. .   .\  **\ *.*.\..*.\. **.***.*.\*.*.. *.\*   *..**. \.\... .\ ..\ . .\..  *\.*  .*.\ . ....* . * *.*..\** \.\ *\. \\.\..\* . #                #
#.. *  . .. .* .*..\.\ .\*. ***\..... ... *.   ** \....** ** .*. ... ** *.***\. ..\.*. *.. .\ . * . ***..*... *. * \\. .  \ .  .. *. .\** ..** . **\ #                 #
#\  *.*.*\\ ..\*..\ *.\.. **\ ..\ .   ....*\..\..  *\***\.*.*\**. . * *. ...**\ **..\. ..*. ** **. .***  *\  .. .\... ..\  .*    . ** ..\ **.\* .*..*#                 #
#..*\ . ..**.*.** * .*. **\.*..\*.*\.*\.....\* .\\..\.\...* **.\ *\.* ..\*..*.. ..*. **\.\\..  ... \**\ *.. *.\ \*.  ..\ .*..\..* .\.  \  ... * . ###                  #
# ... *.* .*\. ..  *..\ *** *.*\. .  *.   . *.\.**.****......\ ..\. *     *\ .\* ..  ..   ..  .\*  . **.*.  .... .  . ..\ .  .  * **\ . * * *.....##                   #
#..\. \ *  .  . * \*  . \....\.  \   ..  \*..*  *.\ **. *\ .*..*\    . ..\..\  .* \* .* .* ..* *.  * ***.** .. *.*. * . \  . . *.  . .....*..* \*# .#                  #
# \.. .\*.\.   *. .   * .. .  *..\* .****. .*.. **..*...\.\ ..\. .. .* *\.   . ..* *. . . . ..\*. .*  .\..\ . \....\   \*  \\ *.*   \.\  .. *. ...**###                #
# \ \. *..  \..\ .*. *.  *.  ..\.*.** .**  \.. \... \ \.  . \  \ *\\.*.\* ... *...\..  ..*.* *.\ . *** \  .*  ..   * \..\*. *\.  *\*.  * *... ..#...  *#               #
#*...\.*\ **.* **. .\. ... \.\*  ...\*\.\  ..**.  .    **\\  * .  * *\ *.*  .\. *\.\\ **. ..\..\   .\.*  .. .* \ .*.\.* . **. * *. **  ..*.\. .# .*.  ###              #
#*.\*...*..* *.\.  *.. *\...  ..\.*\ *.  . \*\ . . *\ \**.\.\\*\.*.\\* .    *..\..**.. .. .   ..\ . .. .*\.   ..  .*  *\.. ..*  .  ...* . .*.. .* \ .* * #             #
#. .**\..\.*\* .*.***.*\*. *  .\ .... .  ... *...*.*. . ..* .  * **.* .*.* **.. . *. **..* *. * . .*.   ...** ***.... .  .** *  .\ *.*. \  . *....\..#.##              #
#. **** \.   * ****..\**\ \..\\ \ *...*.*  ... * \   * .*   .. \...*..**..\*..*\ ..\  .* **\.....*.*.....*.*\*    .  .  .....**\\...\ \*..*\...   .\.*.###             #
#.\.*.\..  *\....* *.\..\... .  .... \. ** ..... *..*..\.   ..*\.  *\  .* .\ .  *\...  \ .*.. . .. .\. **.\.*  .\ .\**  .    .... ** \  **. \ . .*. .\..*.#            #
#.. * *.   .\ *.. ..* **.*.\  *...*.*.\   ** *.\ .* .*.. .... ... .**\.**\ ..\*....   * * ..  \. * * . .*.*..  *\*... .    \  .*. ..\*. \.\*....\...#  .##             #
#.*\.*****. .\.*   ..\**.\. .\. *\.\.**  *\..*... ..*..*.  ... .**...  \* \ . * \ *\  * \..**\     .  * .  * .\. ..*.. \ \* *.**  .   .  . *  \   *.  *# #             #
#*.**.*.* \  *..*.*.   \*.* ... \  **.\\ .. ..   \*.*.* .* \ . *.\ *.**.*    .* .*.** * . \  *.**\.**..\..*..   **...  ... .* ..*. .\. ..\.. ..  \..#..*  #            #
#..*. .*.... \...*\..  \**  .. *.*.*...  . **.*\.......  \*.. ..*. ...***  .. ***.\.. *   .* **... * .\  .*.. .\**    *..***\ *\ **.**\*..   *\  \*.\# * #             #
# .*\*. ***\ .\. .**...*.* .. *. ....*.*   .\...\\\ \ \. . *. . ** .\ ....* . .....*. ** ..  *  .. \ *.\***  \. ..\ . .*\...* ....**. **.. **..  ..*. #\#              #
#.    .\**\.** *.. .*. .\ .* .\.\  \ **.\**\ * . .* . * * .. .  *.**.. . *.\\* *   \.*... \*.* \ ..... ...    .  *.\ \ *    \  . *.*.\ . \.* .\ **\.## #               #
#\* *\ .*..  * ... ...*.* \.  .  ..*\.*\...** ..  . **.    ..*. \.**   . .  .\\..*.....*.  ** .\ \ \...*\.\* ** ...**...  **.**... . \**\. ..**\..##                   #
#*..\ .    .\.* *.\ ...**.  .  \ *.*. . . ...   . \.* \ *. ..*.. .*.\.. .**\ .*.* *. *. ** .. . *.*. . * **.  \. ...** \  ** .\. \  ...   .\...#.  #                   #
#*. .. * .*\ \.*.\.. ***.*  . .... *. *.    \***\.  * .*\.* \  *     . .\.*...* .  .\*   . *    .  . ***.\... *  .   .  ..\*** **..**.*\..  .\*.#.*#                   #
#\.\*.*\ .. \ . .*   .....\  . \...*  *\ *   . \** \..\. *.\....\. \ . .*..\  ..**\*... . .***. ***  *..* .***. *\ *. *\....*. .*.* \*..**.\ .*.* #                    #
########################################################################################################################################################################