###############
#.  ..* .*  .\#
#.*   . *.\ *.#
#    . **.* ..#
#*. .* ...\*\ #
#*. ** \*\**.*#
#*. ..\.***\*.#
#\*\.  ** \*. #
#  *\.**..... #
# \  *\..  . *#
#*  .*  ..\* .#
#.. *....\.* .#
# . ... * \* *#
#\  *. .*.\.\*#
#.. .* *.*. ..#
#\ . *..**    #
#.\  * ** .*.*#
#* .*\ ...*  \#
#* *.  *  * ..#
#\ *  *. .\ *\#
#.  . .\.\  *.#
#*  ..\**   *.#
#.\.\ **\*.   #
# . *..*.\*. \#
#* ..**... .\.#
#.\ .. .*.**\*#
#  *. \*\ *..\#
#..*  \.*\.   #
#  . * ...*. \#
# .\. *.. .. .#
#* \.\.\  \*  #
#  .. .\ \  *.#
#\ . . . * \. #
#.*\.*   ...* #
#\  \..**..  *#
#   .  .*.  ..#
#..  ....*\.*\#
#..     ..*. .#
# *.*. . .. * #
#\* .*. \* \ .#
# * .* \... . #
#.  **\.\..  \#
# ..\*  \.*..*#
#  ..* .   . \#
# *. . .* . ..#
#\**.. *\*.** #
#.**  .\. * . #
# .. \ *.\**  #
#*..\** *.\*\ #
#.\ .* .\. ***#
#  ..*. .  \..#
# .  .*\ *\.  #
# * .\* *.* *.#
# *.* \ .\.*..#
#...* ... .\**#
# R\ *... *.*.#
#\ *\ ..\ \ *\#
#. \*.*.* ... #
#*...*..*.    #
#. \ * *. **.*#
#.   .... *.. #
#.*.\* \. .*.\#
#\. ..*  * ..*#
# ..  * ...  .#
#**...** \.\\ #
#.\.* \.\. . .#
#.\*\  . \..**#
# *\.\*\..\*\.#
#  .**  * . *\#
#   *. .*.* ..#
#  \* *.*.... #
#\. . .. *  ..#
#   *.* *\ ..\#
#\.*..* .*.. .#
#* . ***\.\  *#
#*  \. . ..  .#
# .  *\ \...*.#
#\. \.*. ...* #
#. .. \. *\\ .#
#.... \.\.. \.#
#* \.\..*\.*  #
#\.. ... ...\ #
#.   **. *  **#
#*.*.*.\ \.*. #
#*.*.*..**\.  #
#.\...\ *.*\..#
#.   \* *\  * #
#* \\ * .  **.#
#* .* .\**** *#
#\ .*  ... *\*#
# . *\. . **\.#
#. *..* \ *. \#
#*. * *. ..  .#
#.\.. . *..* *#
#.\  *.\. .* .#
#..  .**.* .\*#
#\*\......***.#
#.\..\    *\ *#
#.\..  ** * ..#
# *\\..*. *\*.#
#**. *.*.. *.\#
#..  ... *\ *.#
# \ ..  ..* *.#
#.**   * *.*\\#
#..  * * **..*#
#  .   ..* *..#
#. \.*  ...*. #
#*..*..  . .* #
#*.  *  *  \..#
#.\\.. .*\*.*\#
#\ .. * * . ..#
# \  .\*.. . *#
#\. *   .\*  .#
#.\..  . \....#
#\. *\*  .  .\#
# \*.     *\*\#
# .*. .   *..*#
#\*..\. .*.. \#
#  *.  ...\*  #
#* .*\\    * .#
#**\.*.....*  #
#\.. .  \.**.*#
#.* *.  ....*.#
# .\... .*.. *#
#. *   \.. \ *#
#\......* *...#
#**\ . ..*.\*\#
#*.*\\\  *....#
#.\*    ***. \#
# .\ *.\.** *\#
# .*  \ *.\*.*#
#.*\ .. .*.* \#
#\.. ..*\.*  *#
#**\\.*.*.\*\.#
#*. \..\.. ..\#
#*.\.\ . \..  #
#. **\   .*..*#
#*.. .  * * * #
#.\..   * . . #
#.. * \\***\  #
#*. ...  ..* *#
#\*.  \.\  .* #
#..* * .\   *\#
#.\. *.** *. .#
#  .\ *.**. \*#
# * *.\...\..\#
#.\  .*   .  .#
# *\**. *. **.#
# *.*\ . . .*.#
#\..**.*\.\  .#
#.  \.*.* .. .#
#   \.....  *.#
#***.** .. ...#
#**....  ..  .#
#\*.\*.   ..**#
#*...**  .....#
#..***. . *.\*#
#  *.. *\*.. .#
#\* \**..\. **#
#*.* *.\\* *\.#
#*\. .*  ...**#
#. \.    .\ * #
#\\  \.*  .  *#
#*  ..\..* \ .#
#  **\. \. .*.#
#*\..*\.*\ .. #
#..* **\    **#
#\ .\ .* \ * .#
#..*  **\.\* \#
#..**\*..\... #
#  *\..*.  *\ #
#*... \.\.**. #
#\..*. **. .*\#
#.**.* \..  .*#
#.....** .*\ .#
#\*** \. **.*##
#  * . **.. ..#
#\ *  *#**..\ #
#  . .*...*.\.#
#*\#. .\.*... #
#* **  #\# \L.#
#\ *. \.*\.##*#
##  #* .##*# ##
##.##*##  #   #
##*# #        #
###############