##########################################################################################################################
#  #*#\* . *.\** .*..\.*.***\*..*\ \.\. \ *\  **..\*.   .  .*.*.. .. . .*\ *. *.*  \*.*\..   .*.*..* ...*.  . \..**#\ \# #
#  #*\#\.*..\**.  **. **\... . .*....*  **.. *. \  *  *.*. *..* *.  ***\...*. ..**....... *. .**.. ..   \* *#.* .\ *.##  #
#  #**\. .. ..\*. ***\ .*  *  .*...\ . ...*...   ...* *. \ ..*.*. *.\.   .*. *. *.** *\.* ...*....   .** *.**\.*\.*.*#.###
#  #.# .\*\..\ .*. ..*.**.\... . ...\***.*   **\. ... .*.  *\...*..  *..  .**\* **.  * **   *\   * .  \... ..* .*..*.#..*#
# #.    ...* * **.   .*.. *\ \ * *   *.*.   ...  ..*. ..* \.  ..***..*  *. \.*\ \.  ..\..*.*** *    . .....**.\.* .** .*##
###.\.** *** \*...*** .\  .*\. .\  ..\..   \  *.. *.* \ \.***  ..*.  . * .\. \  .*.  ..*.* .\.\* . *   *   *. . # .*\ #.##
#.. ...  *....*.  .*** .* .\.\.\...*....*\ ...\*  .   .*.R....\  .\ .*.*\\*.. .* .*.* *.... .... \ .. .. \.*\ .\. ..#*## #
# # * .\*. .\*** .\*.*  *.**.. \. \.\ \*. ..*. *.*.\* * * .  *.\ .. *\.*\*. \* .*\.  .* *...    **.  \..*. . # ...  .##  #
# .#.*  *. .*** \.. \  .\. * \*.... .\*\ .*...*.   ..\..\.* .\ .\**\.**. .   .. ..** *  .**.*  .*. .*.. .\. .\ * *  *#*# #
#..\*..*\ . .\* . . .  * ..***\ .... *.\.\. .\\* *  . .  *.*\.  ... * . .. \. .   *\*. *. \\.\. ..*. .*** ** *.. * **\.# #
#.\#\..*. . ...\ .\**. .  ...\* \ .. * *\ ***..\*  \*\ **. *\ *.* \     *\**.   \*.*\  ***..   .**.. ..\*..* ... \...#*\##
#\   .\*      * *\ *\*. . .   .    **..   *.* .*.*\... .. .. .**.  .. *..*..*.* *. .*. *\.*..*  .\ ... *\.*.  * \ ####.# #
#. \.  . ** .\* ...*..\.. *. . * .....\.  *. *\.*.   \ *...*. .     *... .\.\***.\.\*. ..\.\..\...  \\... .  .. .#    #  #
####*..   *\.*...  *  .**** \ *....*\.*.*... \.*.\\ . *.**\. .\** *\ . ** .. .. \***.*.. \ .. * ..\*.\ \* \.  \\##       #
##.\. \. *\**\.. ....\ *\*   *.*..*.  * \.\**.*.*** .\. *..  \*..\**\ \ * .. .**  .. .*.* * **\ .. ...  *.. ... . #      #
##.#.\.\..\... *.  *.  \ .  \* .**..*.... .* .* *.* .**.   *.. \\.*.. *.\ *. *.\ *.* * \\*.. \ . .\ * .*. *  *.\##       #
# #. *#...  * ..  .**\ \. \*.... \. *\ . . * \**.. .\.. *. .\  . .\. \.. *\  ...   .* . *.\.  . **..*\ .\  . ..##        #
# # ..*. ** .* \.* \*...*   .* ..* *.*.. **..** *...  \  . \.. .. .*\  . ** * \* ** \   \.   *. . ***.... . *. *\#       #
##... . .*.* . .*.\. .\.*. * ....\\. \.***.* .  ....... *.   ...\  ..\\\ .*.. .*  . . .*.\. ..  \\*..    *. *...#        #
#\... .*..*..\. .*.\.* *.  ...* *....\  ..*.\. \*..  .\..**** *\ ..*. .*\..    *\.\.  ** . \..... *\* *..\.#. \#         #
###* *\.\**.\. . .   * .*. ..\** . .  ... ..*\ .... . **\ ..**.*.\*..*....*\...\..  .\ \*\ . . ***. \**.   *## \#        #
# ###.*...*\**** *.\*.  *..\\**.... . .*....*.**  ...\....  *. .. .\....*\ *\. . .  .  ..**. .**.\*\.*.... .*..#         #
##\*..*.**...\ *...*..* .  .**. ..  . *.*. \.*.. . . ...**..*\.\ *.\. .. ...*.  .. **. *.*. \. . ..  *..*\*\**#          #
# #.  * *. . . ..   *\.*. .* ..*  .*.**.***  .*..\... ...* **. .*.* ..   \ **.*. .*\ .. ..\. \* .. * * *\..* *##L        #
# #   . *\**   ... .\.*\..\  ..*\. ..*  *....... *  *\.\**\.*. *. \.  ...\.\\*\..\.*...\.\   .*  **.\\*....  .*.*#       #
#  #*.#*\.\. ....\   \.  \.*. *** **\ \....*\  \\.. .  ..*. ..\*\... *.* ...*.. ..**..*  ..\  *\ \*\ ..*\*\  ..##        #
#  #**.#***  ***\.*    \\. *\ .* *.*... * .*  .  *\ *** *.   **..\ \...\*.*\..... \..*.**.\\\.*  *. **\...#. ##          #
#  #*#. *.* .\  .*\ \. . \.*\ *.*...  . . \ **. *.  *...   .  .*. *\  *.. . .*\\ \.\*.  . .*. .   *..*  *#\.\#           #
#   # # .\.. ..**\ \ *\  * *...*... *..\  . .\*** .*.* .\ . **... .  .*\ *\  .*  .  .*** * . **. *.    \.\#  *#          #
#     # ..* ..**... *.  \. .* *.  \.. \\***.. \ *  *.**...**..\.\ **....  . .*.\. **.*..**... .* \* .*  \ * .#           #
#     #*#\\** .**  * *\ ...   \ .* \* .*.\..\.*\...\.\  ..** \  . .*. ..  *...  *\..\ *.\ * .\.\*..  \  ##.*##           #
#      #*#*.#   .**..*. *  ..*   ....   \.  *  \ *  ..*. **. \.*.* ..  ..*.*. *\.*. * * .... . .*... ..#*\*.#\#          #
#      #* *..\.\ \.. * *..*. ...\..  . *. *..  ..*   ***..**. *.\.*       .*....*.. \*\.*\. ...*.  *.*   ** **#          #
#       ##.*..\*\ \.\..*.\..\*\.*\ \ .*.*.*.   \*.    *. *.. .\.  * * .*  \.....\.....\**. .*   .... *   #..\\#          #
#        # ** **.  **. * *\ ..*\.*  .\*. *.**  *.*\.\ .*\..*.  *\.* .*   .  .\ .*   **. .\*\**   \. .*\. .#..*#          #
#        #\.# .. ...* ..\* *.   \  ..*.\.\...*.*.*...\.*. * . *...  *..  .*** .\..  ..**. * ...  ... # *. ####           #
#         ##..  \.  .  *. *\* * .* . *  .  .**\.*.\ . .  \**\ .**.  . .**\ . ..*** \ \... \.*\*\.\\ .#\.\. #             #
#         #.\.#. *. ** * .\ .    ..   ** ..\ . ..\*..\ . *.. **.\ .* ... **  .\.*...*    .. \.*. .\. *.*..\ #            #
#         #\#*#  .\ ** .* .*\ .   .  ..\   .  *  .. \   ..\.*\.\ *.. . **\..* .....\.*    \ .**\ \**\**.* .*\#           #
#          # #. *..**. *   \..**..* ......* ..*. .**. .*\..\. .*....\ . .  *.*...\ *.* ..***..*** ..*.**..*.  ##         #
#             #*#.*.*. . \....*..*\*..*\  *  ..   *...***  .* **. *.   \\. .\.\*...***. ...*\.\.* *\*  ** *\ .#.##       #
#              ## . * ..\.   .\\.**\.. .*.\ \\\.\*. . ..* *.. .  . \.  .  . *  . *...\ ..**. \    .* \..\... . .\.#      #
#              # # *\\ \.  .*...**.*.* * ...\..  .  \ *\...*.*\ *   \.\*\.  .... . \... \. .  \\* *. .\.  ... *##*#      #
#             #\#.*\ #\.*.  .... .**\...\**..\..  **  .\ . .\.  . . *\  ..**. *..\. ... .    *.\..*.\ #  *#.\.#*##       #
#             #*.   *#..\ ...*..  *\ .  .*.*. \.  \*\*..  ...\ .. . .  *  ..\.\.\*      .\.. ..****.  *. .###*\*#        #
#              ##*. \. .\* .#. ...\   *.* \. .... .***. .  *  . .   **\*  * .  \ ....*.\..*  .**..  # **\. # ###         #
#                #..#...  \ .*.  *.. \* .*  \ *  ..*..\  * *   \ \..*...\.. *.\ .... **   \* ***. * \ #.  ..#            #
#                 ##.\#  . .\.* .. \ .*...\ .*.*\..*.. \*...\ \...***.*..\.*.  ***\. \*.*. \**.# # ...\ # \ #            #
#                   ## #*\ .# .* . .\   *...**.. .*.   .\.\.. .. *....**** .*   .   . *.\ . \* # #\ *.\*#.##             #
#                      #*#. \ *.\    *.*\.** .* \.\* .*..  *.   .*** ..  .* .. \...*...\...\...\*#.**\*.##               #
#                       #** # **  *.*....\\.* . *... **.  \\ ..**..*\ *.**\ \ \..* .. .. . ** \**.#\ # #                 #
#                        ###\ .. \.. . .* .*. . ..*.... .   .*.*....*..\*. . ..  . . .*  ....*.*.* #\#*#                 #
#                       #.*** * .   .* **  . * *\ *.\*... *\ *.*.* \ . .. ...   . \.. . *.. .* .\*...##                  #
#                        #.#  *  *\ *..\.*  * ..*.\ *\ \ **.*****\* \.*. .* ..*.   . *.*#.\.**#.  **.#                   #
#                         # #.\. . \*.   . ..\  .  *..\...\ *\\.. ..# ..#\.* ..*..  .. ...*..#. .####                    #
#                            #*.. \**\. * *\*. * ... *. .  *..**..  ..**. *\ \ * \.\*\**\.. . .*..#                      #
#                            #*. #. * \.* ....\*..\**    *.\**\ .....\.** .\. *    *...* \**** \**#                      #
#                             #*.##*\..*\* \ . .*\ .\   **\#.* . #.     *.\.\  \  *..\**\ .\.. #*##                      #
#                            #\. \## .\. *# *.. #.   ** #.*#.. . ##*.. .\ . .  .\.*# . \.* . ..*#* ##                    #
#                             #### \*\.*\*.\*..**\ *..# \*\#\#**.##*\#* #\.\ \ \.  *#\***..* **.\**..#                   #
##########################################################################################################################