##############################################################################################################################################################################
#           ##\ \... *\**. * **.. \  * .. .*. * ..** .*.*. ...*   \*. *..\..**.   .....*.*** . ..* * ....*\. \ *... \..*\*.\*\\.*.**..\ ** .\*.....\...*** ..*\. .. . .. .*. #
#       L  #\ .\ *\.  .\.* ...... .\ \*.\ ..  \*. *\ **.*. *. * .\\ . *\.   \..**\ .*** \. .\.\* ..\*\\*.*.   ..*...  \.*....* \... ** ... * *.\.\*   * *\ . *.\\*\.  *  ..*.#
#   #  #\## .. .**.**\.. \**.\.* . ...  ....*\.* \*.\...\..\ \.   *      .\.. .\  * ..\*... *..\*\..\\.**\*. *  ***. ..*.**\*. .*  \.\. \. ..  ....   .... * \  \* .\\. \ ..\#
#### ##.*#\\ . .... .*.*\.*..**.\ \* ...* *...** ... *.*  .\.\*\..***.\ . ..\**. . .*** \.*.*... .\ .*.\ ..* .* **.. *\.*\*****  ..\ . .  *. * . *  . .    *  ** .*     .*\ .#
#.. *. *..  * \*  \*...**  **  .\.*\  *.. **  *\  \ .. ..\   *..*..* .. .   *\*.    \*\.... .*  .  . .*.  *\ *\.** .....\..\.\. * ..  * *. ..\*.**.*\.\ ****...*  .\ .*.... \#
####. .... .*....... ..*\  ..\  ..*.* *.  *..\.  \.**\ *...**..\ ...\*\ * * * . ..   * *.*\*.. \. *\.**  \*.*.*..\*  *.*.**.   .*\ *...  *   . \ *....* .*. \* **..*...\ * *\#
# #\    .\* .\  \\.   *\.\. *  .. * ..**** ..*....**\*.\.\...*...**\.* .\ ...** .\* .* *. .\ ..\\*. \ *\ .. *.* ... .**. *.... \.*. .*  *\.  . *  . .\.  . *.......*..** *\..#
# #.   .#\..\ *...  * .*  \.\     \ * ..*\..**.  *.\*.**.****. \\.\ .*. . .* .  . . .**.*. .*\ ..* \**.\ .****. \..*..* *\**..\.\ *. . *\..\  .* \ . \*.. ..*****.\\.*.* \.  #
# #\*.##\* * .\  *. . .\*. ..** ...*.\.   .\*.\      ....\**\  .*...* .\.**\*.*.\ \.*.*.*\  .  * *  .* \*. .*\ .. *...\*. ..** .. ..\* . ..    *.. *. \.    . .. .. \.*.*.\.\#
#  #*#..*  * . * *.  ..   \\ . \.\*. ** .\  *.* .  ..*. . ..***.**..* * **..\* ..\\.\...\ * . *. . . **...**.\.*.* .*.**.....  *\ .      .\   *. *.\.\.. **..\ \***....\.\.*.#
#   # #\ ###**  *\ .   **\.\. . *.*.**\*...  \\***\  **.\ *\...* \ ..*.*. *  * **....  *  \..*\     **.....  .*\ .*..\.\ . .\. .\*    .*  \**..  *. *... *\*\. . .\.* .*\.** #
#      ##\******.* ...\.  \\   ***..... .*.. *\  *  *\.. \.\. * . *\*. .*\.* .. *  \*. .\. * .. \   .\   ..  \.*    *\.  .. .*\.  . . .. .\*  * . *\.*.. ..\*  .  .**  \. .. #
#        #.**... *. *...  .\*.*\\.**. *. \. . .\ .\\\ *.\. .. .* \.   .*         \ .. .. ..\ *.*......* ..  \\ **.. .. *.. \ .*.****.\* ..*  ..... * .\ .* .\\*...**.. \*  \ #
#       #...**.*..*.\*.. *\ .\. *  *. ....\ .\ ..*. ..*\ * .\.\.......  ** .... .. .*. *..   .* \ .*. . ... *. *** .  .\.*.     ... \\*  ***   *  . ...\..\. *\ . ..  * . \ *#
#      #. \ .\..*....*\ .*   ** **\\ . ** *..\**    \\..*..\. * ..**.* *\.\.\.*...  . *..*.\...... . . *. *..  *..* . .. .*\ **  ** .**\.*\. ..* *. .*  .\*.* ..\\*.  ...\. .#
#       #  ...\ ** .*.*  .. . . *\. ... .*\..*\  ..*.. .\. ..\.\   ..  \ *. .\..   *. .*   \.\..      .. ..*. .* *.\   *.. \...\.\  .\**\.    \*..*.*\ ..**.\.\..\*\*. .\.. *#
#        ### ..... \ *. \ . *\* . . ... *.  .\ . .\..\.. .\**. .  ..* *.*.* *.*.** .  .\* *  .. \*.*     .\**.** *\.**....  ...*.  .**.. *\*\ .. .. ..\ ..* **\.\.\ .* \ *  \#
#       #\  #*  .\. *\. ...**.*. \ * ...*\ . * . \. .    \*  . .* .....  ..  .. *.  .*\.\ .*   . . . .. *  \..\*\* \.   .  *\ **\ .*.. .*. ...*... ... .* . .* *.. \.. . .. .#
#       ##**.. . ***. *   .\*..* . .  *.\. .. .. .\. .\ **.*  *.. . * *.     .*\.. ....**..*  \* *.* ...*. *.*.\.. .*.  ..*. \.  . ***..*  *. * *.* \ * .... .*.**.*\ . *  ..#
#      #\ .* *\.*.\* **. \ *.*  ** \.*... .*   .*.... \ .. .. *. .*...\ .\*\.\...*.*\ .. . * ...\...\**..*. *.*\... ** .* \... \ \ .\* ... .\ .\...  *\**..\*.*.*.  ..*. .*..#
#     #.  #   .\....\. ... . .\... . .\.   ..\ .\* *.\. \\ .* .***. .\**.  . . .\.....\*\. *.*...   ..*.*..*. **....\.. . ..   ..*\......* \* *.\....   .  .*.\ ..\ * . ..*.*#
#      #\##\#\  #  .. . ..*. .\   .**. \. .   \*.*..\  ..\ **  . **.*.  *\. . ..*.*\.\**.\ ** * **\.   . .  *..*. ** *** *..**.*.* .* .* ..   .\*.   \ .\  .*...  ... \*. . .#
#       # # .\ ..*.**  \** \. ..*.*.* * .** .*..*.\.* \ \. *.... **.\.  .\.*..*\.. ...... **\.. ..** \..   .\* .  . .*.. .\ \.*. .* .* .\.*\*.... ....  .* .\** \. ....**\  \#
#        ## \#  .*.*. ..\.* ...* ..\..  . . .*.*... .*.. *....\  .*..  .  *  ...\ **..*.....*.* *\* \.  .    .*.**.*... ..*.*..  \R*    .. *..**.**\*\   *.\..*\. . ..*\*  ..#
#       # #\#\.\ ..\. .* . *.\*\  * \. . ...*\... . **  ... * ..*..\.\.  .\ * *. *..*.*.*** .\.*. .  **.....* *..*..*.*.*\.*.. ...*. .*.**..**..*.*.**.*\.\.. ..  . \*\....\.#
#       #* ..   *** .\ .   .* .  .\.*..* * ...\. .  ..* *..*..*\* .***\    *\*  *..*.**.\.*. . * \*.\. *\\....*... .. .. .. * ... *\. *  . \*.. .**.  .*.*  *.*. . *.\ \**.**#
#      ##.  .. \#\.   .     .  .* .*.* .\ \ \*   ..  \**. *.* . * \*\.....  ..*.*...*..   .  *. .*\. . ..*. *.*.*  .\ *** ..**.. **.\.*\* .. ... .* .  *\*\.. . ..*\.. ....* #
#     # # .   *... .  . ..* .\ ..\ . .. . .*.   \......**   . **.  .*. ..*.*\ .. .*....  \ ..\*. ..\ *.* *.  \*  .. ..\**... . .**. ..  . ..\* .    . .**.  . **.***\ \.. \*\#
#     #\  *.* *..\...  *... .  \...  ***.  ** \.\ . \.*.*.\...*.... .  ** \**.    ..  . \ *.  . \. ....\.* \*. .\* .  .*. \*   * *  * .\. *.*..*..*..*... ...*\\ ....* .   . #
#      ## \ **\ . .*  ..** . . ...  ...*.  **..  . .\**.. ** *...***  * .*.*\ . \. .**   *.** .\.  \*.** .\.\ ...\ .\ ..\\.\ \**.\* .  .**. .*  \ . *.*\*. **.. ** . . .... \#
#      #. .\.**\...* .**..  .**.. .   .. .*\. *.*.  \*.   ....\. ... ..****.  *. *\ ..\. . .\ \  \. *\ ..*.  * .\...  *..*\...\**... \  .\..*.. *.. **\....\**\.\..**.   * * #
#     #\ ...* . \.\.  .*.\.*  ** . * **** . * ** . * * .. .* ..* \*.   * .. .\.\** \* *.\.\\. . *.  ..  .* *\* .   ....  \* *\....* .. * .. .*  **\ ***\****.*. ..*.\.  .*..\#
#      #. .*. . \ *. ***\. *\ \ .  ...***\  . .\ \*  .. . * .\**.\.  ...  .*. *...   .\..*.   . .  \  ****..  * .....*..**... . *.*...\.  * .*. * ...*..\* . .. *.\   ..*.***#
#       #..*   \. .*\.\.   **\   *...\..\.. *. . .. ..  .\. \..\*.\*.*\ *.\* \... .. *\ \. . \ *.. .\*\\..*\ **.***.\.\*..   \.** *..\...\* ** .* .\ .*... .*\\* \ .* * .*...#
#       #.\##.\..*#. * * . \ *....** **\ .. .  .\*.*. .\**.*.  *** .*..*.. .  .\ *. .*.*..  \..\*.*\  .*  **... *. .* .*\.\.*.\*\...*. .   .. .  . \*   *. *..**.....*.*\.   #
#       # #\**...... \ . .  .*\..**....  .* ..... \*  ** .*.  \.*\*\.*\..*. \* ...***. .. **..  *.. ... \* .\.\ .** ** ..* ...*\* \ *.  *         .... \. \ \ * *\. ..  *..*\#
#        # *.* .*. *....* \*.*.\ .*.\*.. *..\.*.**.* \.. *\ *  .. **. .\.. .\.\.*.**\ .** . *\.\*\ ..\  *  \.*  .*\**.  .*..**. *\..\.  .. *  .*. .** .* \.*. * ....\\ \.... #
#        #\* #...\*.\ * .... ... \.\.\   *.. .*.. .**\ **..* *  \  .  * ..*\. . \.**  .\..  ***... ... ... * ...   ..\.**\**\**....* ... * .\. .\  *.\.. .*.\.*. \*..*. .. *.#
#         ##  *\ \ \.\. *. .\   * \...\**. \  .**   .* . .*\*\ .. \*.\.   *. * \.\.* .* .* ..\\. .  *...*\..** .\**\ **.* \...\ .. .*\.\ . ..*   **.*.*.* ..*. .  *. . *\ \* #
#           ### .. ... \**. *  \.  *.* ** *.**.*** *\ **.\**.. **\...  *\. ... .* *.\ .\ .    .*  . \*  **.\ * **.\ .**..   ..   .  ....   ... ..\..\.\*\.  .* .\* ...**.. ..#
#          ##*\# .*\ ....\*...*...\..  .. .*. *. .\ * **  . *.****  **.. .\..* * *.* *\..  .\ .\ *.. *. ..\ ..\.  ..\.* * ...*\   . .\   .** **   .**...** .* . *.\ . * .  ..#
#         #.\***# .. \*.\.*.\...*..** .* \*.  .. .*. *\.   .\*.*\   .\  *   *.*.**..\\*..*.\*    .*\ .\. ...* ..*.*..**.   \*..*     *\ **\.\... **.*. *.* **\   *..  ....**.#
#         #\.\**..  ..**. *.*.  .....  . . *   \*\.*     .*...**.. **   * \..\ *.*.*. *  .  .** . ..  *\ .*** .*.* .\.\*.. . *\* .*...* .  .. .  . . .   \  *.*. . \.\*\**..*#
#         #  ... \.*\***..\ .*.*. ... *..*.**\ .\  .\.  * \.*\**.  *\*\  ..*\*. .*\*. \.. .* \* \.*   **.. .. **.\*\   . *  \.*.  \.\ \ .* .** *.\** . *.\* ..  *...*.*  ** *#
#          # #.**  .*..****.  .. *\*\ . * .\....*  .  .*. .\\ \\*.\ .. *  *..*. .. \**..\* .* . . *\ .... *\* *..\.**  ..*..  . \..*. .\*.** . * *  \   *.\ \  *..* .  .\.***#
#         ##  *...*\....*..*\*.\..*.*\ .**..\*..*\ ... .\    ...*\ .**\. ** ....   . ** . \  \*\***.\.\..   *...\. .* *. \ ..\*\.  .*.\..\.*...**. .. ....*  . **..* *. * ..*#
#        # .\ ........***\ .*.. .\... . *\   ..\** .\  ..  .*..\* . .*.\ . \.*** *  \*.....*... *..\ . *.  \ \*.*..**.\...*. .*.\  *.*\.\ *. *\.**...\. .*\*\  **  .\.*.\.\ .#
#         ##.# \#  *.*.....****\  ..\...\..*.\.*..\ *\.***.**\  * ....* .\* ***  .\* *. *.**..... . .\*.. . ...* ****.... ..* ..* .*.*\* ***.\*...*\\ *.*...\ .*  .*. . ..  *#
#           ##* . *\\* .*  .* . . .  *...**.\**  \  .* ..*.*\. .\. \***.\.\ .*\.\**. . .*  . \  *.*\.*\*\* . \ .\*.\..*...*.*\**\...**\. \*..*.*.*\..*\*...\* .. **. *.. .  *#
#            #****\...\**.... *  * .\*\.*.\...\  .  *\*. .**.\ **   ... . *.  . \.*    .*.*.. .\. \....*   *   .\\.. *... **.* \...  .**.*. .*.\ \*. . .  \.*\. .\ *.**\. ..\#
#           #\*\*.  . . *..****..\ .....\* \ *. *..\    *..*  \...*. .**\\.\.\*.....* \ . .*..*.* ...*** .\.*. *   ...*\.\.*\*... * * ..*\.* *....**\  * \ ...  \.**\* ... *.#
#           #*.**. **.\  *... \. .. \. .\. .*.. ... .*. ..\  .  *.** \.\* *.\ *.\*.\*\.\.*...* ....*...**\.... ....\**.  . . .  \\.*..* .*\*. .. *...    *.** ....\...\ \\.. #
#          # **.# \.\ .  ** *..\ .**. .. *\ *.  ... *       *.*.. *\.*\..*. ......*...\ .* .*.  *\.* . .\.  .*.* .\ ...\ .* .\\..\.  .\** .. . \ ..*.* ..*\*... \**\**.\ ....#
#           ####.#.*  .**\*.\.**\...* . *.\..\ ..  .\.\. ..*. * .*.\.. \ **\.  \* *** *. .\..  ...\\ . ..** ** .*\ **.. . ..  ** .\. .*.. *. *\ * .. *    . *.*...\* \. *   .#
#             # *. *.* .*.. **.\ ..* . *.*.\** *\.. .. ..*.\..  .. . \.**.  *\. . * . \*\.**.**.\ .\*.  .*\ \ ..*...***.* .\...\. ..\ *\ *.**  .**.. .*.*  ..\.*   .   \ ....#
#            #*. # # . ... ... .*. \ **. .\..* . .. \\*...*.\. .   \.**\**..\.*** ...\ .  .. ....*.. .\ *.. .\  .. ..**** \*\* ..*. * *. .**.** *.*  .\ .**\.* .  .... \ ..\ #
#             #.###\ \. . \\*.* \.\..**. .*.*.\ **   **\   .*\   *\.. . *.  .\.. .  .  \ .*....\**. ... .* * * \*.** ...*\.. .\  ...***. \...**** . .    *. ..  .\ ..* ...\..#
#             #.#.\. ..*... . .\. *\ *..* .\* * .* ...\ . \    . .*..**\... .** ..*\. ..  ***\..***..*..\...**. . ...\..*** \*.*.  *\.**..  * ..**.\ .\...***.. * . \\..*\. .#
#             #.\* #. .*.*\.\   . * * \**.\** \  .\..** * ..\.\....* *.. \ \...*\* ..**  *.. * .\*..\....*  ...*.\  \  . *.\  .\*.\*\ *\*.. \ . **.**... ...... ** . *.*    \#
#             #.*. .  ***.*..\. ... .. .*. .. .**. .*.* . ... \*\ *.***\ .* ..*\* \. .** . \*\. .. *.*....\ .**.* ..*..  .. ... \  . .\ . \ .**... \*.*\ .*  \. .*.* .**. ** #
#              # . .*...\ *... *  . . . *.. . **.\ .*.. \ * . ..*..* ..*. *  .....*......    *..*.** *.**\ . .* .. * *.\  *.*..*.* .** ..  *\. **** .     *. .. *...*..*.. \ #
#              # .. \. .**.*.*.\. . \*.* *\. \.\* *\* \  ...*.\ *.*. . \*\... *\ .* \ \. . **.. . *.\**.*..**.* .*\. ..*.\*.\. .*\. \...\ \. .**.*..\ .  .*\. * *.\ \.**** .*#
##############################################################################################################################################################################