#########
###\# ###
#*\*##  #
# *.\.  #
# .\*.**#
#*  *...#
##**...\#
# ** .. #
#. .\  *#
#**. .*.#
#.R *#  #
#....*#\#
#  \.##.#
##\..# ##
# #  *# #
##.*.#  #
# L*#   #
#########