##################################################################################################################################################
#..* .*.....***. . ... ....**\...*\. *.*\...    .*.\....  ***. *\\* . . .\..\*.*.... *. .*.\.***.\* *  .*. .***  *  ...... .. . .. \#\###        #
#\.. **\* . \.. \ *. \*.*.**..\*\. \.......* \..* . *\\   \. *\...*\.  .\. .\.\..* ..**\ .. *.* **.*.. .**. .. .\ *.*..\**  .\  ***.\. **# #     #
#* .*\...*\ *  .** .    .*.\.*.. ..   *\.*... .*\ .*.*..*\ * \  . ..** *...*  *\*.\ ** *... .*.\** *. . *. ****\*\..* .*.\\.  *\.\* ...*.\#*##   #
#. .*.\ \.* * **..\. *. \..**. \\ *\.* . *.*  .. \.\ .\ *  ...\* . . .** *.*  .*....  .*.*.  *  ...**\...  . .. . \*.* *\..**.\  ...\##. *....#  #
#  *\........*.\.**.. .\. **. ....\\ .* ...*.*\  .*.*  ...\..*. **..*..* **.\ **... \*.*** .*..* . * .     ** .*. ..* ... ...* *\..   *... \. #  #
#.. *\.*\*.   *  \.. .  . *.*..\... ** .** .*... *.**\...*\  . * *.** ....*\....\ *. \*.*.\... ..*. .\..*.*.\\.. *  *..  *.*.**.*  . \..#.*###   #
#.* *  .   \  .  . *\.*.  \ ..    .\.  **. .. **.. .\ ..\. ..  ...*... ** .* ..\ .. ....*\. ..*  ..*. . ..\ * .  .\ ****.* \* \*\ *.... ###      #
#*... .*. \.\   .  ** .*.*  .\...** *.* * \..... .. .**\.**\ \ .... ** .  ...\ . \ .*  \*.\  *..*.*... **** . *. .*....\ .\ *..*.*  *  .*..#     #
#\. .. . *.\* ..*\ .\ .\..   *\  ***\.* . ..\* ..*.****.\...*\\  .**\   .\  \.* ... * ... . .*\..**.  * *...... \**  .. .*\*\.\..* *\. \.##      #
#.   ..\**. . .. .. .\ .  .\ \...*..* . .*   * * * \\....*  ...  .\..   \*.. \...\ .. **.  . .. ..\ \*.\. .*. . . . .\ \*   . *..*#*####\#       #
#.  \  \.. . .*\  .\******    .*\.  . ...*\ **.\. ... .  *   ....*.  * *..*. . **.* ..*.. \\ \   .*.\**.\.**..\.*.* ...*\ \*. *  ..* .  #        #
#.*. ....   .***..\...**.**.* .\*\.*.\ . \  .\\.\ \. ** *\.\ .....*\*  .   * . ..*..**..\ .\ .....*.** * ..** .  .. . .. .**\* **..*.# *# #      #
#..**. . .  . * .\.* .***.* ..  . \. . . . *\. \.  **....*. ..\. ..*... .\ * \.  *. .  ..* .*. **..***.*.\ \ . *..\*. *\*  .** .**\.*. .\#\#     #
#. *.\.*. . . **   .   *.*... .\  ...\.*\...  . *.** *\. ...\...\\*.* \ .. .\.\....*  .\**\***\.\*...* . **. * *..*\* .*.*.*... ...  *\*\ \#     #
#\.*. *\ ... \*\*....... ..**\**......\ ** **\. ..*\\. .. .\... . . \*.\  .   *.*  * **\.\ .*** **\  * \ ..*  ..*....*  *....  . .**. .##.\#     #
#. .\ . . \*\. .\.*  **.  ..*..\....    .  .. ..\ ***..*\. * *\\..**..\ . .. ..**\\.* . \...... ..** \ . ..  ..\* .*.. **...  .... .*.   .*##    #
#*  .* .**.* *.  ..*\**.  .\.*.      * \.....\.\**.\  *...*.  *. **.*\*** \  . *..\  . ..**  .*. **. .  .*. ..\.\.\.* ..... ..**..\. .\.* .  #   #
#..* .\ ...*. .\..   .\*     .  ***\ .\.*..\.*.\...****. *.*\.\.\**..*.**.*. *.****.*. ...*\ **  .*.. *  \. .  *..  ... *.*...*\.. **\...   .#   #
#**\*.  *    .** .***  \\.*\ * ....*. * ...* .   .. \..*** *\... .. .\\.*..\ \. .*\.\. **..*..* ... .\*\  .\*..\ .*. \.\.\ .\ .*. *....*\ **#\#  #
#* .****   \\\.. . ...*..\..*...*\.. .   \*.. \.** ....\..*..*..*.* .*...*\.\.\ ...  .*\\. *\ ..*.. .*.. \. .  .. \.  . **. .... **..  **#\..*\# #
#*. *..***\ * .* \ \  . .  .. * **. .  *  .*. \..*.\* \.*.*... .\.* * .\*.*.*    \. .....\..\ .* . *.\   . .*\*..**. \ *..\*. . *.***.*.** .*.*# #
#*.\\ \*.*.* . *..\*\* . .*.*.. .*   . .\***** . . *.*. *. . \... \.. * .\.\*\*.*. * \   . .   . ..**.***   . .*\..* ....*..  .*. \..\ ...   *#  #
#. ** ..* ..     \. \.  * ..* * ....\.  .*.*\. *\.\...  .\.\...... *   . . .*  .. *.*\*.**.   *\   ..\..** **.     \ *\* .. .* .*.\*..****. .*#  #
#\* .. .* \..*.. ..*  .*\ .*.*. *.*\**\...\* \ .*.   **\.*..\. .\\ . \ . \\.*\. *..\*.. .*. *.**.   **.  *.\\*\ .\.* * ..  .*\ ....* *. \..\*#   #
#  .* . . .. * \   . ..*.. .* .\.\*.  \**\.* *\   .***.\.. *.*..\. *\ . . \.. *. *.\.\  . *\.*.. .\. .\ . . .* ..* ***\  *\...* .\.\\...\*  #L   #
# \ .... ..  ...**..\.*  *....* ..**.* ..*....   . \. .*  ..*\*   .* .*\  ..**.*\...* .   *. .\    . .. .*. . .  *.\*..\\ ... . ... * .*..   .#  #
#      .\. . .***.\. *** ..*..*\...\ .   .\.. *\.*  ***\ * *.**\ \... .....*.. ..*\.*... *\ \ *.. *   *. ...  . \* *.** *.*.* *.   . * *\* .##   #
#\  . \.****\  \. *....   \ ..\ *.**     ..\ .* **..\..* .\*.*....... * \. .*. * \. ...\.*.* .*   .. \..\  . .\.. \ *.. . * * .\ **.\..\ *   #   #
#.\*\\...*..*...* \. *\**..  **.\.\*.\..\*...** * ... * \*  *\ .. ** ***.  **...\. \*\ . .* \*.\ \**..  .*    * **  *.\ . * ..\.\.* .   \ .\#    #
#\.\. .**.. . *..  *.. . ..\**.*. ..*.*.*.\.**.\ .\ **\  * *..*\.\.*...*.\ *.* .  *  . *. .. .**. ..*\*. * *\.**.* *..**   .*.**..  ..\*# * # #  #
# .  *\.\**  **. . ....  ..\...\. . *..*...*..**\\***.. .\*. * ***\. ***\. . ..*.... ..*\ . \ ****\.\ .  . .\   *.\* .**.** .. \  ..  *.#*. ##.# #
#  **.. \   *..*.* ...*  .\ .\**.* \.\... *\ \..*\..\** *... .\.\*. \.*\*\*\. ..   \*. * .*.\**... .**\  *     .. *..*..\.. * *  .  .\** .#### # #
#\* ..  *****\ .*.. .**..  ..*.*..*  .\.*\.*..\  . * .  .**  .*  \.\. *. .  \.   .. .\ .*..\ .*. ***. .* .\ .**  \.*..* . ....\.   \.*. *#. .*..##
#.. ..\..*.*..*..**\*.*\.*   \.*. * .  \.  ...**.*...\ * *.*.\... . ..   .  *.*.\ \   . .*\ . ..\. *  *.\ .  *\**. \. .  .**.***.* .*.. .*** *## #
#.***\  .. *.. . *.*.\*    .  .* .\.. *.  *.*.** * .*. ***  . ...*    ..* ... \ . * *.* ***..  *.\ \...**. .  **.. . \ .  .* .*\ . . .. *.#..##  #
#**\  \  *.\ **  *... .*.\ *.. *\..\. \*. *...\.\  \\.. .****. ..\...  *. *\ \.\* ..\.\ \*\*  ..\...*.\. .  *. ...* \. .\*. .* .* ..  *\\ . .\.# #
#..**..... ...* .. **..*   ..  .. ** \*. .**\.*\*.. *.\.\ *.\ .  ..*.* . *.. ..**\*.. *\*.*...  ..\... . \.*.**. \*  ..  .  ..*  .\.*... #.* ..# #
#...*  \ ......\ * \..\.*.. *.... *. . *...\. . .. ..    ..   *. ..*.\*. *  **. . . \*...\ .\\..\*. .\.*   \ ..\ . \ . ..*.. \. ****\*.\.*..*\ ###
#.. . *.. * .... * .. *\.\ \.  ...\*     . .\ ..    \*** .. ....   \**\.\.. *\..  * .  *.. *.\....*.\ .. *..* ** .*.*\   .\  *.*\... \ .*.\ #.*\ #
#..*. .\***. *\....*..*  . . . .\*..**.\**    ..\\.*. .* .\ \ .* \*... . *\*...\*\ *\. \. *.*..  *.... *.**.**.  *...*\ .\.  .*..**..***.*.\*.####
#\ .\.\ ..  ... \.**  ..\. ....\.**... .\  \. **** *   . \ *..\.* *. ..* . .*\*.. ..*\ ...\ . *\*.. .\.*... \\.\**.\ *.*\. *...*..*.\*...*  ..#  #
#  \..\  .   **..  . \*.. \. . . . . .\  *.. .. .. .  \ ...\...  *.   *\  \  \   *.*\ **\..*.   . .\*.\*  .  ...*.*...\R.*.* ... *..**.*..** #   #
#..  . .\ * ...  ** ...\ \ .   .* .**.\.*.\* . *.*\\...... ..** \.*\  . \ .\ ..*.\ . ....  .* \*.***.**.     ....*.* \.*.. ..*.. ....\*\.*\..#   #
# . . \\....*.\.*.. * \  . . *\.*.\ \. \.  .* ...\*  **\.*. ...\\**  *... .*. .*.. .*** *.\\....\.**\*.*\ .*\* **.*.* ** .\  .* \ ..*. * ##.#    #
#*** .. .*...  **. .\.\..  .   ....\.*.. .. . .\. ..* *.\*. ..   .*.*....*\. .\ *.. \      .. .** *.*  .  .. . .*.\***...**\* *.* *..  ***\#     #
#\.**\ .**.. \..**\ .*  ***.\.* \.\. .*..\ \ .\.*.**... ...*** \  . **\*\.. ....*. ...* .  \*..\  \*.    **  . .*. **.*...\ * ....  .  .. #      #
#  \. . .*..  *\....* .\.. ..*  .*.. \.* *. .** .\*.. . ***\.\  *.*\.** ..*.* .. . . *. .. .\*. .\*.\.. \***.*.\ \..**** .. . .* ..  *.*#\.#     #
#\\.*.* .\ \.  ... \*\..  **.*. \*\ *. .\*\. ...* **. .* .\...   \.*.*. .\....\**.* \...\...*\. . \...*\...... *  *.\***  \.   * *  *. * .\#     #
#* ...  \*\.* ***.\.. **.*\*** \.\* * ....  .**  ** .  ... .....\  . \*. \*\. ..\....***... .    ..... ...\ *...... *.\....\.  *\**.*\.\ .#      #
#. \ \.**.  .*..*\* .\.*\..* ..*.. *. \ ..\ **.*..   \*.... *\.* ..*.\.   ...  *.\..*.*.. .\ \.  . *\*  .   .  *.. . *  *. \.\ .\ *   **.*##     #
# ....  * ...\ ..** *. *. * . * *. \...** * .**    *.. .. ..\*\. *\.\ .*.\**  ..\.  .*..*  .      .*..  *..\ \ * *\*.* . *.*.* *. \ ... .*  #    #
# *\.\*.. **  *. *  . *.  . \*\.*.\   *.  \. *** \ .**...*. *. * .  ****\ \ ...\.  * \.\...*.. \ \..* *\ .   .   ..**.\*..\.\...\**.*#  #...#    #
# ..* . .*.   \ .. .  ... *\.   \\..\\ * \. *.**. *\**....**.*\**.. ..*..*. .\  ..***.*. *\  ... ...* *. \*.  . .. . *. *\. ..\.....*\*\ #** #   #
#\*\. \  .. *\ *.   . \..*\.. \.*\..*\.*    .\..  .*..*. *.... .. *  ... . \  . .. *\ .. ..* .  *.. **.. .**..* ..\ \.. .  ...*  *\..*#*.#.##    #
#.*.*  .**.\**  * . ..\ .\. . . ** *\.*.. *\.  .*\ ** *. . .\.\..\* ..*... ..*\* .  . .   .. ..* * \.**\. ... *.**. .*.  * *..\*..  *.*#\.#      #
# \ ***\ .  *..* .   .  *.* .*. *...* **. .  . *...* \\.**  . *.\.**\.*. *.*. \ **** .*. \ * ... * ..\*.\  *  .* .*\ * .\.**.  ..*# \ *##.#      #
#.*.**\. . .**\*\.\.\\.\\\  .\*.***\.  * \    ..* *.*\**.**   *.*  .. *  ..\   .**.**\**.\ * *.. \.**.***. .*\*\ *.**.   .\. *  .. \#. ..#       #
#.* ....  \*.**  .* .*  . .. ......* * *\.. \**.\ . ....\.*\...\.. *  * **.**. ...  *.....* \* ... ...\** . *\ *  .*...\.*\.* . \ *. \*.#        #
#.\ ...  * . *\\\  * ... .  ..  . \. **.. .....**\  ..*   ... ..  ... .\....\* ..*.  . .** ...*  ..  . ...\.*     ..*..\..* ..   #. .#*..#       #
#*\..* **...**  . \*.**.  *\*.    .\ .\.. .  . ...\.*.\.  ..*\ . ..... .*.* *. *..  . . **\\   . *\\* \\ **..  \..  .* **.....  \**.# ## #       #
#  . *.*\.\.. * \ ..\. .*.\ *.\  .*   *  **.   \.  * .**.* *.    \*** * . .  ..* \.\ .*\.**  \..  \.\...\.** ... \  ....#.** .  ## #    #        #
#*  .. \** . \.  \ .**.*. *\...  ..*\.*. ..    * *\. ***\. *\*.\..*\*.. . .\ *..\. .\..*\.. \  . . ... *.*.. **    *\  **. ..  ##**\#            #
#. . ..*\\.*.. *. *.*.\.  ..**\ .*.***......*.*..*. ..\.\ **.. *. * *    **.   * \  *.*... * . .  ***.*. .*. *.\. \* *.\ #. .\ .*.*#             #
#*.  * .. **\. .. \.* *.*.... *. ..\ \*.* ...\ ..\.\ **..**.. .*. .*\. * \.  .\.\.*** .\\ .. \....\* \.* .*....* ..\...  .. *.  .##              #
#\. * \. ....\  \* .. ... \.**\.\ \  .*\..**.*.\.*\...\*.*.\* ..  \*.. .... \*.. .* . ..* .\..\.\  ... \.*. .\  \.. .\.\.*\..#  .#               #
#\  *\**********.  ... *\* *.* \.   **\.***.*. ** ...  ..\. .... *.*** * . ... . *.. .. .    . ..**.  .*..   ..*..\ ***.**.###*\.#               #
# ..*  ****.....*\* **.  .*.... ....... .**..\ \. * .* \ . *..*  .*.**.\\.\*..  *** .*.  .. ...*\.  *\*.\.. *.....* ..  .. #  ###                #
#     . ***  **.* * \.. * .\ \. ** *.*.*.*\.*.** ... . ..  ... .*.\..\ .\*.*.**.*.***  ..*\ * .*. \ ..* ..*.\.*.\ .*.\   #..#     #              #
#   \ .. .*  .\ .* \.  \...... *** ***.*.*  *.*. . ..  **  . .  \ .\*.*\ .*.\.. *\ ** \  .... *... . ***  .\. .\ * .* .*#*\\ # ###\#             #
# ..\* **   . *.\.* . ..... \  ... .\**...\..\ *.** . ..\ ..\* .. ...... . . \.*.. .  ...*.  .. \ *  .\. *...\. *....\ .  . . #* #\#             #
#  \*.*.* ** ..*. .\...\\*... . * .. .*   *  . .****\. \ . .*...\.  .\***.   ... . .\ *. .**\ \.**\  ..**.\** . .***..   .  **.. .*#             #
# .\ **. \ .. .* ..\  .* ..... *. . ***. \. *. \.*.* *\  *. *. **\*. .**.\.**.*.*.  .\  . .\  .*.. .  \*..*\ .  .\.\..\  *#.**\ .\.#             #
#*....\  \ . .    *  . . *\..\ **\.* .*. .**.  . . .\**.  *.\  ..*.. ...**..*.....* .. \*.\.* ...*\. . *....\\ . ** .\*.\.\.** *.##              #
#  .\      *.*. **.\  *...... * \..  *..*\..\ .. .. .\**. **. .*. *  .. .\. .\.. .\.\  .... . *  * **. .*. **  **.. \ * #.* *.\.\#               #
# ...*  .\*... .. .**.. \...   *.\  *.* **\.*.** ***..*\.*.\*.* *.. \ *.*. \*  .*..*. ..\....... . \ *  *  *** *.*\.. .  *.. *.**#               #
#.. *\ ..*...\\..  . \\*.\*. . . * ..\..* \ \*.. ***... ..* . *\ *. **  *.*.\ . .* .*. *. *\. *.. .*\. \* .*.* *   .\. .*. . ..##                #
#*. *.   .*.** *  .. .*.\  .\.* .*..*..   .*..\ ......\  *. . ** \. ..\.\ ...*.. * . ..* ... . .. \. . .*.\.*.. *\. **\ .\*  .. #                #
#\. ....  ***  *  \.\..\..*. \..***\.\ \.. .*** *\*. \. \.\\....\. ** .**\***..  \. .**. \.*...\.. .\  ... \* .\\. *.**..\*. # *\#               #
#.* .\\   \**\.\. . .  . .\*\.\. ..*.\  **.\*.. \ *\ \*\ \\.\*....*.**.* ... . * .* \*.. \.\**** *\. .\ .* ...*. \** *. #*...####                #
#.. ... * *.**..*\.* **\.  .. *.  \. . **.*.. \.* .   *  ..\**  ..** .*..*.\*.*..**..*.   ... \.*..\ \. *\. ...\\ ....  # \ .#                   #
#\  ..\ \.. . **.. \ .\.*.  . . \ . \  .***\.*.***. **.*  **.. .   * *\ \*.....\ .\* .   *..\ . *..\ .. *****\ *\.\..\ ..*..\#                   #
#.** . .*\. *.\ \...** **.. .*..\.  .*.\**. .* *.. *\*  .**.\.*** . ** *.\*\*\    .\ \.  .* .\ ..\.**. . .*. . .# .  .*# #.##                    #
#.**  . \.  * \  ..\.**** *.\\.\.\*. *. * *  . .   *.  *... .  .*\..\. *.*\ ..*.  .\* *\ *..*.*..  .\  .  . .*\.** ..\ #*.#                      #
#...\  \.. **\. **  *.*..*\..\**..\ \.. ..* **. .*.*.* ..\..*.* ** \\  *.**  .....*.. .*.. ..\ \ .*  .    ..*\.  .\ *.. .##                      #
#.***.**.  .\* ..\. \ .**  \  ** . \ . .* . ..*\*. ...*.** .\.** . ..  ..*.. .\.\*\ . \  ... **.  ...*    . *..\. .  *\*. .#                     #
#\.....*  \* \ ...* ...*.\\.  .**.. . . ....\.\*...\ \ .***.* *\ . .\..*\  *.*.. .\   \*. .  ..\* **...* . **.\ .#   .*##\*#                     #
# *. ...*. ...*  ...** .... .\*.   \*. .*. ..*...**. ..*.. *.\ *.\. **..* ..\..\....  \ ..\.  . *...* \.*\* *\.  .*# *.## #                      #
#*.\ *   ..\  \** . *. .\*\ . *... .*** . .\*. *  \. .*.*..***.\ .*. ....* \  \ \ . ... *** *\.. .\ .\ ...\ ..***\.###..#.#                      #
#.*.*\.*.*..  ....\\. .**.    .\.*   .* **.*.*\.\ . ***.. **.\... .\ \   ... *.  . .  .*\*.*.*. .**.  *.**. ..*#*#   \ # #                       #
#. * ****.  *.  \**.**\*\. \ \       *.\*\*.***.\* .\*.*.*\. .**..  *.. * *...** \...\\*  **.\*...*  \ ..*#\**.# #####*#                         #
#* .*..*....****\..*\... *\.*  *.\  .. .  .. .. .* . * . ..\ **.  \  ..\* . .*\..*.*. \.. ..\ * \.\ *.\ *.\*.\ ##     #                          #
#* \*\.  ...*..\**.* .\*. \.. \....*** .*  .***\.*\ *... .\.*. \   .*.\*...  \ ... *\   *.... . \   .   . .#*..#                                 #
#  .*  * \...\. ..  . .* \..**\.  .\*.  *.  \... \  * \  .*.  . .  .**... * .*. . ...\..**\. .*. .*\....\..\#\#                                  #
#\*.. *\  *. .\\*  ... ..\.*.** .\  .. *.*. *  . * .*. ..\*   .  .* ..*...* .\.    .\ *\..   *  .. .\  . . #.*.#                                 #
#**.*\..* .*...*\.   *\ * ..*..****\..**.* *...*. .  **\ .\.*  ..*.  .* **.\ *.\.\ **.\. ... .\   * ...* *.. #*#                                 #
#\\*\* *. *.*.\ **..** .* .**. \.*...*\ *...\..\ . .\ \.***..*...**  ..\ .*  \**  .*......\.. .  *. .**\.\ *. \#                                 #
# .*.*  \ ...   .\.*..\..  ... .*.** . .\\  \ *\**.\.   ... *..*\...**\..*.\ ..** .*\  ..   *\.  .*.* \*\*..*..#                                 #
#..  .. * \*\.\.* .\ **. .....  \ ..  ....  .\. ..*.\*.* .. \.*  ..\.\ * ..    . .*.**.*  . *...*\.*.\. *..*.####                                #
#\*** .*.. .. *..\*. \..* *..\*..  * *  *   ..    .\*\... \.. ...  .**\*.  \.*\..\. \.  .\  . **.. ...*. * . *# .#                               #
# *.. **   . ..*\.\ \ *.\\.*...*\ *\\.. .*  *.**** ... .... \   ..* .\ .** ..*.*.*\. .  ..*** .*  .\*.\  *  .*\ *#                               #
#*. **.* \ \. *. . ....\. .*.....**.*  .**..\*. \.* ..  \* *. .\\  .\...**\.\.  **.*   * \ \.* * \..*\.* \. \* \.#    #                          #
#* **. *   .  *.\\  \***..*\*  *\ \.* . . * **\ .*.*..   .**  *.* .** *...*.*.*\*.*.  ..\\   \ .\ .**. **\ *.. **# ###.#                         #
#. .  ** .\**..*  . ..*.. ..**. . .*.  .. . .\*\ . .    \  .*.*\*\.** \. .... .\.. .\ **.\ *. .  . *. .\... *...#.# .\*#                         #
# ......*  .* .* .*..  . *.*..\\** ..*\**.**\**** **. *\..*.*\.. *\* \  ***.*..*  .\. .... *\. \. ..*.\...*\..*\.** \.#                          #
#     . .\  \...\..*.*.  .**.*...\\...*\.... ..*. . * .*.\.* .* .. * .*.*..  \..\****. ..*.*. *\..* .\  .\.. .* #*#* .#                          #
#.*..*.*.* \ \ *.  . *\ *..**\ \.**. \ \\*\ *.*..*  . *\**\ \.\    . .**  \\*.\*.*... . ..... \...**.*.*\.\  #*\ \####                           #
##################################################################################################################################################