#####################################################################################################################################################################################
#  ##.*    * *.\*.*..*\.\.*\**  \. * *    .  \.\. .\*.\ ..*\*..***\*...*\. *... * *\..* ** ...\... ..\ .   .\*.\*\ . \.  . *.*.*  * \ .*** ....*... ..\... ..   .*..*.**...**.   \.*#
# #*.*.   .*   ..\*\.  .**.. *\*..*.\.  \. .   . \ .\.*..\... ..\\*.  \.**.**.\.****.\.....  ****\ **. \  . .\*   .\\.* .\.*. ...   * . .*..**.** \  *  .\ .\   **\.. *\* . ...\ .* #
##*. \ **\ .\  . .*  *\..\*\ . . .. .    ..  *..*\.  . .. .\.... .**\* *. .**.*\**...*\      * .*.   * ...* *\*.\*...*..*.\*\ *.\  . \*...\* ....R*\*.\*\.\.*..*. *.  * ...\** *.*..#
##. *.\.# .  ** ..** ..*  .*.*   *\ . * *. .*\.*\ .\ * *.   *..  * ***\.** .*..*.\*... *. ..\.\ . *\ . ***. .*. *\***. *    .\.\.*\** .  **.* * \ **.\.. \ *.*   ..** .\ .  * *...  #
# # # #. ..\ *. *  *.. .  *.*..\*.. ..\... *  *.*..**  \..*   ..*\ *....** ..*  .. . * .* \ .* ** . . ..** ...\ ..\. .*\*.   ..**. *. .  .*\...*..*. .\*  .... ***.**\ .. \.*.   \ *#
# #*.*. .*  .*....\.*\   ...\***..   .*  \**\*. .*\*.\ . .. . ..  *.\ . .*. *\..* ..*.\.\ .     . . ***.*. *. .. .  \* .. ..*\*. \ \   .* ...* *  \     **\ .*.*...\.  \**. .****...#
#  ## **.*  *.# **.*.  .*. * . . . \.*. ..\\... ** *.  ..**.  **. **... *.*.\. .*.*\.\ ..*.\.\..\ ...*\* \.*\* \*. . . ..*.\. .*..\.\.\ .  ..*.. . ..    . . * . .  . . ...\*\ *\. \#
#   #.**..  \..\**..... .. .* *\ *..\ *****\* .\*..   \.*.*..*....\..*.*...\.\ . ...  .\ .  ** *.*.\..*\ *.\ .. . .   *\* ......   .. . \* *\ .*\  .* *\* .\*.... *.  *. . * * *. \.#
#    ##.\.  .....    * . .\*..\* .. ..**.* ...\...  \ ..  * \ *\.\  \. .. **\..  .\**.  .*...\*. .*. **.\ \....*. .\ *  *\\*.\.\..* \. *.*.\  ...\. .\ ... ..*.\..*  \.    ****. . .#
#    #*.* *\ # *.. \* .. *.\ .*\.* *. ..*\ . *   **\ \. ..* ..  *.\*.\*  ..**.**..\*\ ** .\*... **...*\ *.* .\ \ *.*\ * .*.. .   .\ .. .... ..**.    *.\ .*. . ..*.  .\*..\.* ..* * #
#    ##  # . **..\\.. .. *...\ .*.\.   .. . \.*  .*.*.*.... .*\.\*..**.\.\*......**.. .. * * *..**. *.\..\.... ...*.. .**\    \ . .   . \ *..*.   ...\ .\ .\.  . ...  ..*.* \ * ..* #
#   #\ *##\.***. * .*. .  . .*  ...  *\** .\.**.  ..*... **.*. * \...*.*\...***\  * .* ..\ *.\*\*..*..*.*.*  .  .* ..\*.\.    .... ..  .* *\**\..**\\   ..*.* **   ..**\*...\ .\..\.#
#   ##*\  .\..* \.  .\*  .*\.   *\.*  .* \*.   ..* *.**   . .. *.\* .. *. *.. *.* ** .  **\*.* . ** .*...**  ..**. .  .. *\. \   .   ..*. .*.. \ .* .\ * .... **. * .*..*..\.*..**..#
#  #\..* **.* .\. .\ .*\ .**.  ...**\. **..  *    \**** *.\  \*  ..  .*.... .\* . ..***...  \*. . ** . \ ..  . *... ..* . ..\.  .*.  * **..**  .* . \. .\*.\. \.\.** .*.\\* ..\.....#
#   #\.* *... *.  *. *.*. ..\.. *\.\ .  .\\ ...*.* ..*  *.  ... . \.  *\\  .\..\*.*\.*.\.. \..\.** .*..\. .  .*\.*\. **..\ .**..**.....*..*.****\. *.  ...   * . *. . \\*..  \ *..**#
#  # . .#  . *\ *..* . . * ..  *.*.**\ *  .. \* *\ .*. ...\  . .\  .. *..*\ *\* .*.. *\ *\ .*..  .\ \   *..  ... .   .\.. \...* ..\ ..*.\  *.... . * . .  .. *\..\..*  *.*.* . . .\*#
###\.\....*  .*..* \ *...\.     \. . *. .* .... *    .. ..*. .*. .*.* .*\. .*.. ... \**.*  **  ...... .\.*.\ .\ *  *... \  *..\ *** * *...\.  .\.. .\.\ .\ *.. \\* ..*..*.\. \\ \ ..#
#***.* ***..\..**  .**.   .. *.*.\ * ..*..*  . ..*.*\*..\ *  *.  *. ** ...**. . .* *. .*\ ....  ....*. *..\.*\. * *. .. \ \.*.*\...*.*. .. *    ... * .\\ \\ .  \.  .** \\*\     ..*#
##\*\#..\*.\. *.  .*..*\ \ **\...*..**..    *.\*\ ..**\**..\.*.. . *. \. \*  \ ..* *\**...  **.  *.  .*\   \..**...\  .\...*.*\   \*...\ \* .*\.* \...*. .. \  . .*.. * *\..* \. * .#
# #.#    **.\    . .*.  ..*** . ***\*.. ...   *\. \***.*\ \   ..  *.  .*\.*.\..  \ *..\. .  .... **         .*.. \**\ ..\\ .*. **...  *....\.. . .\. *.\*.\  .. .\.. \  .\. .*\*..  #
#  #\ .\*.\..* *. *..  .* .... .**.*.**. .*.***\ ..\.. ...\*. * .*..*... *.. .* . ..**.... \*\    . .* \  **.*. ..\ *  .*\  *. .\ ..\.\.* . *.\ . ..**\ *\....\.* *\.*\\ .\.*.*.    #
#   #  ...*.*. *.\** *. .. \**.*\..*  . ... .*\.\.*.. \ *.*.* ....*   .....\.**\  *..\**..\ ..*  * .\. * **.\* . \  . *\.. ..   *\.**   .\*.**..*.\.**..\.   ..*.. \ . .. * . . ..\.#
#   # .\\.*\...\*.*.\ .\.* .** . \\   .  . * *...*\... . *.\..*.\ .**.  \* . .  *.\*.**.** ..\.\ .**. ....**** \\ *.. .  *  \. . .... . ******..\.. .**\*..** ...\...*\ ....* * ..  #
#    #\...*.* .**...\..   *.***...* . .. *.. \*\...  *  . \.*.  .  . *.\.*. ** .* .\**** .    .*. ** ***.\*..**...\ .  ...\ .... \......\..*.*. .  ..*  .  .\  ..  .*. * .  *   *..*#
#    #*.*.* ..*.*\. \ ......*..* .*.*. .  * .*** . \.*\.*.. \ .. \.\... ..*\ *.*. ...*.***  * ..\.** *\...* ... .\ *.   * .  ***.. .  .***.. ....  \ .  *.. ..*... .\ .*  .*.\.  . *#
#    #* . . . .\.. *.**. \ *..*  \...... **. .\.***. .  .*  .. *       .. \**\. * .  .\\*..* ..\...\ . ..*....*** .. *. .**\..* \ \.. \ .. * ...*...*\ \. \ * ..   *.**..\ * *.   .*#
#     ## .\**... ***... \ *\.\. ..\*.*\  ..\.*\..*.*. *. \.*\. .. .\  * ...*...\. *.***. .*. \\**  *. ***.* ..\..  *.... ..*..*** .\.. .  .  *.*.* *\ ..*..*.*.....\\.\.  \.\.*...\.#
#    #* \\ ..**.\ ....*.....*  \. * *\.\* \* *  .*......* *.\*..  * **.***\.* .*...\.... .. .....**..\.*.  . \ *.** *.*    ....*.*..\  *.. *.\*. ***.. *..*.\. ***\.. *  * .. * . .*#
#     #  \   . .*. \* .*\. .*\....*.\..**. * ... . \..*\.  **.* . .*.*\..\* .\ . \\.\  **.*  .**...**  *. **... .*\ ... .. .*.*  * ** . .\..* *.\**  *\.. *...\.. * *.*.***.  \. \**#
#    ##**#  **  * .\.\*. ** *.  .** .\\ . ... *.* ..  .* ..*. . . ..\*   .... \ \.. *.* ..* \ *.*. ** \.   .*..\.*   \.*\.**.\. \..*\ **** *. * *..\...\... *  *... *\**.\.*.    ...#
#   #\**.  .**.\*\\.\.. ...\*\.....\..*  .*\* ** .*..*...\.. \  ..* .. .\  * \.....*. . ..**...\.* *....* *..  . \***\ ... .* *\.. . *.*.\ *. . .\**.* ***...\.\\\  ..\.*. ** .\ * .#
#    ##\ #** ....***..  .\. .*\*. .\*.. * **..*. ..\\.*   \ ..\***. *\.  *. \..* ***.*  ...*\..  *.*..***.. *.  .  .* . *   .* . .\ .*\*  **.\.* .*\.* *\.\. .  .\.. \*.**\\\\ .\.  #
#      #\ .* *.\..\ \        ....*\**.. .*.**  *.*\. .*  ..\   .*.\..*\ *.\   .*\. .. \* .\ *.. *. .*\..\ \ .\.* *..        .*  * . \*\....\ ...**\*..   .. ...  .*.* ..\ .*...\.\. #
#      ##. .\..*\** .  . *..*.**.. .*\.. ..*.  .\...*\  . .**  .\ . \ . ..   . **\ * . *\ ..*  .** *\** \ . *  .*.* .\  . . ...\*.\  ***..\\. . ....*\ .\  *.*. . . .\* . .. *   .* #
#     #.*.. .. **\ .*   ...\.*... *\.. \.  ...* ** .. .*.*.**\ * .\. .  .\ \. .\ .*.   ..\.**..  *....* . ......... ..*.   .*\*....*\.*..\..  .. *\ ** *.... . .*  . .*  . *.*. \...#
#      ##*      ...*.*.. *.* .   .. \...*\ **\..*. *.\**.* \...*\ *     .*.. * **...*..*\. .  .*  \ .\**.*... \ .  .  .  \. ..*\\  .......*\  *... ..\ *.\ .  ..\.*\.    *\ ..*\..\.#
#     #*.. #*\\  .    .*\.\**\ .****   ...\*..**.*.*\\.. * . .. ... * .\...**. ..\ *\ . ***..  .\..* *.....*.\ *..*  *\  ..   *.**.* . ***\..*. \  *...  . **\* \ . . *\.. \*..*  . #
#      #.. *##\ .*..* \.* .*.\....\..*  . .. * *. *.*.  \.. \. ..**\. ...\ \. .\ **..\ ... .\  ... .*.* .**  ..\ .. .*..    * ..  .\*.*.*. **... . ** .   \*..\  *   .\ .*   \...\ *#
#       # \.\. ..* ..* .\  \.. .\*..\.\.** *..  *\. *.. .. .. .. .**\   *  * \ ... ..*.*  .   *\.*..*...*.. *\..*\*  \*\ \. ** \   .. ..\*.\. .\ * **. ..\.**. . .\*\*... **  .. . .#
#       # #**..#\*  . *.  *....\*\.***. .\*..* ....   \  *.\*.*   .. ***.. . \... \ ..\***\....\. \***  .\. ...\.*. \ ... * \. .....* .\ .** .\ *.***.. ..*.*.* ** .*.\.*  . **\...\#
#        # #\###*#   ..*  *\.*.*.**.**. * .*..**.. .. .\.\.*.*.*\* ....\. \** .. *. \.\.*\****\\.\.... .*    .\ *..\. ..\ **. . . . *   *.*\.**.*..* .**.\\*.*.*...  \*\. ....*.\*..#
#           #   ##\*  ..*.\ *.*\*\....*. .\.*.*.*\. .\ **  .*.*....\.\ .*.. ..*.\*\ ..**.* ... .\.*..  .   \*\  .. .  \.** *.* * \*\. *.  *  \. ..*.\**\...*.* \..*.\... . .*\..... #
#               #**..\ .\ ... \.\..  .*. .\... .  \ \ ...*  *...*.. * ..*...\.. . *. *. **\*..   \..\ . *.  ... *\ \.   ..*. \ .......* . .\..  \.*\ ..* ..\**..*.* . .\**.\\.*  ...#
#                #*\ .\ * . **.\. . * .... . .   .\*\  ..\...   ..*. .\ .  *.   \...*. \.***\..    *.. .**....\ \.\ .   **.*\ **  \ *. * * . ** . .*..**\.. .. \. .\.* ....   .*  . #
#                 ##*.  *. .*.##*..\*.**..\..*\..  \  \..  . ..*\ .*  .\ ***.\* .*\     *\*  \ .   *.*.\*\ \**.. * \. **.\\. ... ..  . .\\...  **  . ..**   *. ..\**.. .***..\ . \..#
#                   #.*#.#* .#.## * . \.\. .*..**\ .*...* *  .**..\.  *....*...   *** . * ..*.  \..  .. . ....\  * * .\* ** \.*.\\  .\*\.**\ . *.   .*\..** *\**. *.. ...\. .   ..*\#
#                    #. \ .* *.*..\ #\ \.*.*.*\...**.\*. ...\..**\....\**\.**   . ..... .  \** * \* .* ..\ ....*\.\*.    **  *.* .* \.**. .* \ *    ..*\....\....** \*\  *  .....*\*#
#                     #.## #.*.#\ . # \...\.\.#*\*. ....\ *\  ....*...... ..\ ..   .* .** *..* *. ..*.\    *  .\.\.* .\ *.\**. \    . ...\ .\... \.  ** *.\... ***..\.   *    *.\.\.#
#                      # # *##\..*. #.\.\.**......***.\  ... \ * .. \. .** *   \ \ *. ...\*. \   .**. *. .....*  * .\ **\*.... .. * *\ **... \  \.  **. .\..*  .*\* *\ **.  . .\... #
#                         ##  #*.### # \***\.***\..****\  * . ..*......*. ..\ *. .  .  . **.*  .\*..  .*..*\ *.\  .*. *.*..*\...\*. **..*... . . .  *.  ...  ..*...*\.\ .*\ .*  .. .#
#                              ##   # \ .** ...*.\...\.. * * .. *\..* . ..  . .. * .. .*.*  .** *. ..**\..\ *.. .\. \ ..*  . *\*..**.....*   .**. *   \*.   . ..   **. \ .  .\...   #
#                                   # # .*.  ..\. *. ***.*\*. \* **.\...*\.\* . * .    . * * .\*...\ *..*. . .*....*\\*\**\\.  *. ..\.*  .* **.\\ *\ \.*.. . * .\....\    * * .  ** #
#                                  # ...\     **.*.*\*.. .  . .\*.**  ***..\.\.* * ... . .**.* .*.*... ..* **\**  *  .\**.*. * *. .. \.  ..*.*  ..\. .**  .* * .*\* \.**  *.* **..\ #
#                                 #  #\ **.*\ .* .\.*.\*...* ***.\*   \..*..*.\.*. *. *..\..** \*  .. ..\*.\*.*.\ ..\ *.. *. . \..**.\ .\\...\.\  ...\*. *\.  ....*   ..\*. * * .. .#
#                                  ##\. \ . . * . * \\. *. ... . .  * ..  . .\.\.*\  \.*..  \.* . . ..  **...... ..  **\. ...\ . . .\  \..\  *  \.  ....\.***.* .*   \ .** .\.\*\*\.#
#                                    #  #\.#*\  \..*..  *\. ..\.* \ ***\ *. \.\ \    .. .  .. . .\ * .**  .. *.    .\.* ..  **  .*  . .*  .* . \...\ \.\..**. .. .*  \...*. ....*.. #
#                                   #\ .  .\.# .\   ..\. **..\\*..\ *..**.*\*..***.\.   *  *    . ..  *  .. .\.**.*** .  * **.*..*\*.**.\ \.    .\. ..  \.*.. \.  .*\.\ .*  ... \ . #
#                                    ##**\...    **     \ .\.* . .* .   .  .*\...\ .\.\*. .\. *.\... .. \**  . *..\ *  ..  *..   \**.* *.*  *** *...\*...... ..\. * ***. *..  . .* \#
#                                   #  *.* .*.* .\. *\.\.\.* ..**.*...  ...*\  **..* .. .*\.* * .. .   . \.\.\ ** . **...* .**  \...*. \  * . ..\  \.\ ..*** *\.. *..*.*..* .* .\. .#
#                                   #\ *.  .*.. \**  . * .\.\ *..**\. \ *..***\.*\..  *.\.*.* ..\*... .*..\ .********.  *....\ ..  .*...*. ...  .\ .\..**. ..\ \..* ..  . .  **  .. #
#                                    #*.  *\.  \ .\ \ ..  **.** *. .* .. . ..\\** **\.\*.. .. \  ..\  .. . . **.  ... \ ..* .*. *. ...* . * *\*   *.\.**  ..\*\ .*\. ..**  ..*\ *...#
#                                   # \#\ *.\*... ... .* *\.  .* *.\* . \\..** .. .\* *..**  *.*. ..   *\ .\.. \ .\.. ... * .\.*..\.**. *\.  *. .*\. * .\*. ..*.\.** * ..\ *.** .\..#
#                                   # .. ... . . \*.  ** . . *.* .\.. \. \.* .* *\  . ..  ..*\*.*  . **. * . \ ..*..  *.*.***  *. **\.\ .**...**...*\ .\*** . *. **.\\. * *\...* . \#
#                                   ##\ .#*. .* \.. . .. .. \\ .\.* *..\\**...\.. ***...  *..\. *.\*..  ... \ ..\.*\.   . .*  ..*..   . .*.. *..*.*  .\ \..**\. ..*.*. . *. ***\  *.#
#                                  #\  . *#.\ ...** \  ..   ***..\*\... ..\* *. .\.* \* * .*\..*.\ *\.... *..*.. .***. .\..  .\*...*  .  .**.\....* .\ ..*.*.*\\... *..\      *. *. #
#                                   ###.## .. *... *.\. \.  ... .*...*  *\**..... * ... .\\* *.\*.  ..\*.  .*  .  *** .\ ...\.*   ..   \ .\*\ *\. .\.* *\.*.  **\*\ ...*.  \.*..   \#
#                                      #  ##* #. * . **.. * *\.\ **..*. \*.***.. *.. ..*  ... ...*  .   \. .\* .*...*\* ....\ ... *\ .....*..  .*\\ ...*  *.\*.\.\*\.\.**\. ..  . *.#
#                                         # # #\..\*...* ..\.   \.. *. ... .*\.\***\. ...*\*...* **\.. *  *. ..**\...*\ ..* * ** .. . **** .*.*.**\ .\ . \..*.\*  ..*  *...* *.\. .\#
#                                        #\# . *  . . .  . .*  *. *.  *  *. \   \ .*  .. ..\.. .*.\ *\*   . .*\.\.  .* \... . .*..*... ...   .. **\.\.  \ *...*. . .\.**. ...... . .#
#                                        # *..\*#\\  # .\   \ **\. . .* .* *.**... ..  . ....\.* \ \.\ . *\. . . .*..... \.\ * *.*\**..   ..\  *\.   **.. **.\* \**. .*.\.**.***\..*#
#                                       #* .  \**  \* ...\. *.* .\. ........* ... ** .  ..**\  *.*.. . *.. .*\*.....\ \ .... *.* \ .. .  . \ .\*  . \..*.\..\*. \. *.\..  .**..  \**#
#                                       #.\  *.\**.. *.  **.. *** .  \*.*.\..  .  ...  *  . *. *..*\* .\ .*.*.. ..  *...**.  **\.*.*. *  .* .  .** * . . .. ..\..*... .    .* * .*  #
#                                        ##*##* *..\  ***.*. ..\. . .. *...* .. .. . ***.   ...*.  *\  *.\.....  . .. * ..\ \  * ...* ** .*\  .*\\..\ ..*.. * .***..  .  *.\...  . .#
#                                          #  #\.\ . \*** *. .. ..\*  *..* ...\. .  *..*\ .\. *...**.  \.  .\. ..*. **\\ . . ..\.\.*\ ..**\..  \..\ . *  \. \. ...*\. . .*\.*\. *  .#
#                                            # ..#\ . *.\ \  \*  \*. .\** *..   .  *\\   . . .\\....  . .. ..*\ .*. ....  . \. **. *.\ .*.*  . .\  *. . .*  .*..*.*\   .* \*\ . . * #
#                                           ##* . . .   ....*.\ ..*\.  ..*\ .* . \.\* *.. *\.**  \...*. .  ....\ * \..*. . .. . *..*.*\.*.  .  .*.**   \.... . *.\.* **.   *   * *. #
#                                         ##*. ** ** \.. .*\. .. *.  ***....\.. \...*** ..*. *.\\.*.** \  . .\..  .\..\*..\ . ***\ ..*. * ..\.. . *.* \   *\. ..  . . \    ..*.*.\ .#
#                                        #.#    **\ \..\**\.\. *...\..\.   \*.\...  \...**.* .  ....* .   . *  \\  *.. .  \** .\.*. ...**. .. ...*\..*. \. ..   \*** ..\   *.*...   #
#                                        # .  # ** *.   .**  **..\..*.   .*  *  . *..*  .*..  **. \.\*.* **\* . . .**.. . *\.\.*...*** *.*.**\.* .. .\.** .\*  . .** ...  .*\.**   \#
#                                       #\*\  *\.\.**. *\.  .\. \.*.**.*.*\ ..  .\.\*\*\.*  \.. *..  \ .*.**.\ * .*** . ...** .. *\.*.\  . \.*..\*  \***. \.\ *.. ..  \.*\** \* .*. #
#                                        ###.##..    .     ...* ..*....\.**. *\ .   ..\.\ . .*. *. \..  .\ .**\ ***.. \ \..  **.\*...  *\*.. *.  . *  * .\* * . . . .  ..* . .** .  #
#                                        #*. #.   ... \ .   * *\\...\*. ..   .*.  ..  * .. . \*..  .*. . .. ... ...*. . .  . .*  ..    \ .\ \.\\**.*.*.\..*..*\ .*\  \. .*    .* \ *#
#                                         ##.#*.*.\*. ..\ \*\*. .*.\.. .\* *..... * *.*. ***\.. .* \*\  \* .. . ** .\   ..  . .. \ ... . *...*. . \...*. ** **..\.\.*. .**   * . .\.#
#                                         ####\  .  * . .*.* . *\.....\ *.\. \ .*   .. .**.\.. *.\\...*. .\ *. \...\** *\. .*.\*  .*..    .\.  .*..**\*  .*.**.  * \.\* ..  *..  *  #
#                                        #..# #\..*.\..   ..  *. **\.* \.*\\ .*.** .... \. .  **. .  **. \ ..**.  .... ***. **..  **** .* \*  *\..... . . . \   .... **..** ....   *#
#                                         #*  *.\ . .\*.\  .. .* ..*\.\.... .  **. *.\...\.\.*..****...     \\.  .*.  \**...     . ..  \.* .  ..\.\* \\..  ..  . \* *.\* .*\ .*\  *\#
#                                          ##\#..\# *#.#*.*** .* . ... * \. .. .\ ..\   .* .\*. .........* \.\  \*\   .*..  * *  .  \*  *\.*\*.\.  * \.* .\. . . .* ..**. *.*.**... #
#                                            ##*#.#\# #.## *..\\. \* .\. . .\*\ .\..*. .*... *.*\ .*.*.\*\.  **\. .*. *..**\\ .. . **. .\*...**. \.\*.*\.\ **....\.\.*.\*\*..\**.\. #
#                                              ## ## # \ ##.#*.* *.. ..*\ * *.. . \.** ..\**..*..*.* \. .. ...*. . *..*\ ...*.    *.  .*.*  * \ *.**\. ... *.. .*.** . *....\..\   *#
#                                                #    #. ... #*#.**. \ *.\ .\..*.....\ .*.\*. .*   .\. .  ..  * ..*** .*\   ..   \.* **\..* ** ..*...\.*.*.\* \.. *... .** \ \.*.***#
#                                                      #*## .#**  \\...\*\*\..*\  ...  ... . .  ..\* ..     .... *..*.*...*..***....\\. .\\* . .*..\. ..*.*. .. . .. .. ** ... .\..\#
#                                                     #.\. #*.*.*..\.\..*.*.  .  \.. \* \  .   . *.\  *.   .**...**\.*.**..**.\.  ... \..**.*.\.* . \ * ..* . * \ * **\*..\**.   \ \#
#                                                      #####*#. ...* *\ ...\.\*...***.. * .  .   *\.*..* .. ...  .. .* ** ... .  \.*. .. .\ .. \.   .*.**..\*.. *.. .... ..*.* .. *.#
#                                                          #*.*\.#...\. * .   .\. ..... . . .\  .\**\..*   *..**.  \..\*..*   *...\. .\.. *.*\..*\. ..*..\ **.\.\ .**...***.. *  ** #
#                                                           ## . ##. .*\*\ **.*.*. *.*.\.\*\\  . .*\.*...  .*\. *\ . * *..  .*.** . \ ..  * ..*. ...\...*..\\ *..*\.. \  ..\* . *.* #
#                                                            # . # . *. \  ....\**  *.*.. .*\**\. *   . .* .* .   .\.  .\ *.*. \.   .* *. * \ .   \ **. * ..***.* **.. .. \...*..*. #
#                                                            #\*.. \ *#.. .  *...*. **\. . * .  \*... .  ..\\       .*... ...**.. * \...* ......*\.......  ...\...**\ .\. .   \.  **#
#                                                            #..   . ** *  . .\  ..* \ \*..*.*  .. \.\..*****..**.. .  . \ . ...  \.  . .\ .* .**.*.\.*\ \. \ **\..**.  *.*\.*..* . #
#                                                             ##. \  #*###\\..  **..\ ... .... *\ \*  . . ..***.*\*.*\ \ ...\  *   .*** ** \..*....* .. ..* .\...* ...\...  \ . .\.*#
#                                                              #\##.\*#   ###* .*\..* \. . *. *.** .*  .* *...\ *..* ..\\*.. ..... ...* . *   . \. .*\  .*.\ . . \....*\..\  **.  \.#
#                                                               #  ###   #\#*# \.***. *. ..\ .**..*\*   ...*. ..\.\.    \.\*  *  .*  *.** . ..\ .\*   *\..*. ..*.* ..\**\ * *\*.\ . #
#                                                                        # \*  .*\. *. .. ... **..*..**.  ..    * .... . . *\.\ * * ....  \ \.** *\..\. *.**. ..\.* ..*. *. . . .* *#
#                                                                        #\..# .. .\.\  .\* \  . *.* .  * .* .. *.  \.. . .\****.... . .. ..*.*..     ...*.*\\    . ..*.\.*\.**\ \\*#
#                                                                         #\###. .* ..   *****  \*\. *. *... \..*.*..\*\*. ******. .*.    .*. *.. .  . \..** .*.\.\ ....*.\.*..  . .#
#                                                                          ##   #*.....\ * \. .\ ..\ .... **.. ..  \... . *.*\ \. . ..**.  *. . ..... ..\...*  . *.  \ *.  ... ... *#
#                                                                            #.\\*.***.. \ .***.**  . *  *.  . .. ..*.*  ..... *.  \ *\ ..\*..**.**\*      ** . *.....*..** . .**\..#
#                                                                            #.#\.. .\ \.........\   \..\.\*\\ .**..* ..\  *\\.\ .  *..\. .. \*. . \      .*\   ** \ .. ...* ..\\.\ #
#                                                                             # #. \ .. * \ . *... *.. *.\\*.* .... .. *   . \  . \.\*..    \ ....*.. *.  .\*. *.\..* .*.** .*\*    #
#                                                                              #..\.*. *\*  . *. ...\ *\   . ... \.**.\. .... . . **.*.*. \ . \ .\*  *..\.. .\ \ .  . **.**  ... . .#
#                                                                             #\.*.\.* *...   \  *.\ *..\.* *.*   .** * ** *.*. **.. . .**. *\.\.\.. .* *. ... .* *\   * *. *..  .. #
#                                                                             #. #*#.... **\  .\\.** \ * .\.\* *\  ***\ .*  *\. .. . .. ..\.. **.* **...... ....... \ * \ .*.*\***  #
#                                                                              ##****.  . *. *... \ ..*. \..\.* .** .*. **  .*  * .   . ..... **..* ....*. . \\ \..**   .* *.**. .* #
#                                                                                #*.....\ ...   *.*\*... . .. ..*\* \\.*.. ... *  **.\*  . .*\.*..*\.. ...\**.**. *.*..\ *\*...   *\#
#                                                                               #*..*.. . *. ....*.\.. .. .  .* . \*..*.*.\   ..*.\*... . .**     *.**\..**.\...\**.*  * \.*..\ *...#
#                                                                               #*..**.#**\.. . ..*.\\.*\  .* .** .* **  . *. . .... *\.* ..*. .*     .***.  **\... *..**. *..*\  ..#
#                                                                               #\##\. ..  .*\. .\*..*\*... *\ .. ... * **.*\*. \ \ *.* .\.\ \* **\.*\ * .*.\*.* * .***. .. ... ..  #
#                                                                                #  ## ..*\ . . *  ..* ** ....*\ . ..\...\. ** *.*...*. * *.\ \  ..\.**.  .* **\ \***..   *.*.\ .*\ #
#                                                                                    #  #.#... .  ** .*. .. * \  .. \.*.* * *.*. ...\.\.\*.\.*.* ... \* ***.*.\ *.\...*.\.***\*.\..\#
#                                                                                    # \. *\ \ #. *\. .  ..  *\* .   .**\ \ .\ ***. . .** ....*.\.... \\......  .\..\ *.**\.. ....**#
#                                                                                    # ...*#\.*.. .**.**..  .\.**  \.\..\....* ... **.. *\....* * *. *..*..  *.*\*** ..*...**.* *.*\#
#                                                                                    #..*##..*#  **.\*..*****.\.**.*.*.  \*.\* \... *  \*.*   . . *.*. .\ *. ** . \. .   \* * * \*.*#
#                                                                                     ##\##. ...\ ...  *  *.. .\..\*.*.    ..* ***\...* . #**\   ..**..\. * ...  .*\.\.  .. *\. ***.#
#                                                                                       ###*....\.* ... \**.\*\..   *..  * .**\\* .*.\*.* **\**  **.     ***\ *..*. *. .*. \*..\.\* #
#                                                                                       #  .  . * \...  **  .***.* ..* \  .\...   *\    *..#*...** \  .  .*.. .*\.. *..\..\*.*\ **.*#
#                                                                                       #..###.\.  *** \ . .\ .*   ***.*..    **.....**.* \.**\... .. *\* \.\*** .\.*.\.***.\ .*.*..#
#                                                                                        ## #\   * * .* ..\* ..\* .*..****  \* ....# # **. \.* #\  .. \ ..  .\ . .*.. * ..* *\   * ##
#                                                                                           #.##\\ *.**.\ .*.* ..*..**..  *###*\*\*.\..**. \.\##.\. *.*..\\\ *.....*... *\.\.*. .. ##
#                                                                                           #*.#....*...*. .*.\\.\.*..\ *..* #####**# *.*   #. .*..*  . ...*.. * ..\. ..* *.\.*. *# #
#                                                                                            #...\*\..# .#*.*#  . .. .#.*# #*#   #  #\.. *#* #.\...\.. \   *\..**#.\ * *..*   *\ L  #
#                                                                                            #*\#\## *#.\.*#*## ..\* .... *##    # ##*..**## ###**#.\#. \.\. . .\# *.\# **. \ .* ####
#                                                                                            #.# # #  .##.* .#.\ ..\ .  *..#      #  #.*.\# #  #*.*  *\#.*. *#.##\.\. . \..  *.**\.\#
#                                                                                             #    #*#.##\\.*.\..\ #** #\##         #* *##     #*###*## #*\*..*\\*  *\****\ ..*##.###
#                                                                                                   #. ##****. \ .. .## #          #.*##        #   #    #.#*###\ #**..... **. *##  #
#                                                                                                    #*# #*\*.*## *. .#            #*.#                 #..#*#  ###*.\. \ .*..*#    #
#                                                                                                     #  #*.\###*\#\ #              ##                   # *.#     ###### *###\.#   #
#                                                                                                       #.**#   ## ##                                     ###            #**.##\#   #
#####################################################################################################################################################################################