#####################################################################################################################################################
#     #   \ ...* *.*..*\ *..* *.. *.*\*..\.*.*.. \.*.** . * ..  .\.*.    \ ***.. .. \.\ .*.\.. * * ...*  ..*..\.\\ *.\**.\*\**..\  .  *.*\*. .*...\.#
#    ##* .  ..*. .*.. *..\ \... .. ***.....\..\*\* * .... . \\*...****.  . ..**.*.*.*..  ***. .. \*.. *  * *...  . ....**.* ..* *\ .. .  ..** *\ * .#
#   #*##. \..\.\ ...**  *  *.*\\ . *. ..  .* .\. ...   .\.*.. .   .*..\     ..\.\....  \ .*. \ . .. \ \.*\ \.  *.*.*.\  ..\. ***\.. .\..** ..*\. .. #
# # #* **...\.* \ * .**..\**.\*.\ .. ..*.\ *\.. . *.  *\* . . ..   ..**\* .*\ .\.. .**\ *\.. ..   .\\..**   \.\.*.** .. \ *\.\*...\ .**..*\*\....\  #
## ##..*.* *.. .  \. . \.    .**.. *.  ... *.\.\  .\ *\*...\. ...*** *  .* ..\*..*\ **...* . ..**** * \...*...  . .*  .* \..  .. .. .. ..... .. \*.\#
##.##.*#***.\ \... \*.\ . *  \*..*..*. .\\ *..***\.  . *... *\ *..*.*\* **. * .  *..***** .*.* .\.*  ..**  * *.  .\.  .. * .*. .\ \   *..*\*. .\..**#
#\.#*\. *.* .\ \ *..\.*   . *  *  .....*.*. .\ .\. .... * * . *..\. ....  * *..*. ..* ..   . \*.* .\ ** .  \.. .  *.\*.*\\  *..*  ..\.*.\.*.*.    .*#
#  ...  .**.\ \. **  .*. ......\ \..   ....\  .\ *..... . *  *\. .**\...*.* . ..\ **   ** . .. *.* . *   .*..\  ***. . .. .*.*\\**  \*. * .. **. \..#
#*\ # \*..** ..\ *.     *.*\.\ .  * *\*.. ....**.\ ** .\ *\. . .\. .\ .  .\.*\  * .*.\ ..\** \  **.. .\. .*  .  ...   .* .*. *...*  .\ *.\.. ..* .\*#
#..    \. .. * **. ** .. ..* **   .  . .\ *\  .*   ..*. .*..***\.*\ .. .****.*.* .\.*\ *\*..* .\   ..  \* ...   ..*\... .*.. .  ... .. ..**.\* .. ..#
#.*. .\.  * *.*\.. **\***    .*\\..\.  .*\*.  \. *  *....\*.** .*\.**. *.\*.... .****..*\ * . \..* \*\*.*..\ .*\ **.\ .*  .\ \** .   .*\ *. ..* ... #
#*..\ .\  .*. . *\ ....*.\**. ..*\\.*..... .\*. .* ..\.. \* *.  ..*    *\ . . * ...*\.... . ... .*... ...\** ..****.\*\**  ..... .*\ \*  .. *.\.. . #
#..*. ...* .  ...*  .*. .*..     . .*..\* . ...\ \ .** *  \. .**\.\..* ..**\...\ * *.*  \ *.     .* .* .\..*..*..*.\.  \. .* .  *  .  * .  *.* . *..#
#..*\ .\*.  . \\ *.\*   .\*..***\*\.. **.*\.. ..* . ...\*\. . \..\. .*   \.\..   **. *  *...*..*.*\ ..* ***  *\ ..  ..**  * ***.  *  \.   *. .  ...\#
#**.\* *. **\.   ** ** . ..\ ... ...*......*. ... \  * *\.. \...    *\  ....\...*** .. *.   .* *\**  *\. .\  . * .*. ...  *\\.  \*.. .*.. .\*\. *. *#
#\*\.. ***..*. \.\.*..\ . *.    *... **.*  .\ **\   * *.. .\..*\. ..**..*.. *  \. *.   .*\*. *  .. *\**  ..*** \.. *.**\. ..\ * *. ..*..*\. * ... *.#
# *.. ...*\**.   . *.     \  *. .* .**..*\.. .**..  *.*.*\ *.*\\**   *. \*\*   .  ..  \..** .\*\   ...*\... . .\  *. .**.*.\.\ .*.  ** ***.\.  ****.#
#  .\.** * \*** \* *\.\.\.  *.*.*.\...**\ * \ . .   *.  \*. *. .... .** .\.. . ** .* .  \..** ..* .  ....*     **..   \ .  .\..**\...*..\.*\.. .*...#
#.*   \  . .* .    . *.    ..*..**** \.  .*.. *\  *\..  ..*..*..*** *..\.****\..\* .*\ *...**\** **\.   .....  .\..*.\..*.\   .. ..... \.*\*  . *\.\#
# * ... \ .*. \\\ * .. * .  \..\.*\.* . *.. *\..\*..**\.*. \..\ .\.... . .* \ * *. \ . **. \  .\**.. . **..**     ***...* .. .. .*.* .. * \..\.* ** #
# . \.*.*.*. \  \.\ .\\* . ..\* .\*...\*.**..*.\ ...\.\.**.*.*.. *.   *.   * .... * .*\.**\... \*.**.\*.**..\**. ....   . \  ....*\.\*\.*. .*  . **.#
# . . ....  . ...\.   .* .**\*. \ *.\\ \.*.\*\\   \ *  **.**.. *\..*. .. . *. \ .\\ ** ..\ * **.\ .. ..... \ ..\.\ .*\....*.*.   * * *.\ *..*\. ***.#
#.. .\* ..\. * * .* \* *..... .****. .. .*.*..\.. . **\.* ..*. .* \. \  ** ..* .. . \.\.. .\ .\.*** ....  . . \\ ..*..   ...\\.\*. \ \*.. \*..*.\.**#
#.. .*\ \..\.  ...\ *....\. *. ..**\ .\***\* \ . .\ .\ .*\\*..\ \..*.\..** .*..\*.  .* ** .. *\ ... \* .*  *...*\  **  *    .*. \.. . *. ..***\*.* .#
# #. * *** .  ..*\..\..\ *.\..*\  \ ***..\...* *.* **   *  .*.. . *.\ \.....   ...  * .*.. *\. *\ .  *  . . *.\**\...\.* ...*...*\\ *. .**** *..  . #
# \ \....  ..  *.*\ . .... * *.*  . *... .\.\ .**\ **    \..**\. .. .*  .\ . *. \.\**. . ..\*.*. *..\..  \* ..... .\  ..* *\\*.**\. . *.\..** *****\#
#*\*.* \  *..**..*. .*..  *. . . \  \.*\   *   . .***.  *.*.*\  .* \*. ***.  ..  . ..\**. .*.\. \**  .*. .*.... *. . . .\.....**\.\.*.. ....  .\..\ #
#*..***..*\* *.  .** ..\ * *\* .  . ....*.****..  . * *..*. .   *.. ..\.\..  *.. .  \..*. *.. .  *.  ..*..*. . .\*. .\ *\**  \.**\      ...  **. .  #
#*....*\ ...\..**.*.* \...\*..  .\.   \ ..\\. \ ..  *\...  \.* \**\  .**.*.\*.*..*.*.*.. .* ..*. *\\....*.*\  ......  \...\.  .****...   .*  .. . .*#
#.  *...*.\* \...*\.*.. *\*. *.  .. *. \.\ .  . .\ * ....*.  .. * * *\*... *\. . \..   .. ....*  . \  .**   .\*.**\\ ..*.*.** ..\.*....* . ... .  ..#
#\.*\*.\*. .\   .. .\.. ..\  .*... ** \*\...... \ .\*\ ..*..   \.\. \..   *  ...**\ *.. ..* \   . . \..*. ..*.. *.*.*...\ *...\.**\*.\.. ****. .*.*.#
#** ....** .*.**.\. .\.  **...\..*\..\*\.. .\ *\.. .\ * \.\.***..**.* *  ... \\..\*..**. \.\ * * .\.. .*.* \. . * \ .\\.*.\ \.*.** .  . *.\\**...*. #
#..  . ..*\**....\*\... *..**\*.....**.*.\.** . *.\*. \ .\.\..*  .\ * . *\.  \ . *..* ..*...   \ * .\*.\\*. ..*\*.. ..*. *. .*.*..\. *   ..*.*  ..  #
#.\ . ** ...\    *..* ..\ \.\ \ \ .*.*...*\ \ . ..*\ \.. .*. \.\ .*\    \. .  \..    *....\...*.\\\** ** *** * .**. .*.**.*....\ *  \ . . * .. . \ .#
#\    ..  .* *\.  . .*    \. *  *  . *..*..\.\* * .* .   *.  \.* .. ..\\.  ...* \.\*..*  * * .*..*..*\.*\. ..\.***. *...* . .\  \*\ *\ *.*.**\**... #
#..*.*.  .\..**   *..*..\ . ...\* ... .***.*\..\. *. *  *** ...   .\..* *.** ...\..*\*.\ *\. .*...*\*  \.*. .  .... .\ .. .* ... . .  ***.*.* .. * .#
#\........   ..***.  ..*.* .*\.\.\***\ **.*.. .*.*\.... ....\ * .\*...... .  .* . *. ..  *\ \**.*..*... .*. .\.\. ..*.\.*.*\. *  *\ *.  .\.*..  **  #
#.\ ....  **. ..\** * .* .  . .. .**\  .... *. \*.. \.  .*...\.   . *\ . .\ * *\*.**.\* *.....  *\....  *\. * *   \\.** * ..*.* *.*\ .\*.\ ..* *. .*#
#...\ *. ....\\ *..   ..  .    ...*. .  .. .\* *.\ . .*. .* ..\*.* ..       .**.* **\ . \.  **\*..*\  * *.* * . .*.. .*.*\. \.... *.\ . . \*\  . *\*#
#.\ * .*\*  .\  ...*..\.    ....  ..\*.. \.**\\*.\*\. .\*. * * . \...*. ..  *.*.**.\  . .\ \.* . \\*... .....* ...**..*..*.   . . .*  \  ** * . **  #
#\...  *.** **.  \..\*. *\.. ..* **\*. .**...*..* ..\ ..\... .  *.\ . .\.   ..* .*.. *.  **. .* *.\*. .\ .*\.*...**\.\.**...\ * \  ..*..*. \. *\ \ \#
# . ....\  .**\ ..   .* *.  . ..    ..... *.*  ..\  *..  \ . * .\**  *.\ ... ** .***..**..*\* * *..  .\  \\.  *\....*..*..*.**. .   .* * \.\* . *.*.#
# .  .*\*****. *\ .  .* *** . *...*. .**\ .*...   .* .. * *\..\  .\.*.\.*.  *** .*. ***. \. . . .. .... \.\.* \.*\*..\.*. . ..***\.**. *\.\* \..\.. #
#\.. .*\   **.. * . ..*  .**. ..*\ * \. *.\*****.  *\ *.*.  \\ *\... \*\..**.\.\ ** \...\  . *\. . * ..\...\*\ ** .  \.\ *. ..\** ..*.*\   ....**  *#
#**\..*..  *\ ..* . * *  *\..*\.\. ...*.........  * . .  ... \.* . *\ . \ .\*   *\ *.*.\*.. .\.*.*\.  .\ **..*..**  ..  ......\..  .. * *\.  \ .**. #
#*\.. .** .** \ . ...\..\**..*.* **.. ..  \\. * \ **.*.\ \....\ *\*\*. ..\.**\*...*.*  *\. .\* \.\. ...\ \. *..  ** .* *.\. . *.*.*\ ..\.*\.*....* *#
#... *\ .**.\..*.\**...* *   *\. **.* *  **.\... ..* * . \.*.\ **...*.....\.. . *  *.\ *...\.*.... *  ..*   ..\* ..  . *.....*. * . . . .\....* *...#
# ..  * ...  ..* ..\ . \.\ * .  ...\....  ....\*\**.*\ ** .... \.*\ *\.   .\\.  **..\*\. *\ **. * \***\*..\*.. .\.\..  ..**. *.*..\    .\*.**\.*..* #
#.\.\*\ \.*. \*\ \. . *. *.*.*\ .  *  \.\* .\ .  .*..*\.  *. * ..***. * ... *\ \*.\* ..\*.\..*...  *...* ....*.\ *.. ..* .*. .***  .. *. ..\.  ... .#
# *..*   *\. .* ...* .\ *. *....* .\  .*.\  \*  .*\..\  *\\.** .\**\ . . * \* .**  ** ..**. \.\* \ ......*\.**... .. ....* .\ .... \ .... **.. .****#
#\ *...\..*. .  \ *\  *.* .\  .....\. * **\\.*... \* *\.. * ..* .*. ..\. . .\*\*.*..  ..*..*.  ...   .\. ...\.*   ....\ *.\..\ \*\   *.\\.**. * \..*#
#  .*  .*... . \. ** * *. \.*. \ *\ ..  ..*. *..   ..\**.  * ..* .\\*\. .* ... ..*.***.  .\  *\*\ ***....  \**....*\ . . ....    ** * **  .* ***. .*#
#*.\.   *. ...  . *. ... . .\.**.\*  *.. .*\.* *\***.*.*\..* .\*\ *\ .*\ \ .**.*.. ...**\.* \*.\**.*...\ .. **..  * .*.***\**. \.\. ....   *. \* ..*#
#*. *** .*\\...*.**.**\*. .\ .*****..*.  .** . ....\***\.\.*\.*.*... *\*...\.*.  *..  ..*\....\.  *.....\* *\..\ *.....  *  \  \..*. .*\ .*..\..*. *#
#\.*\.\*....  .\. ** ..*. \ . \*\..\*. \. .\.**.. .  *.. .  .* ...  \..*\.*.. ..\.***.. . .\*.  .... ..* .*.  \  .. *   ..  .** * .  .***. .\  **** #
#. ..\   *... \  .\.** ..*  .**  *... . . \* \.   . ..*\**.***\ *. ..* .***     .*...*.** .* .\.\.  .  * ...*. .    . \.** .\ .   * ..*\*..  .*.*\. #
#... \.  \ .\ .\*.**.\ . . *..  .\.*.  **  *****\  . . .. *.*..*.  .  **.***..*...*.**  * \.. .*. ** . .\.\\.* . .\. ..\**.\*    \ \**\  .. .** *. *#
#*. *..\*.. \  .....*.     **  .*.*\. ..... ..\*. \ * . \...*...\ .. *..*** \.*\ ... ** .\.  * .* ..  . ...\.*     ..\.***.*.  \*   *.. \..*\.*..* \#
#....*  ......\  *.\**.*. ...\.*\*** . ..\**  ....  .\. *** .\ \***. **. .. .* *   **. *. . .* *\. ..*. .\ \**. .... \**\* .*...\**...*...*.. ...\. #
#  * *\** ..*..  *  ..*.. \. .****.\ .***...*..\.. \*.\**.\ .*. *\*. .\ \***.** *. ... \.* *.* *\.  *. .  *\ **  * \  ....  ....\... ... .**.. *   .#
# .***.*.*.....\*..  ..*.*.  *..*. .  .*.\.   *****\. ...  \ .....**\ . ..\ ... .\. \  .*.....*\.*.*.*.. . .**.  .\.*. ..*.   \  *.\*.*  ..\*\ .  .*#
# .. .* .. \* *.*\ .\ .. \.*\....     **  *\ *\ .\ .* \.\. .\ .\. .**.  .. . .\  .*.... **\.\\.. . . \*\..* . .. **.*  \... \\ \ * .\*\*.  .*..    *#
#\\. .*. .\...\. ..\.**.\**.**.\  ***... .*..**\*  .*** . **.\... **. *\ . *\ .**..  .. ....** .*\. *  ....*. . \\.    ...... .. .* .**.*.*..\* \ ..#
#.. ....*   \*.* ..* *  ... .\ *.. .\*\  .*.***... \..* .*.*.*....*.\.*.*\.*..  ..* \  .\ \*.  *.  ..\. \.*..*. .   **\ \..*\ *.**.. **.... \ \ .. *#
#\. *.\.*.\*.. .\....*.\*.*. *.\. *..* . ..* ... *..*\.\ *.**..\  .. . *** ..*.**.. \. .* *.   \ \ .  .\\  *****\***.** * *. * ..\.*    . *. *.. . .#
#  .** .*  .   \. * \.... ...\.*\ ...\\\ \.. .*.    *.*.\*.\.*\ .  *.  .\  .*....\   \. ... \\. * .* \ ...  * .** ..***. **\...\* .*\ \ .*\..\\ * ..#
#\  .*\\* *\*.* .*\\**\ \.*...\.\ ** *  *.\. ..\ *.\* *..\.*..*\  *..*. *.*.   .  *....  .*.. \.. ... *\ .**. \ . .**\. ...  \*.*.*..\. \*.  ..*..  #
# .\*..** .\.*. ..**.. *.*..  \ ...  .*\  *\*\     .. *\...\*.. \ .*\...\\..*\.\ ....\...    .*.. *  *. *\*.** **.. *  .\ .. ..\..*\*\.\***  \ .*.. #
# ..****\.  .\\.  *** ..*..* \ . \* . \.  . *\**  *     *\. .\*  \*..*\ .* *\ .*.* *\ .      *\*.*.* .  \ ****.*. .\ .\  . .\.*** . .*.*.** *.. *\..#
# **\  .....* ...* .. . .**.*.....*   ...* .* .\*.**  .....*  *\....\...**.*  ..*.\.... ..\* ..*.*.\ *. \ .**. .. \* ..\.* \\ **. . **\.* . \  ..***#
# .***.\ \  . .  *** \ . \*. \.*  .\    .. .. . ..   .*. \ .*.\.*. \  ..*.*.  **.. *..\..\ .. *.****\\ ... . *  .  \.. .**\...*\  .. .* .  \ ....\ *#
#*....\.. *. ..**.  . . \ \...*. .  **  ..* *\ *\. * .** .*.. .**.* .\\\. ..  *\ \  \. *.*\ *.\.. ..*\*..\  ..\.... \ .... .\.. .   ***\ \...   ***.#
# .\.\ * .*. ...*\.*.\.*\ . .\..    \.\**..\***.*...\.\.   **.**.**.* ***. . .*   . .*.*.**.\...\   .**** . \*.\*.\\ *\ \     *\ *. .\* * *. .. \.**#
#..  **.*\ * . \ . *.* ...***..   .  *.. * . . ...  * * *. *.* ...* ..***..*\.*   * \* .*.. . . *.*..* .\ .... *..  *.    ... *.  \..*.*  .  .... ..#
#\*.* * ..*\.**.* ****  ... *. **  . . \**.\ *. .\  \.    . *. .. \  ..*.\ ..\. * .  .\ .\ \.* ....   .\. .*. *. ..*.... \. .. ..\. .. *. *..\.*.*..#
#*.  ..\ .*..*.\.*  *  *...\.* .....\ .. ..*.\\.\   .*\..** \ .*.\     *\ .* \* *.*  \* **....  * ..\ *.. .. \ ..*. \ \..\   .* *. . ....*..  *  .\.#
#*.* \* .**  .\.*...*\ .\  \ \  *.   ..\*. \..\\*. *..*.\*. .\*.\....*.\* ....*.*\*\. . .  \ \ *\* \.\**\ **..** .*\.   . .*\   ...  \**.\... .\* * #
#*\.\ * ..... * * ....\\  ... **..\  .\**.\. **.\*. ..* .... *.   .  .\*.  . \.***** ..*\  .*  \..*..* **..* ... **  \ \.* . *..*.  ** ...\*.\\.\.\.#
#.\ *.* . ..* .*.*.. .*\. *. \**  ..  *.\ ..... *. .  .  .*  .** .\\* ..\. * .*...*\ *\... **   . \. .\.  ...\ \ .* . *..   \.*. ..\*..\. .\.* .   .#
#.. .  \ \. ..\..*\*\..*. .*.  . \.\... .**.\. ...\*\ *.. . . .*   ...\. * .*..*.*.*..*..* ...*  \\.\.. *.* ..\.. . **..   * \. .   .. . .  .\..\ * #
#\. . ......\ **\\...**. * .** *\. . *   \....**.* . .*\ .    \\ *.. .. ..\\..  .\** ..\ ....\ \ .. . .***.\*.\  \\.*..\ * * . .*.. .   . . ....  .\#
#**. **.    **\.  *. **\ \\ .*...\ *..... ... . \* \. *.** .   . **...** ****\...*. ...*  .* . ..*. \  .**\..  .\.. *.......\.. \*.\  .\  ..\ .  *.*#
#*..*  *... ..*.*.  **. *. ..*\* *... **\*\. \  ***. ..\. . *  * ...  * .**.*\..*.....\.\. \*..*  .. \**..*   \    ..*  .   * * \*  ***. .    .\**..#
#.  *\\.*    .*.**.*..***** *...  . .\*.***. .\.\.. .\..    *. ..\. .*\* * ..****.\.\... .\*.* ....\   . *\  ..   . .. \\.* \ *. *\.*..   .. \...\.*#
#..**. .      . . .\. .\..*\ . . . * *. *..*\ ..***. .**\.*.*\  ..\.*.*.\.\\ \. .  .*.   . . \ .*   **   \.*\* .  .*.*. \ *\ *. *.....**.. **  ..**.#
# \**..*\ ***.\  .\**\ *    . . . \. . .*. .*.*... \.*..**... . *.\ * ...... *.*\.  **\..** ... *..*..*.*.\.  \.*.  .*\*. . ** \** \ .   .**.  *\\.*#
# .\.. .. .*.* \  ...* .* \ \.\. ...*  .*.... ** . .*. *\.\ . *.\ . .*\..\.  .*\* .*.   .. \.*  **.\  *.*..**   .  . ..**\\.\ ..   ...*** \*\\\ *  .#
#   * . .  .\... . ..* *.\ .. . . . . *  **\ *.\ .\ ... .*\.*.*.  .. .*.\.  . ..*......  ..*.\....  .\.*..*.**  .\..\  .\ *..\.*..* *.   *..\.*..\.*#
#\ \*\..  **.  ... *.*.   . *..\ \..* .. ** . .. ..\.. **.. .\. ..**.  .*.* *.\*  . . ...**\  . \ ** ..\. .*.*. *..*...\ *.. ... .. \   .. .   *. ..#
# ..... . . \ *.\.* .*.  * *..\*\ \*.\.\*..*....  \.\* .**...*.. ....\ \.\* *.. .   \*  .**.... . \.**\\ \  ...\\. .* .*   *. ...   .* \... .\ . .\.#
#. \.*  . .. \...*.* ...*.  . *\*..*\.  .\..*.\*\ . . **.*. .***  * ...*. *.\.   \*  *.\  ...*.\.   ** *\  .* ..\. ..  *.* .*..\ \*\.. .*\*. ***.  .#
#\*. \ .*. .....**\*\    *.** .**. * .....*  \ ..... .*. .\  ....\\. *.**\*...\.. ***  **.\** ...* . * .* ** .\... \*. .**  .** ..* * *.* * .\. *   #
#*.\.*\ .  . .  ... *   .  .* .*...\..\  .. .*.\ *..* *. *.. ..  *..*.* ....*.....*\..*\.\.\*.  . * *..\ .*\  * .\* .. *.* ....   . \ ...**..*..***.#
# *\..\ . . *..*\ .*\*\.\**.\.*  .\.* .*.   *.. .*..*\..* ..\..*\.. .\.**  .*\* ..*\***. .*.*.*** *..   ...  . *...\ .*..*. ... . . .   *.\*.\.\*.*.#
#.*. ..  \ *..\* ...*.* *.  *.  .   .* .  *.\*.*.  \*** *.*\**\..*  .***\ ..\*.. *.. ...***\.\**....*. . *. . .. *.. * .* *....\  *\*.*\.\.. **.* * #
#\.    .   ..\ . .  .** .   \*\*    \**..*.**..**.\*....  \ .\.... ..\* . . ..* ..\.\\.*..\  ..... \.* .\.* * \. .\* ..***. \\*.  * . .**..*.*..* ..#
#*.\  \ . .**.\  \.. ....\ ....  *\*..  **\. . .\.  * ..\..\. ..\..*\ .\. *  ... .*\ \ ..*.\.*\..... **  \*... *\ .....*.**.\...\   **..** \ .. ...*#
#.  .. **...**  *. \* * \. .**\*..... .*..*\.  \..... .*.*. \ *. ...*\ .\\.\ ..*.*   ***.*.  * \.*\ ...\.**..* ..    *. **.. .*.* .\..\...\.**..  ..#
# ** . *.    \** .... .. . *\.*\.   *  . *\  * .*\.   . ** ..*.. \**. *...*.    . ..\...\ *.*\. ..   ...* .\.\   .  ... *.* \.\\..  *.*.\\..*.  * \.#
#  .. **.  \ .*.. .** *.. *..\....* .  . \*. \  .  *\ **.*  .*..\.*...\ *.\  *\.*\*\.* .  \*.. \.* ***... \. *.*\ .\.\  . * \.*..\\.* ..*  *.  **.**#
#\ \ *\*.\*.*  * .*.\. ..**\  *..*\ *.*** \.    ..*.  ...\.* .. . \*. .*.  ..**..\.. * *\....\   .  *..\...  . *.\ .** .\** ..*  .. *...  **.. ... .#
#***.\.*..... .*  .*\..\* *..\* .\**.\\. .... .. .*  *.\*.   *\  .*. \*  *.   \... ... *  * \ \*. . .\*.*. *\.\. \  ..\ *...**. *.\*.* \  *\   *. * #
#.\..*...\.\.. . \ *. *. ..*.*.\ *..   *.*  . .*.* ...\  * .. .  * .... .\.*.....** \ ..*....  .*  \* .  **..*. *.\.\ **** *...*.. ..\ .. .  . .  * #
#* .\.\*.\. . \... *  *... ..\....\ .**. ... \*.*.   *\. \*\ \. . ...*. \...\* **.  .*  .*.*\ .*\ * * ...*.  . **.* .*...\\..**  ..\*\. . *\ *\\ *. #
#** . ..\. . *  .*   ..*.\ **.\\... *..*..\  *. .\.. *  \.* * . *\.  *.\*\ . ..*.\ * *\ ** .   .* . *.\...\...  ...  ***.. *...* \ .*... .** .   .. #
#..\  .\*\*. .  .*\.  .. ...\   *. *.* \. .*.\ * .*  \  .\*... . *.  *  .\ * \*\. ** ..*.. .\ .\. . .\*\*\.\\ .\. .\**\.*.*  .** .*..**.. \ ..\ * \.#
#*\* *  *..      *.* \. .  ...\ .**.**.. \ .. .. \ *    **.\. . \.. .\ ..* \.  . \...  ** .*. .\ .** .\*** .       .*\.. \**  .\..*\ *. * .\. .\. . #
#**. .\..* *\.. ... * ***    * ***.\ *. *.  .****...\ \ * \ .  . .*.  *  .* *.. .* .   \ . *.. \.. *.  ..*.  ..* * .* * . *. * * .*.  *\.. .   .  .*#
#.** \ . \ *.*..*.. . *.*\. .\..* *. .*\.. ....\.  \*   . . * .*  ..  * \.*\. *\* ** *..  \\.* .**\.\.\...\ .. .\. \** ..*. * \***.\. *.  \ \... \  #
# \\ ..* . .**\* \.  ..*. \... * \\...*\.\** .*   \.* . *..\.* .\ \. *. ...  .\*\... ..   .. ..\..* * ..\ . \. *.**. .\.\* .. *...\ *. \*.\ . **..  #
#**. . \..\ .*. \  ...**... \**\ . . \*...*\ .\.***.* *.  .  . ..  . ..  * *.\   ***\..\..*\. . .R. .*. * .*\.\. .\..\ ... ..    \* **\*.  . \..*.  #
##\*..*..* *\\*....  . ..*\ *..*\.*\*.*.*\* ****.**.**.\  * .. \  * \.\  .\.*.*..\ **. .  .* ....*.**.\......* *.*.. ** . .*..\.* .......\.  . *. . #
#*..\..    . . **\.   . ...\.\..  ..\.* ... .\*...*\... . .\*.  *..**\  \ . ..\... .\   *\ .    \.*...*. \...*... * ..   *  *.*\**   *\  .\\ . . ** #
#* * . . .**.***.*\*  ** * *\.\   . * *.   .... * .*** *. .\.**.*\*.*.*. **\*  *.\.\ .  .**.. . .*..*\.. .\  *..*. .. * **\*. ... . ***   *.. *  ..\#
#\.. . . *.**..*\. \. .*\. . ..* *  .    ***. \\  ** .*\.*.. *. .****\.*..\*.  * **.**. .\. * *\ . ...*  ...\. ** \*\...... . ..\ .*.** * .\ \*\* \*#
#     \  ..*\. ..  . ** *.*\  *  *\  . . *.*.*.\ .. . *.\.  \.\.*...\\  .* *. .*    **\ *  *. .*. .* \..  .   ...\.*  . \. ..*    \*\. .** ...\..  *#
#\ *...* ...**. .. . .  .\   ***\. ..\ *\ ...**.  *\.....  \* ..  .. *. *.\.\.   *\ .... .*. . .*.**\.\.*. ... \\ *..* ..\ ..**\ * .\....  ** *\.. *#
#\ .\  *..* *\ . . *.... .* . .  * .*.*.\*. *.\\ .*. * *\  ...... . ***.*..* . ... *\   \*.... *\ . .*  .*.\  *.*.\.\.\***.  .. .. *. .\*.  . \.*.*.#
#*. *   .* \.. *. ..... . ..\..\.... *\***\ .\...*.\ . .*\*\.\..\ *.**. *\ .*\  .\**...\... .. * ***..*. **.*\ *\*. . .\.*\ \  *...\*. * .*.. .    .#
#*\.     \\ *\  .*\ ....*.\.**  .\\* \...\* .* . .*.**..\..\ ..  . . .. ...\..  **\.  . .  \  .\.* *....** *\  * **  \ .. .\ .\**\\ .     **. *.\* *#
## \... *.. .*. **   \\** ...\*\ ***  \.  .  .. . \ .\.\.* . .\ \*.\ *\...\\...**.*.  *..\*.\..\..\....\..*. ***.    * .\***.. *.. .\.* * .\* .. .\.#
#.. *. ..*.\ .*..  .\.\....\ .\*...\. . * \.* *.\..  ..*\\ \ * \.*\ *\**  *. . ..*\*\*** ..***.*. *  *  *\*.. ...\   .\  ..*\  *\  . .*...   . ..*.\#
#* . **  . .\.\ .        .\.*** .*\** *.. * \. *   \..    .. \..*.**. ... . \***.... .*  . *.*. .\   \.\*..* \.  . .   *.  *\ *\.*    .\.. .\* **..*#
## *#..\***. \.\ *...**  *. ..\ *.\.*\.* . *.* .*.... . **.**.*.*..*..\   .\.**..\ \  . * .\..* ..\  . .\.*...\ \*.  *\**... **. .** . *\*.**\ ..\..#
#..\# * ..\  .\.*..*..*  *\.*\* \ *.*.\**\ * . ..*.    *  .\\** * ..***\*\.* ..\*. *.  .\.\. \* * .\...*.\  .**...*. . **\      .*.\...*.*\.* \ .. \#
#\ ..**.. .    .\    *   . * .. .**\... ....   *.. *\*.*.* *.\...\ *.\... *. * ... \.**..   ... \\     *  \. ...  .. ****  ..*\ ..*.*.*.\..*. .\*\. #
#. **.\*..***  *  .\*.\ . .   *  .\*** .   *  \.  ** *.*\. ...... .\. \.*\.. .\. .  .\.*  *.... .\*\**.*  ..  .***\..\*\* ...\ .**.*\.  .* .. ..** .#
#.**.**. . \  *\. . . * *..\...\.*...*.  *\** .\..*... . \*. .*..\*.\.**. \.. *\. *** .\ * .\*   ***.* . . .   \\ .\. .*.***\.. *.*.   \ ..  .  \. .#
#\..\*.*** .. .\* *.  *.*.\*.*\**.  .\.  **..\ ..\*\  .*. .. .*   \.* ...*.  .. ...* .**.* ** .** .*... .\  * .  * ..*  *....* .  ..*.*..\ .\  . . \#
# *..*..*  .*\ *. .. .*.*. .\. ....***..*...*  *.. ..*\*.* .\ .***. .\   \... .*  *.\*\. **.\ \.* \\..  \  .. .\*..* .. .. *** .    \.** .  .\* \   #
#.. .. .\\  ... ***\\ . ..    . \. .\.*  *. .\ **.* * .**. \* ..\*.***.\*.  .    .\ .\  . * *....\..**   \  . ...  .*.   \  *\    *\*... \\ .****. .#
#..  \*.*.  .** ..\....*\  . \* ..* .  ..\ *\ **.  \\ .... ..\.*...... *..\.*\ . *\.\    \*\..*\ *. .* *..  ...\. ...*  ... *..  .*..\.\ .\\.*\* *. #
#* ...#\. **  \*\ .*.*..*\. .... **\** \\  \. *..*..  \..*.\..*.. ..*\ .  .*. *.\ ....*.\...* . ** . ...   *.*\.. *  . *.\  ..\..* \** ** .\...... *#
#..\##.  *.. *...*.\*.. .** *.  \.  ..  * *..*.  . *. .**.. .\*\ \.\.. ***  \**. ***. .* \.*. .\**  ..  **\\ **...** ... .\*.\. \. .. * .\** .*. ..*#
#  *. . ***  .*  .\ *.*.*.\..\*\ \.   ...\. .. *.\*.. .**.  ..*...*  .\...\ ...*\*.. *\\ . . *\....* *.. *.\.\.   .. *\  .  * . .. *. .* *.* **.  *.#
# * *..\... * . ... .** \...*...    \\. **\. *.*\..** \.\ . .\ *.\. \**  . *\.\.  *  *. \ \  .\* *\* . .   .\..\*. . .. ..\\..  **.*.\ . .**.\* ....#
#\ .\\ *. \ .*\.*   .*. *\.*....*   *.\ .*. .* *   .**. ..* ...*\*.. .\.. *.. *.* . \.***  .*. . ..     .. *.*  *...\ * ...* \ ... .*.* .... *.\.. *#
#..\.. \. .***..*\ * .. *.\.... *. .  . ...***.*.* \*...\.\** \..\.*   ..\.. **... ..*..****.\.* .  ** **..\..\*.\** .*\*\*.*...   \.\.\.*.  ......*#
#  .   .\*\* * ..*\  * *... .\*.\. **   .\*..\ \ .*..*.\.* .\**.   *\...* ..*. *   .* * *..**.  .\ \...\..**.  ** **.*..*.*.*** ..*.   .****. .*\ .\#
# *..... .#*##.. .\ .**\ ***.   .  ...*   . *.. * .... . \. .*.\..* \.**.   *\.\\ .\**. .  .  \.   * .\ *   .. .. .**. *.*\..\* \\. . .* *\   .\ .*.#
#*### *.. ## ...\*.*.   *... *\  \   ...    **. .\ *\ *.*..* .\.*\... \.    **.. .*..*. . *\ \.  . *.**\     *. *\.. \.. .*.\. *\.  \ **.\.\ .\.  . #
##  #.\###  # \* .*.*..\** . ...   ...\.* .. . ..* ***... .  .\..*\*  . .....****   \ *..*.**.. .*\.. ***\.*..\....\.. ..\...*\\.\.* \*\*.*\  .**...#
#    ##      #..\*.  \.*..\*\\ ..\  .\.*.  * ..**..**..*.. ....****.** .*   .*\..\ *.   **.... .\* \  ..* *  **** ... *.  **...*\.\*..*\*.\.*. ..*\*#
#            #\\... * .*.*.**  .\ * . **  **\ .*..*. *.**\..*\.*. *. .   ..* .. .  ..*.* *..*. *\ * .* ..\..*.\.. * .\.* ***\  .*  * \.*** * *. ..**#
#            #..#.* *\..*  \. \..*.* .*..\..*  . *.. *\.*. .. *** .* ..\\ *\.*.\ .*. *\.  . . *.*..* *..   .....\..*\.** .. .*. .. .   **..*\*. **..#
#             ##.\*.\.* ..**.\*  ...  \.***\...  \* .\ ..*  .*.\*.*..  ..*\.*. *..*\*.. \ *. \\..*\.**  .. *\  *..*.. * * .. \.*.. .  .*.  ...*.**.*#
#              #.... ***\. .\ \ \..*.*. . \  .\ \. .  .*.*.   ..... . **  * ...*\ . .\* .*.*\...*..*.**.\ *  ..  .* \ *** \**  .* . \*.**  \ \ .\.\.#
#             #\*#\. \.*.. .... *.\..**\. ..  \* * ..\ ....*   .. *\ ...\\*.\*\*  \\ ...*\. \..*\...**\ .***\*   *.*  .*.\ ... *.\..**..** \ \  ..**#
#             ###*.*.**. *.\. *\.  *\*..** ..\....   ..*.*.  * . .*\\ .\.\.\*...   *. . ..* ..*.* .\*.** ..* *\. **.\***\  *. ....  .. * ....*\. **.#
#            #*\*.#..*.\.*\ **\   .. .*...  ..*\. .  .*. .\.\ .**   \.* \ . .. *.\\*\.\*. ..\ . *...*** * *..\.\..*.*.\...** \\   ...\*.. .\ . *.\*.#
#             ##.#*\.* \ .* ..    * .\ ** ..  **  . * *  .*.* *...\*..* \.**. \. .   *.*.* \.* *  .\** .. .. **.\.. .  .. .\ .. \..\.*....\.. ..\*..#
#              #*###.# .    *. .***   ...\.* **\.*\ ... \ .\. \.. .\.*.  **.\*.. **..\ * ..*.**.\. ... ..*.\ .* .\. . . *\    ....\*.*.. **. . \ *. #
#               #   # #* .**. .\.... . .. *\** *...*.* .... .  .*.* ...*.*** \  .\..\..\*   .   ....* . .\\  **  ..*.. *\*.*.   **..\...  ..**.. **.#
#                   ##***..**.\.\..*. ****. *.\.\ .. * .  .  *. .**.\  . ..*  \\  . ..*.  .*.\.. * .. .*  .. ..... . \  *..*..\ .. ...\*.\  .*.  .  #
#                  #\ *\. ... *\ * . ...*\*\. * *\.\.*.*.\  .\.*.\    \  \.\ *.** * ..\.** *... .\ .*. . .*..**. *** .*\**\ ** .\*\  * .*. * *\  \.*#
#                 ###.**.\* #..* ..*.\...*.*.....  ...*.*.***  . *\.*\.*\.\.\\*....* .. .*.*.\*** * * *..\.*   ...*. . .... ...* . .. *..*\. **    .#
#                #.. .#*.*.**\*#  ***.\.*.\* .. .* .. \.  \ *\.\.. \  .*. .***\* \.....* ..*.. *\ *.  .. .** *\ \*.\   ..*  *..\  .... * ..* ..  ** #
#                 ###.#.\# ..\..\ *.. .*\*.* . \..\* \  . ... *.*.\*** \ *..*\. \. .*\ * . \* *..\..\ ..**.  .* .\. .  ..*   .. \..   ..*\. ..\\.   #
#                   #.#### \    . .  *. *\.\  .. *   .\. .. *** . ...*.\.....* .. .*.* .   ..\  *.* .* *** *. . * *.. . *.*.**\ .\  \ * \.\  .....**#
#                   #*#   #### .*\ **..\*. *\....*  *  .*\. *.\. \*.*.  ***..\. ..* .\* * * \. .  . . *.\.*. *\ *.*.\.\ ..*.*.*.  *..\*** *\*\*.\**.#
#                    #    ## #**\*\.\.  ...\... *.**  .*. .\.* *\*.\**.  *\  .*\.**\ *  .\*...  *. \.\* .... \.*\\*****........  *\..*. . ... ..**  #
#                        #\ ##\.  . . \   .  .. *\**\. .\\.*\..\.. ** . .. \* . *..    * \.* \  **. *.\.***\* \* ...\***** .\..\.**.*..  .* *.*\.. .#
#                         #**   **\.  ..*.* . . ..*..\*. . .\**..**.. \ . *..\  ..\  .*.  *. .* *...*\..****  . \*.. ...\\ ** ***..  ..*  *\*..\.*.*#
#                          #. .#..*.  \ . *.   *  ...** .   *\.* ...\**...\ **  *\.\  ....    .*\.  \..  .*\  . ..*. ... **.. **.* *.\.*\. ** .*...\#
#                         #\*\.# ### ..*. # ....*.*. ...*  .... .*\*. *.\*. \. **\  **.  *.\ .*.  *. ..  *...    *.. .*..*. . .\*.\* ..  ... . .* * #
#                        #..*...#   #\ #\ #\.*  **. .\ \ .   .  .* .\.*..\*\* *..   ... ..*   *.**....  . * * . .*.* \\* .*.. . *. \***\ *.. .* .\ *#
#                         #.#*#*\#   ## #*# .#*.# *.*...*\.   . .\.. \ .**. . ..*\. \.*. **\ .*..\.* \*\*. .. *.*...**.\..   * ...*. \  *. .. .\..*.#
#                          # # ##        #.\ ##..#  #.... *.*\.\.*. \* ..\..*\..*.\ . .#\..* .*.*  ...**..*   * *.**\*.    .   * .... ..\.\*. . .** #
#                                        #\## #**#*.*#.\ .  ... \* . .. ..  . * .  \.* ..\ ** .*\**.*...  .\ .. * *\....* * **.  . * . .*  .\. .\ . #
#                                         #    ## #####....\ .. ** *.   .**.* .  \*  .\ * .* .*.. . ..\* . ..* \..** *  *..*\.  *\\*   *    .\*. .* #
#                                                   #. ** .*\ .. ... *\.\.... \.*.. ##**   .\...\. \* *..  ... .   \ . \......**....*\*** .. .\ * .\#
#                                                    #*.. #* \#.\. \*. *  ....#..\#.#\.# . .*.. * *..\**.*\.\*    * ..\.  **\     *.\.**   *.\.\. .*#
#                                                   #.  . .*..  .....\*  *#* *.* \  #  .*\ *#.\.  . *.\.\. *.\*\ .. . .** **.* * ...**.\** .\...*.* #
#                                                    #..*   *\..\**\.# * .###\##.#..\#  *  \ .#\.\  \ * *\ .\*\.\*.. *\*. #.**.**...##  ..\ .\   *.\#
#                                                     # * #.### # . * #.\*.*.#  # ## # *   ..* #.#* .\* \..\.*** .* .. *.\#*.. #.***.#\*##...*  \ .##
#                                                    #. .# #   ##\# \\#..**##       # # *..#***\.*.. .  .#*..\#*# .\*. * \*.#.*\ \*.\### #*# \ .### #
#                                                     #  #       # *## #  \. #         ### \#. .#** #*L.*##**. \\.*  . #\## ##.  #.##     # #.*.\#  #
#                                                     #.#         ##    ##.##           #*.##\* #*#\ \.*# #**.\.  .** **. #.# #.##.#         #.*.#  #
#                                                      #                  #              #.##.## #\.*#.#   #**# ..  * .#. # #  ##. .#         ## #  #
#                                                                                         #  #    #*.#.#    ###\###*.* #\*##     ##.#          #*#  #
#                                                                                                 #*\*#        # #.*.*...#         #            #   #
#                                                                                                  ###            ##\*#.#                           #
#                                                                                                                   ###*#                           #
#                                                                                                                     #*#                           #
#####################################################################################################################################################