######################################################################################################
#*\...\.** .\ .  \\ *\**\. . \*\*..\. * *.... .*\. *..*.. **...... *..*\*.  \. ..   *.* .*\* ..#     #
#..  ..\*\.\.* *\...  ..  .. .* * ..*....\*.   .  *\...**\.*..\ *\*.*\ *... .\*\* ** ....\..**.#######
# *. ..**. .  .**..* .\ .  .. . .  .*..** ..  \\\. . . .*.\ .. .\ ...**.\*\. .**.\.** \   *\* .. *...#
# .\*  .*\.. \ . *\.  *  **\.. *\.  ..\\. *.\ ...   \ \ .\* . *.*.  .\*\.\.* \ . ..*\*. **... \..#####
#...* . **\.* .  ..\***. .   * .* ..     *.*. *\**   \..\.. \.. *.. *..\...* . ... \\. ..*#\ *#*.. # #
#.  .*  *\*.   .  *. . . * \ *. \ .   .\** *...  *.\ . .*\*... \\*. \. * **\ \..  ..*   ..#..# ##*#  #
#    * *. \ ..\ .*  \*.. .*.*. *..*..*.\.* .*\.*. \*...\ *.\ ... .  \  .*\.. ..\ ****. *#** \##  #   #
#.  *...\. .\  *\*    ...* ...\.  *.*\. *. **.*. *\.**\  *\ ..  .   .*\.. .* .....*. \.  .#* *.#     #
#. *..**.**  .\*....*. ..\ *.*  ...*\.. .. . \..\..*. .**. . **\ .\  \.... *.* .\ ..\    .. #\.#     #
#\ ..\ *.*\  * \.* \     .*.\..  \.\.*\ *    ** ** *  .\..\*\* .  *. .    .* .*. .*.\.\.**#***#      #
#. *  ..  .. **.  *   **  \* . *   ......**...*..\*.** .\* ...**\  *\   \\**.*\* ......*...*..\#     #
# .* \ .. .\  . *..\***..**..\ ..* . .\ \...  . **.. * *.**. *....   .\ .. ..*...\\ \*.* ***...#     #
#*........\..  .*  ...*  *. ...*..*.\....\ . *  \..**\   .*. .**.\*..  .*. .*......**. ...\.***#     #
#* .**.*...*\ **. .*  .**\ .   * *\* \  ....\ ** *  ... ..\ *.*****...* . *.. \**.*... * \*.*#* ###  #
#.\ ..\..\.*...*.*\. \ *\*****\*.... \  * \  . **.** *\ .\...* ..*  .*\.\ **.\..\ .  \ .\.. *#* *\ # #
#**. \. * \.* \.*\*.\ .\.\*\*. ..    .  .*. ..*...* .  *  * *....*.\ .**..**\.\ .***...\ \  *.**.# # #
#*.\ *\ ...\. .\. .*. .*.*. ** . ..  ..  *.\*. **\.. .*\  . *.** *..\..\. .\*\. * ..\ **. ..*.##*##  #
#\.* ..\\ \  *. .**** .*.*\... \.\ .**.* *. ...\*.  .\ **\. \* .. ..  .. \.*\...\   .\*....#* *##    #
#.*.\**....  ..  ..*.  *\. \..\.  *\.**\**\ . .* \ .. * . *\..** * .*. ..**..\ .\.*.  *.*\#####      #
#** *.....\ ** . .*\.\*\**. .\.* ***\.. .** ..* ...\ ..  .   *.*.*.... .\.*.*..* .. *\*\#*  #        #
#*. * * ... * \ .*.....  ** *. \ . .**\.  \ *..   \..*  ...... ....\**. **..*\.\*.*\.***..*.#        #
#***.\.***..\   \**.\\...\* . * \...\   .  \ . **. . \.\  .\. .. \   \. \\*\. *.\..* **. \# \#       #
#..**  *.**  * \..\*.*  *.*.  .\.*.\.*..\ . ** *.. .\. . .   *.*\.*... \. ..\ *.*.. .\. ..#L.#       #
#..\***...** ...*.* \*  . *\. *. **.\.\ * . \ *  *  .\   .*.*.*...*\.* \ \* ...\.\. *# . .*.*\#      #
# ....\..\..    *..\.\.....** **\..\ \*.\.*.. *...   .**.** **\ \ .. .\.  . **. . . .*.*\***##       #
#. ... ...    . . * **\ *\\....* .\  *.\..  . ***..\ *.\*..\*.\ ...* * *\  \..\* * . ... .# *#       #
# \ *.. .*..**   *\ .*\\.    . .. *.  .*. *.  \.\  . .* .*\ ..*\.. ** \...... ..*.** .   **\.#       #
#\. ..* ..  ...* \.*. .\  *.. ..*.    *..***\\ *...... ***.  *. .*...... \ .\* ** ..  *\ #\...#      #
#..*..*  * \.**...*\\**...*\* *.\\  .*\..\ \**... .*\*.\.\.\.\** ... \ .*.....*.. .***  .*. \#       #
#.*..\\ *. ....*. .... .. *.\ *. . ***\*..*..*    **....\.*.*.   ...**.  *\. *.***..\. . # ##        #
#.. .* .... *R*\.* \  **\*. . .\.\ . . *\.\  .* \*\........** .*\\. .\ \...  ..*.* . \.*.#..##       #
#....\ .*. .* .. *\..*...  *..*      ....    .\*\*.    .  **\* * ..\ .. \.. * .**..*.  .*.# * #      #
#.*\* **.\  *.\.\  ... .*.\.*.* ..  ** . \***\.. ...* . .*\. **\**.   \. *..*\.\.* .*\  .\.\.##      #
# .   ...*\*.\    .  \ \*.  ...  *. . .... . . **\.*\.***. .**\*. .** *. .*. . . *\ .**...\ #\.#     #
#.*.\* *\* .*.   \.. .       ..\***\*\ .* ...  *\*.....*.\..*****.*.\ ....*..\   .* **. *... *#      #
#.\.*. .*. .. . *.*. .\*   . ** ..... .\** ***\..  *.   .*....\.... * .\....*  \ *.\*. \.*\ .*#      #
#****\\ ..\*.  .* . *. .*.   ...\\ . .  \\.***.*\ ...  * .   **.  \..\ . .. * * *     ..** \.#       #
#\*\.  ....* ..***..**.\.\ .\.  .\. .  ...* . *..\*.*.... . * ..\. .* * . ...***\\ .. .\*..\###      #
#.* *\* .\ **  *. \ . * \ .**.\ *. *. .*.......*  .* .**.** ..*. \.* .  .. ..***  * .  .*.*. *.#     #
#**....  .*.****  \ ..... .*.. .. ** *.\... \  . . . *\ *. \ *  ...* ..\ \ *..\ ... *.  . ##****#    #
#\.*. \**\. .\..  ..* \.*.\*..\*  ...  *.**\.   .*.*.*.* * . . ..\ .  \.*. *\ . \   ..**..#\#..#     #
#*\.**. .... .*\**..*. * ..\.  \  * .  *\... ..\* .....* .*..****.\. ..*. * **......\  . \...\ #     #
#*.*. *.* *.*** .\*.....\ .....  ... * .*   . \ *.  \.. \ .\...*\** *.\.  . *.*  ... **#...* *#      #
#\ \.. \..* ..  .  .\    *\ .*.*.. \...*\.*.*. **   . .. ...\*.. ...** * .*   ..  \.**#**\ ..#       #
#*\..  \. .\..\  .. *...*. ....*. *.\*** \..*\.*...*.\ ...*.**.. *\  \**\*\ .* .\ ...*. . ...#       #
#.\* .\...\* \.*.*.*** ..  .\  ** *. ..* ..****  .*.\.\   . ... *\. ....*.* ..  \ . ..   . ##        #
#\ .  .* *..  \.*\  *.  . .\ . .. .  * .\ *.* *....** * *  .. *.* \ \ *\*.*  .    ..*..\\.**#        #
#\   * .\.*..\.\ *\*. ***.\..*..* ..\.  ..\.* *...\.* ... \...\*.**.....*......\.   *.*\ **#         #
#*\*..\. ...  .**.\.\.\..\*.\*  . **. . *\ . *.*.* *   ..*. .*   .\.*..** \** . . *.. ....\#         #
#\ .*\. .  .*. ... *.\* \  .. .  ...*\.\.*.  ...\. . \ ..**. .   *..*. ..\...  ***..*\  \\*\#        #
#...* ..  ..\ .*. . *.**.*.*..*\\. .* ..**.  \. ..**.  .*\.\.*. .*  .\..*.*\  ***\.*.***.\#*\#       #
# * \. .. * *\ * . \. .\*. .*  ** .  .**.* **\. ***. . ...*.***  *\.. ....** \ *..** .*.*# ##        #
# *... .\**\*.**. . .*.*.*.\. *\.. ...** * *..* ....\.\ . .*.\.....\. \  . .* .. *.... .**#* #       #
#.\... .*..* .*.   .\ \. **\**. .  *.***\*..* .\ *\.. *...   *. * \**\ ** ...**\**.*   .....\*#      #
#* .    ..*.  \ . *.*..  *\  ...**\.*... .***. .*..* *..\**... ..\.\..*.. \\*.\... *.*. .\*..#       #
#* *.\..* .\\..  *. *.  .\**\.\ .*. **** *.*.*.*...* . \.* ..  \. .  .*  *.*.. *.. . *.*\####        #
#. *..\*.\ * \\*.. *\\.* ..*..*\ . . \... *.\. .\.\..  .*.* * *\ .*. ..\*. .*.*.\.*.*.* ##           #
#.*. ..  *.  .\. * * . *.  . .. **..   ...*..*. *.**     ..\.*\ . \. .  \**..\* \ *. . #*\##         #
# ** \*\***\.**  ***.\. \   \\*\..\\.\  \*\ ..* .**.* .***  ...\.   .\. .. * ***.**. \  *. \#        #
#  ***  .* ...*..\. .   .**\ .. \ . .*. .. .. *. *.\.***** *. .*.\    \ .\*.\..*. \. .*.#*##         #
#* ... . ..\ *.. .**** . .  ** .. *\\ . .*.*...    ........ \  .\*\.. ..  .\.*  . . \ ..\#           #
#.  *\.* . *.*\ .  .* .\  . .*\**.**\... .. * . *  \.\*.   . ** .* ** .\ *\  .*\  *.\* #.\#          #
#......* . .\...  . *  \    .*\..**\. *.*. . .  .* ..*.\ *\* *\ .\...  ..* \  . \... *.    # #       #
#\* *\.**.  **.*\.\ \  . \* .  **.*. . \ .\ *    .. .*  .. .\.*   *  *\  .\ *  ..*   .. *. ##\#      #
#\. . *\. *..\ .. *..*.* .*  ......   .. .*** .\ *..\.*** . .\ .. . .*.*. . \.*.*..\.*.  .*.#\ #     #
#.* *\.. ..     ..  *\**\\*.* .\ *. .  *. ...*. **\ . .*** *..\.*\*.*. *...*  *... *..\ \ *#.*#      #
#.* ..*\  .    . .  .*.*.\...*  *..  ... ..  *.*....   .. ..\..  .. **. .*   .**\ *....\ ****#       #
#\ .*\.  .\.* .\*. .**.*.. *.\   .. *.\. *.* ..\..\..  * . \ *..  .* .\  * . ....***.\\ .**.\ #      #
#*.\ ..\. .***\*\*.*.. .*\ \..  .\* .\.*.\.... .***. ... \.\ ..* *....\.....  #* . ..** . *.*#       #
#. *.*.  .\*.*. .* *..*..  \ ..\* . .  .*.. .. .\**.* *.\ ..  *.  *\  *. *\   **.\.*..**** ***#      #
#*.... ....\*... ..*  .* **  . ..\.  *\**  *\  **.. . .*   .*...**.***.. .. .*.  . .* .**..# \#      #
#*.\.*   .. *.*. \ . *.*\*. . * *.**\.*\*\..  *.*.*. .**. .*....*\..\**\*. *** *... *#*\#. ###       #
######################################################################################################