#################
# #* *#\#       #
## #.  *#       #
#.#  .#.*#      #
#** *.* .##     #
#\.*\. ...*##   #
# **  .*\*.#.L  #
# *  ..*\..#R#  #
#\\ *...*..*\.# #
#.  .\ \.\ *.#\##
#.  \... .*\* *##
#*\*\. .**. ##* #
#.*. .* \*.  ####
#..\ .# #* \*#  #
# .* .\*\###*#  #
#################