######################################################################
#                                                #*#         ###     #
#                                                #.#    #   # .\#   ##
#                                             # ##*#  ##\# #**\ #### #
#                                           ## #...# #.#.#  #.***.\* #
#                                          # #\ #.\###*. *### .#.##..#
#                         ##               #*.# # ##.##*.. .\. **.. .#
#                        # .####          #.*.#**.##\##.**..  ...\ \*#
#                       #.  #** #        #.*\*\**\ #.#  * ##..\* . #.#
#                        ## *.. # # #   ##\. #.#  \ *.. .    .* .\ . #
#                         #.*.***#\#.###.  #      .* .*...*.  . * *  #
#                       # #\*\ . \*..*..#.**.. \\... **. .*.*   .  **#
#              #   #   # ## .#.*\ \*###* #..\*\ .*... . ..**      ...#
#             #.# #.# ## #\ *  . *###\#*.\# \. . *.*\.*\.*.**\.   *\*#
#             #\###.##\ *..**. \ ##.#.\# # .... *..  *..\.\*   . \. .#
#            #*  \#   ..*.*.*  ...**..*\.....\ *...*\*\.\\ .  .* . \ #
#           #.\...* *** .*.** . * ..##**  .. .*.**\.*.. .. ..\.\ *  *#
#          #.* *\ .\.*...*.\.*.*   #.... .  \\ \. . ...\ \ . *.  .  *#
#           #..* ...*.#\ .* .\ .. .* ***\*\ .. . .  *** ... . ...* .*#
#          #*\.* .\.. . .*\. *.\.  .\*.. ...*** *. \.*.    *\.. .. ..#
#        ##\#.#.* ..*\.. .*. *.  .* .\.*\** .*...* .....\.\..*. .*  *#
#      ##*..\. *** \.*    *\ *.*.\.*\...*..  .\ \..\..\.*. *\.. \. *.#
#     #*.**   * .\ . .*.* .\... \.*.*.\.  . * .\* \*. ..  ...  *.  . #
#     ##\ #.\*    ** **.*.\. *... .. *  .* ..\*..  * .*. *****\.*   *#
#    # *     **\ *.. ...\.  * .\*..* .. \*. \ **.\  ***. **\.\. ... .#
#    #.# .*\ .** *   *...**.** **\\  .\ .\.\. ..\*\*... .**.*.. \ \  #
#   ##*\##\ *.\. .\. .\ .. ***\.\. * **..   ...\.*.. \* *. *..\*. ..*#
#  #*\*\  ....    *\. . *\.*.\. . * . \....** \.    **.\ ..\* \... ..#
####. . ..   . *.....\.... ..  . .. \...... . ...* .. *... .. .*.... #
#..  .\\. ....*...*..*\.. \ .*. \. .  \**.*  .  ** \ ..\.  .  *. .** #
#*  ..**.\.*  **. . ***....       ...* *..*.*  **.\.* * ..**. \.  .. #
### * ... # . ...*\ \..\..    *..*.* \ *** ... ..\. \ \.*.*\*.*... ..#
#*#**.\..*\\* .*..*...  *  . . \** **. ..**. .   .. .... .\ *... *.\.#
# *.*.\. \  *.*.\.*\.\.\ . *.**.\... .. .\\ *.*.**.. .*.  ..\*.\ .  \#
#.**. ** .  *\.  .* * *.  .*.*\ *\  \*  ** *\* .*.   **.  * *.\... ..#
#\*.. .* # ..**..\* \. ..*.*** .* *... .**...*   ** ..\ .....*  ..   #
# \.\ \. . . ..*\.* \.** ..*\ \ . .. . ..**** *** . *\ .*  **.. *..* #
# .*.  *\ .*  *\**....*\.**..*.*..  .\.  . .*.  * . . ..*\.*\. \..*..#
# ....\.*  . . *.. ...\ .. ...** \ *\ *... \   \*   . \.\.***\ .   *.#
#* \...\..\.\ *. \\ **...\.*. .  .....*...* * *.. *\ * *  ... .   .* #
#\.*\ .* **.  **  * *..*  ..\ . .... \.. .\**\*\   ..\.\    ....*.\.\#
#.* .* .*.\. *.*.*. .* . **\.. .   \..  .  .* . .   \.\.  * . .\.\ \*#
#\.  . *\ *** ..** * ..  ..\*... **.\.*.\*\ \... ...\. .\*.\ ..  *..\#
#.. . \*.\...*\\ *..*\ .  \..\ .*..... .. .. .....\*    .\. \ .*\. . #
#. ...*.**\ \*..**.\...     .***.*.\ *  * .. .*. *.. *. \*.\..\.* ..*#
#  .*...*  *. *.**  *\*.. *.\*.  *..*. . *\ *  *\  . ... . .  **. \  #
#. *. \..*\ ***.*.  .... ***..*.\. .. . ***. .\***\*  *..\ .*..* .*\.#
#.\..\.. \.  ...*..*    ** .\ ... ..\ \\.**   .\..\ *. * *. *. *.....#
# .\.. . .\  *..\ *\*\..**. *  . . \ \\.\** . * \  .* ... **.\ ...***#
#  * *.*.. *.\*\ . ..*. * . ...  . .  * ... * ... ....  .\\.**. .*.* #
#.\* \** . . .**.*.   . \ .\..    *  \..\*\.**\ \.*.*.** . * ..**. . #
#.* ..*..*  **.* ..** . .**  ..  .. *.. .. ** ** *.   *..  ..**.  *\ #
#.*\.\ *.\   ..*. **.*.\. * *\*.* *  . \\ \.R\.\*.\ **...*  .\....*  #
#*\.** .* . *.    ...*....**.  ***..  \.*..\   .. .\    ..* *..\.\.*.#
#*\.**.  .  ....*.. **..*\.\..*\*...\ .\**.*  . \ ...\.  .* .\ ... .\#
#* \*.*\ .. *\. \.\... *.* *..* .**. .....**.*\*   . * ..  . . \*..* #
#.\. ...\ \.\  \.   * . * .*.\. * .*\.\ ..   ... \ . . ..\  . * .. .*#
#**.\ . *\.**.* \. .*   .. \ ..\* *. \.*** .  . ..\.\ .*\  .*\. *  ..#
#\..*\*.. ..... .* \.    *\. . . .*\... *.\ \.\*..   .\*.* .. ... . *#
#*\..\* . *.*** *.* *. * .    \* \. .\.** **......*.  *. .. *. .\.*. #
#* ....  ..**..*.* ..  .  . \.**\..*. ..\* .\ \.... ...*.* \.\ \* *. #
#.** .*.* ...\ . ...*   *  ..  ...* * .  \    * \ * .*..\*  ** .  *..#
#.*** **.* .    *. ... . ..   **.*... .\.  * ..*.. ..\. *.*\ . ****.\#
# *.. **..*  \..*. \...  **\. * .\. . \. ..\\ *..\*. * *\..  *\.\...*#
# .   .  .  ... ...  *   ...***.\   \...*..   . *.. ...\** . .\.  \**#
# .\  .\.. \  * *.....*.*.*.\.  . .*  .. .   \  \*      ..\***.\...**#
# .  \ .\*..\ . *.  *.\.** \.* \ ...*..*\.*.   \..  .  *.*.\...* .**.#
#.*.** ..\*\.. **\. .\. *. ..*....**   *..*  . ..** *\*. . .   . .\**#
# *.\.****. \* \..* *\  \*. ..*   ..  ..\ *\.  *.. *...* *\ ...\  *.*#
#.. * *\ \..\.*.* .\..**. *.  ..* *\.*.. * .\ .*......\ .*.* *\\ ..*.#
#\..*\..    * ... ..*\..  *.... . .\*.. \ ..*. \. * *  *..* *  .*.   #
#. * *...***  *\.\ ** . ... ...  \...*\   *.*.. . * .\*.\...* .*..*\*#
#.*....* ... ..\** . \. \   *\**.. * ..*. .** .** .\  .\ .*\. ****\*\#
#\.\.\.. .* .  .. *.\ .*..  ..  .\...\*... **.*..   ..\\ *. \ \**. . #
#..#\ .*\.*.\*\.. *...*. ....\ \ . *. ..  ..*\\  . ** .*\. ..*. **  .#
#* #*. ...#. ... ..\*     ... .*. .*.* .** .*.\...... .\ .\...**.\.. #
##. ..*#  *. .*....*\.. .* \ . .  .\ .* *..   ..    * .  .   \*. \ **#
##... **\.*  *...\ ..  .\. .\....  \ \..    * * .....\**  .   *. . ..#
# #\* #.. \  * \*.  .\  .\..*.** **. . *** **\.. . \***\.**\ .\. *\ *#
#  ### *.   ** ..* *   *\. .****.*. .\*. *..*\* .. .*.. ... .*....* .#
#   #\.  ....*    . **.*..*... ... .*.*\.*.** ***\* *\ .. ..  .\.*  \#
#  #.   ..**. ....*.*\..\ .  .** . .. ..*  . .*\.*...  . *... * ..\. #
#  # **.\...***. .. *. ...*..***  ....\ *** \ ..***  .   ..  ..\ ..**#
# #  .\.\\  *\\. * ..* * *..\\  ..**...*.*\  * .*.  *\..\  \ **.\*\.*#
##\.  .* *.. *.*\        .\.***.. *.\* . .. *.  \.. ..* ..\..***.*.  #
# #####. . \.... . ...* \*...*.***. .. *   *\.  .  .\...* * **...\**.#
#    #\.* \#\.*.*..**.*..* . .*..   .**.**\.*\ *  \* .*....\.*.. ..*.#
#    # \# \.##. .  * . ...**\\.*\.* ..  .\.\\  ..  *  *..  *  .*... .#
#     #.*##  .\...*\  .. .*.*\ *.  \.*...... . .....  *.* .....*.* **#
#      ##.. \#.**...**  *.. \**. ** \ **  **. ... ** ..\ .**. \... .*#
#      #* .*.\..\.. ..* .*..\..**..  ..*\..\\* *\  . *.\**\*.\. \ ..*#
#      #.  ..*.*..  .\.**\\*..\*** \   .**.*.*\....* . ....*. ..  \..#
#      #*. .* .... * \.... ... .*\..\   .**\..* \.\ \* .  .. .*. *..*#
#       #.#.* *. **\    \.. *. ..  ..    ***.**. .  ..*..   .*.   .\ #
#        ## * .**.*.*   *** ..* .**.. **\.*\.**\..*.* .  \ . ..  .   #
#         #**. \  \**.*** **.**  .\ . .*. \ ....\.\..*    ** \\ .\*\ #
#         #*. .#  *\ \*.. . \.. \. . **.*\.\.  ..  ****..*...\ .***.*#
#         #*. **...* *.\*\ *.*. . .*\  ... .* ** .*.*..\ .\.  . *..  #
#          ##### *.... .. ..\.    ..  .. . *\  .\ *.* **. *. ** *.  .#
#              #*\.#\. .*\ \ .** **.***.\  .*\**. *.\  . *.....***\ .#
#              L.*\. * *#.\.# .*....* *.. *..*\.  *. .\.****\ . . * .#
#              #.# ..\.#* .. .   .\\......**.*.  **.. .  ..\ \   *..*#
#              #*#..\*.\.  .*  \ . * .\  * .*\*.\*\** *   ... *.\. .\#
#               # #***#.**. *  **.\ \. .. * ..*.  .*.*..\  *  .* \*\*#
#                  ##*\..*. . .#..*****.\\. **..\*.\\..\ * . .\.. . \#
#                   #.#\###\  \ .......... .\*.*..\* .\. ..  \*  . *.#
#                   # # # #. * * .. * .**...\**\. .....   **.\\ ..\#\#
#                    # \#  #*# #.* .*\..\.*.\*    \ \.. \.\. .\.  **\#
#                    #.*#  #\# *\ *\\ \.. ..*.   ..*.* *.* .  **...\ #
#                     ##   #*# . .\ * ..\*. .*\*.*\ ** *.*  .. .*  .##
#                           # ###*#*\  ..*..*... . ...\\.. * \****\..#
#                               #*.\ .   .. .\.\ * \ .*. \*.\ \***. ##
#                                #\ **.* * . .*.*.*\ **.\.\.*\.*.*\*.#
######################################################################