################
#         # #  #
#      # #..# ##
##    #.##\ ##.#
#.#  ##. .#\*.*#
#\# #*   * * #.#
#\ ###\# . *.  #
##\.  *   \#..*#
###* .*   *\R..#
#\**# .* \.. * #
#**\. ** ..\*.*#
#.*.\.*.    ...#
#** ..  *\.  .*#
#\.\**\.*.*\ **#
#  .**  \..\**.#
#  **. \. \ .. #
# \*\.\ *...\ *#
#  *. .\..\ . .#
# \\*... *. . .#
#.  *\.* **. ..#
#\.*\   \*.*\. #
#*\..\...* *. *#
#**.**.  ***  \#
#\.\ . . **....#
#\*.*.  ... .. #
# .\** .*** .*.#
#. ..*\*.\. *..#
#. ..* .*   ...#
#*.*\. .*.\*..*#
#..*  ...\ .***#
#\...  \  *. ..#
# .... **... *.#
# *..* * .* .*\#
# .***.*. .   .#
# *...***\  .* #
#L   .. * .*.. #
#.\ **\ ...\  *#
#\ .\.#. .\  ..#
# *  **  ...* .#
# .* .\*** ..\.#
# .. ....\ *  .#
#\ .*  \.\ . * #
#. .##*   *#.* #
#\ #. *. \# \*.#
#  * .\ *## #..#
################