##################################################################################################
#             ##. \..*  \#                      #.#.*#         # .#\\  .\#.  . . **. ..\. .#**  \#
#            #*## #* . .##                     #\ **.#  #       #   *\*.  . \  .*.*** .  .\**#.###
#            #.#  #   *..*#                     #...*###*##     #  \#...*** ..\#...\. .*\ ..\.  *#
#            #* . ..*...#\## ##  ##            ##**\*.. .*.##    #\ *. \ *. *.\ . *    # ..***.###
#           #.  .  **. ..#*.# *##*.###        #\ .  *.\. #*\.# ##\*##... *. .\.*\..\. *..\*  *#*##
#           ### ...*  .#\##.##\# #*# .###    #.*..\\.  ..\.## #\  .\*. ..\ .\* .* \..\\.\.  *  .\#
#          #.\..*.\..  .*\.** .###.   \.\####* #*   . .\ ..**#####* \ \ ..*  *. .*. *. \*..\*\.  #
#          # # \...  .* *.*.\\ ..## * ###\. \ .\\    *  .  *..*###.*   .  .** .\.\. ......*#\*** #
#      #   #.#.#.#\ **\. .. \  ......*# ##\**.\..*.. .*.\ *##\.\.\.\ ..*  *\. **** .* *..*..*..*##
#     #\# #\ . \.*.....  .. ...*  *.\.  #* ..*\ .\...*  *.*..#\      .\..*.....* *..   ..\ .**.*\#
#    # ..#\* #*  # .* \ .\. . * .   *. \..  *.*\ *.\*.\....\. ..*.. ..* *** .. ***.\.*. ** *.*#.##
# ###*.#*  .*#\.. *\.\ **..\...*. .*. *.#**.... .*  . *.\ *. .\*.*    ..\..\.*.\\ .. ...*.*.#.\.*#
##. #\.*.#  . * *  .*.\..\**\* .. *.**. ***..  .**... ...*** \**.. ..**\*  ..\ *. *   \ *.***..*\#
##  #* #.#  .** \ .*.*.* ...*......\... ..* . **..\  .\ . ..  .*\* ...**...*.*.  ....*. .  *..*  #
# #\ \*... . \.\*. .*.**\.*\.. . ..*\.*.*... .*..  .*...\*..\  . \**. *\.*\ \...*..\.*  \  .\... #
## .##.#. .*\ \ .*\**..**\.    \\*.. **..\. \..*..*.\ ..*..** ..\.* .***** *.*. **   .\*.**.* ..\#
#   \ .#.*\*.  **.... *.*  * **...  ..\.*.* .\ * ..... * . .  *..\.\.* *..*. .**.. *\\..*...*  \ #
#* . .*.***.  ... *   ..*...***  *.* *.. .*   * ... ** . ** *. . ..  *.. . * \ **\.\*   *.\*\ **.#
#. .\ \..\ .* *..  .*  **\\..**..... .\*.\. \\*.*.\**. ..*\.. . . *\  .   .. .. \* ..\.* . *.\. .#
#\ *....\. .*.*.\  .  \*\. *. *  *.*.****   ..  \* .*****\.\ *\ ..*.*   *.\ ...... .. ** *** *   #
#. . ..**\ .  **.*.. *.. **....\...*\\* .* .*. .....*.*.. * *..  .*.***. .  ..    ..*.**.... .\**#
# \.*  ... .. ..  .. . .* * * \ . .***.\*** *.  ..**.\.* *.\.*\\.*. **.***\**.\**  \..*\*\** \..\#
#.. ...  \..   .*.* \. **...*\ ....  . *.\*.* \ ...*.   \..*\..*... . . ....\..*. ..  * * .\    \#
#  .*** .** ..* . . .. .**\*.*..**     ...\ \ . *. .*.\.**   . .. * ... *  ** *..** .*.\.. *.* \ #
# .*\..\ *\   *   .*.*\ .*..  .......\ \.** .  *\.  .\.....\* *\... \ \**\* . .* *..  \.. **\..**#
#  .*. .........**..*\.  .  .*\..*.\*** .*. .. *.\.. ..\ *. \.*    * . .\      .*\ \..\.\\..*\...#
#  *.* *.**. .*.**. **.****... . . .... .*\\*.\. . \ .*.. *  .\.*.*. ....* *.\.\.. ..   *.\. .. .#
#*\  . * .. .***.....* **\..\ \*\.\..*  * .. *.*.. .. \*\....**\.***.\.\. .***\.. . \. *. * .\ * #
#.. .* .* *.....  .\*.  \* \.* ..*   *. . *\** .. .\ . ..*\. *.  *..*.. .**.. \*..*. * *  * .\..*#
#** .. \...  .   ***. *.....\.\. \ *...\ ***.. *   .\.  ...\ *\* .*\...*\ ***\..*..\.....*.  * **#
# .\..*.***. *..\ .\. *. *. \*. *\ . \*.***..  ....  **.\*. **.**.** . . * \..\. .**..*.* .  . *.#
#*\. *. ...*\.*.... .\. . *...* ..*.. *..*.\ \\*. .**.**... *.*.* ** .* *\*.\ * \**\ . \.... .*\.#
#.\**\*\\ ..* ...\. **\   *\. .*..\....\ . *\ .. ..*. ..\ \ .***. *  \ *.. \ **...\..  \ . .\ **\#
#. ** \.\*. **  *.* .*   ...\ ..*\.. \  * ..*.... .. . *..  .\.*.*.* . .*   ...*. .\*. . *  \.*..#
#**.*  .*..\\*\ *.* .  . \.* ..** .**  **\..* .   .\* \   .** .*.\..\  *. . . **.   * .  *\... *\#
#** * *..\  \*.*\ *****  *\*\.*.\. .  ** . ****\* **....\.\.*.*  **\.\*.**.  .*. ..** .\*....  .*#
#. ..\.*..  .. . .\. \.***...... ..  \**.* .*.*.\ .\*  ... \*. *\ * \...**. \.\* * ..\  ** *..\*.#
#\   ..* \*. .\**..  ...*.. \. .* .*\....*\.**\..  .\.   .**     \...\  .\ .\. . .\**.  *\  * *.*#
#..** **\..\\ ...  \ .  * * ...\..\  .\.***.\*... *.  . .\*.\* .*..\ ..*\. .. ..  *..\*...*.. \.*#
#. \.  \. .   \*.  .*  .. ..*.....*. *... .\.   . .\ .  .**.*.**  *\.  .  ..**  *\... .*....\..\\#
#*.\..\..\   \.*.  .. \ ***..*.   **\. *   .*.  * .   *.**.\\\ *..*...\..  *..\.. . *.*. *\\*....#
#*\... . .* \*..* .\ .\ ...\ *.  \**.\\*.   **. .*\ **. ..*\ * \. ..*\  . *. .*.\  ...** . ...** #
#.. **.\.    . ** *      .  **. .*..*..  *.*.*\.\. .*\\*.\...* .*.* * * \ **. .\..*\..*. .* *\.*\#
#\*.\. . .\ .  ** .. . .  . \\*  ... * \.\..*.* .* .*...  . .**.\.*\.*.*.*.*.*. .. *\ ..\.*.\. **#
#**..\ .\..\.\...\. .*......  .  . . ..   .\....   ..*\*.*..*\*..\.  . . **. .  .\.* *.  ..    .*#
#*  . *\.* *..* ... .. \...**\.   .*\..\.*  ..\\**.. *..\ *\.*\.\*\.  .  * *    .. . .*\ *\. .. \#
#.*.. *  ....... .*\* ..* .\..*.. *..... * ...*...  .*.*  .*.*.  *   **. *\*..*. .\\. ..*.*  ...\#
#  . .\ \ *\ . \ **..\*...\.** *.. .*\ *\* \\\.\\\. . \ ..\\\.\  \****. .\\..*\*\ .\   *. *...\**#
# *\.*. . *\  .. * .\.. \ ..\. \*.* *..  . .*.  \     **\*** * .. \\*.  \.* *  ..   *.\. .*.* .*.#
#\.* *.\..*..  .\..  .   *\...* * . .   . ... .\  .*.**..*.\**.. ..*.. ...\...*.. *\ ** * .\.. *.#
#.**..*  .  \  *. *\.*..*....\ .\ *  * ..*..** \ *\. ...\.\.\*.\.**.* * *.*.* \ \.*..***. *\  .\.#
#*  \..* ..*.\ . .\. . \.   *..  **..\..**. *\..**  .\*\*\ *...  ..*..\.\***.*.*.** .*.\* .. .** #
#****     .***.. . . .. .** \..*. .\..  . . \ *..*. **. ...*.*\..\.* \*.**..*.*.... .. .. \ .. *\#
#..*.   .\...* ...* * *\ .  **\..\*\.\...\.. .** ...*\.*\\ . * . ...*.\...* \ **..\ ****\*.*.. . #
# ..*. .**** .  **. . *.. . .\.*. .**** . ..  *..\*** ***\   .*...  . .. \.*\ \.**.\**.\..\......#
#.\...   .*.\*. *.*....*\  *** *. ... \ .\*\*..*.  *.** . *   .\*. .** * . *.. .... . . *. .*.*. #
#***\.\  *.  ....\ ..*..  \..\ .***. ..\..**..  \*.**.\.  ...  *..\ .\...*..\..*.  \.   \..   .  #
#\*..*.* *\.*. .\.**\  *\.. . .\*..**. ..\*.*.\* *.*. *.*  .\*.. *   ....\.\..** .  **\*.  ..*\. #
#.\..\ .*\. \**  * *.. *   \ *..*  ***\... *.\*. ...\*.. \ ***\ *.\. ..\. .    ...*..* \ \ . .\. #
#. .\..*  .* ... . * *  *\...   .. ... \.*... . * .*... *.....\ .   .. .* *\. \*..*. *...*..** * #
#  .*. .   .    . *...*.\**.*  \*\  *.*. ..*  . . .\. .*.**..* * .... .\  .* . . . .*\* \..  .   #
#\*.\**\..* *.   ..*  .....\.  ... ** .\*. .*.\.. *. ...... .*.* *\* \*.* *\ * \.  **  *  *\ **  #
# .*. .. \.    .  \. **..\.* * . \ .*.***\* ** \. .\..\**  . * * * * ...*.*.*... **.\\\ ..\. \. .#
#\* ..  ...\ *\  .**.*.*.. \\. .  .\. .*.*.  .* *..****.\ *\..  \* *.* .\.. *\* .\.* ..\*. . . *\#
# *  **.\\*   . .\.***.  **.\..** *.* *. \\* \ \*.\.. \.\ \ .   .. \ *\.**\ ..** .\. .* .*.    . #
#*.  \.  .\..**.\*.* * **\ . . **..   ***\\*\.*.. ..  .**\ *.* *.  ..*.* ** \ .. *.**.. .*. **.*\#
#**.\.*..**\.\. *.\**.* . .  . .*..\*. ....*  .. **.*.*.*.**\  .*\.**.*.. * ...\ \.\..\.* \.** .*#
# .\.** ***.. *...\\\*... *. \  .* *\.. *..\ ... .. . *.*....\. ..*...\ \*\.*\.*..  *.  ... .*.\.#
#. .*.*....\ .. .*   . . *  .*.. *\\** .  .*. *.* * *..***.. ..* ....*\.. *. .\.\ *.\*\.  .  .\.*#
#...\.. . *.\ .\*.* *.* \.\ ..\*....*. ** .   . .\.*. \ .... .*..   .  . ..    . .. .*. * .\ .   #
#... *\.  * . *. .* . *   **.*.. . .**.*...\ \ *..  *.     *   .\  .  .. *...* *\ ***.... *** \. #
#. *..*.  . **. * .. .\.\ ...*.*\ * ..\. . .  .\.* ** . .*.\*  . .** * . ..*  .\*.*... *. .\\* .\#
#...***.\ .\..\ . .*    ...\   ** . \*.*\\ . .  ... ..*\ \ ***. **...*\.  .*\.*.*..\ .  \ . *.\ *#
#\\.... . *  .. ... *\*. . *...\**  .  *. *\ \.*\ *\* ..\..*.\ .  .* .** .*..** **..\**...* .*...#
#*. \..  *\.   .**  **\.*. ** .. . *..*. .* .  * **.* ...  \*..*   .  .**.. .*. ..*.*.. . \\ . . #
#\   .  *\ .*\ ***. ..\\.\ .\ .* .\* .* .\ .\.\.\..\   .\ ..\.\. ........*   . *\..*..\ .*. ..   #
# *.* \...*\.*..\*\..*.\\* .  ..\... **  *.***.\. .*. *.. ***\*\*.\*** \\*  ***.*  .\ * ..**\.***#
#.\ * ..*.. ..\  .  .**. *\ *.* ** ...*.*\.\.  **  .  *.*..\. *...\*  . ** *\*.*\.  *.*. **..*.*.#
#..\.  ..* .* ..*. .*.*......**\**\.\...     *... .*.\ \.\ .. *  * .*..\.* \.*.. *.****  **. ... #
#*.*.   ...*   ....**  *\. *\\.  *.     .\... *\\**.* .. . \ .\. **...**..*.\*.\.**.*.*\ ..*..   #
#* *      *.*.\ .\..*..**. .\\   *.\ *..\. .*.*.*   .*\. *. . **** . *..* *.** . *...* .\. .*.. \#
#  ...\ .\...... *. \.*. ..\. ..**  .*. . \.\****  \ .....  \*\*......\...*\..  ... **. *** .\.\.#
#...\. *\*** . ..* .*\..\.* ** .***  *..\...\....  ..* .**...\.* *.\ ..*  ** *    .. .*\***  .  .#
# **. *.*. .   *\ \.... * . ...\.*.\ \..  .\  ***.   \ ...*  .\***.. * ***.*\.. *   \. *..** ****#
#.\.**.\  .  *.....\..*.**.\.\.*.\. *.**.  * .....  *.*. *.\.   \*\..\.* * \. \ . *   *.\  . *.*.#
# **. *** .. ... *..* *\  *  .\ ..  *.\\..\.\.*. ... \* .*  ***\ .... .* .*.\..  **..*.\ \..*\ *\#
#.**  . .. .*\*..**. ..*\.* . *. ** .\.*\ .*\..    .\ .\..\**. **    * . ...   .\** ....*  .\ *. #
# .* .***.*\. ....   .*..\.* .. .*. *. ... . .****\\.\*  \.. .*..  . .\ \* * \*  ..    *  *.. * \#
#\ ..    ** \. .*    ........\* \*  ..   .. ** .**.*  .** .**.**. .  *  .. .\..  ..\** *.**.* *  #
#...  \. ..\ **...*.. .** . \*** ..* . * . ..\ \  *. ..*. \*. ...\  . .*.\ ** **    *\\   . \..*.#
# **\ .** . ...\..    ..\ .... . .\.  ..\ \*  \.. .\.\...*.. . * .\*.\* .***. .***..*.  *..  .\.*#
#*.* .  **\ .\**. **\ *...**.\ *. *   \ .  .\ ... .. *.*.*. .\.**  ..... .\.\* .\. .* *\... . .*.#
#*. . . .. .**\*\\.*. *.\ .** *.  . .\. *. .*. .. . \. * \ \  *..\. \ ** .. *. ..  ..  **.**.\  \#
#..*\ *. .** \..\*. ** \.\..*.*.    . \*..   *.. .. ....** ***..\*. ..*. .*\ *  **.\**... .\ ..\.#
#\..... .  . ..**\\.*... *. . \  .*  . .. *  *  .  \  * .* .*\*. ..\* \****.*. \\. .\. *  *.\ *. #
#\  \      **..*\. .\* ... *.**..\  .. ...**\*\.  .  .\.\.\***\ ** .* ..*\.*.*.\.\.** ..\*.*  *\*#
#\*  **.  **\.\.   **\ ..*   ..** ..*. *.. * \ . *** . *.. .....**.*\.\..*..\.\.\*..\  \**\*\.\ \#
# *\.. . *..*.** .\ .  .\* *    \ . * .\* .\  .\ . .*\.... \*   ...*  .* ..* \ *.** *\.  * \* *. #
# *. .*...... *.   * *\ ...\. .*.  ...*. . .. . ... ..\  \....\ *\*\*... *.* ..\..*.\* .*.. ..* .#
#  ..\*  \\.*\*. .  *\.\**  *  .    * .. ...** * . *..   . \. . ..*.*..  **.**. **.*.  \..\.  ..*#
#\. *.*..**\....**\*\\. *.\...\  .**.\. .** ******\* *\**. .  ..* * \. \.*.**.\*. . . \. \ .    .#
#* .\\. *..* \***....\  .\**\ .**  *\ **. *...*. \.\...... **...*. \. ...* *.. ..* .  ..*. .. \.*#
#* . \* *\..\*.\.. ..  . ...   ..   **.*. ** ..\.  ** *  \ . \.. . \*. ..  ..*..*. .*. ** .\* .\ #
#\ .. . .. .*\*.*.  .  ...\ .  *.. ..\\  ... *** *\\.*.  ..     .. .*.* \*.* .\ .*... . \*. . \*\#
#.*\  *.\*.*.\...* *   \ *..  **..\. .*.  .*\.**** *..\ \*   *\* ****** .\.\.*..      . .\..*...*#
#*. *\  *..\..*\.. *\* *...***\..\*\\..\.. \ .\.. ..*\**** *.. . .*....***.* ... .. * .\.* .*\ *.#
#.\ .*.  .  . .\  .* \ .\.....**..   *..*.* \ .**\. . .**..*  *. *.\\..\.  .   *. * ..*... .... .#
# .....***     . *.\ .\\ **\. * . . *..*.*\...*..* . *\*.  .\ . .\*.\**.... ...* .... .** .\.****#
#*. .* \.. *..** .*.*.. *. . .** *\.***\.* *..***.  *.  *\ ...* ..\  .*   * ..\   .*\...\ . .**.\#
#*   .\..**\ **.  ..*  *\  ..**..*   *\ * .*. ..**\ *\..\ .* .. . .\**.\.*.. \.\ \*...  .* *.*.\ #
#****  .\ \ *..* .\ * *\*..*\. ***\. . * .\*. .**..*...\ .*\   .. . ..\* ...*  *. *  . ...\...  .#
#*..\ *. ..\\**.  * .\. *\. \.*.*.** .\** ***\ *.. *.*\.\... .\ ..\*. *\  .\* .*  ...\. \.. * .  #
#*. .*. *  ..* ..*. \..\*.*\ *... * . *.*.\*. **   \  ..* *.\ . .*. .... . .\. . .\\...   *\** .*#
#.. . *..\*...\ \\ .. .**..... \* *.. ...*..  .\** ..  ...\        ...\...* **. *  ...  * \ ***  #
# *\. . ..* ..*\\*.** *\.   \ *.**. *..\ .*  \..*.  * *  \. ... ..*    ..\. . *.\..\.*** * .**.  #
#..\ .*\.\* ..   .*.\ . *\.. . \* \....*....  .\**. ...** .*** * *. \*..\..  \.***\ ...*..\*.  ..#
# ..\  *. . ...  \. ..* *..*. ..* \ .. *** .  **.* .  \*.... . ... .\.* .\ * .\... .*\ *\* *.*.. #
#. .*..\*.\     ..**\.  .. *. *... . .\.*.* ***  *  \...* *  * .  .* ..  .\\. *\..  .* .*..* .*..#
#...\***.  *. .. **..*\ ..\.* .*..\**.. ..... . *. . .  *. *\ .   \.\. .*\.   . *    *.. \*\.\ .*#
#.\ ..*\\ \.* .  **.\.. .. *   .. .*.. ..***.*. ... **.  \ \.*  * .\**  .*.  ** \ *..**\ .. *.\*.#
#*  * ....**  *.\ \\..*\* \.*.\ \. \.     ** *..*\. .\\.*.   * ..\ .\*. ..\  .*..... **. *\  * .\#
#  ...  . .  .\. ..  \\.....\.  \.*. *..** .**..*. . .. *.... * *.  **\.\ . . .\*.****\.* . .* *.#
#*.\ ...\ \... .* . ..  *....  .  ..**.....  *.\.\**. * ..*.  .*\ *\.... .   . .. *  \*..\ *\. \.#
#**.. .\* * .*  \ ..*..\. . *.  **.\. .\** ...**. ..* \.\ \  **.* *.  .. .. .*.*. *\ *.*\...* *.*#
#** *   . *.  . *   \  *. *\*.\*.*.\ ** .*\\*.... *\\* \** .**\.. * *. \.*..* *.* * ....*\.*. * *#
#\. \.    ..*\.*  * \*.** ..*...*\..*.*\*. **.\\...*..*.*** .** . . \*..\*\.. .. *.   \* *.*\\. *#
#*.  **\. .**. ..*.\... .* ..\. .*\ ....**...\..  ..*..*. \..**\*  \..  .\*.*\**\\ .*. **..*. . \#
# .  . .* *. ..*.. . \.\.*. *\  ...**\... *.   . .  *.\.*\..\\*..     \  *\..*** .. \ ... ..**.*.#
#.\..*...*.\\ ..\* .\.*\ .* **  * \. *.\.. *...\\* *\ *.\.* . ..\  ....... ...*.\*\  . .. .\*. .\#
#..  . .\   .*.*..**  . .*...  \.\*\..\.* .** . ...*. .* . .***..*.* ** .   *..* . .    .* .. ***#
#**. \* ..***\...\.* . \  .. \.*.*..   ... .**  * *.*... \ .. *\ ** .*.\ *. . *.** . . *** ..*\..#
# .. **. \\.* . .... .*. .\ .. ...  *.*... \.*\ .*   ..  ..\**.  \..*. .\.*. . ..*  .\.  *. .*. \#
#\\  ..\.   *. * .* .\    *.*  \*\  . \ *...\.**..\ .. . .* .. ...\.*\  .  *..  \.. .....\ ***  .#
#***.. .  *   .\  *..  .*** . \...   \.*. .\. ... .**..****  *\.\ . * ..  *. **\**\  * \.. .\.\ *#
#...*.* *...**  . \*.\ *****  . *\.\      .\.\*\*.\*.*..\.*.....*   *\ *.** ... **\ .. .\\ * .  .#
#...*.*..\.\.* \. \**  *....... .. *.\* **.  ...*  .*.**..\.\.*..**..*\. .*\.. *.. \\*.**..  ....#
# .  *....   *  *..*    *. **.*\.* .* . ... .\...\**..\**   .. .\. .\.  *...  .*.*.... .\.\\*.* \#
#.\.*\ **.*.\*.*...*. .**\* .... .. ..  \. .* .****.  ..*.. *.\** *\.* .**\  .\.*  . . ..** * . .#
# *   .  ..\.\*. * .*.\.\. . ***. *.  . *.*\ *.*.** ..\ .\ ....*\*\..\ .*.. ...*..*..*.* ..*...  #
#** . .** * \.*. ** ... .   \... **\ \..**..\. .*\.* \....  .. \*..  ....\ .\  . ...  .    .. \.\#
#\.* **.. **. ..*.. .\.\\ .. \  ...\.*\.*.\*.**\.*   .. \\.*\. ..**. *..\* . . . *\.\\ \\*.***.  #
#* .... ..**..\*.\  .*.*. .*. .* *....*\.\..*..... * ..   .\ .   .. *.*.**\.**\... .*.\  **.\*. \#
#..\....*\. . .*\**.\.  *\ *. .. *\ \ ..  *....  . *. *  ..*.*.\. \..*. ***\.   ..\...*****\ * \ #
# *.. .\*..*.. ..*.*  ..\.\*...**\.*..\.  . .** .\*.*.\.*  .*.\ .... .**..\... .\...*\. . . .\ . #
# . .* **  .*.  *.*. . ... .\.\...\..\..\.*.*** \\* ..*..*. \ ..* ..* .\.. \. .*...*..  * .***\* #
# *  . *..*\ \*** * .*. ..** *.. .\.      .*..\. .*. .. ..  . ..*.\ . **\ *.**\ .  * . .* \...*..#
# .. ...  \.....  . *... *......   ..\   \**..*  **...\  *\*  . *. .. ..... *.  ..   * *\.**\... #
#\ ..*\*\*. .. **\.* *. .. . ... .   *.....\.... \*. \ ....  \.** . ...*    .    .. \**\ ** .\ ..#
#* *.* * ....   **.\****\..\  \   ..*.* * . .\.  . \....*  *. ... *..\*.. .\\*..**.. * . .*...* .#
#. ..* .\*.*\ .* .  .***.\\* *..* \\.*\** .**...*\....***  * .  .\.**.* .*.**.\.\*.  *   \.\..\**#
# .. **..*.\.\ * ** * *\* ..*.\.**.  * *. **..\*. .\. .*.  *\. .  .\. .. . *..**.\. **    . .. \.#
#\ . . ..  ** *...\ .*. \.... . .\ .*\.... . . . \...\ . .** * \  .   *..  ***.. **...* *.. .\ **#
#...* *.*\ \*.**\.   .  . * . .\.*. \.*.**.*.. .** \ . **\.  .*.*\**  *.   **.  .*\ ..... *. .\ .#
#..\*....*. .*..** ...*** .  .\ \.*.*\. ..  *\. .** ..*\    . \ ..  *... ..** .***..*\.. .\..  *\#
#.*.. . .* .*.. .* ** \*. ..\*.  \. \ *..  ***.\*.\*.*..*..  .\.  * ****.*..\..**.**. ..* ..\\*\.#
#..*.*.    .* \ *.*   . * *..  ..  *..\. ..*.. .*  *\ *\....  ..*.*  *...**... *R... \\ ** .. \  #
#**.  .. ****.  .  .*  .. ..  *  **** . ..\.  *...*\*  .*.*.*..*..* *.. ..*.\..... ..* *..**. ...#
#\... .\..*..\ \. \ *   *..**.* **.*.\*. * . **   **.*. ..   **. **     *..  ...    *.\.*.*. *.* #
# .. . .*. *.  \\...\*. * .*. ****\. .. .\ . .. .*...* .\ **\..\.\*\*   ..  .* *. . .\ \  ... . .#
#\*... *.  * \... .*.*. .\*. ..\  *\*\**\..*\*.* \.\.. *.*\*.    *..**\. . \ .  . .\.  . .*.. . *#
# .*.* \***\  *. .*\ * *. .. *... ..* .*...*  ..*   ..*.....\  * \**.* *  *.*. ...*.* ..  . .. \.#
#*.\  ..*.*. .. *\.. * .*.. *\*..\* .\**.* ....\*.\\.**..* .*  . **.**** ...*  \...\  \**** . .\ #
#.*.* .* ..  * *. *.\*..*. *\ \\  . * *\ \\.*\*.*\*. .*.\. *\ \* \..\\*\ .* *.    *** \....* ***\#
# * *. . .\..* * \.**...* ...\*  . .**.\..*\. ... . .* \  ... ***. . *... .  \ .. .\. .* \ *. ...#
# .....** .  \ .. . . *\.. *\** . . \..*.**  .* \.   * ..*\. ....\.* **.* . .*\..  *.\*.* *\*  * #
# **.  .*..* .\*\  * \   *.* .*\#  ..**. ***.\*\. *..  \.\ \   .\.*.\*. \*\  .  \.*\... *.\*..\. #
#  *.**....\**.  \.. \.*.\*.* .\  .. *.***..  \.*\*  .*\*.\...\   .  ..*.*  . . . . \ *.*... **\*#
#. *.*\.  .* .. ....  .\ .*\.*...\   \. ...\.**.  ***..*. .  *..\*  .\ . . \  . **.*.\ \ .  *\ *\#
#\..*.***....*\. .**..\.  * *.*.* \.   ...**. .  .**.\\. *\   .\. *\. *\* *.*\**. ..\*\. .* *.\.*#
#*. ....  ...*   #**. . \.. ..*.    \. *  .. \* *....*. ..   \ .*.  * \......*.* *\. .   \* .* \.#
#*\.  .\ *. *. *.*. .**  \*** **\    *.   .\ . ...**.\   .. *.\*..\*. .  *  .*\*.*       .\**. ..#
##.\ #...\. *.......*.**. * *..\.**.\.* .  . \... .. ...\ *..\* \ *.\   ... *. . . . * .* .*.* .*#
#* ..  \..#.    .\* .\. ..\\..   ..\... *  *...*  .\ *\\  **..*\ *.***.*..  ..* .. *.*\.**.* .  \#
#\  #* #\. \   **.* ...*...*..*.* * .*.*...* . . *. *\ ..\..  ...* * . \..   **..*..\\***\\   ...#
#*# #\    . ..*..*. . **.  . * .. ...... .*\. * **. *.\ *   *..  ... ...*\.\\.*. **.. *. . **.. *#
## # ##\..  *#..** \** .  .*... \.. ..*..*..\ . .* **.. ....* ..... . \     . **..\.\ *   .#     #
#      # \   **.** #.# .*#.#*\ *\* .*....*...\.  \ ..*.  . **.*.\\ . * .* *  \** *...*.*.  .\..  #
#       #  *..*.*.\##*\ .\ .  ..*..*. .\   .\.***.\* . .** .\..  \ . .. *.*. . *.\\\..*\  * *. **#
#        ## \##### # ##L#.### **#\.##**#..*\*.. *.*.***... .*  .\ ..  . .*..\ ** . ..*\.  * * .\.#
#          ##   #.**#    #**..#.\.## *\#. \ * . \..*... . * . .*. .. *\\.*. *\\.* ** #.. ****** .#
#                #..#     #.# #### #\** ....*. \.  . \. * ..*.\..*\.. *.  . * *.*.*.. \  * .*.. *#
#               #.\*#      # #      #..*. ..*\*....*  . . .*.**** * \.*...  .\\#.\## **. ..\ ***.#
#                ###                #\..* ....* .  **. ... ** .*##..* *.   * .\.** .*.\. #.* .*\ #
#                                   # *  \* . *** **. \#*.\#* *.#*  \ \..*\ * ..**.\*##\ ...\...*#
#                                  ## .\*. \ *..*\\.**\#\ *#\*#**.\\*. * *#.*# .**.#. \ .#   \..##
#                                 #.*\*##*##.**\....**# ##.*...##*#.*. ..\* .*.\ #* \ ##\#. #.#.*#
#                                  #*##  #.* ** .\*...\#  #* *# #\ .##\ \.#  ..\* \###  ## ##.\###
#                                   #     #*\.\*.#*.###   # #*\# ### #.\.###...#..*#      #  #.# #
#                                          #***..*.#       ##.#      # * **  ### \*#         #*# #
#                                           #..#.##          #       #.. \##.#  ###           #  #
#                                           #.# #                    # *. . #                    #
#                                           # .#                     #\#.  .#                    #
#                                          #.  #                      # #\ ##                    #
#                                           # #                       #\ *\*.#                   #
#                                            #                         ##\..#                    #
#                                                                       # ##                     #
##################################################################################################