###########################################################################################################################################################
#                                   #.#                                                                                                                   #
#                               # # #\# #                                                                                                                 #
#                         ### ## #.##* #\##                                                                                                               #
#                        #..*#.# **....*.# #       #     #                                                                                                #
#          ###          ##.#*#\*\..  *.## .L      # #####.#  ###                                                                                          #
#         #.*.#        #. ... .*. .*.# * *.*#     # #\..**# # .*#                                                                                         #
#    #    #* \.# ##   # #\ \.**.\ .**...**#* # # ##*\.***..#.... #                                                                                        #
#   #\#  #\#.\.##*.###.# ###*.*.*.**.*..# ### #.#.#* .#*#.  .\# .## ###                                                                                   #
#  #. .##..\***\##.. .\ # #**\  ....***\ *#.#*\.  #  \*#.*..*.# .**#\. ##                                                                                 #
#  ##. . .  ..\.*\ #. #\##\#..*.**. .  ....... ..# ..* .\.*\. *  #.#. \  #                                                                                #
###\##.*.  * \*..#* . . *.... *#.. .   .* .*. ..* \*.\ #* ... . .* #.\###          ###                                                                    #
# **.###\  #\.*.*\*#\  .*..* \* .\.  .**.\ ........ \.\*#  .  \. .#\ *#    #      #. *#                                                                   #
#.#*#.#\* .. ***.    *.*#*  *** *. \ ..* .  . .*.. ...  *.. **. . # .**#### #     # ##                                                                    #
# **. ...\.\\*.##  \.*\. *.*.*.\* \.. *. *.. *. *.  ..*\**. *** * * *. .*\# \#   #   #                                                                    #
#.\ *  .\. . ..*\ *\..  \.*.**... . * .*\.* ** **.\.*.* .*..#*\*.\**.\ ##*. #   #..\.#                                                                    #
# .   *\  * \ ..**..\ *.. .*. *  *  *    .*.... ..  ..***\* ***.. ....*\ *. #### #. #  #                                                                  #
#.  \*#.   \#  \*.*.. . *  ..... *\***.\.*. . \.. *.\ . .*. *\*. .\  ...**\ #*.\#*.\ ##\#                                                                 #
#.*.  .. #*.*   ...*..\***\*\.*.\***...... .. .  ..** *.*.*\**. .       .\#.##*..*..\.*..#                                                                #
#.*  **\\.\.. . . .*  .\.\*..\*\ *...** \*\*..*... .**.* \ ...\.**\.*\ .#.*\.## .... .*\####  ##                                                          #
#* . *\.*\. ** *. .\ * .**..\*.\... ... .* .*\* \   . .....  .**.*.\*.\ .\..  . .... *\*.  .##..#                                                         #
#.   \..*...** ..\ *.*   . * ...**   ...*\ .. . .*.*. . .**\**** .. .   **  .. *.\.  * *.*. \..#                                                          #
#.\... .. .*\  ... *...**. .  \**.  ****..  . .  ...\. .*..**..\\.\.* .\*\.  \ * ..  . # ..*...\#                                                         #
#*  \* *.* *. .**.*..**\...  *\ ...   *.*\ *    *\..    .*.*.  .\.. *\\.  . * .\ .. .\*.*.\.    #                                                         #
# ..\.** \ .. . .\*   . \.. ....\** .*.\*....   ..*.*. ...\.\.. .\.  .*. ** ...  *..  \ .* .. ##                                                          #
#\*\  .. ...*.*. **..**.. ** * * ..\.**.\.***.*.***\...\..\  *.*\*\.. ..* .  *.\ .\.* .\ ...  *#                                                          #
# . * * \\.***.** .*.\ .. **.. *.\ .**...\\... *.*\.  .. \   * *\.*.* ...*  \*....*\. *    *.\.# #                                                        #
# *  .....* .*.*.\ .*..  .\... ....\...\...*....\ ..  \. .***. **\. *\..*.*\ .  *. * . .\. \. \*#.#                                                       #
#  ...**\\.  *.\   *  . .* . * .\ \*.* ... * . ..*.\  .**..*...\ *\*.*     .** *\  . .*   * #*. # #                                                       #
#.    *..**.*..**...**.  ..\ .  *..* . ... .... \....** **. .\*.\. ..*\.  ..*  ... .*.*.. .###* .. #  #                                                   #
#. . *. *..\*.  .**.**.  .\*    .* * *..  ... ...\*.\.*..\*  .** . * ..\.\*.*..*.\ **.. *  \ *. \..###.#                                                  #
#* ...  \.  *    ... \.. .**  .  .\*.* * .*   ..*..**\*  .* . .\. ..*..  ..\....*\\.*.**.**** . .\. .. .##                                                #
#*  .*\ .. ** .\.\ * ..**\.*  *\.\ ... \.\. ...\   .\**\*\**.. . \*\. . *  *.*\  ..\*...*\ *. . ..**.. .# #                                               #
#. . .  *. \*.  ..*......\.. .... *.\..*.*\..\   .. *... **\ *   .\ *\..**.   .**\ ...\.   .... \\#\\#.**\*#                                              #
#\...\ .*   .*..**..*. **... .\*\*\ **.. \**    . *...*  ..  ..**..*\. *.*. * \ * **.. *   *\ .\. *.. \\####                                              #
#\     \*.**\\ \.... **..... ..*.\ ***\   ..  . * *\...*.\...\.... . . *** *. ...*\* .\*.\..*..  ..   ...#. #                                             #
# *..*. .*.... .  \ ....\ .  \.**. ... *.\..\ . ...*\. ...  *. *\. *\**.\.\.. *  . . *..*. .. .*.*. .* \ . *\#                                            #
# .\ ...\. ..   *.* .. \   ..  ..*.*.*. \ ..*  * \ ..  . .**. \.. *...*\  *   \ *\ *.*.\..\*  ..*****\    #\ #                                            #
#\ *.*...* * . .*\ ..\.. *\** .* ..*\*.*.\  *. .*.\.\  *\  ** .*.*  .... .. .\.. * . ** *...* **... ..... ##*#                                            #
# .. .*\ ..* \. ..* .**\ *..*.\* *\..*.* * . .\   .*.. \. \...  .*\*\* .  .\   *..\*** .. * .. . ..  .*.\*...## #                                         #
#. . ***\ \*.  .\..*.  ....\.  .... .\.. * *. ...*\.. *   . . *  .\**..\.*\..\ *\.** *\. .. *\. * . * . ..# . .# #                                        #
#.. \** ...\. *\.\ .   .\ * *.***  .* *\.\..* . .*.*\ ..**   ..***.\. . ...* . *. *.. *. \   .**. ...   *..*.***.#                                        #
#\.*.\.*\. ** .\. \*...\ .* \*** .* ... * * .\ *\.. * ****.*.\ ... .*** ..  \* \..***..** .* ***...*\*.*.\ ....##                                         #
#..\.*\. *\.. **.  . \ *..*\.*..\ . ..    .....\..*.* ..\\*.*...*..\*.\.*...* *.  *.* .*. .. .\..  *.  .. * ** ..##                                       #
#*\\.......* .*\..*.\.  \**. .\* *..* ....\\*.*.*\.. * **\.*.*\ ..***\.\* .**.*** *** ..**   . **.\* ** \ *..\ # #.#                                      #
#.. . ..*.. \...\. *  \*..*\.. ...**...\. .\.*. *.  ....\ \\**..\*.*\ . . *..\ ...\**.. .*... *.. .....*.    .   .\#                                      #
#*..   ..   \.**\ ..*\ *\*..*\.*\\*..   .\. ****   .*  . . ..\\  \*.*.*\  \*\*.*  .\. *. *\*...  .  *\*..   .*#\#.#                                       #
#* * .* * .*.*\***\ .  ...**..*.\..   .. * *\..\ .*  *\ \ \ . \* ...*\.....* .    *...   ... .*. . ..*.\.. \ # \  ##                                      #
#  .\. \..*.\.\*.**.* ..\*...*..  ..  \ ...*\....  . . *..*.\ .. .. **. ..\\   *  .*\*..  .*.***  * .....*.\ .  . #\#                                     #
#*. ..\ * *.*. ***.\***\.. * ... .    . \ *  * **  * .*...\.. *  \.*\*. *.**.*. ..\*..\.\.\. . *.\. ..     *  .*\.. #                                     #
#.*\.\.**..... .*** . ....  .*\  *\ \ .   *\**\.* \.. ..   *.. . .**  . **\.**\  \*. \. ...*...*..***.  *...*.*#. \. #                                    #
#*.*\*\.\*.* ** \*\  **\*..  .. .\.. ..\ .. \.....\*.   .  * * **..\.\  *.. \\.**  . . ..\* \ \.**\  .  .*. *.... #***#                                   #
#\  .* *....*\* . .  .\ .  *\.. * *..    . ..* \. .. **  \.*.*\**. \** *   \ . .. * *. . ..\ \.*...\.  * **.   #..*#.*.#                                  #
#\.. ...* ..*. \*.......*.* \.\ .....  ..*  .   * **\.* *\ *\ ..   .*.\ .   .. . *...\.  * .  \.* * . .* **. .*#* ..** \#                                 #
#.     . \  *.. \ *.**\ ... \.*... *\*\ .\.**.*\  .*..*\*.\*.*. .. . *..\.. .\.....*\* . *.* . \.  \*. ..*\  *. .  *..#.*#                                #
#. .*. ..*. ...\.. *.. .\.... . . .. . ...**\\.*   .* \*.  \ .  .\..... * ..**\*. \*.  **..\*.* \ \..\.*** *\**\ ..* ..\ #                                #
# . **\. *\ .*.*\ .. \ *.\.*** *. \.      ..*. *...*. .****.. *.**. *** . *\*  \* .**.\\*.\ ** \** *\*.*. .\ #\.. ** *#...#                               #
#. \. .. ...\. *.. \ ...  ..\*..  *\  \... .\ **.* **\* .\**\.*\.\  .\\. *\ **. ** .\.*.........*. \..\**.  .\*   *.*#.  .# ####                          #
#...*.**.  ...* .**. . *\. .\.  .  .\\ . *\.*\\\.\. *..   .\* . ..*.\*\.\.**.*\ .* .  **..\. \  ** *.* .*..*.\ \. .\..* .###.**\#                         #
#.. . *..*  \ * .. .  **   .*. *  \.*.. .*. . .*\.**.\  \  \.\ .*.** \*.\.*\.*.  .  * ..*\  ... *. . .....*... .* **.\#.   * .*.*#                        #
#*  \ \  . ..\** .*\ * .*.\ ...*.*. *.***..\  .*..*.*.   .\.\.. ...*.*.*. ..**  .*  . **   . *... .\. \. **   ..\\....\* .\    .#                         #
#.. * ..**\ *.\.* ..*   .**\. \*. .*\\ . . *.. ..\* ..\ **\ .  *..\*\.**  \*\.\.* ***\..* \.\.\.*.*..  ..***\  ..\*  \.  .##\ ..#                         #
#* ...\* ** .*. .*  ***...**.\ .** . .**.*.   ...**\\\* **..*.\.  *.*  *  *.. \ .\.  \.\  . .** . .   * \  .** *.\.\*..  .. ..* #                         #
#. ..\***..  *. ... **..*\*.***\ .  . *..... .\*.\. . *....*\..\. .   ..  .  *.*......  **\ \.     *...  . ..**.. .**   .*\. *#.*#                        #
#.*  .. .  . .**  *  ..\**. *..*  \. *....     .*.\.*\. * .\. *...  **..\. ...*. ***. .....*. *.. ... .\...\.*...\ .\..   .\... *#                        #
#.*  .. *.*\  . **\   .*.\*.. ... ..\.\**.\. . ..\.  *..*  *   *. ..\\*...    . \*.*\**.....*...  \*.   *.\ .. . . ..\*..*  *.\*#                         #
#...\     .**\*\.*..   . *\. * . .  * .*.  .  .*.. \** \.** .*....**...  . \   .....**.\...\.* .* .*. ..\..  .\.\  .\...*.\.. *\.#                        #
#  . *.\.... .**.. . .* *\ \\.*.*.\.**...\ * .*.*. .. * . ..** *.. *.  *\*\..  . *. .. .... .\  .\...    . *  .. .. ..#\...*\.###.#  ##                   #
#**.. .  .*.\ \.**.. ****.*.*\*.* * .\.\. *.* .. . ***..* *  *\.. **\*** ..  *.*\.* \ \.*.\. . .... .. *.*..*\*.   . \. .\...\ ... ##**#                  #
#*..\.*.*\..  * ** \**.*...\....\.\**    .*.. *.. .\*. .*....\. .\.. .   . ...***.. ....*\   ...* \.**.\...\.*\\  ...   .*****. *# ##.#                   #
#*. * .\.* .. \ .. .\* .. * **.*.*.**\ .... ..*\*  *. . .\.\* * *  . * .    *\*....**\*\....**  * *....*\**... .  .*.*\  . ..*..##\. .##  #               #
#. .\..*\.* **....* .* .*.* .*.  ..*.** ..*. *.......\ \.  .**...\  *.\*....\ *...*.* ... \ .\. . .. . *.** .* .** ..  .*\ \ *.*.##\..* ##.#              #
# *. * * **.. .* \* **\ .* ... \* ...**  \*  \. *  . .\.*\  .. .*. ..**.*.. .. . *  .*  .\  .*. .\** ..\ **. .. **...*\* . . .*# .\ #\  . ..#             #
#..* ...*.*.  *\  .**..* \ . *. .\ * ..\**.  .* .***\* \.. ...*..\\  *.*...* ..  . *.\  . * .*  .. .\. * *...*..*\. *\*\\ . . . .*\. .\ .#*#              #
#\ *\*.****. ***\*.\.*   .\  \     *\... . .. * \*.\.. .******.**.. \*\.. *.\**.\***\.. . \*.\  *\*\ . .\. * ..\   *.* *.** \.# .* *.\.  *.\#             #
#*.\.*...**.***\.* * * ... *... .  .    .  .*\. ..\  **  .*.... .  ....** *. .** .*.   \ ...  \...\.   ..  . .*. ..  \  \\...   .*\.\. \*####             #
#...*.\.....*..*.\ .*\ .\.\.. .**.*\   .*. .*. .\  .\\* . . *  . .  .**.. ...\\.*. * .\.\ *\ .... ****.**. . **. ...   . *.. ... .*..**\.##. #            #
#...*\.   \.*. \ *. *\.\... .\  *\..\.  \. ** *.. .  \ ..*.......\\. .  *  .\..\*\   **.**\.  **\ .*..* ..  .*. * *\\ *\*\..**.\ ...  \*....*#            #
#.. * ....*.*.\* .*  .... *. .*\ .*.. .....*.. .\..   .\.\.*.. *\.\*    ...... ..  .\....*.** \..  ** * **  ... . \ \.\ \  \ \.   .* .. *\\*#             #
# . * ..*\* .*.**..  .. ..  *\..    \.*... \ .*..  *   ..* ** .****.\**..*.. \. ...*\.*\ .*\.*\..* .* \.*  ..   .. \.*..  \.***.  .  * *####              #
#  \ \. **.\*.\*.****\ *  ***.*\.\  . .*.  .  *.**\.  .* ....\ .\**  .\  *\. ...*\.. .. ...*.... ..*..\.. . *\. **..**.***\.*. *. .#\**.***##             #
#*\. \..*.* .*.**\...  *  .... *  ....*.  ..\*.***\. ***  *..* \.... *\. . .\ . ...\.*\. ..\..  ***\   . *. . \ ..* .. .\*\. . .  ** ..**.**\#            #
#. .    .*.\***...\.....**.\*  ....\.**\.. *.* *.... *.*\*. .\ \. * .\ .*..\   .* *  .   .....\..*..** * .. *.  *.* *. *... \ * *...*. .#.*##             #
#*\  ***  \*\*  *\  ..  \.\  ...\.\ *.. . \ ..\. \.. * . . **... ..**  ..\.*\ . .*\* ..**** *.  * \\ ... .  . * ...\ *\*.*.  *.   * .**.* # #             #
#  \ ..\.  .\.  . \. .\ . *\. .    \*.*..\.*..  \*\  *.  . ... .  \*. * .*\. * . .* \*..*... .  .*.*\* ..\...\.\ .\.....   *\. *..*.*..\**...#            #
#.*.*\ .\ . .*\  *.  .  . *.\.* *** .  ** *\.  .....  .* \ **\.   .* .\* *. ..*  . \..*..  . \\.. \ .\. \ ..  \.  *.  .\   .*\**    *.*..**. *##          #
#\.*.\*** ..* *\ *.*.\ \  **.**.... ..\**... .\ .\.\ . . . ***.  * .  ..**  ..**.*. ***  *\. . *....*.. **\.*\  **.**.. \ .*...\ *  ... *....\..#         #
# .*\..*. \.. . .* \.. . *..\.*  \.  *..* .\ ... . .* .* .  \.\*\*.\ **. .  . .*\....*..... . ..* *..   * \ .*  \* *\.  . .\*\.*.\\   *\... .#\*#         #
#  .. *.... .*. *.  . *  .*\.    ..  ..**  . .\ .** * **.* *...*..  ***.*   ....... *.  . \...\ .\. *..*.\. \*.*.  \.  * \  *.\  ... . ..\. .. #          #
#.  .*\..* ....\  ** ..***\..  .  .  *...***  .\*.. .\.* ...*...*\ .. ..*.*    * *..... *\***\*\\.\.\\.. .** .*.....**.\\*\ . .*.   \*.*\** #*#           #
#  . **\.*\ ...*.\.*   *. .\  *   **\**..*... ..\     *..*    **   . *  .\.. \.*  .*.**\\.*.\*. . . .*. . .* **\..  .   .\*  .* . . .**. ... #            #
#.\.\...*....* .  *. ...\.\**.. . \. ** *\. \ * .*.  **.***\.*.* \.. . *. * *.*.  \...\ .*.. *.**\  ..*. . ..*\* * .** \...* ..  .**\..* *.##             #
#*. ...\.**  \  .\\** . \* . *\ \*  .*.**..  \.  *.*..* . .   *** *..\    *. *.*..   \*.*\ .\  .. .  ...*. \*..* ..**.\.. .\....* .*.**.\*.#*#            #
# * \.  .\ . * \*. ...* ..   . ** *.*. ..  ** *\*.*..*.\ \*\*.\.\... *..*\.   ...  *. ..\ .*\.   \  *...*. .\ ***\ .. . ****.* .*\*.*..\*\. \ ###         #
#\.\*\ \ .\.\..\. .* ..*  ... *. **\     *... . \ \.**\ .\ \. *..  **.* .* *.* **. .\ *..**\.*\.\.  *.   *.. ..*. \*\.  *.*. .. \.. ..*..*  # #* #        #
#.\*..  **..*\ ......*. \*...* .\*..\   .*.\  \***...**.*. . .* *..*. \*..** **.* .**.\ \***\.** .  . **\.*. \ . .\*.\.  *... .*.*.\* .* ****.#*..#       #
#. ..    . ... *\*  \ .  *  ..\ .... .*....*  .\. . *.\..\. .*..***..\*.**\.  ...*\.\.. ..\..  ..\. .... \*\...\  *.\ *\ .*..  .\.\ . .. *... **\#        #
#      ....\. ...*.* *.  . .*\*\* .*..** * .*.\ * \ .\. \.\..***..   ..\....    .  .\* \ * .* \.  *.*.\..... \..* .\*\. .*  * \.\*   . .\\ **.\ #  #      #
#...\** *  ...** .*..\.** \ . **. *.. ** .\.*. \....*. ... *...  *  *..*\. . . .  \. .. * . **  . *.**.*\     . . **.*.  .\**\ *...\* * .\\.*\\*\## ## #  #
#.  *\... . \ . \*..\  .. .. . ....\.  .  .**.\. *.\** . \ .*..... ..\ \  .\  *..*. \ \ \   *. * .*..**\  \ . ..  ..*.*.***.....\ \.\.  *  ... .*#* . # # #
#  *. \. .\.  . *.. . .  * * *\*  .*.*..\... .* \.*. . *..*.****.. \ *..**\\. .*..  .....** *\.\*.\.**\... **.*. * *\**\*.\..**. ..\\ .. ..*. .*. *....*# #
# *.*...\\*   .\..*.\ *. . .*\  . \*\ *. .*   * .*. .  . \ .* ..\* . ..*..*\. .\*  \ \.\  ..*     * \ **\* *.*\. *  *.\*.*\.* . . ...\.. \* \.**...... #*##
#*.\.*\.*.\.***. *. .*.\  . . . **.\...\  ....* ..* \**.*.*\.*\ *. . *  .  *\. *  **.* *...\* ..\.*...\...*.* .. .\ \..*.. *.  \ ... **  \..\...\..#\#\  .#
#* . *\.  . . ....\**.  *\   .\.\.* \ ...   * ..* ** ..**\.**..  *****. .* .*. . .  *.. *..** *   *...**\.*.. .\*\*.. ..\.  .\*.  .\.*\. .. .   \\..* .\.##
#*\. \. .  . . ..\*.... ..... .*.*.  .  . .*\   *....*..\* ...* *.*.*  .*..*.  .\ .*.*.*\*... .   .  ...* *\*. .. *\.* **  .*.. .. .\*.* .\\.    #.**\*  ##
#.*..\. \*   .\*.*  . ..\ \  *.*.* .\ *.. .*.   .*\*..\*.**.*** *..**.. .*\* .\  **. \*.***..*  . ...* .. **. \* .. \.*.*..\* .*   *  ...\*  ..  .*.***#\ #
#.. * **.. .*...*.   .\ ...\ . . *\ .**\*.**  .*..*.\..\.. .*.  .\ ****.....** \. . * ......*.  . .**.* ...*  ..\*\.. . . ...* . . .\.. . .*  .\**.  \.  ##
# *.  .*...*.  .**.* * \*.*  . . \ .*..*\**.....*.* *\. .    .**** * *... \\.\.*.   .**. .\ ....*... \* * *\   \*  *.. *  *.\\.\..*. .  .*.\ \.*.\ .*..#*##
#.**..*  *.\*\\*.*\.  .*..*\.. *..  .\.*  .\  .*  . *\\..\.*. .*.. .*.*.* *. . . . *.\... ** . *.*..  ...\*\**. \  \*\* * .\*\ . .. ..*.\.* ..*...  . . *##
# * \..*\\ ***....* * .*.*.*\ . ... .*. * .*. ...*.. *.*.\*. .*..*...\....**. * .* \.*.*\.\.\.*. ....**.\*.\  ...*.\*.* .  .* ..... *...\  . *.*..   ..#**#
# \  *  **  \..*.*. *\ ...*.. \..  .\. .. ..\ .\   . \  **. \ **.. \. * ...*..\... .** \.\ ..*..*... \* ..\. . .\.*\**  .. **.\ ... *.*..* .* **  *\* \##*#
#.   .**\. . ...  . ..** \... *\*\*.   **..*. **.  .\... ...*.*\ **.* *    ..  \*\  .\..*..*..* .*.   \***  ***  ..**.*  . \..  \. ..*\. . \.  .  ...\.*#.#
# .***... *  *. *\. .  ** \.\.. *.\  \..* *.. \* \..* .\ .*\*\..*....\..  .\  .**.\***  . .\* *\\.*\.\... * ..\.. ...\*  * \ * *\.\. .  .  ...*  *. *### ##
#\*..  \\.\*...\..\............*    \.* . .  \ .\..\.***.  ....*\ ..\** \. * *.\.*.\ .\  .*\*\. . *\ .... ..*.* .\* .*.    .   \ .*.*..\.   . *...  .* #  #
# . * ....  *\.. .  **\.\*. \.*.    . .  ..\   . ..**.*..** **.  * * . *. .* *\ *. ..***  *...*.  *** .* . *. .\. \. .*.* ***.*.  ..\. .*.*   \  \..#*.#  #
# * * ** **\* *. ***..\. ...  ...  .*\\ \.\***.. .   *\ \.\\\.\* .*   **\* .*.  .** ..... ... ..* \ . ..**. * \* \.\.*.\. . .\. *\. *  *..\ \. *.. #..\#  #
#   . .. *  .*  ..* .  ***..*..   \ **..  ..** *.*..  *  .*  *..\ \ .*   .\**\ *. ****\.*\ .  .***. \*\..*  .\. \.\  *\. *   **\ ** . \..  ..\..**\*\.#   #
# *\  ...\ .**.\  ..\. .*\* . .* * *.\ .. ..\. ..*\.* ... . .\\*.*....\.**..*. *  .... \* .** .\*.  . * \. ... *.\ .*\.\....**.*.*..\..*.... . .... # #   #
#.. \   ...*...*.*.**.  *..* \*. \..*..*\ **.. . ..*\.    *\ .**...   .**.. .*.. . \.\*   *.\*. \ .*.* ***\  *....  * .***.\*..**.\ \*   .  . \* .. *##   #
# .*.. \ .\.**\. * .** ..\*....     *.\. ..* .  *.* \.  . *.*..*...\   ... . .* .\  .. .**. ..\ . *.**..\.*\..*...\*.   *.\ *  *.\ * .*.  * *.... # . *#  #
#...   * .   ... \  *.*** .\. .**** *\ .\.\.\ *...**   * \. \ *..*\  **.  .\ .\ .*.  .\.\.   R . **\..* * ** .**.   *.*..* *\ .*.* ..   \.*.\. \*..  #.*# #
#*\*   . \**..*. * \  ..\.\.*\..**. \ . .....*.\ .. . ..**\*.*.. .*\* *.\  .*....\\*. .* .  . ** \.*  *  \ .  . *\...*. \. *.*\..*\. .**.*.   **...*..##  #
#***  * ..\**...**..\* ..  **.  ..  .*\  \*..**  .*\  **...\ .*\*.*** .... \* \..  .*. *.. .\* \  * \*** \   \**.**..*.**..* ..\* ..\ .  ** ..*\.* \*.#   #
#\.\..*\*   ..   .\\\.\.\  \* \ .. ...\. ..**\*. *.  .*. *. \*..\.....*. .*    *\ .*   *. * .. *\*  ...**. \  ..*...\. . . .*\.... \*.* ..*\.\*.*.* #*#   #
#*    *..\.  \.... .. .  .\ .*.. . ** .   \..*...*\.. .. *.\ . *.**   *.  *\.*.  .*. \.*\ ..***....*\.\.*** **. \\ .**   .  ** \.   ... .. *# . .\..#.#   #
#**....  .. .    **..\.***  ..  .\..*.\. \ * *.\ .*.  *\ .**.* ***.*\*   .* ** *\.* .\.. **.\ *\..\.*  *......\*.*. . .*\ \**..*\\....   \ **. .##... #   #
#..\  \...  . \ .***** .*...*   . . .\*. \ * . *.    ...*\.\ **. .. ** .*.\\.* . \.. .\\.*. .*.. .  .\*\ *..*\*. .  . ** ..* ..    ..*.*. *...**. *\##    #
#. *\*\\    *.. **.*\. .* . ..*.* . *.. ***. \.*... \ *.\ *.\** .**\\..\*.** ..\.  \  .**.\  . .. .*...***. ...*   * **.  ..**\  ...\.\.. .\  ..\*.# #    #
#**....\*\ \.   ..*. *  .  . ..\\ *.\.\ *.\ .  .\.\*. *.\*. ..*\ ..*.*\   .\  .*\.  .* *. . .  . *.*.. .*.\..* \..* ...\.*. *\. .\.\.*. * \*..*.## ...##  #
#.\.\*   *  .  \**\. . .  ..**...\.*.....*.. ** .\.*.  . \ .*\.* \  *.. *.**. *.  . .*.\ \ \ .. .*.*   .\.* ..\ \ ..*.. \...\.  ..\  .***.\** .\*.. .*. # #
# . ....**.*\.*.\..\. **..*. **.\  ...*. .  \..  . .  ..  . ** .\ *.*  \...* ...*... . . .\.***\ ***.. \* .\**\ .** .   .    .    ..*..*....*  .\#.#..##  #
#\.. \* .*..* .  .\.*.*.  .  ..\.\*** ... . .\. .  ....\. ***  * *...*.\. .\.\. ..*..    .  *\*.*\*.*.  .\  \.*.**  . .. . .  ..\.**.  *.  ..\..\##* #    #
#. *.*. *. \*  .*  *. .. . . *... \*.   *\ * . *\ . * \*......  .. *.  \ . . .\ .\. . \*\  .\ **.. . \ .\.*\ .\..\...** .*..\ ....\. .... ..\  \.#\*\#    #
#.  **..... .   *. .*.* \ *  . .. *...  .. .\ ....\ ..\*\ .\*. *    **.\ .. *.\.*  . *.. .*. *\*. .*\   *\*\ . \ ..* **. \ * *..** \ .  **\  ..#.*\##     #
#***** ..* .*.*\.   ...**.\*\**.  * \ ..*..\*.\*\ .*.. *..\ * ..\* .\...*.. .\*.  *.**.  .*. * ..\.*** . .\ ..*... .\. \ . **.*\.. \..  ..**. .  *#       #
#..\.. ... .*.\  *\ .*.... .\..*..* .*  .*..\*\.  .\. . .. *****.*** .. .\.\ *.. *\*.\ *  **.**.. .........\. ..\...  *. *.*.    . .   \..\*..#.\#        #
#\ .....*   .\..*\.*\ ..\   * *.**.. .. .** ..\.. . *\**....\.. .\.*\. .*** \.\.*.*...*.\\.. \ \ *.\. \..*\* .* .*..* .... **.\  \   \..\* *\.. *#        #
#  . ..... . ** ...\. .  \  . . ** *.  ..*.* *. . \.**\.**.  ....*\.* . .  * .*.** ..\.*. .\*  ..** ..* *.*. \..  **..*\ . \.... \....**..  .. \\ #       #
#\. .*.  **.*..*\ * .\ * .* ..*...\.. \.. *. .\..*... \*..\*.\*\.*  . .*   * *.... . * *\..  ....... * .*\.**..**\ . \.. *... **\..   ..     . #.*#       #
#.* .  *\**\.....**.*..  . * .\. ..  ..\ \.*. * **\.\ ** . *..* \*\ *.\.*\  .... *** * **.*..  . .  *.\ .. .\. .. . .\ .... * ..*. * *\.***. .*##*#       #
#* *   . . . .. . \* .. \. ...*  \\..   \ **  . ..  .*.. .* * .*.*.*.*  .. .\ .. ..*\. ***..\ .*\*.*.*\ *.. .\**\.\ *.. .**..* **\ *.. .*.* .*## #        #
#.  \*.... .\* *\ ..  \ \* \.**  . ..\ .\... . .  \ \   . .*.. ... \.\  .   .*... .\.\\  . ..... ... ..  .* **  ..... .\*..* *.\..\** .*..\. * .#         #
#....*.\..  .*.\**. .\.. * .\*..\..*... .*\.\.** \.*.\* \. *\.\ .\ * .*. .*.*. . . *. .\ *\.. .* * \* \. **.. .  \...  **.*\*\\. \.\..*. *.\...*.#        #
#.\  ...* \.*.\. .. *.*.*.\**** * *. .....\ . .....*  **.*...* *.. .\ *.\ * .*.  . \ *.. ...  **..*.. .* * \ \..*.   .*  ....* *.  ...   #  #####         #
#\.** .   ..* .**. .**. * .\...*. ..    \  .. \*\ \..\.*.*.  .\.*. ..*.*..** ..*.  .  . *\.* *.\*.  *.\.*.*  **.* ....\ .\.\ .\ .  \ \ . .# ##            #
#.\.* *\.  *.\*.*\. ..   ** **  ..* **\ ... *.\* .\. *\.   \ *.. * *.* *.. .*\.   .*\**** .. *.* ....\. *.* .**** . .  *  .*.*\. .\.*   .**...#           #
#.*\***  *.** ..\.*. . . ... . * \.*..   .\* ...*\ \ .*..\.\ ***...****. \.. .\ *\** .\*.   \*..   .. ..*.* *\*.... . \* ...*..*  .\. .* #.# #            #
#\  .\   . ..* *.\.. **\.* .\..\ ..*. *..  . \\.*.   . \  **...   \ .\... . \.  .*** ....**\*. .\.. .  \ \  \.. *  *\*\.** \ ... .\.*. .#..##             #
#.\.**. *..  . .\**\. ..*\  **\**\*.. \  \* . **. .\  \.*. .   ***  .... *\.  . \ .*.*\  *\ ** .  \ *\ ..*  ..\*.*.***..*\*.**.  *.  .* *...#             #
#. .  \**.*.*\ . .*  .\.*..* **.. .* ..   .*\...*\ ..\.**.. ***\..\\*... . \ *. .\ ..*.\***... * .....* *   .\ . . .*.*.. .*.\. .*.*. **\ . .#            #
#\ *. .*. .*....\*.*\ *  . .\. . *.....\ ***..*.. .* ** *.  ..\  *.\.\ . . .***.\.** .. ..*\ ..*. . .\.** .  . . ...**\  * .. .*  ..\ ... .  #            #
# \.  *\..\  . **. *\..\* \.. \. *. **.*.\.* .. ..\  .  .\ \.\.  \ .\**...\..*.*. .*.***  .  .\..*\\\ \.*.  \ .\ \ * .  \*.    . \.\ *  . *.*#            #
#*.. \*..\.\ * ..*\.. **. .\ *  . . .*\...*.. . .  .* *.. .. .**..  ..*\*.   \*** \...*. .* *\*  .. . . **.*..  \* .\.*\ ..\***\ ** .. *\ ..*#            #
#* . .**\. *.*\*     \.\ .  .  .  * ..*\\ *.   **.* \.* . \. .\**..*. .*.*. *.\*. .*\.*\  *\. ** **..  .*.  \\  .*.****.**...\..\..   .. . \.\#           #
#* \ **.. **...**.. * .   \.. .*\*\.\..\. .. * \* ** \* . .*\\*.\ *...*.*.. * .***\ . . *\.  \.\.*\\   .*   .  . * ...\ *** \. .  \ ..   *\..*#           #
#* ..\ . ..\.*\... ** ***   . . *. **\.  ..  *..** *. ***  .. * .*.*......**.**..*..*  .\*\ .*.  .* .   . *\   \ .\  *....  *\ ****\.\ .\.*\*.#           #
#  ..\ . *  .** .  ..\.*...   **.***..* .*. ...\.  *  *\** *\\. .* ..**.\ *  ...*.\.* .\. *.*.* **\   * ..\ *.*.\* \*.\ * *\\. **...* . .*. .*#           #
# . . *  *........ .  .**  .. .*\ **\ .\..** *\    .**.*.\..**. *.  ...* .*  .**.. *. \ ..*\*.*.... .\..\ * .**.   *.   .\ .   .\ \.\.   ..*\#            #
#  * ..\\   .. \  .*.*.** * ..*\**\* .*.. .\ .*. .  .  *\*. .**\*...  ...*.\*...*\ .*..\ .. . .* ..  .* .  .\\\\ \*..* . . \ **.  ..   .* #**#            #
#\..  . *  .*. \ ... .**.... ** *\.*..*. .. ****.*.*..*  .*\.\* .*  . *\. ... ..\....\\. \  .* .\\   .**.**. . *..\ .\ ..\   \.    *\*. #* *.#            #
#. ..\  .\. *. .\*\.\*.*.* . ..**.\* .* ***\\** *\.\*\. . .**..**..* *\...\*..\.*.\. ** \..  *. ..  **.* *\*...*...\     ...\ \*. ***.\*\.#*\*#           #
# ..* * **. *\.*.\   .\\.\.  \  .*****..  . \.. . .*. .*  ...\  .. ** . . ... ..**   .*\. .\     *. **.* ******. .\.   ...\*. **.*.\  .*#..*##            #
#   \.\*.\*.**...* .\..*.* .*\**\**..\ **  ... .  ..\.*. *..*  * . \*..*   . *  .   \ *. .\. * *\** .*\..*..**.*.*. \.. ***.*   *.. * ..*\#\#             #
#\.\.\....... **\*   . .*\ *.*...*. .**..   .* ** * **.*.   * .**\*.*. *.*\* *.\ ** .*.*..*.\. ......\.\*.*\.\.*  .....*...*..\*. . .* *.*  #             #
#.   ...\*  . .\. * . .\...* .\.\.*\.*.    *..**..*  * ..*\ . *\\.... ****.*\\  * *\ . . *.*.*.** . \   *..   .\     . \\ ..\\ \.*  \..\..#\ #            #
# *****. .\.\*.*. ..  **\.*.* .***.*.** \* *  ..* \..*.*.*.**.. ..* .\ ...\ ....  . ...*.\ .** *\ * .\.*\ . *..*.\ ..\. ** \  .. *  .\ . .#.#             #
#\.\...  *. .**.\  *.*. * .. *.*\.\. .\..* \.* *.\.*.**\ *\*..*.**   **. \  . \ *. .* .**..***..  .    .. *...*.\...* * .....**\ .*. \ * ###              #
#.\* \. ...* . .. *\.*.** \ *.** ...  .* .. ***\*.*. ..* * ..***** .**.  ..\.\. *.\ .\ *..\ \.*    .**\  .* * . * . .*. *. . \.   *.   *\**#              #
#*..\.  \**. .\ *... .*.. ..*...\. *.. . \  *..*.*.* .\. * *   * .  ..**   .*. *.\.. . *...*\*      .*. * .*\.*..\  .. *\*. **.*\*.\. **.*.#              #
#. **\.. .*.\  \.***.*   \..*\  * \*. \ ....*   .. *.   \*\. .*.** *.\.* . \..**\. .\ *\ *...*  .*\  .. .  .\*..**\ *. .*#..*..**. . .\\* *#              #
#*.\.** ***\.\*..\*\.*. *.\..   . ...\ \*.*..\..   .**. .\.*. . ..** *... \   **.. .*.\ .*  \. .\ *...**...* ..\.**.\.*   .\.. *\**\...#  *#              #
#..* .\ .......  *\.*.\*. **\..  .    ***.*   \ .*.\**\.***..** . .*. \. .   ... * ..\.. *\.*  ..\** .** *..**.  ***. . **.*.. ..**.\..*\ .#              #
#*\*.\. .. \.* *.....*.*\**..  . *  . .*   \.\. * .*.* **...*..* . \.* *.   .* \ .    .. ..*.* \ ...\*.\. *...* .*.*\..*.*.. *  .\*  *#####               #
#.....\ \. ...*.  \  ... *. . . . *.\  ... .. .\..*.. .* .*\..*.\*\.**.*.*** * .\ *.   . .  ...*.\. *.  ..\ *\   \*.*\\. . * ... *##\.#                   #
# .*  *\  . \ \*. . ... \  ** \.  ..*..*.*.  .* * .    .*  *.*..*......*......  *...**..*  .**.*. \.*\\*.   . .. .* .** . ..# .  .\ #.#                   #
#\ \. \*. ... .\  . . .   *\. .\  \ ..\  . .\.*.. *\ *****.* .  *.....*... .\.*. ** ..*\.  .** .. .. * ..*.*.  *  *\  * ..*\ \*.   *#\#                   #
#\.*.*\\*\    ..\    . . * .\.*.**\* . \ *\ . ..... .. .* .... *\.** . . .*\....\*\*  . .*.  * \*\ \ *  \..**\. .    *.*..... **.. \##                    #
#. . ..*...  \*.\....\ .  ..*.....*** * .....* **..\ * **\.    . *.\.  . *.   . *.*. .*\*.*\. \ . *. \ . *..\  ..     ..*#  * *.*#.#                      #
# . . .*  \.\.*.**.  ...   ..  *  \.* **.... . *.  ..*\. .*. .\  ..*. .* .. ....**..  . . *. \...** *..* \...  ***.** *....*##### #                       #
# *\. .*\.* . . .**.*.*  .*..\.*\\.**\.*.   . *\**\**. *  **.* . ......\*   \.*.*** . .\  *  ..\....* .***\*..\****. .. **##                              #
#..*   .\ ..*.*.. .\...\\ *.* . . ....  .*    . \.... \.\...\ *\      ....  . .\.** ** *.*...\ *... \  \.*...  . .. .* *#  #                              #
# ...\ ..  .**  *\   .. . . *  ...\.   . .*... \. *.   .   \*.* * *\..\ .*  \ . .....  \ .***..\.*..\.   ** ..*  * *.\.*.##                               #
# ....* *. ...\ . .. . .\ *...** ..* \ \.\\  .*. ....\. .   ..  . *.*.   .* .*....*.    ....*..* .\ . .\.*...*** .#*\#.#*#                                #
#*\** * .*. * .*\ *.*...  .  **\  **\  .  * \ .\  ***.... *\. * \ .*\ . \.**\. \\ *.\ .* *.\.**. *..\ .\\.\   ..\ .*.## #                                 #
###########################################################################################################################################################