#############################################################################
#     #\* .* \ .\.*  *    \***\ . * .*.* **  . .\***...\.\* *.\.. \***.**...#
#     ### . . *.    *.. .  ..    *. *.*\ *. *\.\ . * \ ..\\ *\* .\\...\....*#
#    #. *\ * *.\.*..\ .   . *\  ** .*. *..*.*** ..*\*..*\ \.**...*.* ..   \.#
#    #* .. . \ ..*. ..   .  \.**.. ..\ *  . *..  .* .*\*.. .* *.. .*.. .*..\#
#   #...\.  .. ***    .\* ...**....   ....*..**  .**....\.. * .**\  ..   * \#
#  # .  * **. .... \ .\ \   *\**. \*.*.*... \*.\. ... . .. . ...* .... ... *#
#   #. .. .*.*. .*\..*.*  *..*..  ..*...  . *...*.\.*\. *  . *. \ *       * #
#  #*.\..\*. ..  .*.. ** ***..  * * .. \  .. ..... ***\\..*. .  \     *.\. \#
# #.   . *\... .*  . * ...**\*. \..  ..*\.**.** .\ ..  .* .* \ ****.**.\. ..#
#  ##.* \.  *\*..  ... \*\*. .\. .*..* ..\.*... ..\.*  ... .. *\  ..*..*  . #
# #\ \.R . .*** .... *... .\.\.***.*\.   \.* . *\  ... .\ *   *     \.**\  .#
#  ###...**  ..\**\.\*..\.\... .*.*. ..\.* .\ *..* \ *..  *..\*.   . ..\    #
#  #**\\...*.*.\..  ...\.***\.**..*  ..\\ .. ...*** ** \.*   .* ..\  *\*\. *#
# #\#. #.\*.\.  . .\ . . .... *. .\ **\**\.  . .*.\..* \..*.\..   .\ \.. \\ #
# # # . ..# .\*. .\..\*. . ..**.\..  ..*\.\.* .*...**  .  ..  . \ *.\ *   *.#
##**#*##* *.* ...*.  .*   **..*..  . . \.** .  *.. \. .*.   *..   **  . .\* #
# #.\##.  . . *  \*\*  *. *\... ..**\* .. .\ \ ..\\    .\ .\***\*.*. *.* . \#
# #   *    * . .* * *..    .* ..\.*.....\...***\ .  \ * **  ..\*...* . .**  #
# #    **\*.*.***  *\. \.***.\ * *\***. ***..\\ ...\ ..\*.    **.*\*.*\*.***#
# #\..**\ .\  ..*.*....   .. ..* ..*.\.\*..**... . *** *...* .\.*. . ..\.*\*#
# #.   *\. .*.\ .\..    .\ . .\\. *..\.  *...*..\ ...* *.**  ........*\  \ *#
# #\\\......*.***.\. ...\ **.\  *.*.**.\ * \** .  *\ ...**.*.*\\..*  \.\** *#
## #...... . .. . .   **.**.*  ... * * *..\ .\. ....*.* *. *.* .  * *. ... .#
#.***\*\* . \....*  ...\.*....*  .\  \.*\ . .*\  .  \*  . \*... . * . .. .. #
###....*.. \. .. \ .. **\.*. \  .*..  .  ..  .*   . .*. *\* * . ...* .* *..*#
# # .\..  \.*** ..\.. .*. *  . *\*.** * ...  .* \\* ** *. . . *.. * .** .\ \#
#  #*.*\.*\....* .* ... .*.  \.*.. *\  \.\* \*.**..**.*.\*  *.*.  \ ... .\..#
# L......*. \.* . *.. .  .. *  . \.\.     . ..*.\* .*\ * . .\.*.* ....\.. .*#
#  #    .. ..**. **\*\\*  .*. *.*.\*.*\ .* .**..*.**\.. \   .\*.*   . \\ * .#
#############################################################################