###################
#**\  .\ *  **..\.#
#...\  .*.*..\ *. #
#.*  \ ..\   *..* #
#\.*.* * ....\. *\#
#*.* .\...\ \.* \.#
#*  .**. .*\*.  .*#
#**** .***....   .#
#..*....... *. *  #
#\... . \.*....\..#
#* .*..*.  . . ** #
#.*.\. *..* *\  . #
#. \ . ** * .  . .#
#* . ..  \  . . . #
#\* * .*. . *..  .#
#*. .* *.. *.*.***#
#.*. * .  * ***..*#
#** .** .*. \ .*. #
#\**\*.  ..*.* * .#
#*....**..*\*...\ #
#.. \.*.. *....\  #
# ... *.*. ... * *#
#\. \.\... ..  \..#
#. \.   ..\..*...*#
#*...*\*\\ *.*\.  #
#***.* ..*..  .\.*#
#.*.. .. . \. *** #
#\.**  *\. ..* ** #
#. *. ...  .\. \* #
# .* ..\  .\.*\..\#
#  \ \ . .\ \. *\ #
# *. .**.*.\..\.  #
#. \* .. \.. . ...#
#\  .*\ .   *.\ *.#
#. . \ *\ .\.* ..\#
# .*. *  **  .  . #
#\ ****. ..*. ****#
#. *..\ .\ . . ..*#
# .. . ..**.*.*.*.#
#    \.\ *.*\R. * #
#\..\  . ..*.\ .. #
#\*   *\ * ..* .\*#
# .\.\ ... \..*\ .#
#\... .**\.  .* . #
#\     .*...\ \*.\#
#*.   . * .\**.*\*#
#* . * .\.  .*...*#
#***\.\  \. *..  \#
#\.* .. .. .  . ..#
#* ..    *. .** . #
#. *.. \.\.. ** #\#
#..***  *.* \.**..#
#.\*..  .*** .#**.#
# ..... *.*. *.####
## *#\..* *\L**\###
##\.\.   . **..\.*#
# #**..\** ..\ .*.#
#  #.*\.** ** *..*#
#   #**  . \*\..\##
#  #**.\  .\.\.#\##
#   # ##..###* ## #
#   #.#*.\..##.#  #
#    #... *.##.#  #
#    # *.*. #.\#  #
#    # # #..###   #
#     # ##\#      #
###################