######################################################################################################################################
#          ###  #...\*. *\ *.* ***\.\ * . \.    .*\ *.\ **\\.* \*** *       \*\.\  *.\*.\ .\*\* **  *\\. .. .*  . \.**..* \**.  *. .\#
#         #*.*##. . *. .  *. . .. .\. .*\ . .* *** *.\.*...  .  .*\. .\..* \..*.*  .\ ...*\......*\ .******.\..*    \..... .*. **. \.#
#        #.#\**#.  \.\.. .\..** *\****....*.*..\*\ . .\. .\ \ \ ..* **  .* ..*..****.. .\.**.*  \.  \.\\\...\ .....* \  . \ \. .  .\ #
#        #\ *.#*.*\.*. ... \ *.*. \ \.. **...\* *..\     .\*.\.. ..*.\.*..  * * *. .* ...*.* ....*  .**  .*  .*\*.\..  \ ...*  . \.. #
#       # .* . .*. \****.*\.*.\.*\.*.*.\.*  **.....\.\**\.**..  \.*\  *\..*. \  .. .* ..  \.\ *\*..* *\   .\  . ..   *......*\   ... #
#       #.* ..\*#. ..##. ...**\..  ***.*    . .*. .*...\.. \ .\. .*.\**\. * . * ** \* ... *....  .**.* * *  *... ..**. .* . .. . ..*.#
#        ##.\. *.*.   *. \...... . **.\..  .\  .. *   . **\   .*\  \**\* *... \\.. . .\\.**.\*..* \.*\\. *\ ..*.* ..**\  . \ **    **#
#        #\.  **\. \**.. **...\.  \.*\..  .  .**\ . .*  ..*. ... . .\.* .*. * .*  *. .*\ * *.\ ..\     ....*..*. \\..** ..\.**. .**..#
#         #*..\..\..\\. ..*..\*\\ ..*.\ ..\   *. *\ *. .\ \ \ ..\ ...... * ..\ * .. .\. ..*.\*\.\*.....*. .***.  .   ..\*** .\ \.\\.\#
#        ###\* ..\\ ***. *. ..*#  **.\ . *  \.\* .**.\    .\...** *  .\. ... ..\.. ...  .   ...\ .**...\ *..*...*  *. * **.*. .*\ . .#
#       #\.  *    .\*...\**  **.  **\  .....* ..  *.\ .*.\ .\\  ..*\   *\. \* ..*. \.\. . \ .**.  \*\***.\.\. ...\.\ * \..***  *.. *.#
#      #\# *.. .**\. *\\ .\ *..* *.\ .   **. *...*.\.*\*..   .... ..*..*** ...  \.. . \***   *.. \ *.\..*. *  ..\. .\.  * .***. . .. #
#     #.*\ . \* ..**\..\**. ...... *.. .\*.\*\.* \*  .*\.*.  . \. .\.\.*.\. \* ..**\. ...\ \*.  .  .\* *.    . * *.\ *. . .*.. .. **.#
#    # .\ ###*..  .. ..*..\.  .*.\.**.\ ..\. *\*  ..  ** *. .\  . *** *.. **.* *\ *** .  *\*..  .\ . **.*. ..**..\..\ .* **.**\*... *#
#     #\ *#* *  . \\   *.\......*. .** \. \....\.  **  *  ..\*.*.*. .***. .. .\. .*\.  .*\ *...\. \*\.... *.\.*.   * ..****. \ ..\**\#
#      #  .*.*.\.*. \. ** *   \ .*. ** .* ..  \ *  .*. * .   . *. .. *\ * ..\*. .\ .  . ***. ..\*\ ... ..*\.*\.*\ *\.*  ..... .  ..\.#
#     #.#.. *.\.\. \ **.* .*\ . ...*.*.*.\ *.*.*. *\.* .  \* .\*.. . ****.  *.\ **.*.\. .*.\. *. .** . .*.* * ...\ *...  ... \. **   #
#    #. *\...*. .\..*..*  .\ .....*. . ..**.*.....\  ....*\.\. .. .  .**.\*....\.\ .\. * \ **....*\  ...*.. \\*.. ...* \...  * .\.\..#
#   #*\ *   *. .\ **.... ** \   \ ..\*  .\  ...   \ . . \..\ *. \*.*. \.\ .. *.* .\*..*.*.\ . .. ..   ..\  *.*.*.    *.\.\ ..*  \.* *#
#    ##.*..**\ ..*..* .. .\\.***  ...  .\..  .    .. *.R \..** .. *.\.* . .  .*... . \.**. * . *.* .** \ .\. .   \ . .\ ...*..\ . *\.#
#   ##\ .\ \. *.*.  .. .. ..*...\.*\**  ***\* ****.\*....  .**. ..*\* . \ *\*.*. \ *\ *\.\**  . **  ..\   * .. *\..\ *\  \ .\*** *..*#
#  L**\. .. . . **\ ....  .. *  *....**\ *..\ .\\.\ *.. ..\ .* *  ..\*  .\ .*\***...* \.* .*  . .*\ .*    . **.*\\ * .. *...***. .*\.#
#   ### \ \* .  .....\ .*.  \.*..*  \.  . **\..    *. *.. \*  *. \* .*.  *.*....*.  *   \*.***  .**  . **. . .**.*.. * .*\*\. .*... *#
#   #\.\*.\.**.* ***.. ...\ .  *.*..**.  \.** \. \      .\..\..  ..\* *... **  ... ..* *.* ..    ..\\.*.\. \**..*\.*.. *.  .  .*  .\.#
#    ##...* \..*\*...* *. *.*..\. * ..     ..\ .*.*.* . .\  . . *.... .*   **  \. .*\ *. . \   .*\  . *. \ ..*. .*\\* ..*\* \.\. *   #
#    #  *\....*\....***\.  ... . *\..\   *\ *   ****.. . ... \ *.\  \ .*. *.  .   ****. .* ..\...* *\\. **\ ...  ....*  .*.\. *. \ ..#
#   #..* ..\. *..   ...  ***\.  .***\*\ .*.. *. .\..\  * .   ...**  . ..\  * \*\...*\***\\..\.*\ ..*  ....*..**. .\.*.  *.\.*.. *.   #
#  #.#.*.     .  . \  .\*.*\..\ \.. \.   .  ...  \.\.. *\*\  *.*.*    *. *\... .\.\.*\* ***.*... .***. ..* .**...\. .  ..*.**.. .  .*#
####.*\*. *... . ...   **\... . .  *.\ *.\\ .* .....*\...\  ***\.**  ...\\ ... . *. . * .** .*.\.\ *.*.\ **.. **\  * .* ...\..\..\**.#
#*  *#.#* \...* *    \.. *.*.  .   .  *\ *. \... . \.** **..\.*   .     * . .   \...*.*.\*\ *\***\ .*.. .*.*. *..*.     . .*... *\.. #
####\\ .....\.. .  .\.  ..\.. .*.*\ * \.**.. .. \. ..*...*.\.*. .  .\  ..*\\ *.\.\. \.. *.  . .**.  \.** \..  .*   . .\ *\.\. \*\. * #
# #** #  #.. .* **\ ..* ***....*\.* \..*\\*.\   .  ..  *\* *\.. *  * *.* ..  *. . *..   \. . *\.\  *. .** ..*\.*  *   . .*..*..  \ .\#
#  ####.*.* . . *  \ *. ....\ .. * .. .. *. ....   *.. .**\. ..\ .\  .*\.*...  .*.*  \ ..    . ** .**\* .*. .*.......\.\\...\.\. .  .#
#     # ###  . ...   .\** *    * ***.*. .. *.\    *.  **\.. \ \*  ...*   ...*\  * ..* .   . .. .. .*..\ *.. *.** . *.*\* *\*..** ..*.#
#      ##** *.\  *  .\ .. .. *.* ......*\ .\ .*  \.   ..   *. . .** .. . *\.\ . ..*...\ ..\ *. *\ *.....**.*. .\*. ..* *..* .\*.. .* #
#     #.\##\..*\*.    **\. .*..  ..*\. * *** *.*. \ \ ...* ..* .\..* *  .....* .*   *. *\   .  *  *.* * *. *\  * *  *. * ** ***.*\ .\#
#     #  .\.**. * *\  *.  *..  ..* *.* ..... \ *  .*.\ \ ..*.\ ...  \.\*. \  ..*.**..*  *.\ .**  *\*  .\\.\\ \*.  \.\..\\ \ *** . . .#
#     #*# * .\*.**\.*....\ .    * \ ... . .  . * . . .  .  .*.*...**.....*.   ..**\ ..*.* ..*.* ** **.* ..** .*\ *\.  *****.\.***..  #
#      ##*#\**\..\*** * *\ ..*\.    ...\   \ .*.... .    .*. ..*..\. ..**.\..*  **. \  .*\  \ \ .\.  .. *. .*\..\.. * **  .*. *..*..*#
#      #   **.**\..*\*\...*.****.* *  \..\ ....\ *  \ .*. .\.*\*.*   *..\**  . .\.\*   .. . . . * *..  .. . ....*.  .\.... \.    .* .#
#      #* . *..*.*.*  . .*  .*    .*..... . * ..*.**.. \*\ \.**  \.  .\. .   . .***.  ..  \.*..*..****..*.* .. ..* . \...*.*.* *.\..\#
#     #...*.*\*..*  **  *...\.\.* **\ * . \.*  *..***.\*..*. .\ ***  .* .\......  *. .  \\.....** ***. \.*\..\. *   ..\.\. * *.\*..\.#
#    #****.*..\  .  \*\ ...\..\.**.** **  . \    .. \*.\.\.\... \*.. . \ .\ \  .. ** . *.\ .\  *. ...\..\.*\.\.\* *  *.*.*\*\.\** * *#
#     #...\....*\ *\ .. \ .. .**\..*.*....* . *\.\.*. ..    .\ ... *.  *. .. \   *. \*    .* \ .. .. .*..\.** . ...... ...** \.*.*.\.#
#     #*\ *.  .. \.** \..\ . * \...\*.*.. ..*\.  .*... *... * .  ......* .**...  *.*\*..  .*  .\.\\.*  \  \..\  *   .\.* ***.\.*\*** #
#    #  .*\#   \.* .    *.*.  ...  *.*** **\..  .*.. * \ *  ..   .\   ***\** ..\ *.. *. ...*.\..    .*  . *..  .\.\*.  *..\*..\ ..\* #
#     #\.* ... ... .   \. * .***.....\.*.\* ..  *.**. .... **\  * .  \.*. ...  \*****\.  * ...   *. * * . \*\  .   .   \*  .\ * *..**#
#     #.##\ .\ .* \ ..*\...\**\**\ ..\*.\ *\ .\..\***  \\**...*\..\\ . .**. \..\ .*\  \* *. \  .\.*...* \ \..*\*..*..* \* *..* \\.\.*#
######################################################################################################################################