#########################################################################################################################################################
#                   # .*#.*..#.#\..* .  ..* .  ..*.****.*\  *.  ...** *.**\ .*.. . \..* ** .*  .**. .** ..  .  **.  \* .*..*...  \.. *.\*....... * ..*.*#
#                   #  .****\ *#* *. .**..* \. *.. .... .* ..   . \*  .....\*.     \  .\*.  *..*. .  ... . * . ..    *...*  . .*\ *.*. * *.** \  .. .*.*#
#                    ##.*#..\. *\.*..*.*. ..\ ... ..*\.. \.*. .**  \.   \ ***  .\*  \  * .* *\\* .  \. \ * ..* . .*\. ...\** ..**.\..... . *. . *\  *\  #
#                   ##* . *\  *# *# .*.\**. .  . * ..*\.  *\  **.* * \   **..*.  ..\  *. .**.. .\*.  * .\....* \ . . .*. *\. \.* . *.*...* *. \ . \**\  #
#                  # \**\.. #\.#.. \   ..**\ * *..\. .*.\..**.*. \\\..** *.. .. *.\\.\*.  *. \** . .*\ . * **..   * ... \ ...\\..\**\.\ ....   .. * .*. #
#                ## # *..* ..*.*.** ***.* \*..\**. .... * ....*     . ***** ** .\. \* . *.*. ....*** . . * .. \. *..*  \..***.*.. ** .  ** \*...\ .**.*\#
#               #**#\\#* .*.*.*. \......\    ..*.*\ *  . .\.*.*\*  .... *.* .**. \*.. *\  \.*\  \...*..... \\\.\ . *\..   ..\*... \ .\ ....\.. * *..**. #
#               #. # *#*\#** .. *   .\*\**.  ..*...*   . \* *. .*  ...\ . . ..**.*..     *.**..*  *\\... \  \. ..* ** * ..*..\\** \** . *.. ***.**. *.**#
#                #.  ..*\...\ \*.*\.\ \ *   ..  *.\* . ***. . .  .\*.* *.. .....**\.. .. . ...*.. . . . * * .*. **\.* ..  \ .*\.\* ...  . . ...* .. .**.#
#                #  *.* . \   ...*.* .  * .\.. *\* ..* **..   \\ \... .\**..\*\..\.*. .\ \*. \* ...*. \**.\*.. ...*. \. ....*.*... *...* .. \*.. *** .. #
#               #  #. . ***\. \\\....*. . .. *...*. * ..*\*. *  . ..   *..\ *.     . ..  ..\ .\ ..\.\..\* *..\ *. ....  *.\* .\. *.*. *\ . ....\ *** *..#
#              #  .**.  *.. .\ *.   .  .* . \..\ * \\.*.  * .* ... .\..... *.. .  **\.*. .. * .     .\...\*.*\.*.. .*.\..*..* . .**.*..* .*. . .*... .\.#
#               #  #*###\.   ...* \..\*.. \*..* *\*. ..** *\...\.*.*.* .\\.*\  \* .*  *     .\\**.** **.\..*\* .\  .\.*..*  .. .*.. *.*.. *\   ..\.\.\*.#
#              #* . * .  \..\.\ *..\\   * \**\*\.\   .... * ..***.\. * \...\..\.*  *. .   **  .*\.\*\.\ *\....\.     *\..\ .*\ *** *.**....\*..*   ** .\#
#            # #..  .. \ ..*  *. ..**.  *....... ..\ **...**  ..*\   .\..*\****\.  .. *\...\ .*\\**. *.    \\.. .\  * ** *  ... .*. \..  .\.\ \.  \... .#
#           # #.***.\. .. *..\.\**\...  .\.   *..* .... \**..*.\* ..*.\. .*. \..  *  ....\    . *.\  . ..* ...\ ..*..* .   **    . ..    \..** \.*.**\..#
#          #\.  . **.\. **\ .** *.*.* \. . *\...\. \.* ..*.  .* . .*..    * .. .\*\.** .\ * *.. .  *..\*.. *.  .*.. \... * *. .*.   . . ..*. * .*\.****.#
#          #. .*\..*\. .*\*.**..  *.* * ..** \***...\...\**.\ .*\ *..*\..*.\  .*... **\*.*.\.* .\\..  *.\  .* . * . . .*..*.\       \ \.  \**.  . *.....#
#         ##* .\ *\\ * *...\.\ \* .*. *.\..\ *\.. **. \...* \....*.*.\ .*** \* .\  . . ....  . .\.  *.   .*.\  \.\*....*. .*. .* * *.   **.**   *....\* #
#        #..##. *..*.*..*. *  *   *** .**.*  .. . .**.*  *.\.\*****  .***.   ... ....*.     ***\  \ *.    \. .. *....* . . ** ..** *.* \.\  ..**.  \  . #
#         #\**#.**\#**. \.  \ .\.*.. ...* .* ... * . .\ *... ..\* ..\*. . \\  \*  \   .* * .*\* ... ..\   .    ..**\.** . ... . .\... \.\.*\.*.* . .  *\#
#         # #\..*. ..\..... **.. ..*\* *.\ .. ....  \***\***.**.. *.... *     ..\\.**. ..\..\..     .**\ ...*\*  *   *. .\     .  .\.* *..****.\**.. . *#
#         #\.*\\\*. \.\   . ...** ...* . .*\* ..\** .* ... **.*. \...\ ...* *.*.*   .. *.  .. \.*\*.\** .  \..\  *** .\* .\    .\*. ...** .*.** *\*  *\ #
#         #****# *. \ *.\ . .\*\ .*  *.   \ ..  ...**. ..\*..**..   .*..\.\ . . *.\ *  .... \.*.\***.* *  ....\\ .\. .**.**..** .\*... *.* .\**....  ..\#
#        #.*#\. *.....   . * *.\ *\. ... .*.. .*. .\ .*\...\ .*. .. ..* .   .\ .**  .* *.*   . . .\.**\\*.  * ..***.   *\...  **  . *.*.*. ....*. .   . #
#         #.  \ \**\.*.*\  ...*. ...  ..***. **\****\\..*.**... ..*.. .   ..* * .\ *\.\\..**.*.. .\ .***  **.\ *.\   * **.*.*\....... \ ..*..  . *. *.  #
#        ##**. #*.. .**** \. *** ** \ ***... .**\.  . ...\..*.*.* * ..  \  .  \.\  ...    \. \\. *....\**\*.. .\.. .\.\.. ....*.**. ...   .. . . *\ **\*#
#       # #\.\*#*.* ***\.\.\. \. ***\ ..*. * .*.  * ..  . ...*. * *.\.*\. ..**.* .** .\  *   ....\ \   ...\*.. .*\   ...\ \.\*\ ...*.\\ . ..\.**..\.* ..#
#       #\##\......*\.*...\.*.  ...  \  ***..* **   \..  ****  .. \.*..* .* . .. ..*... \* \. . **  * .* . *.. .. *\. \*. .\ *.*.  *.. *\*   \** .. .** #
#       #  \....\*.   . ...*.    ..\... .\**\   . .\..*  *....* \ . . . \*   . \. \\.*\* ...\.\...  .  .\  .  *  .*  .\. *   .  . .. . . *  * .. *.* ...#
#        #\.#\ \ .*..*  \... .**..\ *..  *.* .**\**. *.*\.. **.\* *  .....    ** ..*.* * . *.*.**.*..  .\.. . .....*..*  *. .*...  .*\..\* .\*.. . **.\*#
#     ## #\*.. .. ***.   .*\\...... ..\  . . .***.\\.   ****.*.*...**  *.* *.*\. .\ .*. ** ...  \* .\ .  .  \ ......\**..**...**.** \ . .\*  ..**.\ **.*#
#    #*\## *...*\ *.\.   *  *\  \.*    .*..*. ..*. .  ..*.*  \ ..\** \ ...** \  \ . \.* .   . . .\ *... ** *.\ *\ \***...    **.**. ..\ .\. ..* \ ....* #
#    #* #\.*..*\ .**. . .*.... \**. ..\.* .*  *\.. * \  * .\ . .*..*..*  ..* .** *    *  ** \ *\ **.**\*. **\... .. ..  .... *\*.\ \*...  .*\\  ...*...\#
#    #.. .***..*.\..\  \* ... \.*.* *.....**  .. *\.\. *.. * ..*.***  .\* \..  . .. \*. *\.\.  *.. * . **  . *\.** * .\.**. .* ...*.*\*.*.*\**.\.\\..  \#
#     #\ ...* ....  * . ...   .*..* *.\..\.*. *.*\*\**.  *\.**. ..  \  .. .   .*  \ .\ **.. *.*\ *.*. .* *\.\..*\.. *    ****\  \.\ .**** .. **.* *  *. #
#     #* .* .  . *.  .  .\.   . \...  . .. ..** ..*\....*.**. . . **.. ..** * ... .\*. *\*..*\. ..\*  ..\.\. .  . .   *....*...*  .**..*    ...* .* *\ .#
#    #.* . ..*.. .. .\ * . .. ... * ..\..\\ \ . *.*\. *\. ..  * \ .*. *   *\.  \.\..** .... *.\ *.**  .\**..  *  *. .\*       ...\. .\ ..**\..**\**..*  #
#    #\#*    .. . .. ..\   ...   . ** **. * . * * .\* . \. . .* ..*.\....*..  *\. . *.. .\.* * *\.\* * .... . *..*. * \ * **.\ \.\.. ....**.\ \ .. *\ ..#
#    ###.*    .. .\.   . * *. * * ..  ..**. ..\.*..\ ......    .\..\* *  . ....* ....\ ..*.*.\ **.*... \.\ .  . \. .*.  .\.* ... .\. . ...\.... \  *.** #
#  ##.##\.*.**\. .\ .* .**\*.  .. .. \.  .\ *  \... *.*\  . .*..  \** * \.\..*..\ \.. \ \* \*..*..*.* . \.***...\.\.  .  ...\\  ***.  **.. \. \ .. . ...#
# #   ..*## .* .. .  .* ..*..* \\.**    * .*... .\. ***   ** . ..\. * ... ** ..  \.\ *.\ * . .*.   *....\ *..\..\    *\*.   .. \.\.*\  .*\ \ *.*.*.  \ .#
# #  .#\.  * ..\.**.. * \.\... .\. .\ .... . *...*\...\ **  *.\*.*    \  **..*\  .*. ...\ .\..*.\*.*\\  * . *. \  \**  *    \  ** ..... *.     ..*  \.. #
# #\.. *\*\. . **.\* *. .. ..  * ..*...*.\. . .\**    .\.** \*.***\.*..  *.*.**.\ \.  . . ..* ****..    .  ....\*..*.* *  .*...\....***..   \.* *.... * #
# #**##\ *.. .\... * .. ..  \ *.  .*  *.\ *.  \ .. . .  . .\ *\..  ** .*. ..*\.   .  .*.\    .**.. \\\**\.*\..*  * .*. * . ***  \. .*  . .\ \.. . .***\ #
# #* *.. \.    ..  ..\.\.**.. \.*. . * * * .\ **.   ..**\\* ....* ...  ..** * .*  *.*\* **\.. ...\ \ ...**.\* .\** . .**  \..   . *.*.***\ *.*\.\...\*. #
##. . ...    *.. .\*.*.*\..    *   .\.   \ *...**.  \... . .\ ....*  .\.\..*\*.* *\.. .\ * .. .*.*... *\ *. .* \ \  *... \.\\ *\*  .**.\..*..  .....*.* #
#\  #    ..*.*..   .**  .**. .\..*.\. .*\...*   ..\ *.   .... \****..\ .  *. .*...* \.\ *..   .... \. *. .\     .. *. ***\ ..... . . .\ .\*  *...\*\  . #
###*.*.*..\.\.*\ .****\.*...*..*  *.* \*.  ... *..\**\ .\. *. *.***     ...\ *..  *... .  **\***.**\\.*.   *. *\. ..* . . \ . ** *\..   * **. *  \*   \ #
#  #.. .*.. *.. *.*.*.. .*.*..    ....** **  ....  \*  \.\ ..* ..\*\ ..    * . \ ..\\.* *\*\ * . .....*.\ *. \.*.  ... \. ..\..* ..*.*..  *. ..* **\ * .#
#   ## \#* .**.**.*.\* .\ \.   *. ..* *\.*\ *.\ ..*.\.\. *\  **   ..\...**...  . *\  ..*. * ** *****  .*. .**.*\*  \. ..\  ....*.  ..***..\* .  . * .\  #
#   #. .***.**\*  .*..\ *.** * .*.*.*..     .* * \*. *. \\ .*. ..\  .* **.**.... ***.* \ *.**.....*...\. . *. *   \ *.*.*\. \. .*.\****** ..\ *.....  *.#
#    #\ ...\.*.**\ . * \..    .\.* ...\. ** .*.*..*\  .\. . ** **..  **. **.. ***.\.. *   .*\ .  \. .* **  .. . ..\\*..*.    \ .\  .*.**. *\. ..*  *.***#
#   #  .**.* . *** * *\.\\.* **.*.**.*  \..    ..\. . *.*.*.*..*.. *..*\. \.*..\.\  * .\.\... . ..\**.....  ..      ..  * \. *.\.*. .\.. ...\   .\ *.*\.#
#    ##*#*. \*..\.  **.* .*....\. .*.*.\. *\ .    \.\ \.\ .*\*..\..**\.*  ..*.\ \**\. .. . * \.**.. **.*.. .*.. *  ** . * .   ** **\   * .*.**.**. * ...#
#    # * **. .\ *.\ \..  \.*..*. .* . ..\ *   ..\...*   .*\ ..**...**. .   \* * ..*..\  ..  . \ \.**.\. \.\ .\...\ ..\..\. \ .*. ..  ...  .\.**.*\. ...*#
#     ## **#\** .. *. .  ...*.. .\*.\.*** .*.. ...**\\ * .. ..* **\.. ..  . .**\. * *. * . . .... . . \..  . .. . .***..  .* ... .   . . .\*\.... ...*  #
#      #\.*..#\.  .\*.*.*.  ....\ *\ .\.. ..* *\  ***..*.. \ \. ...\.. *  ***...**. *...\*\  * *   *.\.\ .  . .  ..\.. . **..\ . \.  . \ *.*.*....*  * *#
#      #. *\. ... *.**\. *  .*    \* .. ..\*  .**.*.\.\.**   .\ *.\..\ .\. .  \*. .. ..***  .*..  \**.. *. .\.  .  . \*.... .*   . *\.*.. .. .*. *.. *\*#
#      #*.#   \ \ *  * **. . .*. * . ...  ..* ..\*\ *.**....*\ *..*. ..**. *\ .... \.\.* . .*.* ... . * ..* .  .. ** ..*.**.**..*\**. *\*\ \. *.\     .*#
#      #*\.. *...*\.****.*.  ..**  *..**\.. *  . ..*. ..\* \.**. *..\ .....*. . * .. *  .\*.. .**.*\   .\.  \..*. .\  *..*   * \* *. *..*\*.**..   **.*.#
#       ## . .*. * .*.*.*.\**. .  .*. ...* *....****... ...*.*...*. .\**. \*. *\* ..... \ .\ * .... .* ..*\\. .\\.*\***  * ..  .\*.\...*\ *.\.\*\  ..\.\#
#       #*    *.* .*.   *\**. . \  . .   \*    ......* ** *.. . ..** *.*....\*\ . \\... ..* ..  .  \ . \.*  *  .  \.\**. .. .  ** ..  *...\**\ *\  .. **#
#        ##\#** .*.* \. . \.*.  .*....\ ..*\..***\**** .\ \ *   ...*.* *   \... .*.  .\. .  ..\ ..*.\  ..\*.\*.**. * .\.**\ *.\. .*  ....* .**.\.   \ ..#
#     ###...**. \ ....**** ...\..* *   **.* . ....*....*.   .\..*  \ . . .\.  .. ...*. ..**.   .*  .*** . \*.*  .\ .*.*....*. *\*....*.. . ..*\ *....*\.#
#    #.*#  *.\*  . ...*.*..*.\  \* .*.. * .***  . .. *...\.\ ..\*.*.*...* .*.*\.    **\.\*. .\ *.    **    . ..\.\ *.* ..\*\. . *  \.* .  \  . \. ..\ . #
#   #  *. ... \..  *\...**..... .*   . .\ *.*. ***...... ***...*..*.*\...\*.*.*..\ .**.* .  * **  * ..   ..*  . ....*.. .**...  .....* *\    \..\  **.\.#
#  #*.*#\**  ..  * ..*\ ..\ .. .\.. .\\.*.***\ .\. ....\...*\ ...   * *.. . . ..* . *. \ .    ..*.  * .  * ...*..  \..*. ...  \.* ..*. .*\*.... .*..\ ..#
# # .\*\ *\   \**.  *  .. .  *...... .\*\.*..***.  \**. *  *.* ..\. ...*\*\*..*.*...\... *    .*\....   .   .\*..\...\**\.* \\  . . \*.\.... .   ..*. \*#
##** **. .**..*# . ... \\*.**.*  *** . .... *...*\.  . \. ....   ..\**  ..*. \..  * .*\.\.   . \\ \** .. **      *.\*.*..\. . **. . .  .. . *..\. *..*.*#
# #*.**\***.*. \ \ ..**.. \. \. .\.**.*.\*..*..*. * ...*\ \  * . *.**..*.*.* ...*.* .* ..\  .. .   .* \ .\.\\. * ..*R*...* . **.. \\ . .*.  ..*. *.**...#
# # ##.*..\ *.#. . .  . \ .* *.\. *.**.*  **...* **\***.*...*\ . ....**.* *** **.\**\** .     *\**  * . \. .*\  \* ..\*.**\*. ..*  ..\* \*.**  *.* . *  #
# # # # * .* ..#\   .. \ .*  *  . \ ..    **\....*... .  *\.  * . ** . \ *\**..** . ..\ * *.\   ..***\..  ..*.***.\*  .\ *.\ * .. . * ...\.*. .*.** .*..#
#  #   ##.*.   *.\*.  . ** . ..... .    .*.***..  \\ .\ ... *.*\.  \ *\*..\... .*. .* .\... ...* *\.. **  *..*\* *... \*\. .. .\ *..**\.\ .... .* .* **.#
#        #*.  *..... *\ ..   **    **... ... .**.. *. ...\\..\. * * ** .*. *\ ..\  \. \*\* \. ** *  . .** .* ..\ .. ..*. .\*   ..\ . * *.* \** \*..\. .\#
#        #*\. ##. \*\\ *\*.. .....*. ... *\* * .. .... **\*.\  .\ *..* .   **.* .*\.*\.  ..\.* . .* ....*\..*\..\..\.\.. ..** \ * *\ .\. .....*\.** *\  #
#       # .##\..*.\**. .\..   *\  \ . *.*.** . .\\*. ***\.*  ......***   .*\ **.  . .*    .. .* \.*.*\ *..*.*. \  \....***\.. . . \. ***.*.. .* *...* ..#
#       #.##.* \#. . \.  *. **. ..... *.\*.. *.\*. *.*..*.*\* \*  .**...\..*...*.. ..\ \.\    .  . **  **....* . \*\* *.**\ . .  ..*....**\..*\ ...*\ ..#
#        ### *\  ** \#. **  \*..*\  ... .\.* .*...... .\.\. *  ..   *.\..*.* ...*\.* ... .\.\ *.. *\ \...  *\ \*\.\\  . .. . ***..* . *.*.*  . * *.. . *#
#        #.\ #\*\.#    ..*... .  .  .\.*\**..\..* .\ .  * .\\ .*\.  ..*.* *     *. .\. \....*..*...*  .   \* . \*. \**.. *....*\**\\ .. \...*\.... ..\.*#
#        #..#....* .\. . \ . . \ .. \  . .\ * \*.\ . . *.  *.  \.\. **\     \.* *.\ .    .* ** .....*  . .\.\* ..\.... **   ..\ ... .  ..\** ***   \  \.#
#       #*.#..* *  *. .  . \ . ..   ....*   .\.\ *.*\. . . \ *  *  \. ... .*..\.* . *  \. . \..\*\... *...*..*.*     * **\   *..\* .\*. \ . \ ...*\ ..**#
#        #.. .*.\. .*  * ..*** *  \.  ... \\ *\.\. .. *   *\*. **  .*.\.**..*.\\.**...\.  . . * . **.*..* **.. . . . . \  .*..\ .*\ ..  * .\*\.\*  \* **#
#         #*##*. *..\ **.\. *\*\* ..*. *  .* .*\.  .\ *. \... *...  . .*.\*. * . ..\..**\*\ .....*..\   .*.*\ *.*\ * *\ . .\ \ * ..*.*..*.* . \ ....* ..#
#        #\...**\..\. .** * ..... *\ .**\*.*. .  .. .\.  \.**\  *.*.\. . .\..\ *...  ... *. ..*. *\\ .  *\........  .. . \.*.  .\.......  ..  .  \*.. * #
#         ##.#...*\. **   ..    **  ....*..\ .   .. *.**.. .\* *   \. . . .\  *. .*\.\\. .\ * ..***\..* \.....* . .\  *  . .\.*.. **    *  .** . .\* .. #
#         #.\ .. * . .. \.  .* .*.  ..*. * *** * .  \* . *  .* ..*... .. . . *... . .\.\. *.* *. . **\*\.\ \*.\..*\ *.. **\  *.. .\.*\.. *.\.*  .\ . **.#
#         #.\  # ## *\* .  \..  .\**.\.* . \.\.*  . *..* . .**   .. \\*.*  .\.\\.   ***.\.*\......* *...  *  ..*.......\.*...  .*.. ..  .**\  . *. \.*  #
#          ##...\ \.*.\  ....*\. .*..* .. *..*.*.\*.. ... . ...* *.**\ *. *.**. \* *.... *...  \. . *\ \..** . ... .  * .* * *.* ..\.\ .*...** **.*. ..*#
#         #\* *L. .\. *..*. ..  .*.. .   ....***\.*.  *..* .\  . *..** \ \* \\  \  **  ..  . ... . ..*\ * ** .\ \*.\\ .* . ..\ ***\. ..\..* **\.*.\.. *.#
#         # .*\\*  *  ..*.. *..  . **.  ...  ...*.\   . \.  .. *. . *.\ ..*.\....  * *.*..\.\     *.*\...\*..\.\.*.  \*.*.. \.\ \..\ *. . *\*\ .\. *.  *#
#         # ##*..\*. ..\.........\..\..*.*.\**\*..*.\    .*\. ..* ..*\ *  .    *..*.\*\..\...... . ** *..*.\.* .*. *... ..** . *.*..*.\*. *       .\****#
#          #  ####*\*   \ \* \  *  ..* .*\* ***.  .**.  .**.. \... \\*\**\* * .* *.. * .***\\*\\.  .* . *...* .\ *\*\.  .\..**....\..*..\ *.\  .\ *..* \#
#                 # . \.*... .*. .*. ** . . .\.* \. .*.**.... . * *.*. .\*. .\** \.**..  *\*\ . .*.*.\ \.. ..\ * . ..\\ .  .*\.**..\  *\  *...* \ ..* ..#
#                 ##. . \.* ***. *. *\*.*.    *.\..  * *.. *.*.*.*. . \* .   * *  .. \..\\..* . \. .*\.*.*\..  *   *\* .\ ...  .*. **\.   .\ .*\. ..*..*#
#                #*.  *\ *. *\ *.\.\. ..*.. .\\  *  \. .  ...***...\.*..  * ..\  .*.*. * ...\ *..*\.*....**\..*\  ..*\ \ .\\..\**.\\.* . *.*  **\ * .. *#
#                 ##...  ***.. . * .\. * ...*...... \...** *.....**..**. *\. \*.**. .* .***   .\   .. . . . *.\  ..*..*..    *.*\ ..*.\*\*.*\*..     \ *#
#                  #. *.... * . .*.  . ..\ *.. ..** ..*..* ***\   \\..\ **...... .  . . ** * \* ** \*\     ...   ...* . \**..*. *.. \ *.*...*.   . *\ *.#
#                 #\#  ..   \ .\ ..*. .*. .* *.*..* \. * . ..\  \ .\ \ .*\ .**.\.   .  . ..* ..\. *....**\  . .*. *.*.\ . ..... .**  ***..\ . ..\*\****.#
#                 # #...**. .* ......* .   * **.*\.    .\  \. **.\.. *.\..* .  .*** . .\. ..*.\ .*..*\*.\..\ ..\* .\*...*  ..*\ **.. .\.\\  *\*...*.. \ #
#                #. .*  ** # .  . .  *.\*   *.*.*. \  \.....\ .\ *.\ ...  . *.*\\*..*\. ..\*. *.... *.* \.* ..\.\  *. .. ..\..\\...**. *. *.\*.. * *  ..#
#                 ##*.** ...\..\.. * *. . . . *\ *.. . *.   **.*.   ..\ \..\. ... * .*....*  .*..*\.... ... .\ **\** **.   .\**. .\ \* *.....\.*\. *.*.*#
#                  #.\.*.*.*. *\\\.**. \   ..*\ *** \\****. *.\   ..\ .   *.\ *..***\..\  * ..* *. \.. *. \.. *.. .*\.***. .**....  .. * *.*.. *   *..*.#
#                  #\##.\. .*....* *. * \.   .\.*.. .* ..\* .\.  *.. *.***.** ..*. *   ...\ **\ . \ .* .\  *..\. *\\. ....  ***\..***..*   .. *. *\* ..*#
#                   # ..   ..\*.\*..\ . . *.  * *. * ... ..  . *.\*..\ *.* .* * . ..**..\*.* ... . * .   \ ..*\ .\*.  . **\*.*\. ..*.*\**\  * .. ..... *#
#                   #  .* #.. \* .  ..   ..  *....*\ *\.**.. ....*\* * *. *..\  *.* *.. .. .   ...\  *\*. .\ .. *..  . \*\*\ **.  * *\.......\       ...#
#                  #\*##\   .\ . ..*.*****\.  \*  \*.\ *** \**.. . *.**.\ ..*.*. **\. .... *\\ \\. ..... . *.**.  .   **\** *.*  *\. *\*...* *. .*..** .#
#                  # ##..*.  .\*..\....*\.** ..*\ ..*.*.*\..****\. * .  .. *.**  \*.\ ** . *  \.. *\.  \.\ .\. ...**. * .. .\.*...*.\* . *\.\ . ..\.. ..#
#                   #  ##\\..\.*\.*..\ ..\.... ..*  * . .*.\ ....\.* ** *.\..\.*.... *\. * .\\.* .*   ..  *.... ..**.*... .  ..*\  . .*...     **..*\** #
#                      ####*\\ * **   \...\.    *. \.\ ***\ **....\. \. .***. \. .\.\..**..   ... .*.*.  ** .\  .\.*.**.*\..  *\ *\.\* .\ . ......*\... #
#                     # ...\.\..\...* ..*..  .**.  . . .*.  **. \**  .*.*  *...  ...   . .. . .\ . .\..*   . .   *.. .* *.... *. .. .*** * *   .*.*.* \*#
#                     #*\ .*. \#.  ..\.\* \ \*\*..**  \* *  ..  .\.\  ..\ **......    *......  *\. \**.*  .  *.  ...* ..***..*   *. ...*..\ ..  . *\. .*#
#                     ###. .\. \... *.\..*..\\ *.\.....\..** .*  *. .\ \. .. \* .**..*..*\  * **.\  .. * . *... \ *...\.\.\*\..  . ... *.. *.*\..\..\.**#
#                    # * *.**   *** **  \.. ** *.*\*\**\  \\.**.\*\**... \ . *    .*. . ..\*.\.*.  .*  . \.*  .*.\\. *  ..*.*\ . .. **\..  *\...*...  ..#
#                     #*\...* \..**.*\.*. * *. *\* .**. \ . *\....\.. .*\..\ \. .  .*.. **.  \ .  ..****. ..\ \*.** *\ .*..\.. *\   .  *  **    *      .#
#                     ## *\*   .... *.\. *\ .* **. . .*.. * *.* .   ..\..**.*..\ *..*** ... *.\** * . *\*  .\  ...\ .*.*. \*\*..*.**. *. *\. ..\**..*. .#
#                    #. . .. ** *.. .*..*\ . . *  .** .\ .\ .*  .. \.**\ .* ..\* .. .\*. . \.\*.\.*. *... .***.\.\.**..\.*.*.\  ..\**.. .\.. ** *.. .  .#
#                     #   .* \.**  \..\*. .  *\*. **   *.\ **. ..  . *.\.** * .  .*..*.* . ..  *...*.\ .\.\ ... ..*..\  .*.. .\.**.\.*..*. ....**\ .* .*#
#                     #*.#\.*. **\..\*..* *\ . *\....*..\*..\. \***.*. ..\*...*\\ \*\.....\  \**..*\*..*...**\* * \\*. *\..*\ *.*\*.\*. .   *\ \ .. .\*\#
#########################################################################################################################################################