#############################################################################################################
#                         ####.#                                                                            #
#                       ##.. # ###             ##   ###                                                     #
#                      #.**#\.*#\*##          #*.# #..*## #                      #                          #
#                       ## *  *. .#*#        # # ###. .. #.# #                 ##\#                         #
#                       #*..\...  #..#    # #.* \  #\* * .\.L ##             ##\* .#                        #
#                       #.*..*\.#* *\ ## #.####*#**... ** ### #.##       #  #**#\*# #                       #
#                    ###..\....*. * *##*#..\  .*  .**.\*\. **\* . #    ##.##.#. \*# .#                      #
#                   # . \ ..  *. *\ \.**.#.... . # .**#.##\#.*\*##   ##  .*#.. \##*\#*#                     #
#                  # \ \*.  \.\. * ...\.*\.*..*.... \*.\**.##..\ .###.\  **.  \...*..*#                     #
#                  #\  *.\ .   ..*..*.*...*..\.* *.***   \ \\* *.# * .#.**.\ .  **...**#                    #
#                   #\*.# .*.. *\..  ** \.**. \  *  .. .\#\#**... ....*\.. .* * \..* ...###                 #
#                    #. *. ..\... ...*..  *.\*.\.. . *#\..*..**. . *.*.# .#.**...\ ...\#\**#  #             #
#    ##        #### #\  .\.\ *\**  *....\ . . *    . . *  .* .*\*#*. \*** . .. . # .  #*.*## #\#            #
#   #**#      #\...#   .*. * * *.*  .***** .*..* **  \ .\**. \. *. * ..  * #.*  ...**..*.\..##.#            #
#   # ##    #  ##.\ .* \.*** .*\ .\   .*\.... *. .. *. .**.**..... .   .\. \.*. *.*. .** .*# #  ###         #
#  #\ *\#  #\##.... **\ #.*. .*.*...*\ **.  .  ... . * ..* .\*.**  . ..\.* .....*  .\ .\* #  #*....#        #
#  #..  .##. \ .*#.*..*......\ .... .. *\ .*  ** .**..  .** ....\   .** .**\ . .\** *\* \.\# #.#*..#        #
##### .*.# #*.\ .   * *..\.*. ...\.***..*\*\ \.*\...*.   ..* .. ** ..** * .. \ .. * *.\ ..# ##\ ** ##       #
#\.*..*.# #*.# \*.\..  .\** .. ...\...* ..\.*\ .  ..\   . .*..*  . * ..    .\ *. . \*  .. # .** ..\ .##     #
#. .   #.###**.... ** . ..\ .  *.. ..**...*\.*\*  \  .  * ..**** * .  ...*  *.\.. ...*#  *\  #* #.  *..#    #
# .  *.. #* .** .* **. . ..  .*.   *..\. .. ..**  . *\*.. * *... \    \ *. .*...*.* \**#..*.. .* * .*.*#    #
##\ \*  \ #. \.. . \.*.   \..\. \. .\\. \.   .\* *. .*.   .\.*.\*.* \ . \ * ... \....*.*..*.\.** .*.#.#     #
## .### .**.*#* ..*....  . *     .  .**\**. \ \.*  ..* *..\.**..*... *\ ..\  ....\. .\...#.. ..*  \ ..#     #
#.\... . . #*    .\* .*.** .  * *\ *  \**. * * ..\.*. ...\.**. .....\. .***.\.\*.  ..* *.. *..*. ...*#      #
#\* *.*  .... .\..**..  .\ *. *\... \.. .\ \ .\..\ .\\.\* \...*.\.. \. .* .\  .\ *  .*... .*\ ....\ . #     #
## *.** *\ \.\  * .# ..\* .\ *..* *.  .*..*. *.. ..\*\  ..\. * *..* \ *.**\. .**..\**.\   .  \*.* ..#\#     #
#\*.. \ . **\   . ***.*..  *     ...\.*   ..   . .\.* *.. ****. \.  *.* *. ...\.  ...\ \.. ..\.*\ ** #      #
#..*     ....\* **...*. .*.  .. . . *  *. . \     * . \ ..\ ..\ .\.\  . . ** . .\*.\.... .  * .\  ** .##    #
# ... .*. \ .*...*\**. .*\. .** *\*.* .\.    *.** *\. .  * .  ..\ * . .*.\.\. \ \... \* .* .*      . * *# ###
#  ..\ *.  \ . ..\ . \* ..\  .\\ . .**.  .\ \. ... *\  \***...*...*.\. .* * *   *.\  \  \    *. ..*  . # #.*#
#..  *.....*... \.\   .   *. * . .* \.* *  *  .  * \. \   \.*\** ..*.\.\ ..  .* ....*.. ..**.**\. *...###\**#
# .** *\**.*.\ . .\\  \ .*.*..\*\*. ...  ... *.*** .*\*.. . .*.\.\ \..*.   .*.. *. *      .\ .  .\\   ..\.###
#\..*  .\.**.**  *. .\ .\**.....**\ .*    **   ...\ * . .\\  .\ ....*......\. \..  .*  .*. ...  .*. ..  .#.\#
# *..*... .  .  ** *.* \**.  * *.*. ..\......\     .** .\.*\    ** *.  ..* .\. ** . *.\ . .\.   ..*.*..  *.\#
# *.* ..*  .  .\.\.**\ .. .\*.   *   ..***. *  \..*.*\.\  .  .\.*.. .\. **..***\.**....  ... * . *.**.....*.#
#\\ .**.. *. .. ..* .*\  .\ . *.. ** *\*.*..*\\***\.*..**.\ . . *\*.* .*\*.\..\ \*.   *.* .* .. \*.*.   * .*#
#.  *\. . .*  ..**.*\.. \** . \. . ..*.* ...*  ..*  . ..  .. . .*.*..*. *....\.**.. .  *. \. *\ ..*.*\.\*..*#
#. **     **.*.\. \**  *.  *\   *\.... .. .*  \....* .\\.*\..    *..*...*..*. \. ..  ...   .**.  ..**    *\.#
#*... *\.* . ..*\....   \ *.  . .*.\\  *   .  ..\ . *\.. . ..*\ .*. *.***. .*.  ** ..     * .*. .\  .\**.. .#
#. . .\ *.*.\\ .  *\.*..  * .. *.\  ..***. .. \ *. ...*\. **\.....\ **\..\  .  .* .\..*....  .*.   **... *\.#
# ..\ .\. ..*. .\*\  .*\. .*\.\.*.***..*.   **... . . .*\*..  *\  ***.**..*. ***.**  ....\*.  . . *.*\. *..*#
#\.*. \*..\* *.\*** *. *** *....* . *\.. .. \..*\     .  *. .\. .  * *\. \.***. \. .\ . ** ..\ .. ..** ..\ *#
#. . ..*** .*\..*..*.*..\...   .* *..* .   .. *..  **  \*  \*.*. * . ..*   ** .*..*\  \..*.*. ** .. *..*..\*#
# \* **\.\  .***. *. *.*...  *.\. ..*\*.. \**   ** .. *  **\*\*\... * ..**  .  *.*.*\**\\.*.\.... . * \*\**.#
#\.\..* * .*   . \ ***\. ...*.. *. .. \.\  .. *. *...*.  .* ***. *  \..... *..\*.*.\..\*\ ..*\ .\.. . .. ...#
#*\.\*. ....**** ....*...* .\  ..\  \ .    . .*** *  **.. .\ *.  ** *\   ..*. .. * *.*\ \. .... . . ..* ..\ #
#**. *.... ....*.* \.\\ *.  ..  \..\.    ...*  \...**\* .    *.\*.\*\  .** ....\** \ . *...****.*\   .**... #
#*\ ...\**.*.*..** *.*...  .  . * *...* \..\.**  *. ... .  .**. \...*..*.\ ** . ...\*\**  . .*..* \ ..* \.**#
#.\ ...*\.*.**  *.\.  \* ...  \.\. \ *... ..  *. .  **\.*\.\.\*.  \ . \.* \.. \..  .*... *\ ***\.   .\* . *\#
#*** . *.. .\  .*\.* ... *.**.\ .. * . *.  .. * .  ..*.**** ....\\...*.*.*.\.  .*.\ . * .. *. . .    .\  ...#
#.\ .*    .**\\ .*...  *.\*. \.* ..*. *\.. \.  . **\***...... **...\ ...\.\..R .\.**   *\ **\* .\... .\..\.*#
# .. ..*.. .\..* * ..\ . **.. *..   * ..   .\.\.\..*.***.*..\ \*  .* * ..  **.*\.*.\.*.*..*\.  *.* *. *. .* #
#     * *. .\... \.  .*. **..\*  .\  *\ *...\***.*..\*.* *\* . **.....   \.\\ *..***  *.* .* . ..*. .*\*..*\#
#.**... ..*..*. ... .\*. \*    \**.\ .*** *  .*..*.\**.......* ..*..*....  . .. .. .  *. .** .     . * .* .*#
# *. *. \*.*.**..*. * .. .*\..*.  .**\. ... . .\ ..  *    . .. *\*.*..  ...\.  . .\ \\**\ ..... *.. ** ** *.#
#.. \. \*.* *. . .** .\ .**.. .* * .*  *\.\. .*...   * *\ *. **.. .*  . .\..\..   * ...**  \ .\  \. \  ..  .#
#\...  .\ .*..\.*..*. ** \.*. \.  \* ...*. ...... . *....\*  . *. *.\.***. . . . ..  ***.*.*.*     .*  . . .#
#. \. \ \*  .*. .. *\...   ..*.*.*.\  ** *.  * .\...  \* .* *..\...*  . .* ...\*.... .*. . ..\ ..* **. **. \#
# *.* .\ .\.*.\ *..*.*\\ \*.\***.*...\*..\.*..\  .\ .\.\. .*.* ..*.**.. .. . \ ..\ .  ...     . . \.*  ..*\.#
# \.*\*.  *\ . ...*\.*.\*....\.\** *\..*...\....*.*.*...   .\\ *.... **.. . .... *  **.   ... . ....*** .\.*#
#* ** ... .**. .*  .**..*.**. .*.\\..*.*.   .*  .*.*.*.\   .*  \ . \** ..\.*\**  *\**.*.*.. * .  \.*....**\.#
#. .\. \.  *..*.\ .\.*. ..*.** * .  \  *..*\\. .\*\.... . ***. .  . .\.\ .*.*.\ \\\.* ** .*  .** ... .\ ..* #
#  \..*  .*\ ..**\*.\.*\*..\**  * .*.. *..\.*. . *.\*..*\. \.\.  *  .***.*\ *... ..\*\\. \.*.*.. ....*.* .*\#
#\ ..  \ \. *..***..\.\ ..\*..\\***..\ \. ..* .  *......*  .\... **.\.*\.\..\*\* .....\ *...***   *.\*.. . .#
# *. **.\. ..  ..* .*.\. .**\*  **....\ *. ** .  *\. .*. **.. .. *\. **.**..\...** . ....   .\*\..\..*   \.*#
#  * . \ ***  . *  **   .\.\..* \..\*. \*.\.* ..**..*\..*..*\.   *.*...****.**\*. ..  *.*.\.\.* .*\.*.\.    #
#  *.\. *\.*  \ . .\   *...*\.\  ...*. .******* ..*.... ..\.*\.  ..*.*\*..*  .*\ *.\  * \ .*. *\.* **.*  .*.#
#\..\  * .\..  .*.\.\.\.*  ...  ... . ..*...... ***.**. \\ .\ *.\.*....*  \ \    * *.  ..  ** *..  .*..  *.\#
# *. ..\\*.  . .... .\* ..**   .\*\ .*. . \ \ . * \ \.* *..\ . . *..\.\* \.\.\.. . .   *.  .* * *  \  .  * *#
# *  \...\ *\*.*.*  *.* \ *. *\*.\..*.\   * .. .  .. ..**.\ .\ *\.****...*..\ . \ *\  ..\ *.. ..** *\....\ *#
#\. .. *..\.....\*  * .****.*\...*\\*.\ ..*\.\*\.     *.. . .... **.\. \ **\ *  ....*.....**...*****.\. *.*.#
#  . . .*.  ..* .*.  *.*..*.*..**.  ..   .  ..\.  .  \.\ \  .  . \ .** ..*\* **.... \*\*\.*.  *.*.* \* .* \.#
#   **\ .. .\. \.*. .\\. *..\*.*.\ *   ** .\ ....**\..*.*. .*..\ ***.. * *** *.\\.\*\ .*...* .* **\..   .* *#
# *\..   * **.     ...  . .\** *   *  *...   ...*...  * *\**. \*.\ * **. **.. .*.\*.*. **..*\.\.\\**.\** ...#
#. \  *\ \ ..\. .* *.  \* ......**\. **..  *   *. * ... \ . * ..*..\..\*.\** .*.\.  \....\ .. \*....... ..* #
#.\.  ..  \.*  . .\.  *..\\* **.**.  ..\ *..   \.*  .\**. .*.. *. *....* . .  *\ *.  ..* *.*\.     *.\.*. .\#
#*. \*..    *.\* * . *  . *.  ...\*.     .\.\. ...\ \.. .. .\. *.\.*  \* *\ \.* . . .**\*.  ** ..*.*** .. .*#
#..\.\. .*.\.\ \ . \..  ..... \*.*..** . .   .  .*...**.... ..*.**\* \.....*.*\ ..*\ * .\.   .  \* ...  \.*.#
#\.**..  . * . .*.*.\. .*.\   .\.. .** ..*\.*\*  * \ *. .\.\ \*.*.*... * \. ..*. *\*.***...*. \***. .. .. .*#
#.  .\*\.  .. *....* *\.\ *  .\   * *.\  * *.\.\ *..***\ ..* \ .*.*.*\...\*.\..  \*...\. *.** .... \ \ .   .#
#\........*\..****.\\   ..\.   .\.. \ .* .\.*.\  .. . \ \.*. .*.. * ***...* *.\.\\.  . * . .. ....  \...\ .*#
#.  \.. ... .... ***...\\.***..*.\. . \.  ..\. \.   . .\. ... .  ***.\* .*.\. . . *    * .\    **\**.** ...*#
#.\ . .**. . *...  .*\.  *\*\.  **.* ..   ..**..  ** *..   . ****. . ...*\*.. .  *..\*\.\ . \ . . *\. .. \**#
#\.\\  .\*.\.\*..\.    \.*.* *\\ . ..\..\  .\ .*...*.*.*.. .\.*.*.** .*.*.*  . ...   . .\ *.. *\.\***...\*..#
#* *..*. .  ..*.\ .* **.....    .* \.   **. *..** \.\.... .  *. ..*. \.*....... *.  \*\....*..*.. *\.\  .*..#
#\ ....\.\.\ ..* . .**..  * .* . .\. *  *.\\.*.*. .  **.* \  .*  .. \....\ .*....*  \. *   .\...*..**... \.\#
#.\ .  *\  ..\.*. \.*.*. . ..\.  .*...*\* .*..\. *        . *..**  * . \.*.\ ..\ *\ .\*.\*\. . .*..*.\ .*\\*#
#.  \* .*.. .*\  ..**.\*\..* .*\ \. * . . *....\*.\ *.*...  *. . .**\* ..*.. * *...\.*..***.*\ \ .     **..*#
#.. **  .   *.*  . ... .  ..* ....  .\  .\.     \.*..**.\  ..\**   .*.. *. ..\\***\........\  .\.  \*** \.\*#
#\.  \ .. .*. *.\ .\  ..\. **.\***.\    .   ...*. \\  . .**. *\*. * ..*\*.  *...\ *\ *\**   \****\****.***..#
#  ***\\ **\*.*\   .* . .\    ..*.\. * \ *.\ .   . \ . **.\  . .\  . \ .. *\ .\*.\ *.\...\* .*.*..*\\.\ *. *#
#..*. *...\** *. . .*... .*\. .\. .... .\*\..\ ..  .\  \..*.\\....\.\. .\.  .  ...** * *  **.**\* *  .. . **#
# **.\    ..*.\.*\ \..**\ *.*\  \.*..\.. *. .*\.  \*  ..  . .*.*.\.*..\**.\.*\*.  ...\. *.*.\..*... .\\\  .*#
#...\*\ ...** * .*.\\*.* *..*. \. . * * *\   . \..\.*     \\..**  \.\. .*.* \.*.  ...*.\ *.**.....\. *...* .#
#*\.. *.*  ..... .  .\*..*\**. *.*. *.*.\. .*  **.*...\. \  *. *.**** .\.\*. **    ..   .*** *..*\. ... *.\.#
#* \*\*\.*\\*.  *\..\  * .**\*... . \  *.. \*. * *.\*. . .*.. *...*.. .*...*\*.*\  . ...... \.\ **\.\. \.\ .#
#* .\**   .\. ...  .  . .... .\*..  .... . ..*\. ..*. * .*  . \. . .\.** * . .***  .*.         ...\. .\*\ .*#
#\*.. .\.\\*. **  .*..*    *. .... .*\.\  .\.**.  .*  \.*  *. . .*.\* *\ ..*   .. **\.\. ...* .. \..  ..\\..#
#.**\.*\. \..*\.\. .*..*. ...*.*  \ .\ **. * \**\ * ...\\..****\  *.\ \.   .. *  \* .\*  \ ... *\. ... ...**#
# . . * .\.*** *.   .  \*. . ..* \.   .\*. *\ .  \** \* ..\.**.*\..*.* . *. *  \... .*..  * .\. *.* .   \.*.#
#*. . . *.***.*.***. * ..\   .... . . .* *****.  . \...*.\*. *...   *.  ...*..\.\* \.. \  *...  .. *.  ..\. #
#*.\.. *\***\ . *. * ** *.\  .***  *.\.   .. ..*\. \**\*.* *.**\* . .  . .*. ** ..*.   . .*.\. * ****. . **.#
# \.* ***.*.*.... .*..** \. . .\ . ..* .  **\  ...*.**.\ *...*\. *..* \. *....*\*.\*\   . ..* *\.. .... *.**#
# **... ...\..*... * .\.. \. \ ..*.. .  ..\.  *.*\.. **.\*\....*.*  \.. \.  \. .* ...\...  \. **  \.*\  .\*.#
#\*\ ..    . .*\***.   * . . .*. **...*.* *.\.*..**  .*\.**\ ....*\\. \..* ...\.***  .  .  .\\**\ .*.*\. ..*#
# *. * * ...   \.*\ .. \ \ .*\*.\.*..\ .  .* **  .* * .* ..*.\  .*.   .. .\  \*..* . **. \ * ..**\ .\  \ ..*#
#.\  . ..*...  ....*\.... *\**\*. * ** \  \. .\ .  **. .*\ .\ ...* *   *. ..* .*\*.* *.*\. .* .**.**.*. .\ .#
#* ...* *    .**...\  . * **.* .... ..     . *** .*...  .    *  \... \*.* \**  *.*.  . ..\ .. *.*  ..*** ** #
#. .*.. .\    **. \  * \.*.** \* .      * *..\..\ ...* \.   *.  .\.*\.*\  .*....* .  *.\....  ..  \\*** *.. #
#\.\.*  \.  ..**  .\*.  ** .*. *  .*  *\* *. . ..   .\**  \ .*  \**\* .*\ \... \*..*..\..*\*.\.\.*.\.. *.. \#
#. .   .. * **.. .  ..\*. *.*.* . \ .**.\\*  .. .*\  ..  * *\. \.**.*\.\.* .**  *\ ... \. .\*.\*.*\...  .  *#
#\   ** .. *\.*\....\ .* ....**..*\*.*.\*.. * .\\*.*..  ***. ..  . ... ****  . ...    \.....* *\*\  \   . *.#
# *.**..** \..\*.\ * ..* \ *.**... *.... * ..\*.*..  .*\.*..  *.** **.. .*.\. *    * *. .  \....\. ..* *. ..#
#\.\ . *\* .\..\. \.   . .\ *.**. *....  * *  *..  .  *..** .\\* ..\**. *. *.\ .\... *   ..**..*.    ..\ .  #
#*\.  \...*.\..* ..******.  .**.. **\.*. *.*\. .\.**\ .*\*. .. .\  *.*.*. ....*\.*. .\ .*.. \ \*. \..*. ..*.#
#.*.   *.\.\.\..*\\\\...**.\..... .\.\.. *.\  .* \******..\  *\\ .\. *.  * **  **.***.\.\ *.\ ...\ \ * . *.*#
# .  .***.  ... *.\.\.\.*.\ \ * ... .\.   .*.*\..*.. *..\*  ..\\*.. **\.\* \* ..*\. .. ..*\ *.*\. . **\. .\*#
#. .\ ..*.... ..\*...**...*\...\**.\  \ \. . .. .\*.  *\*.. . . .*.*\ *.* .*.   * *. * *\. *. ...  .\... .. #
#*. *.. ..\**.. . * .\\.\ ..*...** *.\.. ....*  *.... . *\ *. .\.  *.**\.. ..* .\\.*.  *. *... *. *.* .\ .* #
#*. .\.  .* .. \. .**..*  *\\ ...\....* **\.*.\*.  \  *...\*  **.  ... *..*   .\..\.\..\*.***  . .**. .* *. #
#.. .*  .\*\\. . *.......*.*..\.      .**  \\*..** ..*.* . .  .*...  ......*.. *.**.*..*. *..   \...   *\ .*#
#\ . .**.  .*    .... \.. *.*\.. *...\ .\.\.*. *.\ .\* * . .\. \. \ *.*.  .  *.. *.\...*...* **.*.*..*\   ..#
# .*.**.  * . *  .. .  .\ .\*..  . ..*.\  *..\ . *\  .*.. .\ .\\ ... ..**** \ *...\ \  .*.** . *\.\  *. \..*#
# .* ..  ..** .\*..*....** *.  . *\.*. .**.* \   \ *..*** * \..... *\* ..\.\..\.\.* . . ...* *\.\ **.\.....*#
#. .  . . ....*. \*..  ...*. ..*.*. *.. ...\. ..\ *...... . .* *  .....\ * .   \ *. *  .  ** . .\*..*..*. ..#
#.\   .\ . ** .   *.. *  *\  .**.*. **\ \  ..   \*...*.\.\.  ...*...  .* ..  .* .*..* .*.*.*\ *  * *.\ \ *\.#
#. * **. * .. \.  .\..*\.\\** **..  .. ..\ *\\. *.\*\.* .*\ *.   \ .\.\\*.\.*\.\****.*\*\*..* .. ..  *.....*#
#\** .**\.\ * ..\  .. .. .\ \*\\* ..\\.. ...***..*** ..  *. *..*\.* .*.. * *.* .**. .\ . .  .  *.\*. . . .**#
# .*.*\.*..\\ .\.*\.**.*\.  *\ *.  **.\..*.. *\ ..*.  .**   . *\* \.\*.  *\. .* \*. \.  .  *\*\. .*. ...  .\#
# .. ...\..*  * *. .\ .....\...\ .*.*. \...**.***.* * ..**.**.*.\ . .* .\\.*.*\* *.    \ .\.*\...  . .*    .#
#\ \.. ..*****..\.*.\ \* .\***\.\\.\. *.\...\ **\ .*.*.**\**.* **...\.* .**  **.\*. \  * .**.* .*.**. .  ..*#
#############################################################################################################