################################################################################################################################################
#\ .*. *\** ... .* .. *.\\.*  .\ \*.*   \*\ .*.*   \.\. .*....\..*.*    .\...   \ .. *.\ .*\  \*. ..*\*.\**..*\ . .* .\.\*.* . .* .\ .**.*##\# #
# * \...***.*.** ..\. *. ...**   .. .\  .**\*. ..*****  ..  **.\*... .\ .   \. *   *** .\.\. *.*..* \ **...\....* .. . *  *\    .#*##\. .. *.# #
#.. *. \...*.*.. .* .  .\ . .  .. .. .*. .\ \ .  .\**. .\..  .*.. *..**.*.\\.\ *..\ .. *. *\.. .  \......**.**. \\. * .**\.*. \... #\ . .*..#  #
# . .\. .\.....\***.  .\..  ** ...*.\.. .*.\. \*..**.*     \. ..\ *\. \ *\.\* \.. .* . .* *.**......** .  ....*\  ..*\.\ * * ..*. .*   *\.#. # #
#\ .*... . .*.\*.*.. ***.\ \. *  .  . . ..* \ \** \***. . *..*  ..*..*.\ .*.* . \\*\.  *.\*.*..*   *..*\\ .**\.*. **...\...** *. * .\ ..*\. . ##
# .*....\\*.. ..*  *\*..*. .\ . \..\..* *\\....\. . *..\ *..*.. \..* .\.  * .**....* \\. ** . \*  .* \...*\.**.  ..*..\*. .* ***\\\ * **#.....##
#***.*.....**    ..**.* *.. *\** \** ** ..   .. *.\*. \*..\**.\..** .  .**.  *. \*** .......* .*.\ \ \.*... ..\.** .....*. .*... \. ...\.* .*..#
#.**\.. ..*.. **\...... .*.*. \. .  ** . **\*. .. .. *.. *.*.. \.* .*. \ *.  . * \.*  *\*\.\.\..*.   * \\* .\\*..* ..**..**.* ..\.\*   . \######
# *.**. *. *  **.*.*\*.*... .*..*\..\*.  ...  *.* ..  ..\..**.. .*  . ..**   * *. *.\. *....*...**. ..\..*\.*.. *. * *.* ..*..*\.\ .\* *##     #
#   ..*.\   **\  *. ..*\ .**  \R.... ..  ..** . \\..*..\ * .*\  ... . **..  **.  . . .   .*.*.....*. .   \ .. *\. \*\  **  *... *.** .. #      #
#..  .*.**. *****.* *..*  .  * * *.* .\. ..\.. . .... . .  .. **\ *.  *..\.**  \.\.*..  \**\.*..  . .*. \.\ .*.**.\. * \. .\. \...*. * .##     #
#\* *.  *.**.*. . .**. ..\ *.***. ..*.. . *.\  .*... \      **.*....* *\.*.\*\ . \.\*... .. \*\* \  \..\.\.  . *.    * .\.. . .....**\ \..#    #
#*. \.  \**.*..  .  *\  .\....**.\.\*.*  .. *\  .*. *..\*. ...**. .\. \  . .*   .*.. *.*..* .*\. \ *.\ ..  ...\.*   \*..  *.*  * *\ *.\###     #
#.. . . .*.*.*..... ..  ..\*   .\ .**  *  . *\ *. . *   *.  \  * . .. .\ ..   . *.    \.. \..\.*   .*.*. \ *.*.**  . *. .*..  **.  . . . .#    #
#. * .. **\.* \. \* . .\.\... ..\* ...**.\. .***\.  ..*\..\ \..\ * .*..*. * ..  .. .  . . *. .... ...*.*\....  * . * \*.*... *  .*. . #**#     #
#. \. \.*.**. .\ .\\**\.**.* .** ..* \**...\*.\ *.  ... *..\.*\... .....*    .**.  ..\ . \*\  .*  .\  ... *.**.* . ..\. .*  \....**\ *  .#     #
#*\...\ .*\.... ..\**.* *. .**.  *\. .....*.\..***.*\. *\.* . *....*  ..\ * \.*\  ** .\*.\***.  .\ ..\ \ \ .* **.**. . *  \.**.\.\** #.#.##    #
#\.\*\*. ...\.. . .*.**..\.... ...    ..*.**\* ... ..* * ..* .\. . ..\ . *** *.* .. \  .*....\ *\..\*.\.*. ** .*\ *.. ..  .\.\.   ** *#\**\#   #
#* * .. .  * * .**\. *\\..*\***   *.\. ..*\.*..\***.\ ..\ *...*.. . .*..  .. *..*\.  *\ .* *\ *..*... .... *. *..* \*.\.*. .** **#.* \#####    #
#. ...\ \* . .* ..**\...*.*..\.. *** . .**  .*.  ...  *  ..\....\* *.**.  *........  ...**    .*\\ \.   .\.* .****..\\. ** *..\  \L..*\##      #
#\....*. .  .\... . * \**\*  *..*...\ \ \.\   *.*. .  *\**\.\ .  *.     *.. ..* .*.*\\*\.* *. .\.*\.*.*.. *\**..*.\\.\*.*..*. ....#\.#*#.#     #
#.  \...*.. *. *.\*.. ..**.    .*.\.* . *.    .\.\ \  ..*.. ***\*..\ . .\*\ * \. * ..\ ..**...  *...\ ***  .*.** \**  \..\** .*..*.* * #*#     #
# *** *.**...\ . *.*...\.\ ...*...**.. ..... \.*.*  **. ..\.\ *... .  \ ..\.. . ...\ ..  *. *\ ..**\ * .**..*.\*.....\. . .*\* . ..*   .\ #    #
#\. .** ..   . ..\\.\*\.\... *. .*.. .\   ...\***.  . * *    .\ *.\ * .. *. * **...*..* *..**.\ \  .\* ..\*.\..***.* .*\*.  ***** \* . .#..#   #
#*. \..***\..   **.. *.\ .** .....\  \.. *. ***.*. * .***\.*.* \.  ***\*..\.. \\.  . ..**. ..\**.\ \. \ \ .*.. \*. . \*\  *\..\ *.#..* *.##    #
################################################################################################################################################