#######################################################################
#    ###*#.\.* * .*\. **  *.*.* ..\*.\  .\.*. .* * **..*. .\.. *\ *...#
#   # **.\*.\\\   * .\**. ..**\....  . .*.*...** ..\**  .*\  *.  *..*\#
#  #.  * ..\#* .  .\* \. ..**\.\* ..*\.\*\. ..  *. *...* .*. ..*.* *.*#
#   ###.\.. *. .*.  .*. \ ..*. *.   .. ..\.\ .R .**.*\ *  **.  . . . *#
#  ###  . * .*... *\ \*\. . .* . *.*\..  \ * .*. *..   ..**.  . * *. .#
# #*..  \ . .\* . *.\ **.\\   \ \.**  * .. .* .. \.*..*. *. \****  .  #
#  #. *  *\.. \*  ..***..*.**  ..... \*\   \.\. ..... .\ \**.\.*\.*  .#
# ### \ **. . .*.\.  *\. . .. . *\ * ..*   *....  \.*...\ *. .\  ..* *#
#L *.   \.. .  .*...*.. .\\ *.*..*  . *. ...  . \* \..\.***..* .. ..*.#
# ## .*\...   \ .  **.   \  \*.... **\..*..\ .\.\.. *. .**.*\  .. .*. #
# #  ##\ * *.\.. .\*. .\ ..   .\  *.**.*\.. *\.*... * .*..\.. ..*\.*. #
### \* *.*.*.*..  \* .*. \ ..  .  **.\.. \* \...\.*.\    ** ..* ..\..*#
#**  ...*\**. \..*..\...\.*. \ \ ....*  .\.*.. .\*. . * .* .\*..\ * ..#
##.  .*....\.*. ***.* ... .\ ....\  *.   * .. \..\..**\.*..* .\...\ ..#
##\## ..*\\\ .  *....  ..***\. * \.* .\**. .* *.*. .    .. * \.  .*  *#
# ##\.\ .*\. \  . \\. *.*..* * .. * ..\...\*. ... ..\. ..*\. .. . .  *#
#   #..\ .. *.*.  .* ...   .*...  .\\ . .**..   **\ .\.*\.... ...\..**#
#  #*\*.    \.* \**.* .* ***.. .\.* * .\**. .* *..*..**.**.\\.. *.** .#
#  #*..\ *  * ...*...**. ***  * **. \.\ . \ .* **.\  ..*.* *   * .. . #
#   #... .**.. \ .\. *.* * \. .  .. ..**\.\*.\.* . .*...*  .. \.\*  .\#
#  #  . * \. \*..\*\**.. *\**\* .\ .. .*..\ \. .  \** *.*.. . .**.\ *.#
# #\ . \.\ **..  **...*  ..\*.  \ ...\.* \.*  .  . .. . . *.*....\. *.#
# ## \* . ..  .\ ..  .\ *. . \.\..* .*\*\.*. .\.   ..  \  . .*.. .  \.#
##\. #..  .*\. .*.***  ..*.\*.* . *\** . \**  ..  ..\.* .*  \.*  .\ ..#
##.#\#  .  .\\ ****.\  . .** ..\  .\ * .. **\    . .*.. *..* .*..**.\*#
# #..##.\ \ .  **..\ .*** *..* **. .\*. * ..*\*.... \**.****. .* ...*.#
##\*\.. .*. .**\ * * \..* *.\*..*\**...\.\  . * . \ **\*\**... *... .*#
#######################################################################