###########
#*.\**#   #
##  .. #  #
#*  .\ *# #
##   .#.###
#. \ .\*. #
#... \ # ##
#.\#\.. # #
#*.*  ##  #
#*\#*R\#  #
#*.#*L#   #
###########