#######################################################################################
#.*  ***. ..\. .... \ *  \ \.*.. .*\*..*\. *\. * .  . *. \ *... #    #                #
#\*. \.. *. ** .\.*. ..*... ...\.*.... ** ***\. . ***\  . .*.\#.*####*##              #
#. . .. \ . .**.*\. **.. . \    ..\  .*.\.*..*.*..*...*..  #.*..* \\..\.##            #
# .*\ .  * * ..*\ ...*\.   \ \.. .\.\ *.. . ..*. * . * .\ . #..\. .#\..\\*#           #
#..*\. ... *.  ...*..* ** \*  \\. .***.* ..   *\.\ \..*\  \.\ ...    * ...\### #      #
#  . \ *\..* .\  ... .*** ..*..\ .. *.\\..*.* ..\  ...  ...* #\  .* .\   \# .\#.#     #
#\. ....   \. *    \ ..***.\..*..**.*.. \ * . . ... .\ . \..*...... ** ..#*  .  #     #
#.. \. .***.... \... \ *.. *.\..*.  . . ..\..\*\..\   .*. ...\ .\   ..*..\* *##.#     #
#. * . .* . * . ..*. .*.\* .   *...* \ .  .\ *\*\\.. **\*\ .**.. .*.\ . .\*\.*.#      #
#*.. ...\*..\... *\.. . ..\... *** *\  . * * .*\*.   .*..*\.**....\ *.   .. *.#       #
#\..* *  ..\*..* \  . \ .  .\ .*\.*. *.. ..* .**. .*..* *.\..*  * .\..\** \.##        #
#**.. .   . .. *.\*....**..**\* *.\...*\  *.\ .\.*.*. .  \* * ..*.* .*... # ..#       #
#*\..\ \ \   .*...*\***\. . .\*\* .* .*.*..  .*.*\ .*  . ..*..\*\*.* *..*.# . #       #
#\. * . *.\  ** ... **.*\  .* \*** .. * .**\*.** .\  .*.  .... .   ..\.\.\.   #       #
#..\.  **.* .  \ .**.\*. .*\***.**.*     .**.*.*\*..  ..* *. *.\* **** ..* .* *#      #
# **  *..**..*. \..\* * ....*.*...*.\   *****. *..*\ .* \.\.*.\ .  .*. . .\ ..**#     #
#\.* \.....  . ..  .. * ..* . .* *.\*....*.**.\*\ .. .***     ***\. .\**. ... **#  #  #
#.\. . * . **.  *.*** **  ..  *\.* .\\ .  **.***.*\. * *.*\    **** *..* \*.*\*.\##.# #
# . ****....** ..\*...*.\*** *...*\*. . \.*\ .\*...\**...\ ** *....\   * .... .* ..  ##
# *.**..\ .  .\ *.*  *\..... *. ..*..*...\ *** *    *\ .\. .* .  ***.. .**    .\   #.##
#.. *\  ... \   ***.\ .*.\  .. *..\\...**. \*. ..* .*.. **.*\ **\*..\. ... \  \...##\##
#*  *.*. . .  . ..*.  \...*.* .*.* ..* *. *..** ..\ *  .\.\*\**. ..*.\ .  ... \*\.\## #
#\. *\.*. . *..\ \... .*. . *..*..* * .\ *\\*.* \   .... \.* .\*.. . .\..**.*..\###   #
#   .**..... *    ...\.*.  \.*..\ \* **  . .. ...  **\* * .*.* .*  *.*. *..*\.\#      #
#.*. .. * \.....*\. .*.. \ *.. **. ....*   ****.* \.... .\   . ..  . ***#** *##       #
#*.. . ***. . \.\ \.\.*\*....* *.*\.  **..\..* ..\. . . *..\\*\. .. **..\.*#\##       #
# * .\* *.\ . . .   *.* *. ..* .\*   .*.**.\. *..*  ....  \.\*** .  .*..  .\*..#      #
#\..**\.* ** *. .  ..  ..* .***.*  ..\*. .*.. * \. **\.  \.\....\.*.\.**\*\.*###      #
#. ****\. .. \...*\  .*. *  .. .. .  *.. *.**** .. *..\.*...\*.* \.\....*.  ..**#     #
#.*.\\..*  . ..**\.. **...  .*   .*.  . .. .....  \**  *.\. \..\..*..*\.  ..  **#     #
#*.  .   *  ***.. \. *\..*...*.\. ... **.   *.  .. ..\ *   .  \. .. * .*\..  *\#      #
#. **\.**.\..*.   .. .*R *. ..*..* ....*.** .\...\..  .*\ *\..\.\ * .  *.  \#..#      #
#.. .. ...   **.*.. . .. \... ****.    .  *\*  .\.  . **..*   ..*.. *.**  *.....#     #
# * . *..    .. .\..*.  *  .*.*\. .. **\.\ ..  \.  .  **.\..****.\\ \ .*.\.*..\.##    #
#  *.. ...*.*  .\ *..\  *.  . ... \ \.**\. \*.*\.\*\ *\.*   ...*\ . . .***.. .. * #   #
#\ \ *  . .\..\.**   **   **\. .*\... \**\....* **.** *\.  .* ****.  .**.*.**\. .#    #
#*\. \  \... \*. .\\ .\\ ..  * \.*. *  *.  ..  * . .\.*.\*...*. .**.\*\ ...\**\..#    #
#*..* .\.    \.**. *\\.. .\. * *.\ .. .. \..\..**\\.. .\ *. ..  \......  .   .#\##### #
#*  ..   \*  *.**   . .*\** ***..* * \\.   \ \.\.*  * **.  *.*. .  ..*   ..#\ # #\.*\##
# *.*. .*. * . **  *. *.**. \ *\*..  .  .\.\ .... *\  *. \ * .. *. \ .\..  ** .*\**.# #
#**. \  * .*.*.*.*.. \. ..   .. .  \*\ \*\*.\.*...**\.\ . \. . .\. \..... **.  \*..\ ##
#*\.   .\\..*...\..\ .. .*..  \*. ..*.*. ....   *. .  ..    *.  ..* .*. *  .    .\.# ##
#..  ..*** .. **. .*\.\*...*.*.*\*. * .*.**.\...* .  ..   \*\ ***.* \*\*. ...\#.\*L# *#
# * .  **.  * *.*.* ..*. .\  .\  ... \ . .**.\* \***.\\*. .* \. . .  **.\ *.* .###  ###
# *\   *\ ..\ ..* * \\..*\\ \ ..   \*  .   . *.\*.\*  ....  .  \.  *  . \**.. #**.##  #
# . .*\.. *. ...  *..\... \ ..** \*.. **...\*. **.   .... ..*..\ ..\   ...* * *.  #*# #
#\  ** .    ..\   *.. ...  * ..\. .   .* .. **.*\..\..  \ .*..\*\*.**...*.  \ **# **\##
#*   * ... .*  .* * . . . ..\       . .*. \.....  .  *.\..*.. .* .\*\. \*..*#.\*\ \*.##
#..      ** * .\  ..   \.* *..*\ ..*... \*..\.. * . ....*\ *   ***... ...*...  *####\##
#* *.\...\.*\*.....\ \ ...\** .*.. ..***.. . *.\.\** .. .* *. \. .* ** \ .\\*.\.. *## #
#..\ .. . .* *   * .*.*\* ..**.*.   .***......  *..\   .\ ..\* .*  *.*\.**..\* **..#  #
# \.. .. ...\.\...*..* .. \\.. *.  \ ... .\   . \.\..*\.. \. * *\\*....  \.**. . .#   #
#   \ \.*  . *...\ . ..\.\ * .\**   .\*   ..* \*.*.\ ...*\.\.**  ** .*  . ....*.##    #
#..\.*  .*.... .. * \ *.  ..\\...  \....\. *. .*.**. ..\ . .. \.*.\*  ..\ .*... .#    #
# *.*. ..*\.*. .. . .. *.. ..\..\.\* ..*.* ..* .\ *\* *\. ..*..\. *.\ .  #.  *.\.#    #
#\  * * .\ .*   ... ..... *....    \.\ .\.\ \ \ *.\.*\.* .**. \*.*.. .. *  ######     #
# ..\ . \.. * **.\ *.**\ *.* ..\.*..\.. . .  \.*... * .*\ .** ** .\\ .  ..\...#       #
#  .**\. .*\. .  ..\ .\.\\.  *.  . * \\  *\  .**\   ..*...\.. \*..  .* .\* \\.#       #
#  **. .* *.* *... ..      . *.****\\..\.*\.**...  \\. . \ .\..**... . ...  #.#       #
#.\* .\ ... **\ *...\   \ *\ *\.. . .. . *....\.*. . ..\    .**.*  .*.. .*.###.#      #
#*.* ..\.  .**   *.**.**. *.  .   .....\ .*.\ ..*\. ......**\*. *\.**..   *..  #      #
#\.\  \** . **\.\. \.** *.\*.*\ *. \ \ *.. *.** . . .*.\  *.*..*.. . .. .**\. *#      #
#.  .*....\ \ *.*    *. ..** .  . *.. ..*.\.*\. \* .*.. *. .\ .  ..*\. \*.* \.#       #
# . \.*. **..  \.. \ ..*\*..** .  *.*.  *.* ..  ....    *    .\.*\... .....   .#      #
#.  ...*\. \.\ .. .. * **..*.\. ****..\.*.*.***..* *  .*.\** \.*.  * ... .\. *..#     #
#\ *.* ** .  ....\   . ...*.. *.* *. .. *. .*.** *.. ***. ** ..*.. ..  .....*..#      #
#* .*.  .\* *** .. . \. .\* ..* . .*.. ..* \.*.*  \ \** * .*  .*** **.*  . \ \.#      #
#.  *\\.* ..*\.  *.** \ .  ..*. \..*... .  .  *.* . ... \  .\* ..\ ..\*. \. .#*#      #
#*..*.  \ . \*\.\. .* . * \ ..*.\..\ \\... . **.\  . *  .  \* \**\...*.*..*. .#       #
#.. *..*. .  *.. .  ..*\.\..\ .\.\.** * *   *. \. .*.* . .*.  ......\..*\*# *##       #
#..* .***.*. .*\. * . \ *. *. ***.\**..*. ..**\.  *. . ...*.  . . . . .\*. \#*.#      #
# *\ ..*\\.* * *. \..  . *\*  ..  \*.**. .*..*** *... . .   \*..\  .* *..* #.\\.#     #
#..  *. ...* . \* **\. \*\. ***.  *.**. * * *.\*\* .** .*.\ \..\*  \*. \ .##\ ##      #
#** *. \.* .  ... *.  ..\.* ...  **...**.\ .\**  . ... **. . ..... ...\ .  \*\.#      #
#*.*\.\ .\ *.\*. .. . \. .*..*   .*.\\* *    . \..*.*..  . .\..**.*.\ .\.\.### #      #
#\.*.\..**\....\   . ** \.*  .   \*.*\*..   **\.. . .   *.*.. *.. *. .# .. .# #       #
# .* *\\.*........  *...*.\ \\ . .\ .. .. \ * . *. \*.  \.  ..*\  \ .* ..*\ #         #
#. . * \ *  ..  . *... ..* . *. . *.*   .. *.. ****... \. \  ....  . *  *..*#         #
#\   .\ \*.\  .\..\.\   *.**.* \**\. .* * *..\......**..   *... .  *.\ \\\.#          #
#.. .... \   \*...*.*\..  *. .* * ..*\* \\.\*..\*..\*..  .\..*  .  *. \##\ *#         #
#.. ..\ . . * ..  \ ..\. \*\*\..... .*...   ..* ..\ ***.  *****  \ * * *\.#.#         #
#\. \*.  \ \* **.*\ \. * .. ..\ \ .\.*. . .\\ .\. . ..  *\*\....*..* . ** ###         #
#.\ .\*.. \***.. ..  *..  \  .   *. .*    .. . . \ \* ****\\.*...  ..**#\....#        #
#  .. .  . .*\    .*..\*\.. * *..*\..\*   .. *** . *.* .\ .\ . .*. *... #* #\*#       #
#**.\      ....*.* .  *..**...\. *  . .**.*. ... .**... .  .*. ..... *.\#* *##        #
#** .*. *.... *\*. *. .*\.*\  . *.*.*. *****.   .\**..\* .. . .  ..*#.#   ##          #
#*.*\*  \.   .. **..   **.*. * *  **\**\...    \. .... * *. .. \.. #. ##..#           #
#... . ..\*.*\\*. * .. .**.* *  \**.. ...   .**..\. .*... *.\*.\*\\*#.# ##            #
#.. .*   .*. .*.  .   . *.\\.** ..\. *\  . . * *\.*  .**..**.**** *. #                #
#* . *  * ** . .**..*.*.   ..  . \  \.\*..\ ..\... ..*..  .\ \.. *\ * ##              #
#**...\*\..      * \  .*.  .\.. .. \... .**...**.* \*. . .\.....#\ .#.\.#             #
#*.\.*  *. \**..\*  ****.\** * \.  .\ ..**.* .**\.\.*.  \... \  .*\*####              #
#.  *. ..*\...  . * *.*** *\.*....** .* .. .* . .*..* \\.   **.\\#***#                #
# . \.. ..\.**  * . ** ..\*..\  *..* \*\ ....*\..*\**\.  . *\..# ####                 #
# * .*\*..\ ...*\.*. .  . *\  \.*  ...**.. *\.. **.\\. .**\.*  #\#                    #
#.\\**.. *.\  \ . .  .   .*.... .* \. ...\\.  ... . *...\** .\.##                     #
#\.\...**.***.  *\   * *\ *.\  *..*.. \ \.. .. *  *\**.\...*..*#                      #
#.\  \.*..\*  . ...* . . \. .* . *. . . .. \.**...**.#   #\.. .#                      #
#*\...*..  .*\ . .\. *.\.  \...**. \    *\*.*..**.*.*. *# #   **#                     #
#..\* .* .\.*.. .. .\..   ......** . . * ....\*...*. #.\*\...**#                      #
#\ . .... **  * ..*.*.\..  \. *** ** . ... . *\..*.* ..####.*..\#                     #
#**\  . . **.*.*\.**.* * \. .*\.\.\*\*.*.** *\  \# * *  # #..##.#                     #
#######################################################################################