#######################################################################################################################################################################################
# #.# . .*\... . **.  \ * **.*.*\. **..*\.*\.*.\.*\* \.\..*\.\ *. ..*  * ...*.* .  *...\. .. ***..* . *..   *. .\..  . . \.**\.*.*. *\ \ .*.*..** *  .   .\ .*..\ .***.. ... \.\ **. .#
##. \. . *   . * *\ .. .. *.*. ... ..\ . . . \\... .... . \.*.. *.**\..*.*\*.\  .\..\   *.\  . .* \\.\. * .\** **\\****\ . *. .. ..*\ \.  *\*......*..  ..** \  .**. .*. . \ .* *.\ . #
# # ###. *...  \*  *.. ..\. * **      ..***\ ..  . *.\  *\  .   * ...**\  *.*...*  ...\ *. *  \*.*  *.. .. \.*\*   **.****. \.. . \.**    .  *. .  .*..\.\ . *.  ...\.*   *.*.* ..*\.*#
# #.##**\**    ..*.\  .*.. ..\. \* .    \...*.***.  . *. ..**** .\ ...**. .....** **\..*.* \. .* \. ..\.  .  \*\ .  . .*. \..\. *.   .* ..    ... *.**\.....\ ..\.  . . ...*.\. \ . *.#
#  # #\\... * . \.\.*  *... .. *.\.. . .*\. . .* . *\.*. * .*.\ **\*....*..    *\ *\  .*.  . ...\.\  \. . \\..\.. *.\*.  ...* * *.\ .  * *. *  .*\ .\*.*\**  . . \*\.\  *..*.   .  ** #
#    #.\**\...\  *  .*. \* . \ \ . .\ . . *  . .*.   ..* *.. .\  . .  *   *    ...*.  *.\ *.\ \*.\ * ...* \* *  \.. \*\ \ ..*.. ....  ** \... *  .  .* ...\*\. \ ... ...*.  .*\  \ .**#
#    #*.\\*..... ..* *..\.  \ ..\..*.\.*   ..\ . .  .* . . ..*..*.\  *** ** .* * *\.\. ..... . .\ * * ...\ . .  ** .....* . .\.\*\ * * \....*\..* .. ...**.*.*.*\* ..* ... ..*.**\..*\#
#    #. *..   ...\ *  .  *.  .* ..\.\.\ ..*.* \ *\.. . ** . \. .*.   .*\ .  ****..\ .\*. \. \. .  **. .  .... ..\* . * .. *.\ ...*\**.  * **\ *.. *\... \. .\.*.*...    *\  *  .. ...*#
#   #  * \.\  .   \....*\  ..* .  . *\...*.*. .*   . .\..  *.\.*  ...***\**.***.* .\..\ . .. \ ...*   *  * . .  ...  ..*\.\ \*\  **.*.....*. ...  ***.* *\* * .**\*.   *. .*\ \.  \ .*#
#  #*\.**.\ *\. *.\..  .*. *....\*\.**   . ..*..** .** ..  * * . *. .**...*.\ *.. \ \ . .. *    .   .\ \ .  \*\\ *\ .\ \. * ..*.\\  .\.  . *\.*.   .\ \..*. .* ***...*\*.* *.*. .** .\#
#   # #*    \ . . ... ... .. *. ..  \..\ ..**. .*\** **\ .\. . . . .* .   .*...  ..\\..\ . .    * **.. ..*.*.*.\* *. * .*  \**. ****   .   * .*\...\* .\ \ \.. . . .* *  . ....**.\ *.#
#    ##\* *\.  .  .*\. \. . *\ . \.*.\**\ *\.\*.* ..  . **.\ . *....*  ** ...*\*  . \****\  * .*. .\   ..** \ .....* .  .*..*.  ***..**\   ..  ***.*\ ..\ .\. .......** .* \ **.. .\..#
#     #\# #...*. .\. ** \*  .*  * \* \...\.*. . *\..*  . .**.\ .*.. . *\ .*.*.\..*. .\\*.** \*.*.\  .\.. ..\ *\ . \.....\* .. . \*.  ..*...*  *\.\.* *\    .. ..  .. R ... . ...\  *  #
#   ##  .*..*\**  .*.*\ ....*. ..* *..*  *..  ..*  . .*.  ...***.*.\ \.**.\\...\ *..*..* ..\\. ..*\** \ .*.* *..* .*\*.. . ** .   ....   .\\  \. *.*. **\** . .\...\. ***..* **. ..** #
#  #\.. .  **.*..\..\.\* \\ *. .\...*\* *\*\. \ \**   .* .*.\..**... *...***  \...* ***.\. .**.* *.*.\.\**\.*...\  .*\*\***.\*\  .***.*.. *. \ * ..\  *  ..\  ...\.* . \....\*.\*   \ #
#  #*#\    **. . .\ .\ ...\*. .\*  .* .\ .*.\ .* .. .* .  ..   \\ \\.\..\ ..\... ..\..*  * *....\**.*\. .*. *\ * . * *.. *\ . ***..\ .* **..\* . *.*  * \* .****\  . \\  *.  \..\\.*\ #
#  # \ ..****. .\ * ..\ \ ***.\ \\. .\ * *. ...* \ \ ... .\*.\*.  .. ..  * *. .* ...* .*..\.\.\..\... *\ * \  *  *.\.*\ ..   *  *\*.***...**.\*** \.*.\**\.\.* .  .  *.*\ .. .*.**..  #
###      *.\.... *. *.**. .* .  .. \* ....* .* . .  . \.  *..*.    **\***. *.  .  * .   .....* .*.* . *.*.*.***. * .**.   .* ***. .. \.\..*.* . *\...**.  \**.*  .\.*.*.*... *.....\**#
#\.   .\.\. ...*.....  .\. .  * *.**... .*.. *.*\*    *\. .\... .* .\ .*...*....\*. \ \*\\.\\..*.*.. ...\ . . \ \*  .  *\*\** . . .. .\*. . \. *..\.**\   .  ... . .\.\..\ *...*\. ...#
##**.* *\   *..*..*..*.. \..\ .\.*..\ \ ..* *\*.***.  .... ..*  \....* .. .\ .**..  .  *. \*\\   .*. * .* .* ..*.. \.\ *\. \ \. ..\ . .\*\ \...*.....\**...*  *.. \ *.. .  ..* .* \ \*#
##..*..*.\**. *..**.. . ..\ * ..\. \*.* \ **  \*.\.. .* .\. ... ..\ .* .   . \...  \...\* .. .  ***  * \.\ *    \*.. *.. ...*\*.*... * .**\ *..*... . **...\. *.  .\* .....   .**... .#
# #\.#\. ..*.* ...*\. **\\*  *  ..\ .\ *...*  \* *.*.....  .\ . . .\ .*\\**\..  ** .*.* .  \*\.\..*. .* *. ...* ..   ....\..*....** *.\... ***  *. ***\  .\  ***.  ** \   . \**..    .#
##**  .\ *..*.  ***.... ..\* ..*..*\ ..\.\.*\ .\.**.  ..* \***  .*\. ..**.. *\ **.  * .   ..** .. .\ \. .   \..**. .* . . . .**\.*\*.    *....*\.. *\.*\ .*.*...  \**..* ..*. .\ \.** #
# ##\. .#..**. *.. **....* .*.\**\*.\*\...*\.    *...\  .*..*. .*..  \..*.. *\ *.* .*\**.\ *.\* .  .*.**. ... \. .\ .   *...*.*. \** .*. .   .... .. .**.\....  .*.*. *..  * \ . ..*. #
# #.. #.** .*  *.*\.. \  **\  . * \.\. . \ . . . .**.. *.* ... ...\*.* ...  ...**.  ..\*\  *\.. ..\   .*..\*\\.* **.*..** . .\*.\ .**** \. .. .  .*. .*\ ..*.*  ..*.* .\*  * ..   .*. #
#  ##  .#*  ***.\.\*.*.*.*. ..*....      \* *  .\ .. .\*..\*.\*  . ..\... .  *\ .*  .*. .  .*..\*\. \* . \... .\ ** **.**.\.   .**...**. . *.. * *.. . \ .\. .**\ . . ..* \*   **.....#
#  #*#\ #. **..*.\\.\.. *\  \ \ *   ....**..*..* . .*.*\  ** *..\ ....\*. *...**.. *\..**.*..\ * * \...*\*. *   *.* .\*..*..\*\.. * \ **\  .*   *\.*\ ...\*** .\  \. . ..\ . .*.* .\ \#
#  #. .\. *\. .**...*..*.*.*..  * \* .. \.\ * .  \  \* *.\* \...   .\\.*\ **. ..*\.* \ . ...*\*. *..* *.*\ .. **...\.*..   . .*.  **......\.*\..**\.. .  .  .   *  *\.\    \  .    .. #
#   #.*#*#.*. **... .. .***..  \. \** * .\..*   .*. ..  ......*  *..  *.*\*.*. **......  . ...*.***\* . ** .\.*\  .**.*.* .. ..*..**.. ..   .** \...\\   \ .  \ . \** ..   **.   .. * #
#    ###** .*.\* \ \... ..***.*....* \..* .*.. * ...*\.* .\ *\.  ..  *\.\ ..*\.*...  . **.*\ * ..\. . \**.* . . *. ...... \\ . .\...\. . .*. . . ..  . . \**.\..\ *..* \\ . .** .. .. #
#       ##. . *.*.  \      ..    \\.*  *   *. **.* **  *  *.* .\ \***..*..  . . ..**  .\. .\.. .**..*.\...*.\ *.. .  \..* ..\ .  **.*. .** *\.      ...  .*\.*\  *.*\.  .**\. **.*.   #
#         # ***.**  \..\. .*. .*  .** *. . .\*..** .\..*  .. . * \\\*\.*   \*\ ..*\.  \**..**.\* .*..*.\\ \ .* .* \.*.. .....  .  ...*\.*...   .. . *.. *.\*.** .\ *.   **....*.. . ..#
#        # \**...*  .\..*\ . *.*. *\.**\.  **.  .\  * *..* *.*. ***..* ...\.. ***\ .*. .* ..*  .\*  ..\.*. * ..\..  . *. ..\  * .\ *...  .*\ .**..  \.* . ..\.. .  ...*\.*\ . .. ..  *#
#       L ##\.** * ...*.*.......... *\.** **.   *  *..*.*\ *.* \\..\ . .***  ... .  *..\ \ .\....**.\*..\.*.**  \ .   \..\  . *.. *.* .. *\. .. \  . ..\**\...**\.* . ..*\.*.\* ***  .#
#       #.*.***\.#\.*..... * .\ . **.. .*.. **.\*.*..\.. ..*\..   . *\\ **. **     .. .* **\* ...\.  *\.*.. *\.\.*.\*  *..**.. ..*..*...*. \ \.. \. .\ .*. **.\...*. .\ \***. . *.* . #
#        #*.#.\* *.\..\  . . .* .*\  \ ... * .  .\*    * *. ..\.\.\\..*.\..\..\\ . .**.. .  *** \..\*\**. .. . ..*...*\\. ..    *******.*. ...** .*. **.\* \. \.\     .. *\..   . ..\.#
#         # ..*.  \.\****.\..  ... .*..  \ *  .\  ..** ..  .    . .\ \   \ ..*\. *  .\  .***\. *.*\ **...\..   . .  \. \    .\**.*\. .****..*\ *. \\ .*\ .\ * .. \\   \ ....\   *  \  #
#         #* \#\.* # #...\.* * .... . ... .\ .\ **.*..\**\ \.**     .\..* ..*..   .*\. \...**..*\.**** .*  *.** \* ..\\.*.\... .  .. ..*\.\..* *.*  .* .* * \**. .* *\.* *   .* . .. *#
#          #\##  \  #.****...\\.*\ . .\ .\   . **\.** ...**\ .**\ .. .* *\ \*.\  .* ..\.\  *** \\  *\*.\*.*\*.*\. .  *\  .. **.**.* \*.. * *.*  **\.\. *.\** ** ....*. ...\*.*. \.\ **#
#######################################################################################################################################################################################