####################################################################################################################################################################################################################################
#.* . *.  * .\.* \. .***\  *   ** .**.. ..* .  .\*  . .\.. *. * \.   . .* \... \*\....\***.\*\. *\\. *.... *\ **.\ .   \...*. .. . **.\\.. .*..*...\.\ .  *.. **  ..  *..\*. \**.\.  *.\*..*.\ \*\.*\  *. \.\\**.   . .** . #      #
#..\.  .. . .*..\.\.  **.*\.*  .* ****.   *\ .* \. .*.*. .**\\.\ *\.*  \. .\  \...** *\*.... .  *.  ** \.\.* .* . \ .. . *\.. \.  *...*.*\**....\.*. \ ..\. .*\*  .  ..\.**.\..\*\*.\..*. .*\*.... .....  * *.#. * *\..*.\*.# #    #
#\...\ * .****. .\*\.\..... * ..... .... .. *.. .   \ ..\*.. . *.** . ..\ \..\.*  **.* ......* \ ** ..*.***.. ... ..* .*.. ..*...\.* . .*..\*   ... ...     *. * **.\.. \*. . ..*......... ....*.  . *.   \.* .\ *.. ...*..\## ##  #
# ..  ..   * .*.\..   \... .*.       \* *\.\.\  .* ...*... ..* .. ..* \\..\ * *..**.*.\*. . .*.. *. .*.\*.**.*  .  .*.  *\   *.  *   \.*  ..*..*.\ ***.* . ......**...*\... .* \.\   *\.\*  **..\ ..  * * . . * .  \**.\. * #. .*# #
#*. \\ *...*.*...* .\.**. .\ *  .  *  **.\  ...***\.. .*** \\.*  ..** .  \*\*\. *\..* *.**\. \.  *. *** .*  ..  \*...**  .  .**.*\\* \ \. .*  .\*. *.\ .*\\*.  \..\ ..*.\   .. .*  \ .* .. .*.  \  .\. .*. *. * *.\...\*  .\\\* *# #
#\.*.\...**  .* .. . .*** . .*..\  **.*... . **.. .*.\.*.... .. . ..*\. \.*..\ .. *\. \.*\.*\*.... \*.* .*   ..  **  .*\**.*\**.   *.  .*\.  \***..\.\ \* **..*.   \ ..  * \.....  \  \*.*. \..\\\  .*.* *\ . .\\ ...  . . #*.###  #
#* *\.*\  . .*..*. *.\..\  .* \\  .\\..**  *\.... *..  .\  . *\ .   . * ..*...*.\ .* \.\.... ..... \ \.\*..** .\.\*  *. \..*...   .  *. ..  ..*...\.*. ..*.. ...*** . \.*....  * \ ...*.**\.\*.*  .**\..  .**.*   .*\ * \*\..\*#   #
#\.\   . . .*.  **. *\ \  . .*.*.\  *....\**  ...\...\ *.\...  .. .*\. .\ .* *.***\...*..*   *.\ . ** \*..  \* ...* .\. .* **\ \* . .*.\   *\*\\ \..* . * **  . .\.  **..* ...\ ... ..... .**.\*..\ ...\.  .\..* * . *..#....*.#   #
#..   . \  **.*\.\.. ..\ ...*. .. *.\*\ **.. **..\. . ..\. \\*....\*..*. ..\ ..*.* \. ..*. \\.......\.*.*.  .**\  .\..** . *  .....  .*.**.* . ... ..\* . ..\ *\ . ..*..    *..**.  .  .\\\.\ * \.*. \   *..*..\.*   * ****# #  #  #
#\ ..** .. **\.* ...**.. \.  .\.. . *.. **.** \ *....* \  \. ...\\ *...\ \.*.*.* ..\.   *.\. . .  \. *** ... ..* *.**\*.. *. *\\** \..*.\. . ***.      .. . \ * .* . . .*. \* *\\. .*\*. * .  ..  ..*.  *... . ... \**   *.*..\#   #
#...*..\*.\.* .. **  \..*. .*\.* \  .  ... ..*.... * *\. *. *\    .*.\.*   .....*   . \*.. .     *.\ ... .\. *\.  *..*.* ..\****... ...*. ...*..\ \.*       . **\*** .. * * **. .*  ... *..   * *. .** *\ \  ..\** . .*** *..*. L  #
#*.*.*\.  . . ..*.*\... \ .  . . .*\ ...* \..* \ \....*. .\\..\*.* *.* .  **.** \ * *... ...* \ \*\*\ . \*\. ..* . .*\*\ *. ..*.\*. ..*..* *.. .. .*. * .**  .*...*.\.. ..\ ...*.*  . *\*   *.*.*.\*..\..*..*\*.*.****. .  .  ##   #
#* .\. .*\.\   \..\.  * . .. ..*\  ...*.*..  \.**..*.. .\****. ..*\\\.    ...\.* .\** .. **.* .*.  .*.\. * .*\   ** ....***  .\   .* * .\. \* .\.. *.\. \.    .. .*.* *.*...\ *...\.. * .** .*. *  . *.*.*. ..  \ \.* *   * #*#    #
#*   . ..... .\.\**\*..\*.. .*.\...\ *****. *  ...**.\ ***. . .. *\.\... .  \*\..  ..*.\.*. *.*.\.  * . *..   *** . .  *.. * ***.. .\ .*. .      ...... .\ \*.*   \ *. \  \.  ..* **\... ..  .*\.*. .\*  .*..\ \... . *.* \##. #   #
#..*.*\*\ *  .  .*\.\ . * .    *...  ** \.  . \ *..**  **.**  .. . ..*\.*.. .*.*.  . .**.. .. * ... *...** .* . * .\ .*\  ..  \   *.   .....***\\.*  .**\ ***..\.*. \.\ *. .  *\.**.. .*..\ .***. .. .*\.* .\. *  *\*.* .\  **#    #
#  * *.\ .*\  ..**.. \  *  *.  .. * .\* * . \\ ..*\.\**.*... .\* ...  \ ...**.*..**  \*. . * ... .**.*.**.  \.  \\. .*\*.*. \*..* . * \ ***.**..\..\  *. ...\. ..\  . . .** .\ *.*\*\*  .*.\**.\*\..*.\*.\ *   *  *..*.. .\*.#*#   #
#. ..\.*..\. .\*.\  ..* \.**.**.\ *\  **. \ . .\ . . .  ..\***. .*\ . ..  ***\  .\. *\**.  * * .**.. . * . \. * ...** *  . \ *..* *....  ...\. .*.**.. *.** . . \ ...  \****   ..\.. **  *. **.*    *. **.\..\  .\. \*. .  . .*#   #
#\\.\ .\ . .* ... ** \.   .\ * \. \.... *.... *..* ..\**\...* .\.* .\. . *..\....*. *..\  .\    .*.*...*\. .*  ..  .*.*\   ..\\.. .*\ .*  ..* *..\ *.*..*.. ..\*.\** .**.\** ** .*\  *. ..\.\* . .*\ . *.  ** .  .  .**\..\ #*.\#  #
#.   .\.. * .. ..\* *.*.\.......  .* \.*.. \ \.   ..\* * .**.*    *\. \ \.   *\\.*..*. *\ *  . ..\ .  \...***    *  .*  .\**. . .. ...*.\ * \..*  .*.*.***..*.*   *.  .. ...\ * \*.  * .*  *.... . *.. *.* *\  .* .  .* \  . \.\#  #
#.  .  .\ *..\. *..\..*   .  ..*\. *.....   \ .\. ..*.\*  *.*..  **.   *.*. ..  .\.*.... .\ *    ..\*..\**\.*\*\*. *   \...  .\ * \.* * *\.  *\. **. ***.  *. *.  ..\.  \  . ..**   .. .**..\  ..... . ...**..*\.\.***.*.*.* *##   #
# . *  .* . .*. *.\ ..**.   *\ ..  . * *\..\   .    .. * \ .\ \. *.*.**..*\.**.* ***\ .* \.*..  *...*\ * . \*.* . **.*...    . .. **. *.\.  *\. **.\ .\*..\......  \**  *  *. .... *.. \**  *... ..\  \. ..\\*.\.. .*\  \*.*.\##   #
#\ *.\*\.\   .  .*.. *..*.\*.  \ ..  *...  *  .***.\*.  \..***.  \** **...*.*.**  \..  . .\\ *   * .**   .*.*.\\.\*. **.    .\ .*.*\. . ... ..\** . .\ .* .*..*..  *.\....*...\ \R ... .*   \*   .*  *. .*.\..\.  *......*   *.*## #
# *\*.**\*.* ..* **\..*\. *. .  .*  .  **  . .\*.\...\\\ \ .\.*. .\ *.\.\..*.\.... .\\. \....**. *\*. . .* ... .*..\.*.\*.\**.  **..\*\ \. .\   .  *\..** .*.*..*  *. . .*\** .*.*. .. *.\*.\.. ....*.*. \.**   ... \. *\.\ .\ .#\##
#\**.....***....  .. . . .\ .\.**\  \**. .\* * .  *\.***    * *.\. \..*\  ... .*\ .*. \ . \ ....\...  . .   ..**....  ...* \* \.** *.. * .  \...   . .**.**...... .  *.  .** ** .. **  \. .\*.\.*.* **. ..*. *\   * ..\ .**\  *.\.##
# .*  .\ ...  *.**  .*\.****.. .* . *..*.**.\.. .\....\* .**\..\*  .   .*\. \. .*..*.*  ..   .\. \ \ .\\*  ....\ .\\..   \..\ * .  .  ..   ...\.****\ *. *.   *.\.*.**** ..\..*  \*.*\. *   .   .*\.  *. \.....\*. \ ***\.. . *.#* #
#....* ..***.*\.*\** \.. .\**...* \*.*.*\*. .** . *.   ..   **    .***.*.    *... . ..    . **. ....*...\. . . *  *.\.  * .. **. *. .  . .*  * \\\.\  ..*\... ...  . .*. * *....... **\..  \ .\. ..  .\ .\  **  ..  ...*.. .. ## ###
#\\.*.*. .. *. .\**....*.  *... *...*.* .  *.*   .**\.* \  \..*. ...\\.\. .  .***\.\ .. .  *..**.* * .\ . .*.*..    * .   \  *.* *   . * *. .* . . *.\.*.. *** ...\  .*  *.* *\\  .\*......\ **..\\ \*. . *. .\..  * ****.*  .#\#  #
#*..\ .****.    ..*.*.   **. .* . *. \* . *. *.**\..\.   .  *\\.\  \. *. .*. **.. \.\*   ...\. ... . *...\ \ .\* .* *.. *\* ...*\.. *  . . .     *\.\.\*. ..\..... ...* \..\*.   *. * .. *. .** \ . .**\ **\.*  ...   . .###   .#  #
#.****. \.\ \ ****.*\..* *..\\  **** ...\..*..\.* ..* *..\\..** ..*..**.   *\.\* \  * ** .. *   . \*.. * .*. . . *. *..*\... .*.**. .*\* * . ..*  .\ .*.   \*.\  \..**. . *.. . *\  *.  .**.  . . ..\**.*.. *\ .  *\**\ *#*\.###   #
#..*..  ..\..\... ...\ ***..**\*\.*.  \.   . . * .* .*.*\.\ .. . *.**.* *. . *  .*.\* *. *. \. .   \*. \  \.\   .**..\ ... *\*\..\**....*..   ..  \  .*..*   .  . \..\\.*..   . .   .*.*..\\..\.* \ *\  .\  *\.** \.**### ##*#     #
#.*.   .    *.  .**. \.*...*.. \. *\**.  *   .\.  .. *.*.\**..* ...\*\.\.\*  .\.**.*.\.. .. **. *  ..  \. .*.\. ....\. *.  * *. *.. ..\\..   \*\ \*.. \.\\**  ..*  .. .... ...*....**. \. .    *...*.. \**  *.*..  .\#*#    #      #
#*\.\\\..\. ** \***.* .  ...*.\*.\ * .  *. \.\.. . *.**..**\*\.* . .*\*...* \ **\  \. . \\ *..**\  ***\.\. .  * *.**.\\.*. .\..**\ . \* \ \   **.*.\* \. \..   ****.*\ .* *\ *. .\... * **.* \     . ..\*.* . ..  \ *..\#          #
#*.* ..\ . ...  ..*..\.*.** ** .\.\. * .. *.*. **. .*.\..\. * *.*.\*  .\. . . \ .*\  .  . \*.. *  \**\ *\   . .*\... .\*.*\.\. .\ .\.*\..  \  .. .  .  ... . **\...****..\..*. .. \\.\\*.\*... .\.. .\ ***.* *#.. ..** #           #
#.....   *. * ..\..*.\**\*\**\.  ..  ..   ..*.. .\*.**. *. .. ..*... . . ..*  .....*** * *.. . .\*.   *..*.....\.    * .*. .   *  *. * \....   ..\\.*\ . . .***.\ *.****..*...\ **..*..*\ .* .. .  *\ .* *\*     ** **##           #
#**.*\ \ **.*\ *..\ \*..**.*.\*. . ..** ******.*  .\.* .\*..*.*..\** ..\. **\.* ...\   . ....**\ .....**.*.\ ***\...**\.*\ \ . *....\*\..*** \*\...*. .  *\.... **.* *..\*.\ .\ ..\*\.** *.*\ *..*\** \.\.*. .   .*#*.*\#          #
####################################################################################################################################################################################################################################