##################
##..**. * \.. *. #
# L*. \*.   *...*#
##*.#..*. . .   ##
#R*. .\**\*\.  # #
##################