################################################################################################################
#*. \.   ...*\\..* *..  .*. . *. .. ..\    .*. *.\...\*. ..*..*..*. .***.\   \ .*....  .**....\.****..*\.#     #
#*\ . *.\*......\.\* .** .. .*.\ **\ . * . *. *.\.  ..    *.*.** .*..\.* .. *..*. \   *...*.\.. ..*\.*. #      #
#***.\   ***  \ . **.*.\ *.*\\*..*.\ *\  * . ..........* * \**.\...\. ..\  \.  ..*..  .**.\ \*.*.*....\*.L     #
# \* **. ..*..**   ..*.* . *  .  \ ..\ ** . *.\.* \\ . ...  \  **. ..... *...** ......*****\ *..\. . \ ##.#    #
#*... .*. . *.*\....*.**\\\.. *\\.* . \*.\.*\ *.* . \*..*.  ..   *  . ..\....\.*.  .\*. .\.  *\\ . . . ..*#    #
#. *  ..*.\..\*  .*....\ * *\ .. ...*\ *.* .*......* ....   * \*.\...   * . \*\*..\..\..\  .**.*.  *\* *##     #
#. .  .*\* . **. \.. *.. . \. .***...  \. . \  \.\*. ***.\* .\.. ...*..*..   . .\*.\ .* *\....  * ***..#       #
#.. \.* *. * *.  .*..*.      **.*.*\ ..   \.... * * \.***... *.. *. .. **...*\  **..\ \....\ \  .\...* .###    #
#..**\..* .     *.**...*  \ .... ..* .\....\.\... ....\.. \ \*.  ..** ..\ *.   * . \ \ . . .  .* *  ..*..*.#   #
#* *.*..\ ..\.***..**\ * .  *. \** **. *****\.\*.  *.\* \ .... ** \***\...*.  **.\ ...    *   .  .*  *.. .\#   #
#.\.*\..*..  \.\..\.\* ...\ ..\...\*..*. . *. .\. .. .\ .*.*.* \**.........*\  .* .*..\ ..**.. \\.. ..# . *#   #
#\ *\ * .*.  .*.\.* *\... .\* . ...****.\* .**.*\*.\.    ... .*.*** *.** ....\ \. *. *.  \ \   ... .  *..*##   #
#.** ***.*   \.** ...*.. \\*.  *.. .*..*..\.\\.....*..\  *  \ .* * ** ***....*... *\* \... . * .  .\\..# .#*## #
#..* .   .. .. * \  ..**..* . ..\* ...   * *.. .*.*. \  *.\.\.\.** .\.* ...**..*\ .*\.\  * .*. *\    *\..  \# ##
#...\ ..   \.**... ..\.. ..* . \.. ..*  \*...** *\ . .  **  ...\*..*\\..\.\*\*. *. * ..\.** \  \ ... * .#.** \*#
#\.. *.*. *..\ ...\*\.* .*.*.*  *.\* . *...*..\.*\ \.*\.*  **\*.  *. *..* *  *.. ..   ..*.. . ** \ . . *\ .*#*##
#.*.. *.. \  **\. . *  *  \. ...*...\* ** ..*\. ..*...\ *\ * .\* .\*. **.\..*\. . .. \\. ..   * *. .\ \.. *  *##
#**.\.*.   .\..   ***\.*.. . .\. * .\....\. \..\**..   ** . . *.\\ .. ... **...\   .....    . * *  .*\  *.*...##
#..\.**** * *.  *.**.\..*.*  ***..*..***.. **\ .*..**..\.**\* .* .\.\ .*.  .* \ \ .  .\. ..*  *\.   . ... \ \.##
#.   *...\. ** \.   ** **..\...\. .. ..*.. *. .. .*..*. \ *..  . ..  R*.\ \** *.*. ......*.. ....**.* \ . #**# #
#\  ..*.**  .\ .\.  .\ ..*  . . . .\.  . .**.   **.. *.\  *.*.*.  .\**.\.. ** \... \***.\. .    ...** .*\\*.#  #
# ... * ..*.\ ..    *..*..\..  .*.*** ..  ...\.\..*\ ..*.\..*..\   * . . . ......*  \.\* \**\  \  \.*.\\* .*.# #
#\  *\ * \ .  * *  .\* .\*.** . . .*.   . *\  ...\* * *.*.. .. .. *. ...*\  .\ .... .\*.. *\*\*.** **.**.*...# #
#*.. \    .. * .*   .. . *\ .\*..* .*...* .. .\.\.. .\  .**.  .   .** *..** \ .   *\ * **.\ .*.. \*\***...**\# #
#.  .. *..*..  *\.\. . . .*\  ..\** .* .**\.. .\**. . \ .*.   .* * * ..**.***.  . .*.\ ...   * \ ...\.. .\ ##  #
#* \\..* .**    .  . .\ *...**...... ***\ ***.\..\ \*  .*\ ..* *\**.\ ..\. .\\ .* .   ..*. * .\.***  . *.*#    #
#. . \ .\ ...** *\.*  * .. . .\.   * .*\ . .\.*.** *. .\...\.*\* ... .. .*. .***  .\*\  .*\.  * .*..*.#\\#     #
# *.\ * *\. \...*  . . **\...\***\**. .  \****..\ \.\*...* \ **. *.*..\ ..\*.**\ *.*.*\..***.\.\ \.\.*..*.#    #
################################################################################################################