##################
#.... ..\. ..**L##
#**  R .   . *#.*#
#*.. . .\**..*\.##
##################