###############################################################################################################
#.*.* . *..    ..* *...**.. .*.. .   ..\.\.... . **...* ..*...\ .. \ . ...\* *  ..\**.\ . ***. *\.** *.\ .. # #
#\\.*.*  \*..\.  * * .....\. *.\ *.*. ***  . \ ..*.*.... . *. .... .. . . *.\*\.  . .. .. ...* * \**...# .##  #
#.*  .. ..\.*  *.  \ \ ..\   **. ...\....\.*..\ \*** *..   ..    *.  ...*..\.. . .. ..  *..* .\.* **\ *.#*\#  #
#..*. . .*..*\ .\*. *. \ .  .\*    \......**.\ *.*** . ...\ . . . .\.*..    .. .\    .* .. * .* .***.\.. *### #
#*. .**..  ..* *....\ *.  . \.  .\. **  *.\**... ...\ .... *. \* .*** *.    * .  **\.*.**\\..\.*\.... .. *  .##
#*.  ......  .......  *. .  .\ *\ .**.... . \**  .  *.*. ....  *..\  *.  *.   *.\.\. * ** .* . ..***..   **## #
#.... \* ...\*\**\ .*... *\ ..*\.**.*\.* . \. .\ *  **...\**  \..\ .** \*.  * .*.*.*   \.* \..\ \\... *.*.#   #
#  .  .*\** *. .**  *.  \*..\*. \.\ *.. \*\. \ . . ** \   \*...\**\..*\ . *\** ... * *\.. .. \*.    .... .#   #
#\  ..\..    *. *..*..*\*.   \.  \* .** .\ \*..    .**.*... . . .* .*. .    **\. . *  . \.***..  .***\###.#   #
#..** *\  * ...\. * .** \*.. . **** *... *.\.** .\  \. .. *.*.  *...**  *\..*.. . *..\.  ..... ..* ..   .#    #
# ....   *.\..** ..*.....*.* . ..\\**.  **.*.\*.*. .. . *   . *.... *. \. ..\ *\ .. \. . \.  .**.**...\.#     #
#*. .\ *... .**... .**  *...*.*** *.*.....*.\ \*... * ... ** ..\* *\\   *\ *.*... \*.\....* .** \..  .. #     #
#...* \**.*\.*.**\.*** *   .  \..*...*.**.*\ .  \.  . *..\...\ *...*. ..**.\..**... *.\  *.****\ \.\ .. #     #
# ...*  ....\.. *.*..* . \..*\..**\   ....*.. \*.. .\*.  ..   *\.\.. .**....*  ..*. ..*\*. ** * .** .*\ #######
#. **..   *. \ \.\.*..*\ .\.. . .*.. *  .\ *  *. *.* *...*\\..\* .. \*\* ..**  **...\..\.* *\   *\.*  .  \ .**#
# *\  ...\..**.*. **...\...** \...*\ .\  *.  ..*.\ . .\  ** ...\   * ..\**.\*.\.  .*\*   \ .\.\.*\..#****#\####
# ..\   .**..* *. \* .*.*.*.\ .*  \   ...\  * .\..  \  . * R.\ .  *. ...*..** *\.* .....*  ..  \*..#* . .*#   #
#\   .  *. ****..*..*.*  ..** *. ..\.\. **     .... **\.\*\\*.\.\.\.*   .\* *..   .**.\ .\  .\\. \.\* L#\#    #
# * . .....  \. .**.... .* .*\**\ \...**.*..\ ..\..  \  .\....*\   .*****.****\*.*\ . *...*** ***.\*. * ##    #
#\ \ .. ....\.   ..  \ \ . \.. .*.*   *.... *\**\\.. *...** . * * .*.. \.*..*\*..*\   *. ....****\**  * .*#   #
#  ..\\ ...\. ..*\. .*\.. ..   *.\. **\.  * *\*.**   *  *\*.*.**\.... ** \\....  *.*....*.   \..**#*  .\  #   #
#      .*..*  *... * .   \.\ . .....*\**\.\... \.  . ** ..*\\.. .  *\. \*.  **.  \\. *. ...\*\\ .*. \.*  * #  #
# \\.*  .**.  . . .\  . . ..* *..***. ....**\ ......... ..\*.*\\**\.* . ***  ..  .**... .** . *\*. \.##*.#*#  #
# .\ * .**\  .*...**..*...  .\* .*..\  . *....  . .**.*  \.. *..** .  .. * \*.\*. .. \......  ***..####\# #   #
# ** .*..**. .*\.\**. . .. . **\ *.\*\*  ..*** ** ..... .** .* .*. .\.. ..\*** .   .\. *.  *..*.\* \*. #      #
#\..\ \. ..*\*. **..  \. ...\\.  .    *   \**\..  *.*.*.*..  . **  ........\.. *  *\..\..\.* *.\#   \##       #
#* *   \ *....*** *\*\ *.*.  . ** .. \.. **.\.\* * .. **\..** *...*. .. ..  \  . . . . .   **\ \* . ####      #
#..* ...*. . *\ *.. .*\.  .  .... * .. *....  .. . . .*.  ......  * .  *   \*  *   * . .  *. *.. *.*#.. #     #
#\ .. .\. ...\ \.... *. .. . \.. *.\\..\*.* . ***.*.. .\  *.\....*.. \**..***..*  ..* . * . \   .. ...\ #     #
#..  . *\.* . ..*.***.* * *. .*\ **... *...\*.*.***.. \   ..  *  .. .*... ...*.* .. .*. .*. *..  \** . #      #
#*.. **.\.**  .**.\.*.\ .....\..* .  *.*.\.*\.  *.\ .\.  *.*  \ .*\ .......*...*.**..*\  .\..** .*..#* #      #
#.\ .*\..\...  ....*...*. *. ....* ..**.. **..* ..*\**.*\. *...*  *.\. .\\*.* \*...* .*\* *  *\ ** # ##       #
# .*... . . ..  .  .  ..\ ...** *.*.*.. ..**. *  .* .  * . . . .  * ** . \..** . **..*\   \ #.#\*.#           #
# *...\  * .\*.\. . .* ...*. .**.*..\  *\  . *.. * *.*\..*\* * **.  .*\\. *..*  *..*.*. * .\.\..##            #
# . *.\ *.   \**..\. .  * .\*....***   * ** ..\...** ....**\ \ ..  **. .   *.\***\....**. *.  \.#             #
#. ...*\.... ...* .. .. .\.. .  **... **.\. **  .\.*. \. **  . *.*. .\*\.  *\..\.***  ..  *.*.##              #
#   \.. *   *. .\.\.* *. *.*..*...*. *..\. .* *. . . ..  .\. .\. .  *.* *\*.. *\.**  *..   ****.#             #
# ...\...\  .\.*.\..\*.\*.*.\.*.\ .\... . * . *. .\*  * . ... .*\*.*. . .*.* *..\.. *.  . * \..*.#            #
#* .. .\.. .. \..   ..*.*. .  .\.  .....\. .* * .\ *...    .....  *.*.  \....\...*. . *.\..      #            #
#.  .. *. .. \ .   * .. ..* *      **..\.\ .* .\\*..   *. . .\* . ....** *    . * . . \ .# \...*. #           #
#\*\.\ \.  .* \...****\*.. .*..    \ .*..  \.** ..\ .  .. .**..   ..* .\.* \ \ .*\*\. .\ .*   .#*.*#          #
#.*.  ..*\...   .*.*..\.\.*\..\ \\..\..* ...\.*.. * \ \*   *.\   . .  . *. .**.\. **.   .*.\.. .*\.*#         #
#\ ** * .* ...*.. **. \ . .. *. . \*\. .\ *..\ .  .  *. \ *\*\. **.  . .*.  .*  \*....\.\..  . .\.  ##        #
#*. ..\\ ..*. .**.\.*... . *..   \.* *\. *. ..  .  . .  .. *.... .\.    .**. *.* . .  .. *. ....#\   *#       #
#***    \\. . **\**\ . *  ***\*. ...**..\  \.*.*. *...*.**..*\*.*  *.\....* .\*..\  .*.  \ .    #.*\##        #
#\.. *\..*.\..\ .**. \*.\. ...*  .* .**\     \**\ .*\ . *. \*.*.. .. .\    . *.***..*.* ..   \.\####          #
#. .*. ***\.     *..  . .\*  .**\.*. .. *****..* . \. .\   ...*...\ *  ..\.  ***.\*...*.\*\\*#.#              #
#*.. .\.\  ***.*\* .*..   *..  \*   \* .  . ..**\**. .\. \.***.  ** . .. . . .***. *.*.*....####              #
#* .\\ .*.*\*.*.** *.*.\* ...*...\  . \ .. .\**..* * ** .... .  \\.  .. ..*.....*.*. . *\*.##\ .#             #
#*.*.\ ..*... .  *.  .\..\...**\** ..*..\.....*. \ .* \ .*\*\* .  *.\***\.*.  . .**   .  \* . .#              #
#.**..*.\.*..*.\.\..\\  ..** \ *. .\ ..  .*  **.  ..*\  ..**..   ** * *.. . *\....**  **....*##               #
#*.*  . ....*..* .  .*.  ... .\.*.  ....**. * ..\.\*.*.\* .\. . \*.*. ....  ..**  .\.\ ..*# #                 #
#*** . *...\.. .\ \.*..*\.\ .. *\.**  *\***  .  *.*..* ..*. . *.*.\**.**..*\*\...***..\  ##\#                 #
#*.*.***  .*\. . . ..\\..*. . .. *\\*\.*...\  .**..* *.  ** \*...*. *\...  ...*  *..* *#. * #                 #
#**.\*.\ \****  *.\.\    .** \ .\. .. .\. *   ** .** \**.*.\.*  *.. \ * *   **..*.\.\*# #.##                  #
#.. ..*\. \*\*\. .....\*** . *. .. .\**.. . \*  * *\ .\* *\**.\*. ..  *\...*..*.\ *#.*#  #                    #
#\  \*   *. * .*.  .\ .**.*  \*...*.*.. .\  . *\.  .  .**.*...*.**  . . *  *.#****. \#                        #
#*.  **\*. .. . .**. ..*.. .\ .* .*.  **\ .*\ **. .**  *\.\ *.*\*\..   .*\..* .......#                        #
#*** **  .*  . . *\..* .*. *. ..\... ...****....*..*. *\ .*\.*...* . .  * *\.\*\.\.  #                        #
#*\...\.**\ . .  .. *\  * ...   *\*.  ..*\ .. ..*\*...    .  * .*. *  . ...*  . * ...\#                       #
#\  . .*\ ..*\**. * .*\.. .*\.*.\ * .* * **..  .. \* \  \* *.*\*.\...\* ....\ # **\ \#                        #
###############################################################################################################