#####
#\# #
# # #
#*RL#
#. .#
#..*#
#.*.#
#\\*#
#**.#
#.. #
#.\.#
#** #
#\. #
#.**#
#..*#
#  .#
# .\#
#. .#
#**.#
#.* #
# \ #
#..*#
# \*#
#...#
#.\.#
#...#
#...#
# . #
#. .#
# . #
#\. #
#.* #
#*. #
#\. #
#*  #
#.\ #
#\* #
#.. #
#.. #
#. .#
#.\*#
#...#
#*  #
#.. #
#\.*#
# ..#
#* *#
#.\ #
#.**#
#*\.#
#* .#
#*\.#
#*. #
#.  #
# .*#
#. .#
# \.#
#\..#
#...#
# . #
#***#
#...#
#.\\#
#.\.#
#\ .#
#*.\#
#*..#
#.*.#
#.\*#
#. .#
#.. #
#* .#
#.. #
#\.\#
#.* #
# **#
#\..#
# *.#
#\.*#
#*.\#
#\.*#
#\*\#
#.**#
# * #
#\\.#
#*  #
# .*#
#.* #
#\*\#
#.\ #
#.*.#
# \.#
# .\#
#\  #
#...#
#\*\#
#..*#
#.\.#
#\.*#
#.. #
#*. #
#*.\#
#\..#
# \.#
#*. #
#.. #
#.  #
#.* #
#*.*#
#*.*#
#**\#
#.**#
#\ .#
#...#
#\  #
#*\*#
#** #
#*.*#
#.\*#
#.  #
#\..#
#.  #
# *\#
#.\.#
#*. #
#*. #
# . #
# * #
#\..#
#**\#
#...#
#.. #
# * #
#\* #
# * #
#** #
#\  #
#.. #
# .\#
#\ *#
#* .#
#**\#
#..*#
#.**#
#.  #
#*.\#
#* .#
#* *#
#...#
# . #
#*\ #
#.* #
#*  #
#. .#
#\. #
# .\#
#\..#
#*.*#
#. *#
#\*.#
#**.#
#.  #
#. \#
#.**#
#\..#
#*..#
#.. #
#.*.#
#\*.#
#* \#
#*..#
#.*\#
#.**#
#\ *#
#*..#
#*..#
#*. #
#.\ #
#. *#
#   #
# .*#
#*..#
#. \#
#* .#
#.\.#
#. \#
#*\ #
#\ .#
#* *#
#. .#
#\ *#
#.**#
#\  #
# **#
# ..#
#*\.#
#. .#
#\\ #
#.\.#
# * #
#\. #
#  .#
#\. #
#  .#
#. *#
#  .#
# \.#
#\.\#
# ..#
# . #
#   #
#\ .#
# .\#
#.. #
#  .#
#.  #
#* .#
#\* #
# ..#
#* .#
# * #
#\* #
# \ #
# * #
# .*#
#.. #
#   #
#\\.#
#**.#
#\. #
# \*#
# ..#
#\ \#
#####