####################################################################################################################################################################################
#                                               #**. .\...*. .*\.*..\ .  \* . * . \. * .* *. \ *..*.  *.*** \*...* . *.\. \.\.**...* . . \     .\.\**. **.*.*. .  .. #... *. . . *.#
#                                               #\  \**\.** **.. \*... \ ..  ** * .**..*. .*.. .. \.\ * ...\.....*.**. *\..* .*.\...*.  \\.*.. .. *.* ..\ . . *.*..*\ *.*\*\\..\*.\#
#                                               #.  .*.  . .**  \...*.*...**\***..*....... . ...*\ .* *\\. *  . ...\. *. **.  .\ \ ... *. .\ ...*\. ..   **   ..  ....*\... *.\..  #
#                                               #*....\\\.##*.\ . .*. \#.**...  \ .*  *  .* .    . ..** .* .  \.. *.\..*.*  .* ... ..*..**\.* * ....  .\....*. .... \\*.*. .* .* *\#
#                                                #* .* * \. *.* . ..*..  ..*..\..* *  *   *.*   ..**\*  ....\...\. * .\. .*.*...\. **.\*...\. . .  ...***...\ . *.  .***.\  .  * *.#
#                                               #.....*.  *\.*.\ .* * *.*.. ..* \  .*\\  *\.**  *...*..\* ..  . .*. .**.  *. . *   .\ ..*. \\  .. .*\*..  \  ...\.\**... .\..\.\.\ #
#                                         ### ##*##***# \*.. .*..***.\*.*\ .  *  *  \* *\.* **.***\ .  ...* \. \*..\....  * *. .   *...*\* **.\  \\    **. ..*** **.*..  \.*\  \ * #
#                                       ##**.#\ \##\.##* * \ ..*..*\\ . \.\.\ *. . \  .\... ** . *   *.. \ .*** . *** *. *.*...**\...***.....*.\ .  *\\ .*.*.\..* . \*.* . .**   . #
#                                      #**# ### *. #*\#..* **.\. *..*.\  *.\. .   * .\. .*  . *\** *\  \  \ *  . ** .\  ** ..*\ .**... ......**..\...*.**.* .  .\.  ...*   ..***\  #
#                                      #..*  *..*# \* * .. \* *   .**  ..*\..   ..... ..*. *\.*..* .   .\....\  . .. .* *.. ..*.*. \. \*. . .* ..* .* \.  .*.   *\ * .\.\  ..* **\ #
#                                  #  #. # ## #.. \..\ *.  ...   . ... ..\**..\**\ .*  *.\.\*..*\.* . . *\  *...\*\..** \.\ .\.* ... ..*\*. *.. \*  \ .* **.  .*** *..**. ..\  \. *#
#                               ###.##*#. .*# **\.* \. \..\ .\\ ..***\\* ..*. *\. \ .  .. .*.. *... . *  . .*.\.. .\..*.*    ..*. * * .*.. ..  .  .. * .*.\. .*..* .* *\..    *\.*.#
#                              #.*.**\ ** *..... * \..\***\ **.\ ...  *\. .\.. **..* *. *  * . \\..\ . .*. .. .. \.*..\ . *** *.*\* .\\. .* ..  \**. .*.  .   .\*.*.. \. .  *..\..*#
#                             ##***\ #*..*\. .   .*. .*.*   ..\  \.\.*\ ** \ .\ \**  ..** .   *.. \  \.  .** .   .*..  .* \.. *****\..\  * .* *\*....... **...**\ .**.* . .   **  .#
#                          # #*##\ \.#*..\\  .**. * \.**\ ***\   .  \.. \.* .  \..* . *.*\   *  \ ..*.*..\ .*.\\ .*..\**. ..\.*..\.*. *\ .. . *. *...\* . .\. *. **\ *.\    .\** * #
#                         #.##***.*.* .\ . . **.\.\..  *....**\ .\.. *. ... * \..*. \ . ....... .\.*  ..*.. . * *.. *...*.\.*.*\*  *\***  ..**.* \* *...    \**. .. .\.. . * .\.\.*#
#                         #\* # **.*\. **..*.*. .*.\ . ..*  .* ** .   *\**\ ..*  **.  \ .   *\*.\.\ *.  .*.  .* .\\***  *\  ..** . \*..\*** ....  *\.  .\* . .* . \. .. *  .*..\.*.#
#                          #*.  *.\*\*.*\ *..*. *.* **\  .*\ \**... *  .*.**..*\  . *..  .  * .\ ....\ . **.* \.  . *\.*...*  ..**.\..\ **.\\ * . .. *\* \ ..*.....\*.. . * ..\*..*#
#                           #.*#**........***.\ . ***. . **. * *.    * *.. .  \*\..*.\\*  .*. \  ...\. *.**..*..  .\..*.*.*.  *  ...**.*.**.  .\..*. .*.*\.  * ** ***  * **\. \** *#
#                          #...\*...** **\...**.. .*... *\. *.  **  .* ..**.\  \  ..\  .  *\* . *\ .*..\.\....   . .  *.* . ... ..\  \.*..*.*.*.. ..**. . \... *\**\.....*\. ..\...#
#                   #### ## \.** *  ***\. *.\... ..** . .   **\....\ .* ..* *. \**... . *\. \   .* * .*   * ..*.* .\....* **. .* . *.* \. .* \.\.* ...\.*..*. * ..*.*\*.*\. *\ .\*.#
#                  #\..\#..#.**.*.* .\..  \ .\*\* \.***. . . *\\*\ *. . . .** ...*. .\.*. \*.**..\ \\.**.*.**  ..*    ... ** * .\. \*.. *.\  \ .*. *..  *\.. \\..*. *\..\..**.  .. #
#                 ## *##  . *** *\. .....*.*.\... ..\*.  *.*.*.**  .\.* .\*..*.  ****   .. ....  ..  \..\ ..* *\  *.  .*.....* *.\*  *...  * .  .*\  . *\*.\  \***..\.\..**..*.* * #
#                #***##* . .*..\.*\ \ * \   ..  . . **.  ..* . .. \*.\  . .\*   \.\***. **. *.**  \.*. **..*\..*. .. \...*..* .* **. ...\* .*  *\  ** \ ..** .***.\   * .\.*..\ .\.#
#                #*#.*. \ \  \.  .*...\.  .* .*.**... *\*.\**\ *.* .*. .* .....\  .**\.  .*.. *. . *.* ..** .. ...\ *.*. *.\  *. .*.\.****. .\.***.**   .\**  ...*.  .*\ * .*.. *..#
#               # ##. .\.. .***.**\.  **.  .\*. .\\. *\*\ * .. .**.    ..* *.\. .. .\   .  .\**... .\  **.. *\ *\ *..*.*. *..   .*.\. *.*...\ *.\  .* . . ...    . .. ..\* .*.\ ..*#
#              # ###\*. *. \.*.\*.. .\.. * . .*.***. .*. .\ \. \.. . .\\.  ** .*\\.*..* .*\.** . .**...*\* *..\*..\ .* **\*.. . \**..*\* .... . *\*..\.*\..*\..\*. .\**. ...*.*   .#
#              #\*\# \  * \..\  \. ..\.. \  \\. *.*.*. .  .*....** * *.* \*.\ ****\.\\.\..**.**\..***\.*.  * \.   *.\*   \...\ . *.* . .*  *.. .*.\.* * **.\..\ .* ...*.. ... *\.* #
#               #\.. * *...\ *\..** **.*\.   .* .   .  *\. .* .\ .  .* .... \. ..... \.** ..* .. *.****.  ..*.\ *..*.*.*\    *..  *   .  * . *  ..*..*.*.....\.. . .\\..*\.*  .. . #
#              #.#..## .*... \**..\...\*   . *..*.*\.   \. *. \..*.. ..\*\*  *\ *.**  .*. .\\ . .*.* *\ .* .* *..*\. * . \*.\..  *. ... .*  .* *. *  \**. *..****.   .\. **.*. **..#
#              #...\** ** \ ....*. . ..* *\..*  .* .*.. . * *..  *\ * \*...  .. * .\  .*..* .  .\.*.*... \.... *.\* ..* **\*  *. .. *.**.... * ..\.  ..\.*.*....\*.. * \..* .\ *  .#
#              #.\* *\ .*\.\ ..*..  . **...*.. . \  ..  .** .\  \.  *\ *\.\\    ..  \ *. *... .*  *. \*\. .* . .*\.\ .* ..\.  **\ .....\ \ .  \. *\..\..    \*.\.   \*  .  . ... *.#
#               #**\... .\ .*.*.... . ..\\..\  .. ....* *..* **.***..\.\   ..*..*.   ** .. \..\..\.* *\ .. ...\.\  .\*\..*  \ \**\*.* \*\..*    .\  .*.\  .*..... .  . *  *.\.  .. #
#              #..  *.*\* \. .\\\ . * ....*. ..\ ..\* .... * .\ ..* .* . .*   *.\.*  ..\ ....  .*  ***.  ..*..* .\ *\   .* ....*\.. ...* .\. .*\ ...\..  .  *.*.\* * . **.*\. ..**.#
#             #** \*.\. \.\ .*  .*  . ..  \ * ...   .*. *.\** **. .  \ \**. .* *.*.\ **.**. .\ **.. . .*..**.... ..\** .\. .** \*.* .**.**.\. . **  .* ***.*...**  .**.** ..  .** .#
#              ####\ .    \  * **..*.  *\  ....** . .* .\ ..\.. ..\ * \ \.   ..\\.** *..... \**... *.* . . .   *  *.*   . ....**.\.*   *\.\. . .*.\* .\.*\ .    . .*..*. . \..  *..#
#              # \#.  \ ...*.. .*\**.\..*.. \ .*\.\* * *.  \.*\ **...\ \\ . .\ .  \... ... \.. .\... *. .  \* *\  \.. . .* . ... *\..***  .. ***   *\. \** *. ***. *. * ** ..*  ..*#
#              #\  ... \* * .\....**\ *\*  ..*** \ ..*..\ .\.\.*\. .\ *...  *..*\...   *** ..\ *.\*\ . \. . . .*.*.\  .* .\.. . \..  *..  *.\*.\.\.......*...... **....\.. *..*\ *.#
#               ###*  * **\ * *. *\.  ....  . *. .. .. *.   *...\..   *   .\.\. * *.** .*\..*. *.... \..*..  . *..\.*\\  * ... \* *. *\*.\*....\  .*..**.. .*..\ \*\  ..\..\.*** .*#
#            ###.*.   *\ .  *.* * . ..   *\* \*\*  * *.\.. *. \*.\ * .*     ....* \ .\.... .*.*...*  .*.\ *  *. ***   .*.*... *.**. . \.... ... . . ***..  *.. *.. .\.\. ..* . *.\.#
#        ####\...*# \ .\.*\ .**....  *.. ... .****\ .. \. \.*. .. *\  . .*\.  \  .\.\  . .\* ....   ****. .\*.\ *.. .\*.*\.\ \. ..**...  \. * .*.\ *..*.*. \ ....*\ .\ .* .*\  . * #
#       #*..*..# .*..\.. ..\* .  \ \. \\\.*   ...  ..**\ ..*.  **\*   .  .*. *\ .*.   *  . . **. .*..*.\.*. ...\.\ **\.*.**..... .\*  *.\ .*\ *. *. .. .*...  .\ .  . .....**.     #
#       #* *..*\  \ . ..  *.. \.*. .  . ... *\*. ..*\ *   ..\. \*... *.* ..  \.* . .* * .. ..*.**  . **    **. .\*.. .*.*.... *   ..\*..* \***.\ ..*...\.* *  .  .\.* * .* * *.*.\ #
#        ##\ ..   ##\.  . ..\**\. *. .  .\ .*..*. *...*..     *..\*. *.. *  \ .* .. . .  ..**.***\. *\*\ ** ..  ..  *\..\. \ *.\.*** * .. .\***.\**.  .. .** \*\*..\....\**  * ....#
#        ##  *.  .\..\   .\  .  ..*\.\ ..**.   .**.  * .*...\. **. . .  ..  * ..\.\* **.\\ *. .* . **.\. . ...**...*..   . .*.. ..**  .*. .  *.. **\.*   .*.  .*. \ .   . *  .\*.  #
#       #\.#*.*   *\*\..*..* *.*  * \... *. .**\*\*. .\ ..  .*. . .*\    .*..*  *\..*\.. .*..   \....*   ..\....\ .* * .\.. .  .  \.\  *  \ *.** \\  . \\ *.**.*.. *.*.*  .  .**. .#
#     ###* .* .\.*\.\.*..\*  .  ..* .. .*..  *..*..**\**.\..*.* \ *...\ \*...\ \.*. .* .\.\.. .    *   *.\ **.***..  .. .. .    **..  ** ...* *....   ..\.*..* .  *..\ .. * .**\ .\#
#    #.\.  *.*  ... ....\ .\.*  .*. *.... *\ \ \... ........  * .*..\ . \.   **\ .\ .\  *\ \.* \.**\ ...* *** ...\ .\ ** . *\.  \\... .  \ * *..**  ** *  * *.\. . .\*. .*\ .* ..  #
#     #* .\...*\.*\ *.\ *..*.. **. *\ . *** *.  *  \.  . \. ..*\**. .   .*\ ..*.\*  . * . . ..   \***.*\\ ...\*.*\* .*.*.....* ..*..**....\. **.. \ \ *. ..**\ *..\. ..\\. . *\   \#
#    #*....\ ... *.\ \..  *. .*   .. . .*. ..*...* .\.*.\. *.\* ..\.**. . *\ .. .  *....\\.\...* .*.*... .*.\ .*\*.. ...*\.....\ ....**.   * ...   ..*\.*...\.\  ... **  ..*... \*.#
#   #**.*\*...\. .* ... \*\.* .  *\*...\*..\. .**.* . ***\. \. .  **\\ .\ .  .\ *  ... \.*. *\*.  . **  . *\*..* .\.. \*\   \.*.\*. *\**.    ....  \ ***... *...  \  ....* .***  \.#
#  ##*\... .***. .** *\.  .....  \.   \*.*  . ***\*  .  ..*..  . ..\. .* \..*..*\...\*...*..  *..\*\ \*... *\ **. \...* .*....*\ ...\*. *\..\. .* \. *.* \ ... \\.**.*...... .**. .#
###\.#\.*\ **  .\**...   * .\*    *.  * ..\...  . .   .*.*.  . *.*  *.\*..\.**.*. *...**..  * \\...* .. \ ...*.** .\....**....* \    . *  \*..  *\***. * **..\.\...*. .   .\  \.   #
#\.. ..\*.\\*.\*.\.*..*..\  . *.  * . .\ ..\\..  *   \*\.*  * .*.* .\.*. *.  .. .   * \.*..\. .*.\...   .\ \\..\*..** *  * .\ . ..*  ..*  \.*  .....** \*.... .* ..* * *.*.* *   **#
##\\\   .* ..*  ......*   ..* ..  \ . .*.*.*..**.***.. ...  .. . .** ... \..**...  *\\...*.. .*  . **\ *   .....*...\. **.\\  *\.  ..* *\. \. . . ...*. ..**\  *\. .*.\...*..\   ..#
##*#\ ## . *. ** .. *..  . .**. **\ \**. ** .*.*.\.. .* .  . *    ...*. ..**. .\\ \.****\.. *\.**\.*....**.    **\. .** ..*.***.*  \.* *  \ . ** \ ...  .. .***..*. .. *\ *. ..*\ .#
# ##*#\.   \. ... ..*  . . *\.* ..* ....*.*.*. *... \ .* * .\.\*\* .*.**..\*.*****  **. ..**** *. *.. ..\.  . *.*  *. ..* ..*..  \..\.\.*. * *\.\.* * .*.*\..* .** **.  . . . .\.**#
#   # ### ..  \*\. *. .   .* *.. .. .\. . *.*  . \\* . . * *** \..*  \*..  .*\.  . .*. \ . *.. .*.\  \. . *\   .*\\  * *\ ..\ ..*. .\. \ ... .\*. .    . \.  .. \****.*\ .\*\  .\.*#
#       #... * . .*. .\.*.  .\    *..*  *** * .*.\  . \   ...R .*   .. .\ ....*     \.  *. *\.... . * *.\ ..  . . .\*\   * .\.... .    .\.. *.. \.*\. .\  **... *..*.. *  *   .\. .#
#        #*\*\. *\.\*   *\.* ...... ..  ... . .... * . .\   \ * .. .  **  . *..*\.*.    ..*..  ..   .   .  .***.   . * . *..  . *.*.. ..\.*\..\ .. .*    .\*.\.***  .. .\ ....  *.\#
#       # ..*. .*. \ .  ***\..  **.  **.\ \*.** .*.  *\. * .  .  **** .***... .* **.  *.**...\    \.\.\*\. *... \ \ .**...\*  \..***.  .. .***.   *.\..\.\..*\ . . **..*. \   ..  .#
#      #\\ \\.* *   \ *...***. \.*. .* * .\.\*.\*.. *.\\\..* ..*\... .**\*.\*. . ... *  * .\*  ..*** *.  .\*\  .. \*  .**...* .* *\ ... **..**\*. *   **..\*.*\ *.*.*.. *\ ..***\  #
#       #### ..* ..\  ..*\.**..**. \.*\**..\.. .*\ ..*.  .**\.*.* \*\*.* ..*.. ..\.. \\*.  . *\ .... .**\\*.  .  .** \*\. . \  *\* ..* \**. .. . *.. *.. \*.* **.  *.* \.\ **\*\..*#
#        #*.\  .\ ..\*\*.. ..* *.....\..\\.  \ *.*..\...\ *.**. . .*..*. . ..\.  . .  *.*\ \*.. ..  * \.*..*.**  ..\.*  .*\...\..\  .....*..*\  *. ..**.\  \**.*  *  .*..*.*..\*. .#
#       #* L#\**   ..**\.\. .* . *\*...   .**.....*..\ .* . **..**\.*... *  . * ..* *..\****..* ..*. .*    ...*  \...* .**. ..  ..    .*  *... ...*. \..\ ..   \* * *.. .....*..\. #
#       #*\ #.#  .*  ..*  **\*.  ...  \* * *.\ *  **  **... **.\.  *.*   ..  .*.  \ . *\... ..*. ..** *.\. .. .... .. . **.\  .** \ .** ..\ .*. \..\..  . *.*\*..**  ..*  * .**\ . #
#        ##*#*  *\*** \.*.**.*.......\  .\ ....*.\.\ ..*\.*.* ***. .\* *\ **  .  \.....  \*\. \ *. ..  * *. ** . *. . \  .   ..*. \* .. \    . .  \   \.*..*\.*....  *  ..** ....*.#
#       ## * . .# .\.\ .* *.\*\.* *.**. .  .*..*\.. *.*\ ***.. .\*. .\.*  *\ ***.   *. ......*\..  ...\. ..*..\ \ \*..  *.** . ..*.. \.\ **..   \ *.* . ...\  .. *\. * *  .**. . * #
#      #   \. \.. *  .**\\ .... \ . .*. . *.. .*.** ... \. *.. . *\.   .\\\ **.  .***  .. .*..\. **..**.\ ... .*....\*...**. \...*..* .*.*.\ .. ..\.   ......*\ \ ....\.* \..*.....#
#       #* . .. .*  ***\.. . .\ .\ *..*\ *. . .*****\* * .... .\ \.\ * . .\ .* .\.. **\  ..*\.*.*.\.*.\\..    *.\**\.*\**.*.. ... *. ..\.**.\. **..** .   .. .* *... . *  ..\ * ..*#
#      # ***.*#. ..*..\..  *\*\  *.* \*. .*\   *.*\. . .     .\.  *...\.** ..*\*.**...* .* *  . ...*\*.*..**  . **. \.*.\ \ * * \.* . .. .\....  *\* \\.  ..\ .\*  .\ *\ ** . \  \*#
#      # ###\...    .\.**.\....* .\.\  *\...\. . . ..*\ **..\ ... ..... *   .* . ..\.\*. ...*     ...*\\**. .**...*\.\. ..  . *\  ...*  .***.\* .. .* . ...**\ *\.\. .*\.**.  .. ..#
#     #.*# ..\*. .**. *.\* *...* \.** .\ \ *       . . . .. . .\. .\**.\. *\ . * .\ ....\\.*\ * *..  *\.\* \ .*\. * *. ..\ .....*    . . .**\ . .*\ .\ *   .*.  \*.  *\*.. .  **\.*#
#      ## #* .. \.*...\.\.* *   ..*..* .\ ** *\ *\.*.... ..\\. . .\.\*\****.* *. .*.  .  ...\.* *.*  ..\*.***. . .. .    ..   .\.\*.**. **.*.... .. *.\.   .* \  .. **.*..\. **.*. #
#   #    #.*..  .\   \ ** . .\\ *..\ *.  *..*.*.  *.  **..  * * * .  ... ..\*\.\ ...*.. .\.  .**..*\ * *** *.*\. \\ .\ *\*. * *.*\.***.*..*. ..**. ..*. . .*  *. * * ...*  *\*.\*. #
#  #\# # #**#*..*\*  *.... *..* .\.* *\..** *..    ..\.** . .\. \   *. .*....*..**    .**...  ..\*.  . *.*.**...\*.**. **.*.. *.*..*\. .**\* \.*\ \ \.*\. *\ *. ....  .*. \.*..*.*.#
#  # .#*# #..*.  ..*.\ ..*\*... ***. ...*.\ .\.\ **.. *..\...*.\*.... .*. .... ..* * ..... *  *\ . \*\...****    .* *. *. .. .*\ \*..\ ..*..*. .\*.\ * **.\* *  .  .*\*\*...*\ ...\#
#   #\. .## .. .*\ *\.* .\.*\..*..\ \.* ....  * . ***\..*. ... .*.\.*..*..\.\*\*.  ** *.** \  ..*.   *.\ .... * * .\\.*..    .*** *. .\ *** .**.....  ..**...*\.\.....\.\ .\*  *\*.#
#    #.  *#..*. .* * \.\.. ...\*.  **.. . ....\ ...\\.*\.\ ....\*\. .  ... \.. ..*\.... .*... ...*\ .**..  \. ....\.. .*\. .. ** \* .* *.*\ .*  . ...* **.. .\..**  *..\.   *\.\\.*#
#    #\.\.\.* . ..\*..   .*\ . .  .\*\***.\.. . *. *  \* .*. . .\  .* .* ...\ ***. *\*\...... *\.  \ ******.\**.\ .  .**.\ .\  .*\... \*\.*  .  . * \.  .  *. .. **. * .. .**.*.* .#
#     #*. . *.\.\. ** *  .  * .  *  . .... \...... .. ..\*. .   ..  *..*   .  ..****.. \ * ..  .*..  .\.* .*...\ . \  *.*\.* .*..\ .  ...  ..*\. **.**..\ *\.*   * ***\.   .\...\*.#
#    # .*..**\.*  .*\ . \*\ . . **.* ..*.\ ..\**..\** . .\ ....\\.. .... .**\ *.**\.*  * * . .  *  \.\**. *.  *..\*  *.*... * *  *. * \.* * \*  \*. \*... . ... .*\ ..  * .\\ **** #
#     ##\* .\* ..* \. . .  ..\.*....\\.**.*  . .*..  \*\ ..* .*. ..\  . .**.* ..**. . *.\**  \.**   ..**  \*\*.\.  .\*.*. *.\\\.\...\*...\... \.....\.\.. * ..*. . *\.  .\ **.. \* #
#    # ..\*\.*\ *\*  \..\\ .\.\.* \ .. **.* ***.\* *\..* *\. *** \.*.*.\*.\ .*.\**.*\ \.. ..\\ \* **\ \*\.\.****   \*. *  \ ...*. \ .**\ .\.\*\.\**\   *. . . . . * .. .**..\ *.*\.#
####################################################################################################################################################################################