#########################################################################################################
#\* .*.** . *  .\  *..\.*\.*. * .  * \  *..*.\ * .\* ...\ ***.  .\. ..**.. .\#                          #
#*...* ** .\. \ . \.*.*... ...***.. ..\.*.**...\ .\*.. \.. \.\.**  .\.. .  *#                           #
#*. ....*  .*\..*  \* \ \  * *... .\   * ..*.. *.*..* .*  ..\.. .*\.*\ .*#\##                           #
#. \.\* . . . *.\  *\ ..  .* .. *\ ... ..*.*\*  *.* . **\.**.*. \ ..\.. . **\##                         #
#*. .*  \.\ \ .    ....\ .   *\ ..*. *** .*.* .**.**\****.....\ . *     *.#****#  ##                    #
#.   . *\. .*  .  *.. *.\*\ .\ ...** \\ . *\ * *\**. **..** \ ... *. . *.\.# .####  #                   #
#.** ..* \*\\     .\*.\  \*.\..*.*.\\.*..*. ..  *.*  .*.*\*..* **   \ *\.*...\#*.\* \#                  #
#*.*.* *  ... .*\  .. .\ .. .*.\*\... *  .* * .*.  ..\  *.\*....* ..\*. ..*   #...*\#                   #
#**..*..   \*\...\  \\\ .*\*** ...  *\\.. . .\.*  .* ...*..\  **.  ...*..\\. .#  \###                   #
#*. *.\  .* *. ***. .** ..  ...  *\**. .  . ..\.. .\  *..  *...*.. ..* *.** .*\* *\.*#                  #
#\   **\ \...  .\.\. ... \.*  .    ..   *.* .       *\.*.  \  ..\ .*.... ....#..*.. .#                  #
#**. . .. .  .*.. . * .... ....*.*..*.\ .*.  .* ** * *......*.  .**. . *  .... *.. .# #                 #
#.*. . . . ** . \ *.* ..  . \* ... ****\ .  .*  *. *..\ \ . **.. .\ *  . ****.**.* # # ##               #
#..\.* **. ..\ \\ *.*\    .. .*\.* \...\ *.**** . ..* .*.*. ..* \**..*.  \..\.\.**\ #.. *#   #          #
#***\ \.\\.** . . *...*..  * .***.*..\ .\. *..* . .*\. ...\.  * .*.\**\. .\ ...***#.## #\ # #\#         #
#.**..\. *.*...  *.  \. *  ... *.*.. .\ ...*. . . \*.. .    .*\  \  .. .*. *...\ *.#.#...# #..##        #
#...... .. **...*  *\ .\**.*.. . *\.. *..*.*  **  ..* * . ..\.*. .   \..***..\... \ .\ . *#\.* \#       #
#\ *.*\. *.\.  .*  .*.. .*** . *\...  *\ . .. **..  .\.  .*. ... \.\.* *... \*  .*.**.\..#  *\*#  ## ####
# . *. **\* . *..* .. .. ...\.*.**.\ .*..*... *. .**.  \. .*   *\**\ .\.*.   ..*\ .. .**\ .* # ###*\#\\*#
#....\ ..\*\. \ *. . .*..\ *.*.....**.*\ *. * *....** . . .\*..\*. . *. .*. ..\ ..* **#*..*.. .\.##*.* .#
#.*.. .** .\. . ... **.* .*.*.. ** *..\  .. .\.**. .. .*   ..* .. .*.\.\***.*\.**.. ...* **.*  * #.**  *#
# **..**.*..*. *  .*..*   ........** *.. . \.  .\  ..*\.*.\ *.. . *.**..\.* .. .  .    .**.\. ..* \. \* #
#.\* \*.*. ..* *.* .  \.****  ***.* .  \ **.\**  *.*.. .*.*.. .   *... \ . .*.   *\.*..  ...   .\# \ #.\#
#\.\* *.* *...  ***.  ...**..**.. .\*  ..\*.*.  \\  *  *...*  \**.\ .**.\ \**\....  \   *.**.*.. .\ \***#
#*\.  .*...\.\  *..\*.* **  *.***\  .*..* . ...  ..\...*.  .*.\*.* ***.** .*.*.*.  *.* ..*. *\. \ *\.**##
#\. ..   ..*.   ..\ . *.\.*.*. **. **.**.\ .  \ .. .   \  \*.... *.....\\.\..*.* .. ... ..\.* ....**\.# #
#   .\\ .   *. *  \.  \ . ..\... * *..... **. .*.** ** . \ .. \ *.\   .*.*..*. *.  *   \ .  \  *. **.####
# .   *.*.* .  ..*. * . . . ..*   **  ***\.*\..* *.\\.* \ ......\..\ \. .* .***\..*.\\.  ..\.*   ...** .#
# ***.*.... \.. *\. . ***   **. . ..  . **\ **.\ . * \* .. *  *  *\ *. . .* *. .\** . .*.  * *.\..\\*..*#
#...* \.\*. . *.*  .  ... **\.*   .*. . . \ *.*.   . *\.\\..\  * . \\...*.* .*\.*. \ .*.* .  .\  * *#.###
# .**..***.*\.* ... .*  *.**. ..*  .*.. ..\.* *\. ..\.*\ *   ... .  .* *. **..  \   .\..\    . **\....*##
#. ..*. .**..*\  *\*\.   .*. . *.\  ..  .*.*.\.. .*..*.* . .\\.\*   \...\ .*.\ *.  *  *.*.* .*  .... **\#
#.*. .. .\..  .*.* ...  **\ \. ... .. ***  ... . ..*.*\.**\  *. .\......... * .*\. \*.**. .. .  **  ..###
#..*  .. . . * .**   ..\*..  *\ .* .\*.\.\  ** .* ...* \.*  *   * \.\ **.*  ..  .\. **.\. *.  .. *.. *# #
#..\*. \  *  .\ .\....\ . .. .\ \.   *. .*  .\ * .\. *\. . .* .. **..\.. *\\.*. **..*. ..*\* ..  .  *#  #
#  *  .   \* \.*.\\.\ .*  .**\* .\***...***** ..*.*  .\..  *  . \*.***.*..*. \.\.\.* * * \ .  \\.  *.\# #
#\.. *\.*..**...\**.** . *** ... * \.  \ *.\.  ..**\ . ... *. .* .....*   .* .... \.\ \. ..*..\ ...\ *# #
# \. * *... . * . .* .... ..    .* . .. ...**. . \. *   . *.**..\. *\\.   **   *.*..  .* . \.  ..**..  ##
# . \.**\ .\* \  .*.* .*..*** .*.* . .*\ \**.\ .*  . * **.. *. **..*...  **** ....  *.*..\.\.\ \ #* .* ##
#. * ..  . .*. ..*. ..\... * . ** .*\ . .*.. *. .\*\ ....\\.*. .   ..   *.\.\  ...*\.\*.** .  \.. .*\#\ #
#.*  .*.\*.*. .... ..\.*\.*...*....*  \ ..* ..\* ..*.*. **\ *  **\   *\..  *. *.* ..* ..*.\\.**.\**..\..#
# . . .  \ ..\.\*   ** *  . . ..*. *. *.  .....* *\.*. \*.**. ...   . \ ..\. \...*\ .**\ \  ...\. \.\##\#
#*.* .  \ .*    .   .*..\ *.  *..\  * \*  ..\*.* \.\*\.\...***....* .* .\****    \*.*.. **. .. . .   ***#
#\..  . ....* * ..*\ . *. . .**.*.\*\ .. .*. *. ..**.. ... *  **.* ..* .* .\\  .\ .  *\*\.  . * .** ***.#
# \.\ *\. *..\\\ *.. .\.   .. \ ...... *. ..*.*..*.*...\...*..*..\ .*.  * ...  .. .....\.*.. ..\....** .#
#..\* . *\***** . . .   ..* **..* .*.\  \  .*. ...\.*.  * *. .*. .* ..*\.. \ .   .\  *\...*.**  ..#\.. *#
#\\.. ... *\*.\ *\ ....  *.\.**.  *..**. .* *  *.\.\.. ..*...... *...*. *.\\**. * .*   *\ \ *..** **  *.#
#   .** *....* **.\*. \  ...\.*.\ .*\ .\\  .*.*... **. \...\..  *..*\\..\.* \*. .* ...***\.\*\ \***\  \ #
#\.\ *. \..***..*.***.. *\ . .*..\ **  \.. ..\.** *.*.. *\ *... .*\**....\*.... .. .\ *....*.. .*.* .\..#
# *.*. . .**.\.*...\..   \.  * \.\ .*. . * . .\*\*..\.  *.*..*.  * *.\  *.\.*\ ...\.. .* * \*  \**.  .*.#
#\ ...*** \*.*\*. *\. ** . \ .* **...  .*\. .  .*.* .\ .\ .  * . ** .\*. ..*....  . *..\..* * ...\#..*..#
#*\. *.  \ ..\.*. . * *.*   *\* .* \.** *.\  \**. ..*.*    \.  ***. .* .**\***\..** .\*\ **.\ .**.  *.*\#
#. \*..**.\    .* .\.*.* * ..... .\.... *.  ..*.  . .*\ .\* *.\.*.\  ****\*..\*\**  ..\.* **. .*.  *.*. #
#**.*. .\** . *..\ .  ...*.. \    .*  *.. *. .\*.    ... *.\ *. * *.*.......\.**\.. \\*.\.\...\.\.* **# #
#* .. .*..*..*.   .\\*   ..* ..*  *.\****\ .\..*. ..\*.* ...*\.\  *.. \.\   .\.*  \. *....\.. ...*. ...*#
#**... \ .*. ..   .* *.\. *. *\*...\ .\\..\\*\** \\.** *. **\ **\  .   ..\\*\... \   ..  .  *..**....\..#
#*..\. . .* *\*\.*\*.\    ..\.**     .*\.*. ..** .\..* . .*. ..**  \* \  .. .*.. ...  \ *  *.*\. .* ..#*#
# **** * .*\.  ...* .. ..\. ..**.\ .\*\.\   *.*.  ..\  \. .\*\*.\.. **.. *   .*\*.* \   *.***   ..*.* # #
# ... ..... *\**.*. .   *.\   ......*..\ ...*....\ *.\. .*...*.\  ... \  ..\**.  . \..  .*.. . *  \.\.#\#
#*\ *.**.* *  .*.* * .**   .*.... . **\* .*..\...*  \  . *. . . * **\ .. .  .*.\.   \*.. .**.. ** .#**###
#....*... ...*.**\ .\..\. \.. ..\*  .\ **\..*.**\.\*\.  .** * . \*. . *\   . * .\.\...*..*.\.\*#\**.*.# #
#** \*\.\.**.\ *.. * \. .  *.\ \.. *  ***.*...*..\.\...* .\ \*\..... . **\\.*.**.... \ **. ..... *. **# #
#*. ....*..\.*. \ .\ .  *...\.....\. *.**  \ ... * .  .. *. *...**.. * ..*.*.*.*  *..  ... ... *..*.**# #
#\*. .\.. \. \ \. \..\.*\ . . \...*\**.\..  \.   *  .   \ \*\ \* *   *\.*.\. ..\*..\ \** .\ \*\.. ..** ##
#*. \*.*  ..**. . .\*.\*.   * .\.\.. * .    . .\.  .* \..***. ..*..  ... ... * .    . ... . ... \ \.\.\*#
#\.... ..*. .*\.\\ .*.* ....\\. . * \.*..* * .\  \  ** *... * *. ... .    **.*.*\. . \    .*\ *.# ..*.*\#
#*      *.   .*.*.\.....\* .\. \ .....* ..........*..\ .\..  .. .*...*..\**\\.**\  \. .*\\ *. *.\.**...##
#*..*  *\*  ...*.   .\ *..*\* ....*  *.*..\*...*.\. *. \...*   ...  *. *. . **.......* **..**......\**# #
#....\....   \.. * .** .*.**..*.**..\\*\\..*.*.*  . .\ **..\.. \.. .*. . .  ..\. * **.*.\  . ***.  .. # #
# * *  . *.... *.. *\* \..... . ...** \ . ***.  \.* *. ****.. *..    *...\\....    *.\*.  \.\..*\ .\**# #
# \***.*\  \* . * \* \  . \**.... ...  .*\*..*..* .*\*   .*.. ..\..* **.. \.\*.\ .... *\..\* \*. \\# *\##
#\. .\\ ..\..**..  *\ *.\.*.* *.* . . ** .* . ..**......*\..  ... \ *.. **.\ . .   .*...\. *...\ . **\#.#
# .. .\ . **\..  ...* .** .\. .*.**  .*.. *.    .*. ..\.*  * * \\ . \   *.*. * .***.. *  * .*\  .** *.#.#
# .*.* \*.....\.**. . ..\.\ . \ *. .. .  *.  *.* .. *..**..* . *.*.   *...*  * **. . ..\\ .\*.* **. **  #
#. *.*  ***.  .*..\.\.*  ...* . \.\.   *..\*.*\. *\*.*..*\ .\*\*.\.\.*.\ .* .*..*.**  . ..   ..\..\. ***#
#\..... .\\.\... * .*..  \...  . *  \\... *..*  ...*  \*\.*.*...*.. **** *\. *.*.**. *.*.\ .\ \..\# *.. #
#*.\*. .*  ..\.\..\ **.** .\.\\.\.\*..   ..  \.**. *. \.**. . . .\*\*... .*\. ...*. ....\ .*.*\\ .  .#  #
#.* *.* **.  .\. \* \*. .\...  **\. \. . \.\ .\.*\  .\. \**.\.\. \. .**  ..*.. . .*.... * .* .*.  .  .\##
#.. * *\.    *.*.   ..*  **.\.**\ *..*..\. *. *\ .*  .* . *\  ....  *.**  ..\ .*\ .**. . \. \\ \ ..*\* .#
# *\. . . .\.\  ** *  ..  .\  .. *  **.  *..*... ***..*. \.*.*  * ..*.. *.* ..** .*.. .. ..*..\ . *.#\. #
#.. *. *.*.. .  *.     . .\ \\.....\**\*....*   .. .\*..  *...*.. ***** .*.. .\. *.**\*..\ *..*  * \*. .#
# .\.*.* . \   *\** *.  . *.. .\.**.. **\ .  . *  . .*  \**  *..* *\.** \.\.\ *. . .* .\ .. * * .**. *###
#*.\*.*. *..* .\..\ *...  *  . * * .\ * \ *.  \. \.*.  ..**. *\.  ....* .  **.\ *.\ ...  .\..\*. * \.#  #
#.*.*..  . *.*.**  .... ...\.. ..*** .\ ..\.  .* . \. .\* \* .*  . .\. . \  .* .. .\. ..   .. ...* ##   #
#*.\..\...\.*. * *  .\ * *\\    .\*\  .  *.*\.*. .. \**..\ .  * *.\ *.   **. . .**... *  ** *   \ \#    #
#\ *  ** * \ *\* . ...****. .\.** . \...**. .*.  .. .. .*..\*.\..**..\ .**\ **  \.  \ .* *. . .\ . *#   #
#..\ \*. .* *.*   \**\***..\*. ..\.\. . *.   .*\   *.*. .\ \\* . *. * *..\ *\* *..*.* ..**\...\.####    #
#...  **.*. ...  . **....*\..\* .*. *   .*\..*. .*  .*\. . .*\..\.*\* .\... .\.***. *  **.*...# #       #
#.....\***\* .\.*  .\*\  ...* . \. *. .\  .... . . * . \ . . .\.*\*...** .  .* ***... ##.*  # ##        #
# \  **... .**   ..**.* ...* ... \..  ***.*. .\ ** \.* ..*. \  .*.. **...  .*.\.*.#\.*## #\.##          #
# \...\*.... .  .*\ * ..\.\.\*. \ .  .*.**.*.*  *. . . ....** *.. \.\....   ..* .**. *### #.#           #
#\..* *.*. .*  **.*..*..* .  ...*\*...\ .\** .*\.   . \.** ..\.. \ ***.*    **. .*   **.###\#           #
#.\\**.*\* .* *.\ * ..\*. .\.\.. .... .. **.   * . \  . .* \ **.  \\*..* * *.* ..*.*  .** ##            #
#\*.\*\... ** *\.*. .\...\**..*....... .*.....*...*\*\ \.*\.*. .* . \ . .* . *  .*\.# #*#\#             #
# .  .. .. *.\***.. * .*..*.  . \ \\. .... ..\. \.... *.\.*.\.\.. *    **.\ *.*.\ .. *.# #              #
# * .* ..\ ..*****\    .  .**..  \.\ ***.  .   \.  *  * *.* * .\ *. *\ \*...**\ *.**.#\.#               #
# **.\.  ..  .\....**\.\ ***.... .\... *.\.*  ...*\***.\**\**\ ** **.. ..  .... . .* ##.#               #
#....*.*.  \  .. . *.  .   .. \.... .\..*..\ * . ..*.. * . *\  *. *  \... **.\...\ . *\ #               #
#\ .*...*. . .*\  .*. .  .**\\. * \ .. ....*   .\.\* *.*.. ... .*..* ..\\ \ . .*\ *  ..*#               #
#*.\.\* ..   \....*. .*.  *. \  \..*.* *..\ .. .*...  * \.**\ .\ .**. ... .* * .* . .#####              #
# ... \ *.\  .  . .   .***.**...*  ... * ..... ..\.* .*.. .. *..\*.*.  ..  .**\*  \.\   ..#             #
# . .\.*\...*\. *\.. .* .\*.*\ *...*  . . .  \ *.*.* *.*  .. \.... . . .* * .* *.  .*.\L##              #
#* . . \ *. ....*..\  .....*..*. * .  ..\ .\. .**.  ****. \* *.*.*.\.*\*     **\ .*.* *. #              #
#.**.\*.  * *.. \**.** ..\.*.*. .*\.*. . ...*  .\*.\. ..*  . ....* .\.*  \ .... * \ * ..\ #             #
#\..*.. ... *. . .. *.  \.\*  *.....*** . . .\ .*   .* .**. . ** .** .**. *** .\  .*.* \.#              #
#.\***.. . ..*. *  *.* . **.. . ..*.**. .*  *\**..***  \..\*.\*\..\\ .*... .   *\\*.\...#               #
#.**.  .  ****.  . \..* *... \   ...\   *...\...\ *.*\.. * *...*\  . . * * * *\  \ *.## #               #
#. .*...\... .*\*\*.. .\*. .\.**\.  .***. .\ ..\. . \ *...... ..  *.\.*.. * .*  \#\.#**#                #
# \.* . *.\. *\..\.. .* .* . \*\*\.*  *\ * *.  *  \.  ..\ \ * .\. **. .\  \ \. ...* ..#                 #
#*\.**.*\ .**. ** \.**. *.**.\. .**.* ** .\*\*.. *...\   *..\.**.. .**. . \ ** . *..**#                 #
#*.\*... \....**..  ..  *..* ....\.. *.**.\.\\. .*** *.\.**  \ .*\...\*. \.. .*..*\*. #                 #
#.. .***...*..   .. .\* ..\.* . *.\*..\..* * *.*. ....*\ \ .*.. ..*.**.. .* \** ....  .#                #
# .   \.*.. ..*..  \ *****  .\.\ **.  * ... .**.. .   *\ ..\.\.*.\ ..\.  .....  *. #**.#                #
#  *\...* *.* ..\ ..*...*.*. .***\.* *\  .**\.*.\.\..**..  ** *..* .\.     \ .* . \*\*\#                #
# \. \.** . *** .\* . . .** .**.\. * . . *... \ * ***..\*....  *\*. .*..\.\.**.*\.#*###                 #
#\ * . *\ * ..* ..* . * *\*.*..*.*. * .**.*  *.. ...\* *. . *** ** \.\.\*..**.*. .#*..#                 #
#** .\ . *.\**.* \. .*. . ...***  ... **..  *\ . *   ...   .*.*.\. ..  ..  * **...   *.#                #
#*.* .*  .... ..    .* .  .* *.. \  .*\.*\. *.***\* . *. .\*....\* * .*.  \ ..\*  . \.#                 #
# \.. *   \\   ** .* .. *  . * .* \**.* .*. ...*\\*  .. .\ .\.*.. .    *.*.. * *   \#\#                 #
# . *\* **.. . ...  .*..*** ..  .\ \.  .*..** *.... . \* ..   **\.  .\** \ **.\. *\. *##                #
# .\. . .  *...*   . .\*..* ..* **\** **.. .**** * *.* *\.\* ....*.. ... ....  .. . .* *#               #
# *\*\ .  * ..\.\*.\.\ \*     **.*. .*\***.\....\. *...*..*.\*. .. .*.......... ***  #\*#               #
# \**...... ..  .*.. ..\ .*...\ ...**.*...  .R***.\..*. . \**. *** .. .**\.*  * .*\.\..#                #
#\.\..** .*  . *..\.*....*. *..\*  .\ .** \.\*... *\...**  ..\*...\*   ..* .  \ ..\** *#                #
# ..** \ .**\.      .  *..\.\**.*..* * .. *  .*.  ..* .*.. * **.\... .*..\ ***. *#\ ###                 #
#.\ .. . *\*.\ *  .  ** .  .* .   * *  **..\  .* . *. *..**  .    .*. *.   . .\.*** #                   #
#... .. . *.** ** **. . *.  .*.** ....\.*\ ..\\..**.. *  **.*\ \.. \. ..\ ...*. \.\. #                  #
#.\ .* .\ **..*\ *.*..  .* ..\  * **.** .  .. .. ..\ ..  *\\. \ *. ..\. .  ... *.\ *#                   #
#. . *  ... .  ..*\*.*.    *  .   .*..\* . . *\ \ .* .  \...*. ..*   ... \....*.\ .*\#                  #
#..*......**\. **..*** .*  \.   .*..\ .*\ .  .*\. \.  .  ....\  *.\*. ....*#\ .\##\.*\#                 #
#*.\ .\ .....\.\**.*..  * .. .. ** ...  .. .*...**..  \ .** \.\.. ....**.\.  .##  ####                  #
#  ..* *\.***  * *    . .*.. ** ..    .**\**\..*....\*..**...*.*..**  . * *    #                        #
#*  ..\.. **\..\ .* *.\. * * ..\ \ \.  .\*... .** ..*....*.\..\*. *\*\ ** *.\ *#                        #
#..*.*..   * . \* .\*.\.\* \    \\ .  .\*...*. ..*\.* .\**. \  ..  #*.\..*. *.#                         #
#  . .. \.   ..   \ .**. ....***. . \* ... \ ...*\ *\..*  \ *. \*.**..*  .\ .#                          #
#\.\  ...\ *.**  *. **..* *. *.*.\. ..\*\*.*.....  *.***....   ..*... #.... *#                          #
# *  *   *****\.*.* **\.* .\ .\..  \*.* *. . . *.  .\**..*.\ * ..*#\.. .*.*.#                           #
#*.*..* *.\*..\ ....* *..  ..*. \ . *.**. ..*.*.*  .*..*.*   \ . .\*. ..# .#                            #
#* *\  ..\..*\....\ *.*.\. . \ \*..\*\.******..\ \ *.  ...* * \. *#..\.\##.#                            #
#\*.**\...\* *..\** . .** . .  ...* ..  ..\..\. *. .\\ .. ..**.*\.\\\****##                             #
#*...\*. .\\ \.*\.* .. ..* . \   ..\* .*\ .\*.  .* \.*.  . .\.**..*\. ##*..#                            #
#\*....*\*..  *.* .* *\.*.*\...\. **.  *.\. *. *.. ...... \ . ... \...\*.. #                            #
#\.* \.*\* .\.*.. *. . .**. . *****.* . *.. .*.. .  * *. *. *.. \*. .\** ##                             #
#...\..* .. .*..  **\  .*.\   **.**\  . ** . ** .\***.* *.* ...#.# . # #..#                             #
#\  ...\.\   .  .\.**\... .\.*\* ..**.. .\ . *...**\. .....\****..\*\#*###                              #
#*..**..*.\ .\.  . ...*  *.  . *   .* ..*.\..... ...\* \   **. .*\.#.*.#                                #
#* **. .**   *.*.\..**..** ...*\.. .***  *\. \**. * ..     ..\.\ . #  \#                                #
#\**.*.*..\........ * * *\ .**. ..\\.*.*\...*.***.*\.*.*  *.*.*#.\ .\ #                                 #
#\ . *** *  .  \*  .* . ......*\ *.\.. .. **. \..**  . .. . ***\**  ##                                  #
#..\ *\. \ **...*  *..\  ..\  .*.. .**.  . .* . ...\*****.*.*#\.#\# #                                   #
# .. *. . . ..* .\... ..  *.*.\.......\ ..\\*...... \\. .*. *\*.  ##                                    #
# **..* . **.*.*  \..\ ... \*. ..\ .*..  . *.  *. * . \#*.*####**\#                                     #
#.*\..  . ..*.* .*\* .\* .  ..\ *.*..*\..\\ \ **\.*  \. ..#### *.#                                      #
#*..*.\ **.*. .. .***\*. *\     * *\*.  .. **...*...\.*  .#  # #\#                                      #
#*.*.. ..\ .*  ***.** *.\*  .. \**...**. . **\..\*\... . **\# # #                                       #
#.   *.. ..*\* .\.**  .**. \..\ .. *\\ .\..**. \* * \  ##.*#                                            #
#\ .\* .\*\..\ \.*..  \*.   . .    \. **   .\*.  *\#.. \###                                             #
#      \.* \   \.\  ..  . .\*\**    .....\**.. . .** *.#                                                #
#.  . .. . .*\ .\ .*\ *..\..*..*\* .\..*\........*.....#                                                #
#\ *..  \ ..*..   *\*.... .\. *.*.\ *.  .\.\*.*.*..#\ #                                                 #
#*..   * .*\..***  ..\\ \*.  ..\.. *.    . *... .**.*#                                                  #
#.*.*. *...  *\ *...  ...*\\ \ *...*.\* .. **\ .*.# #                                                   #
# \ *....... .*.\\  .  * .\ ..\. **.....*\ **. *####                                                    #
#. ...\...**  *  . .. . .. .   * *. *.\.\. *.* ..*\\#                                                   #
#\ * ..*. .\ .\...  **\. ..   ..*..\.#.  .  *#*#*#..#                                                   #
# .  .*..\.. **. \ **.**\. .*.  ..*  .\ *.#\*## # ##                                                    #
#. ....***.  \ .  ***  *.* ..  ....*.   .* .#                                                           #
#* .   *.# .\ .*** *.\****\..* \...\.\.\#* #                                                            #
#....* *   ..#**.  .* .*##. ..**  . ** ..#*#                                                            #
# \**. ...**. ..* *.. ..*. .*..\.. **.* *.#                                                             #
# ..* ..# *\  ****.   *..#\.\  *.**.#*.*##                                                              #
#..  ## .\*.*###\#.*\*.*.#**.##\*...#.*..#                                                              #
#   * *  *\.\#  ##.\#\*.##*.*\ *.**# #*##                                                               #
#*  *\.* # ##     ### #.##\#######*# #*\#                                                               #
# #*##.### \*#       ##\# #       #  #\#                                                                #
## #  #  # ##          #              #                                                                 #
#########################################################################################################