###################################################################################
#\.**.. **   \*..*. **  ..* ..\...      .*     *.\.\..*.. \.\ \#                  #
#**** \.\ **  . \ .. *.*. ** .. .**....**.  \.\ * ..\. . . .  .#                  #
#*.*\    *.\.*  .  .*.**. *  ..*\ \ *..** .  *..*.\...\ .*..*  #                  #
#*.... .*. .  * .\ \\ ... *. **\ .. .*\ .\.  . *..\\**.* . ####                   #
#.*\\   \  \.\.*. ...*. . .\.* * .  .... . .   ** .*.*\. . #                      #
#\..   .. *  ..\\ .....\. \*....* \ ...* . .\*..\. .*... . ####                   #
#*\  *.*\\ .. \ .\.\ \*.  ..  . * . \...*** . **....\.* . *. \.#                  #
# * ...**. . .... .* . .  \.. *.\*. .\..\\. ...   \ ..* .\\ # *#                  #
#\.. *.*\. .\   **** . ***  .\.\ *\ .* .   .**\*\*..*\.\*. . ##                   #
#* \ .\  .**. \*. .. \.*.*\.\  **.  .*\ .*.  \.. .. **\..... \#                   #
#..... .\. **..*    *..*\...*  .\.* .** .*.**.*.\   **.*.. .*#                    #
#.  ..  .. ..* .. \..  *  *  ...**. . .  * ...*..\  .\*..   \.#                   #
#\*\ .**...** . *  ..*.. .. *.. *.. *\. ** ..*. *. ** * *..*.  ##                 #
#..***..**\.. * \\  \..   . .**  .** *  .*  ** .*\ *...\.\#.. *#.#                #
#*  * .....\\ .  ..\.\  *\*  .** *.\*.   . . . ****.**** .. ....\##               #
#... \  ** . * .* * \  ..  .  .*\. .*\* \ \.\ * \*..\... * **. *.# #              #
#.  .* .*.\ *..   \... \* .\. *.*\....*.* . ..   \ .*  .*\***.\ *..\#             #
#.**\. .*\***.*..* .*. .. * .*  .**. *.*\  * . **.. *.  *.\* *.   .#              #
#\.\. .**  \. . .\.*. . *..  .\ .***\..\ *\.\  .*..*..  *  .*\  \*#.##            #
#.     .     .*.**.\.\...*  * *.\....\.. .... .\... **  ..   \.....\*.##  ##      #
# *.. \*. ..* .****. \. . \ * . * \\..\.\  \.. **.***. \ \.**..  * *..*\## *#     #
# .*\.\.. ..* .\**..* * ... ...*...*..*.   . * **...\.. \.  .   * *\*\.. #*#      #
#  . ...*.  .\  .* .. \  *. *.  .  ..*** \ *...*..*.*.*.  *. ..\...*.#. \ *#      #
#\ *\  *... .. *...*\ *\ .* .. \..\. .*..  .*\*. ......*\.* *..\. .\*. *###       #
#\  ...*** \ ***.\.*\.*\. \ . \.  .\  * .\. .\.  .*.\*\**  \.* .  . .###*#        #
#. .*\ *\.\...*.  **.*.*\ .. **..*...*\. .**    \*.***  ..*..*. . .**.#\.*#       #
#* *. \.*.* *     *.* *.. *\ \*\*\.* *.*.*..\ **....*.*\ \.** *.  .**. .###       #
#**.\.\.\. *. .. *. .  ****  ... ..**..\*\  .**.. ....**.....\..\ .\.  * **#      #
#.**.  \ ... . **\ ..  ...*.  * .  ...*.\..\ .* .*.  *. *    ...  **.*#*###       #
# .*.\*...\..\..**. **. * .  *. \.*** *.*\. ... \*.\**.*\.\.. .  .\. .#*.##       #
#.*..*.  *.. .*\*. \*.. \* \..*..\...*..\...  **.* * ..\. .*  * .  .. *.\..#      #
#.*  *. .. *\*. *\. .\.\..  * .\*.. * . .*.  . .\. .**. .\..**.  ..**..*.* #      #
#\* \..*..\.  .\.  *\. .*  ** **. \ . * *** \. \*\* .* \.\ *..***.\..*\.###       #
#*..**..  .. \ .   . * \.***. \ **.\*..  .*.   ** *\ ... ..*\ * \..\***. ###      #
#**  \. ..*\*.  . .\ *. **...\ \***\..*  *.. \..** .\.*\ *.**.*\.*\  .**  .*#     #
#*\.\.*\\ . .\  .  * *.\*\* *.. *.* \ \ .. *.* ..\*.. *  .**\**. .*. *** ###      #
#\..*** *. .***.* .\ .*.... .* ..   .. .\. ...   . * *. . .*.....*.# ...*** #     #
# \\.*.*.  . \.. *.* \*  \\  . .*.....*** .... *.* * ... .\.\.\.*.**.*\*. *#      #
#\.   **.\..*..*\.\*\.  \*\ \ .\\. . **  ..  ...* .*\. **  .   *. .. *.** \*#     #
#**\ ..* **... .\. \*.\\ . \. .  .*.  ..**..\.....   .*.. .. *\.\*.\*..*. \#      #
#...\* . .**.*. ... .**..*..  *. ..  *\*.. \  .*\.   *.\ .  .. ..**.\****#####    #
# ..**\.\..  \..\ **\..* .\   .  \* ...\.*\ .\  *. ...    .*.  *.*..**\*...  \#   #
#  ..*..... *.\*  ... *. . *..\.\.*. ...***...*. *.   \   .*.**....\.* .*  . .*#  #
#.\...\.  *.** \ *\. .*\.. *.*** .\* .\.. **\ . \. .*.. .\ .\.\ ...**...##*.. #   #
#     .    **. *..*\.***.  ..***\. ..   *.*\ .\*.* * . .\**.* ..*.**  .\##.*\#    #
#.**.   . . ***.*.*. *.....  ....*\.  . ..*..\ *  .\ . *... . \*. \*.*..*.*..#    #
# *.** . * **\\**. .** . * .*.\.\*   \*. *\.  .  .****.. ..*  ..  *. . .\.* ..#   #
#.\.......\..*.. **. .   .*... . *.* .\....\** \  .**\*\.*   ..  .  ..\ .*.* **## #
#\*..  .*.*. * ** **.\.*.**. . *\*..\ .. .**\*.**.\\  ....... \ .* .  .* \. \##\*##
#*.*.\ ** *.*.\ \.\.. .\.*.. *\. . *..\\.... .*.* .***  \.\ .\.*.\.....*\...#  ..*#
# ..\** .\\.  .*...\.   ..\\.***  ...\..\.*  ..**. .*.*\ **. . .* * . .* ..*#\. ###
# .*..*** \ . *. .\. .. *.....\* . \ **.*\  ...*.\* ....*.**..  .\ .. .*  . \.##  #
#..\*..\. ..* . ... . * .. *.\ \ .\..***.  **\.*. .***. .**\. .\  . ..\.\  ...\#  #
#.\.*...**\..... *.   .\ .* .***  . *.*.** .*.. *. \ *. *  . * *.*. *. * *\**. \# #
#\. ...*.****\***  . *..\ **\ \. \ .\..*..*.. . .\.*\..*.* ...**.*.*.*.....** *## #
#.. .\ *   .. .\. * . ****.**.    * * *.**.\  .\**..\.\. ..*\*..  ..*\.. *...\. *##
#.*\***\... .  .*. . *..\.  \*\*. \ . * \*\ .\.. .. .*  \**. ..    **... .*\ #*## #
#.. *.. *\..* .*.\\* \*.*. . ...  .*\......* .  \  **.\  *.\ *. **.*\*.\ *.* #.#  #
#** ..* . **\. ...\* \. * \ ..*\.*\**. \.**  . ...*.* \. .*  . * .*. ... \.. ...# #
#* **.\.... . \....** \ .*.*..  .*.* . . *. *..\*...*\.. \.  ..   ..\  * ..#*..#  #
# \... \ . \**.\   .\**\*.\. .*\. **\*.  * \    \ . ....***.*.\. .\  * #.#\#*##   #
#* *\  .   * .\.*.. .*.*\\....** *.. *.. ..*. ...\.*.**\.....***\.* \\ \.*..#     #
#*..*.  . .\   *..   .*.** \\..*\*.....** *.* .*\ . * ..*\ *.\..\..\*. . ...#     #
#*. * * .\.  ...\*.** .\.  .*.**..\ **..**.*.\..  \**** ...\*..*.*...*\*. * #     #
#*.*\ ..** *\. .*. ***  .. **  \* *.....*\ .. .\* ..\.*  .\ ..  .. . \*.\\.\*#    #
#.* *. . ...  \.. .*...* \ ..*... .* *..*..  ** . ....* ***\.\.   .. ... ####     #
#  ***\*  * . .... *.*\.*.*. .. ..* ..*....\... . * \ .*. \.   .*** .\ .*. #      #
#...\..*.*\*  ...  . .*\**.. ** . * \. \. \   \.\  *.\ .    .* *.\. ..\#..#       #
#.\**. .\.*.\.* **  **.. * *..\  ..   *. \..\\.     \.\****\.. ..   .* ##. #      #
# . \.*...**....*.*. ..  .\*  *. .* ..*  * *..   ** *.\..**. ..*.**  ...   #      #
# *.. \. *..* * \ * \  .* *.. *.  .**......\*. .*.\ .\ .\.**.  .*.  .\*. #.#      #
#\*.*.\.\...*.   \. .  *.\... \.  .**\ ***  .\**.* \.  * .*.*.*...*\* . \*#       #
#....\ *. .*.  . .*\* ...... ..*. .** . \.   ...\. . \ *. . .\. .\.*.  \##        #
#. . .\ . .**.** ...\..  .* **.*..* *  ..    *.. ... ..*    . ***..#**.#          #
# .. *.*.*\.*\.***.* .*.* . .**.. . .  *.\ .*... *.\.. \* \\...\. *.##\#          #
#*\...***. \..**\ .* *. **\  *. \..  .   *\...*\* ...\\. \.. .*.\*.\\ #           #
#*** ..... .*\. .  .\*. .\.\ *. . .\*.** . \  \*\    .\.*  *# .* ..#.*L           #
#...   * *.**  . . **.*  . *...*\*.\. .. . \*..\. \ \* *. \..#.\*###\#            #
#.** \.. . .\ * .* .* \ . .*. *.\.***.* . ...*..**.*.. *# . ..   \##.#            #
# * **\  * ***\  *  *....**. ......\.\.  \  \*. *.\  .*. ****.. .#  #             #
# . * ..\ ..\...\*\*..... . .*..\ \.**. ..* ** . . .  *\* \..##*#                 #
#\..\  .*\.*..*.*.*. .* *  * ***.\    *\*\...*. \*.* .# .##*# #.\#                #
#. *..\.*   ....* .. .. * .  *\.***.\  ..  * .**.*.. .\\**##  #*#                 #
#.  .\....\**.  \\  *\....*. ..*..\.   *......*. .\** *.#.\### #                  #
#\.. .  . ..\*\*..**\. . \.**.\**. * ... \**. . \  ***\   *# .#                   #
#*...***.\ .*..\ \* *\   *\ .. ..*.. .* . .*.   .  ...**.*...#                    #
#.\**.. .** . \  ..**.  *.\ **\ .\** .*   .. *.\..\ \ *. \ ##                     #
#*.    ..*\*   .*...*.....*..... .*. *...*.*. *..* *. \  ..#                      #
#*    . .* *...\. .\  .\.\*  *\.. .. \ .*.****. .**.#\  .\#                       #
#**. . \** .. . ..\. *..\*\... * \. ...\. . ...\  .\.*#*##                        #
#.*. *  ... *\**..  .* ..  .*..\. . ..    ...\.**.** ..#                          #
# .\.\.*.* *\.*.* ** *  *. * . .\   ** ..\.    *\ .*####                          #
# **. ...* .\ . \*..*.. *...* *.R * ..\.*   .\*\.\ .\.*.#                         #
#\ .  ***.....\*.\.\*****..\*.*\.***.  ***..* ..*\**.*##                          #
#.* .*\. ...*. \.. .\*.*. *   \..***.\***.. *  .\.**.*#                           #
###################################################################################