#########################################################################################################
#  .\. . .*....* ..**. *.\*\.*.*  \  . . .*\*\.\.\  .* *    \.*..*.\.. ..*\**..\\*.\. \\   . \.  *.*...\#
#\. \..  *** *.* * ..*..\ ..\.*.  ..\ ** .. .. ...\.  .*. *...*  .*. .** . *\\\ ** . . .\ \\ .\\..**\.. #
# *....* ..*\. \.\.  .. ...   ..\* *....* .  **.\.     \. ....  \..* *.*......\***     ..     **  .. . .#
#\.  * . ..*.  \ * *.** \*.*\*\.*.**.* *.   ...  *...\..  *   ..  \...\.\. . \.* *.\. *   ** .\. \  .. .#
#.\..*..   *.  .  ...... .*. ..*. .*\  ....  .   .\.. .** \.\.  .*.*.... ..*.  \ \. .. ...\.\. ......\. #
# ...\*\.*.* \.\..  *  .*.* .  *  ...* .\.\  *\.\.*  .. *  \ .  .*\*.. .**..... *  .\*. .* . . \.. ** * #
#\..\... \.* **..\. \\.*\ ****...\*. .***..  *...*. .*\.   .*. * . *.**  *** * *. *..... .*  \ ..  * \ .#
#.*. ..*.  . *\* * *  . *....\ .\. * . .\.*. . .\* * . * . \\ ..  .\...  .**\*** ..\   . ... ....*..\. \#
#. \ . \\** \*.. ..*.   . \*......*..* ..   *   .\** * . *.. * . .*  .. **.\  .\ ..\\..*\..**..\.\ .*.\.#
#* .*    .. ..* .  \\.. **.  .\ . .  *\ *. **..***.*. ....\\..  . ..\ \..\***.*\. **..*. . .\ \.\*. ..*.#
# . \..\ .*.\..** \. * .....***. * . ..*. *..\ . . .*.*\.  *\ . *\.\.\..**.  *.* ..\* *\.  .   . .\* .\ #
#.*.. .. \. * *\*\.... *.**.* * ..\..\  * * \ .\. **.*..\ *\*  ** ***\  . . *.**. * ....\*..  .    \.   #
#.. * * .. . **. .*.*. . .**.. .\ .**.\** \ .\* .    *. * *. .*.  .\.*...  . ..\    *  ***.  .*...... * #
#  \* **.***..*.  . * .\..\*\*\ \ **. *. *.. *.\*..\ *  . . .... .. *..*\*.  *.. \. .. ..\ .. \\ .*..\. #
#.. * ...**..\.    . * *....*  .. *.*\*.. *  *.*\..  ...*\**.\ *. ..\...* .\.*.* .\ * . .    *. *.. . * #
#\..\.\. ..***  .*\  ..*\.*. \  \ * .*.  .*...*. *   \  . *\....\..** * **\. . *.\.... . . .  * \*..*\.\#
#. *.*. \  .* * \ .*   . \. .  .  .\** .* * *\..\. .* .\..* \.*. .. . ...\  *..*.*\*.* .  ..  . . \.*  *#
#.\..*\\ \**... .* .. . ..\**..* *.*\  ..*. .   * .\..\ .\..*.*..*. *.   * .\\.. . *\.*..*.* .   \ .* *.#
#* *\.*\ ...\* . * ..  *.. *. *. \*  .  ***\ .*\*  * * . . *..**.\.*......   . . \\ .*.    *  *.\.* . **#
#\...**.\.\..*.  . *\ *.*\* * *\. .. **...*   .*...*..\ .. **\\. .*.\.\..  \\.   .\... \ *..  \ .*.\* \*#
#.**..*. .*.**.  * .*  .... \\.  *   ** .*..    .  . *. \ .\...**.\.\..** \ *\*.*\.\*\ ..\. *   .**.. ..#
# *\.*\ ..  **..... ..  .*. ..\. *  *...\..\ \..*\.  .   **.*. .... . . . \....*.. \. ...**\.*\*\.* . . #
#* .\* . .*...\ *** .\    . \*.. .* .. .  * * .\ *\.. .....  *.* *.*\\ .*. *   ..**\.. *.\*****.* .*..\ #
#.* .. \...*.\ .*..\ .\ . . .**. .*\ **. * .\.*... * \.*  .\* ....*.   \....\.\*...  .    \.\**..\.  \*.#
# * ...  ..  . ...**...*\\ . ..\ .*.* ...*..*\.*   *  \.  ** .\* .*. .\..\.*..*  . .  \*. . .** .  *. ..#
#**. *\*    .\*. ..*   ..*. .  * *. *\ \****.  .\.. ... .  \.... ..  .. . **  * *\**.  . * * .*\  .** \ #
#..\.. .. *. ...*\.*.. . * *\.\*\*.....\.**. .*  .* ..*.*  .* \. .*  . .\*.*. *. *** \ * . **\* **\. ...#
#.. . * .*.\ ....  .*\ . *.\*. \* .*.  .  .\*\  .*.\ \**.. \  .* .*.      .. *.\ .\...*.* \.. *..\ .*...#
#.\.* *. . .\ .*.\* .    *.* *  * .*      \ ..\* . .\ *..\ ..* .* .. **\ ... *   .*.\.* . .* ** *\. . . #
#****\.*.\.   **. **. . *. .\\  *  \*.*.\..\....*.\*. .* .  *... .  .*\..\****\.* .\.*.\*.**.* .... * \ #
#*. *\...\ \. \*  ......\...** ...\*.\*\ **\* .\.\. .\.\ *\\ *\ ** **.*..*.\... .*.* .** *.. ...\   . .*#
#\.   * * .* .\.* .\*  **.*...  *\\.\*\ ..**.*. .*....*\ *.  .  .* . \.. .*. *...*\.  *.....**  . . .*\.#
#  . \.*\* .\ . .  .*.*..\   *. ..*  . ..*.. ... .* * * *\. **  \.\* .*  *.* ...\\..\ **.\ .*\*..\.. .. #
#  .*.*.*.    ...  .  . \** *\*\. . .***.... .**..*\. ...*  .\*\*. \* .*.\ *. \ .* \... .*****..\.*.\ \*#
# .*. . .* .\ *.  .* . *.*.  .* . ** ...  . .... .\.. * *.\\.\. .\* .\ .\   \\. *  .\. *\..*... **.* . *#
#*\****.\\ * *\.\. . *.\.*....*.* ... *\*\  \. .\ **. ... \*\. *..*  ..*..\*...*   \   .\ ...* .*.*.\*..#
#. ....\ **\ *. .... .*\..  ......  . . .....*.*. *  .**\ \ * ..\*\. * .**.\*\\* .\ *** ..\.**.* *.   .*#
#\.*. ....*.\\.\ ..  .* . * *  *\ *. .*  .**....  .**   * ..* \***.. ....\* . *.*  .*\***.....\*.*.. \  #
#..*\    .* .*\  . ..*. \ . . *\.*... *.*.\*   \   * ..        ....   \  *\ * .  \*\.*\...* ... ..*. .  #
#.*. .*.  .. . .   . *. *.*.*.**.*.. ** ..*.\*\. \ .*\. . ...*\*\  .**. *. .*.\*.\. * *  ..** .*. .     #
#*.\. .*.* .\ ...*.. .\..\.*.*..\..   .*\ ...*.*\.. \* \.. *..     ..** ..*.* .*\. *. \ *.\.. .\.  .*** #
#* .*.\.*. ..\.* .* .\ .***..\. .\ *.  **...*.\.. . \ .  *\... .*   ..\ ***. ..\.* \*..\. *.* .* \ ..**\#
#**.*.*...\ .... .**.\  .*.   *. . .\ *.*. .\ *  *.  .\.. * . *     .  .* * . * *.*\ *  ..*\   . .\ **\*#
#..\.**. **  \  **. *. .\.  \*...*...*. .......\\*\  .**\\.*  *\\.  *  .* .\ *\...\.\.**. . \..*  .**.*.#
#\. *. ..\..**.\*.*\. . . . . . ..* *\* .*\. ..**. \ \. . .* *.  *\.  ..*..*. .\ \* ...* \ * ...*..**\ .#
#.. ..\ .*.*.   .**.  *  .*.  * \ ...*.*  .\.*. .\\*..... \* ..\*\ .*.\  .\ .* .. \ \ *  ***.\.\ . .... #
#**. ..  ***.\..**\...\ *   \*..... ..\*. \  .*\.  .\*.  *..... .*\ **..  *. .\...   \  *\ .*. *.*.\ \**#
#..  \.. .\\.\.\.*.**\  .* *.*\**. .\.*.*. ****.  ** ....* *\** ...\*.. ...  .*  ..*\ *.  . \ .\\.\ *..*#
#**....  ..*\ *...  .*. .**.  *. . ..*\.\ *\..**.*.. ****\ .... . ..\** .\\.\.**.**\ ... \.\.*\.. * \.\*#
#*..  * .**\ *..*\ .**. .. .\.. ... * .\.....\. \* . *.*.**.* . . *...*\.*\* *\..*.  *  * *** . *.**. .\#
#  . .. ... ..*\.*  ... .\.  .*.. ...   *.  *.. .* .** ....\***  \.*.\.* ***. .*.*..**\ .. ..   ...*..  #
#\* *..   \** . \  \.\    *. *. *.\.\   * .**.\ ..**.\**\*..\ * *.***.*  .** .**..\ *. . \ ..... *\.*...#
#..\.*\*... .  ..* .***\.. *\. ...*.. ..\ \...*\\.   .\ *..\*\..\.. .*  \.*\.**.. *..\  *.***. \ .*\*. .#
#*..\ ..* ...\  **..... . .**. *.   *. .\* \ *..\*\. .*\ *. .*.*... \. \. . .. * ..  *\*\ \**. .*. ..  *#
#.\  .\.. **..\..***.\.\*    . . ..  . ...\.*. ..* .\ \  ***.. ** * .\.. .  .* .**\ \.*....*.*\.* **\   #
#\.\ .*\. ....* ..\. ....**\*.\ \ . .**. * *..** .*  .*\* \..\*.**.. ..*..*. .\* ..*.\   . ..** * .** .\#
#*\. . .  **  . \*.*\ .  ....\.... .*.** \\...*.\.**. .*.*\ \..**. * ..*.*.*......\.*.\** *  *..\.*.*  .#
#..\. * ...  \ ... .* \\\  * **.*.  ..**\.. .\ ..\..  **..\ ...*\ ...*..\. .. *.\ ... *.*.\  ...  .** *.#
#.  .*..*. .\***...**  . *  *.\ \*.\.\.... \ ..       . *\*. . ..\\ .*. *.\.  .. .*\\*.\.**..* ........ #
#.. .. .. \* ...   .. ....  . . .*   .*.**.... ...  .\ \... ..*.**  **..*  ***  . .  **\ .**.. \. .* . .#
#\*  . .  ..* **  *\* *  .\ .\.. . \   .. *..\* \ .*\ *..  \  *...*\..* .\*...\.  .* *\. .*.**\.. ..**\*#
# **.*. \*... .. ** *.. .\. \. . *..\. ...****.*. .  .. *   .   . . *. ***\.\.* .  . .*.\*.* . \.* *.\ .#
#.\*** . \..*   *\. ......  .\...*\..\. .*..\. **.  *...\ *\\  ..*.  \ ....*.*... .\..*..\**    *. * **.#
#.  *. . \ .*.\.. *.   . .*..**.*... .. .*.\* .  .* ...*.* .  .  ** **.* \ ..\  . *..\*.... .  *.. * .\.#
#\   .\ ..\**..*.*.* \ **.*\*.**..**. .\ .  .. ** . .. ... .. * \.. ** \*.*.  .*.\.*\.*\  . .. . **. *  #
#*    *..  *.... ..*****.*\****..**.  ..*. * ...*. *    .   * .\..\*.*\....*....   * \.*..  .. . ..\*.\\#
#\ ...* .\.*. \ * .*.\.. **..*.....   .\.*..  *.\....*   .. ** . . . **  .\.. .*. ** .\*  \\*.   \  *. .#
# ** ..\ * .*.. .  .  ....*. *\..\. . .* ... .*\*.. .  . .  ..  ..\* **\ *.*....\ . \.*  *..* ..\ ..*..*#
#\...\.*.  .. ..****.   *. *\**\ *.* *. **.\ ..*.  .\ .  . *\. *  ..\.* \\..*\\\*. *.\\..*\.. . . *. \. #
#.\. .*..\  .**.*.* \..  *  \.. **** ..\.**....**\  . * \\\ *\\.  *.\.*  . . *.*. **   *...*  \ ..*\ .\ #
#*   ***\.. .* \*. .*.\ *. ..  .. .\* .**..  . *...\* .  \..*....\\**\..*. ...  * \...\. *.* . \  .. \*.#
#..* *. * .\* ...    .  *     .. *.*.\.. *.  \ *  ..*  \.  *..\*.*.** \.*...*\ .. .  .** .*...\.  *\\ .\#
# ..*.* \** *  *.   ..*   ..*..*..\.\.. .***\.*.  **\ ...**.*.  ..... * *..***. . . ... ... .\. .*.. *\*#
#\. . * *.\.* ...\. * *  \.\ *..\**.*.\.\***  \  . **   *.*..*...**...*\.*.. .*  *. *. *\..*   .* *. *.*#
# *....\.\. ..*.  \.*\\.. .*\* ..***.* .*\..** . . *.  .   *\* *...** .\\. ..* .*\  ...\  \*\ *\* .* *.*#
#\.  * ..\..\..\ *. .*\ *.** ..**\..  .....**. \.**.*   *\** . .* \.*.\*..* *....*.*...  **...\.. \ .  *#
#.**..*\* \ .   *. *  *.\..\*\...*. . . \  *..... ..  *.\ ..* .*\\ \\ . .. .\ \ .. \ ...\...* **..   ...#
#*.........* *  *.*.\ .  . .*\ .\  *. * .*\.. *... . \.*. **..**.**. \*  **  ...\..***.....\*..*\.*** *\#
#.\.\. *.  .\. \. *. .\ *. *  . . ....\  *.    .*  ...*..... \*..**  . **.   .  .  * \. *  .. .**. ...\.#
#. *.. *.*   \ **.\.*\* . *.*\.* \*....*..*.\*    *. *.. \ \ . ***. \  .*\**.* .... . *...*.. *...\*. .*#
#\ ..*\.***\***.. .\...*  * *. .*..  *.\.......***.  . .\  . . ... .*.. .**\**\ .\.*\ .. ...  .. \*..* *#
#*   .* ..\ * *.  * . \.. *  . .\*. .* * *. . ....   . ....  . *\*.\. * ........ \ ...* . .\*  \ .** * \#
# ... . * .** ...   .\ ..*. *..\ \. *.\  ..***..  .  . .. .\.*\. \*.*\.  \*.*.**..\.... .\ .\   *\..*..*#
#.. .*   ..*..\ *\.. \* ** .*.\ ...*. * .\ *.*\*..  .*    *  .*  . .\.\   *.**.**.* *.. . . *  ... *.*\*#
#  .*.\ *. *\ \ *. ...\\..  .   .\. .. .*\.*.. . *...*....* * *   * . * *. *.\.*..*.\... *   **.\   \..*#
# .*.*...\... .\.**  .*.**.. . \*.. \. .*..*   *.. **\. *.. ** *  *\. .. .**..\*\.  ..**..  *  .**  ...*#
# *.**  ..*   \**..   .*\..*  . . \......\\*.* \ .*..\ \* * ..\.... *\ * * .**.* .*.. * \\.\ .  .\.*  * #
#**\\. .* **....*..\ \ .*  ** . . ..  .  *\ *.*. .\*.*..... . .     .*.*  .** \ **.\***..   **.**.**\ ..#
#\. .* *. . *\**.***.*......*..*\*.\\  .*..**\.*. .... \..  \ *  .*\**.*\***.\.  \ .*\ **...*  .\*\. .\ #
#.\. *..*.\ ...**... \.*\.  \ ..**.\*.\ . .*.***\ **.*.. *.. .*. \.*.. *\.\* .   ..*. \.*   ... *...*\  #
# .. . \.   . . .  *.*....\*. *.\.\...... ...*.* . .*.  .. . \. \..*. *\. \* ** .*.. *.*.. .  ... * .*.*#
#**   .   ** .  ..*.. *.   *.*.\ . * ..\   . * \.. .* *.  .\..    .*. \ *.*\ * .*\. .*....    . **.  .*.#
#**.*..   ** *  **\.*\ \****.\. *. \** * .\*\   .. ...*.* . *\..\ .\   **.*  *. .**.\. *\*. * ..*.* *. .#
#.\..  .*. . ..**..\ * .\.. . *.. * ..\  *.*  ** *\.\.. .\.\* ..*. *  .**  *.\ .\.... **.*.\. *\. **\\* #
#*.*.*. ..** ..\ *..**. .. .*.\**.\.** . ..** .*\\.*\.\.* \ .\.*.* *.* *....** ..**  . . \. .**  .\..\..#
#*** .\.\*\*    ... * . \   \. .. .\\..*\..\. *.. .**\*.\.\. ....*... \*\*   .*.\. *\\*  . **. *.\.  .\ #
#.\. *** .*. * * *.*. * ..*  .\.*. ..  .. .**.\  ***\ ..\\.* ....*\*.*.. *\ \ . * .* **  **\..\* .\. \.*#
#*...\\..*.**  . *..\..  .*.. . *.*.\\**\.* .\  * .. *.**.\. ..  \ . . * .\  *\ .\.. \.....***.. * . .*\#
#* \*.  *. ..\.. .*\* \.*\.*..*.. .  *.\. *    ...*..\\.\ **  ..**\  *\.\..   .. *\..*..*.*..\.*.* ..*..#
#. .\ * .* *\.\** \.. ..*.***....\ .\.* . \ \.  .\  .**. . \ .. \*. *...*......*....\. \..\    ... .\  .#
#.\ .\  *\ \.  ..\   *...\.*...\**\ ... ..  .. \* .  ..  ..*...\.\.\*\ **  .*\   .. .\.*...*....  * \ ..#
# * .. .*.\  ***  ***.   *.. . ....  ***.. ** \ . * * *. *. .\ \.*...\. \ *  *.. \..*.    .**  .*\.\* * #
# * *.***\*.\ ..* **. .  .  ..*..\  \..\.\..... .*.*.\....   .* . .\. *** \  .   .. .\\  . .  *.. * .*. #
#\.*.\\.\....  **.*\\.*\...\* .  ..\.  .*..\.* * . ... *  .*.... \ .\**..* *****  \  *.. * ....**\.  . *#
# \\ .*  \.. .. .*..\ .*.**.*..     .. * ** \. . .  *\ . .*.  .. .*\\..\* .\. * *..\**. ........  .* . \#
# .\* ... . .*.**\.\ . \.....\. \\*  ..\.*.\.*.**.. . *\ *...  ** .\..* .  ... *..*.*. * .*.. ....*.*.\.#
#. ...   * .**\* ..\. *..\.\*.   \* .   \.*... ...\.* .. .*\..* .\* * .   .* *    **.... \*.. ..\ .*... #
#.*\ . .... *\..*. .\ ..*.\..\.....* ..*. .\ ...\   .\*\\  .***\ .*\.  ..* ... * .. . *.\ \...\.**\.\.. #
#*.*  .\.\. ..***.  * **.*. *.... *...*    *. .*  * \.** **...  * ... . .. *.. .\ .**\..  *\ \.  ** .\..#
#.* . \ \.* . \.\. .* \*...*. *.*...\ . .* .  *...\ ..\.\*. ......  *\.... ..*. .* *..\  \  \.. .*..   .#
#..\*. * \*.**.* **\* .\ .. * .*\.   . **. *\*.** .\ \ ... . *\\*** .*  .\. \.\ .*\.  **   ..  *.*\... .#
#...\ . .  ..**..*. ..* **\ ..    ..*. *. .\*\**.\*.*..\..***.\\..\.*.*.   *...  .. .*** *\.**. \*      #
#. .   * . ..... ** \ .\ .. . . .\ **..\.** ....\**. .. .*\*.. .\.  \. ...  ......\.\.\.*\.*.  \..* .*.*#
#.  . *.*.  **. . *...  * *...\* ...*. *.*. * . *.. .... *.* \* **.*.  .. \.***. .*\...  * ***..\ \...\.#
#** \\\* *.*..  .\ .\. * \..** *..\.*  \*..\ ..*\... . ... . .. .\**. . \.*..*.. ..*. . .. \.**  . .  ..#
#** * *..*..\*.\ ..*** *\. *.   . *****.* *.*.\.* * *.. . * .  .   .*\   *\ *\* .*   *\. ..  .  .  .  . #
#\* *.  ..*. .... *... . ...\\ .*.*.*.. **\*\.. * . *.\.*..* .\* .***.  ... ..\***. *.**\   .\ .  . *.  #
#**\.* ** .....*\ \.* .*  * *...\ ** * ....** \..*  ..****.  \*...\... .   . ...*.\ .\...**\ . *\ .*\  .#
#.. .\..*..*** .. ....\*\.....** .*\**.. .**....**  .*.\.... \ .\   ..  \.\. *... . .*..*...*. * \\*..\ #
#*.\  . .  ..*..\ *.** .\*\ ** . *..*** ..**. \*.. \..**     . *  \*. *. ** *.\.  *. .\ \\  .* . ...  * #
#*  *.*  *\. . . ** \..**....\ . . ...\. .\. *.. ...  *.  . .*..*.**..\.....  *\...\. .\ .*  *. .  * \.*#
#.*.....  .** \ \.. .. \..\ .\ * .  ***.*. . *... *\ ..*\*.. .\\.. .* .\. *\* **\ .\.. .  \ *.\\.\*.  . #
#.*..... . .. .. .. .\.**\..\ .* .*\... ..*\ .\..\**.  .**.***..  .  *  . ..*. .* *.... ... .* .. \  *  #
# * \.\ \\*.\..\.*.**.**\** .. \ *.*\. ...*.*.**. .*    ***.*..\ . ....\.*. *    **.* *\..   .   \.... .#
# .*... .\..**.. * ..*** \.** *. *   ... \.**   . *..*  *...\ .  . \. .**.*.. *.\**.\..*\  * *. *\.*.*.\#
#\ . \  .*...**\  .  **. .\ .  \*.*.  *.\..*\***.\ \ .**....*\* .     .***......\* \.**.  ..\*\ ***.....#
#. . .\. *...*.  *.\ ... ..*....*\*  .* \*..* .** *. *.*..*..*\ ..**. .\. *\ ..*..* **.*..\ .\.*.. ... .#
#.* * \ \...\.  ...  . .* .\ . .**.\. . .....*..\*.*..*.  ....\ . ...\.  . .  *.*..\ \**. . *..  .* \.\.#
#\.**....  \  * *.\ ..\ .**** .  ... \..*.** . \....* \ .**.\. \  * . ..*. *...*.* . .*.*  .\.** .  .* *#
#.* *.\...*.. . *\.\..*.*\.**  .\... . . . .\ *..  \* * .\\  ..... \ .* .**...  .*. .**\..  ..*.**\*\  *#
#**...* . .\     \.\*  \.*..*..*. .........  *  .  .*. * .. . \..\ . .* ...\ ..\ .\.**.* \... ...\*    *#
# . *\  ...* ..\*.* .. . .  ..*. . **  .* .* \ .* \.\*..* .\*. .\. *\ .  \*.  . ..*..*\.*. ** \.. .*.\*.#
#\...\* *  .  .. . * ** ... .*....*.*..*. **.\... ..\.*..\ * . **\ .*.*\. \ *.*.\*\...***.\ . .\*. ***.*#
#* *. \ .. . ***** .\.. .* *\.***\.\.*** \....  *..* ..  ..\. .\\. .. ** \**\**...  .. .\*.*  *.. * ..\*#
# ..*  ..*  ***.... ..*.. .  .. ....*. . .*. \\ .\. * . \ .    ..* *.*.......\..\*\*.\ *\*\*.** **. *   #
# ..\ *  .  .*.*    . \.   .\  \ *  *.. . .\..     ..* .. .  *..*.\ . ...\. *.   .*.*. *. .* .*...\*\**.#
#   . *\   *.. *  ..\\ . *. \ ..**.  ....\*..*\**  *   . *\ *\... .* .*\*.  .*.. ..**... * ..*.***. .* *#
#  *. .  *..\  \ * * . . . *.. \\*..  \.  .  . .\ .*\..  .*..      .  \*.\.. * *. . **.. * * .\...**... #
#.   .. ..\... .*. * *** ..*\ * ... **  \ .\ **. .\. *\*  .\. * .* *.*.*. .*  *.. ..\* **. *     ... ..\#
#** ...*..*.\ .* .  *.*.. *....  * **..*.\ . ..**    * . \  .\.  . **.  . ...  .  \ *.*.*. . .*..* .\*\.#
# ..*\.  .**.  *. \ .. ..\.  *. *. .****\. \ \    *... .\ .\. *\  \..*....    . ..  . . ** .*\.\..*\*. \#
#. *.. * ...* ..   .*\. .   \*. . .\.*.. \.  .....  .\*..\.*\ *  .* *\  *\  *\**  .  .  .*.*..   .\.. ..#
#.. .. \ ..\  . .\**\ *.\. ... \.* .....\*\ **  * .**.. \...*..** .*. ****.\.*** * ... * . . *  **.   . #
#* .  *.  . . ..*. **\.**  .\ ... \  . * **\.  ***\.\ * ..*\ .. .\.*  *.. .  .. \.*\   *.*   .\  . .... #
#.   **. *.* ... \.*.**.*\**.\.*.. .   .*.*..*\.   .  \*...*.\ *** ..\ * *.\*..  **.*\**.. *\. . ...* *.#
#  .*\** ....* \.. *.*. * ** .*.* ..  .*..*  ..\ \** *\*..\..*. . \ \ ..... *.  \* ..*\.*  \.  .\*\ *.. #
# *..*....***.*** .*.  .. ..  . * **. *.*. ..*\.\.*. \... .  \*.**.*.*...\.*.* . *. ..***.   \ ....\*  .#
#*. .\.. *\.*. . . *. * .*. .\ .**..\ .... **. ...\.. .. .*** ***. ..\ ..* \ ..*   * *.*.*.. .*...*.**..#
#*\.  *\ .\\.*..  \..\* .\*\\  \. \.* \.....*****.  ..\ . *.*\ .*\.*\.\  . **\ . ....\****\   .. ****.. #
# .. . .  . *.**.\*. *   *.. *\.\ . . .*  ...\*\. * .* .. ...* . . *. .*.\ . .* .\  ***..*..**\.  *\.\..#
#*. *..**   * ...*.. . ... ...*..        *..\.\*...  .\* .. ....\ .. ..\* .* .    ..*****.. .* .*..\..  #
#  .**.**.* .* *..\*.* *.\.\  . * . \.   ** .\*  \ .*\ . \ \..\**   \  ..  .**\.**..*.... .*... .* . * .#
#  * .. *. *.. .\\ \. ..  \ ..  \*\* .\ ...*. \*\.. \. ..**  *..\ .    *\ \\ . *.\ .*\ *....*.  .**. \* #
# .*.*\.* . .\. ... *.* ...\ .....*.*.. . \.. .*...\.   ..\* . \*..*.*.*.* .   . * *. .......   **..  . #
# *\ \.. *\ \.    \.**..  ... \*\ \.* \**..\ . . .\ \..   ..   **\\.*..\\* \..\ ..  ..\...*\ * *. .\\\\.#
#..*\   \***.*. *.. .* ...\.. .\ \. . .*.* \.      ....*.. * * **. *. .**.  *. .\*...\. ... .. * .*.**..#
# *\ .\ .. ..   .. \ .*. .   * *.\.\*.** .* **..\\.\ *.. .  .*...  ..*.. .  * . \. .\.*.*   .  *. .*.*\.#
# ***..*.  \. * ..  .\  \..***   ..\.*..*\.\..* .. ****\ \*. .. *.* *...\*\*   ..    *. *.* \...*\ .*.. #
#*..  ***\.*  . \  .* .\.. .\***\ *.\..\*.** \..\.\..\.  .***.*.... . .\.. *   * .. ..   **.   .*  . .. #
#\.  \ \  *.  .*..\.\ *. .. *.**. . *\  ..\.. ** . *..\ . \.. .*\..\  .**\.*.. .  .\* ****\ **. ** *\ ..#
#   .. .   . .*.\..\* . * ...***.  .**.*  *.. *. \.*\...\* .\** **\ .*.** ....*.\.\.* .**.. *.*.*\..**.*#
#.*\ .***  ..\ **\.*\*.*.* .\*\.  . \**. .. . * *...*\.\\.. .\\..* *\.. ..* \.. . . . *...\**** . .\*.*.#
# * ...\*\ *..*.*.....*\ . ..*  \. . \\*\ \ * .* *.*\*\*.*   . *.\*. *. *.. **.\ ..\  **  *.**. * ... **#
#..\ *    .. *. *.\*.*.*..\ *.\* \\ ..** ... \\..\*..*.* .\. **. .*  * \.**\* . *. **\..*.**..\. . *\.. #
#  \ \.. ..\ .* *\ .. ..\*.\. *...\.\.\*.*  \.*. \.  ..\.. .*.. ..\   \. *. *.. . .**. .\ *. *.\*  ... .#
#\***\ . \ .\\. *.  *.*\*\.\** ..  .   *** ...\.. ...\.  * ** *.* ..  .*\**. * \ * ... \.*...\ ..\. **  #
#*... ****  *..*\*. \....*....*\.  *.\ \..\.\..\ \.\ \*. \ **... \. .   **\. .  ..*.\**. ..\**\ ... *. *#
#.* .*.*\*.**\..*....*.\.. \.. .***...... * *..  *...* \ .**.  ....* *\... .*.\  *. \*..* .***   . *\\ .#
#*.\*...  **\ .*.\\ *. ......\..* ... . .   **\..\*.*. . *\.\.*\.*   *..\* .*. ... *.   *. .*. .......\.#
#\* **...  \.**....*... \ * *.*\.\* ..*\** .*.....\ .*\ *.* . ....*..**. .. ......\. \  .*\ .. \\. ..\**#
# \..  .*. *.\. ..\.. * .. *.......* ..*..\. .*\.    ...\*...\ *  . **..\*.... ..\ . *. **    ..... . .*#
# . * .**.  * * **.. ..   .*.\ .\ \.*   \*.  *\**  .\*\...*.\ *\.\ *.***..\ \  *.\  ****** ..     .\. *\#
#**.. \ * .*.\ *\..\ *\\.*.. **.*.. .\.\. .\.*.\.\*....* ..  .*.**.\** \\*.\ .***  \ ** .*..\*....\.*\\ #
#.. .\ \**..\..\.\** .***.   \*. .\  .\...*.\* .*.*.  .*.***\..  .   *. \.*..*..  \.  *.... **\  \* ..\ #
#..  .*...**..... **\.*.\ * ....  * \  *.  \*.* . .*\  .*.\ *.\*.* \.**. \.*... \..* ..     .\. ..*  ..*#
#*.  *.. .*.* ..\*.** ***. .\ .*. .   **.  * . .. *. .*** *.*..\.. .... *....* \.*..\  .**. *.. ... . ..#
#\** *\.*   \ . ..\***.* \**.  \* .**... .*\ *. .... .** *...\ *.\.\.\..\ .    .. *\.*\  ....\ ***. ** \#
# *\ .  *.* .*\  **..\.* \.*. .... .*\ \\*. ..*. ***... .. * *.*. .**  *  ..\\ \.*\.\... \  ****....\. \#
#... * .. *\..*\... *.\.... . \.*..**.* ..*\*\ \ \. \..\ .*\ . .*\... . **.* .. \*.*..\...\*.*.***.  ..*#
#\   . *  ..*.. .* .  *.\.\ \..\... ..*..***..**..\. **.. **\..*.*  .  **...  . *.  * ..   *..*...  *. *#
#.*  . .\ .\..  ... ..*.\ .  ** . *. .* *.... .\. * *.\ **\*.. .*   *\.\* ..* * .*.\ .. .\  \  .\*.*.***#
#\.* \ * . \ \ * *\\*.*. *\**. *. . \*. ... \  *  ... ....*. *\.* \. *      .*....\.* .*.*\  \. .... .**#
#...\.\..\ .. ..\*  .\*\**\.**\*\ * *.\ . .*. \.*.\   \. *** ...\*.... *  \**\** \. \  \ .* .**....*\...#
#\ ..* * *  \*.\..* ...*\* \..* *.* ... *\  . . . .*  .**.....* **.*   *....**.. ..  .. \.. .....* ..  .#
#*.*\  * *.   *  .*.*\ ..*\.***\\ . .\  *  .\. \   *.   .*  .   * .\ .\ ...*.*.* *  *.. .. .... ..   * *#
#*.**... .  . .  \..\* * .* *.. .* .. \*..  *.\.***. * * \. .. \.* .. .*\**..*.  \. ***  \    ...  ..***#
#.*..\**\*.*  \ .. ....\..  *..  .**\\\ .***.* \.**  .   ..  .. \.  .\\ ...* . .*.\.... .*.  . .\.\ \ .\#
#*.. .*..*..**\****.   . *. .\*  *... ... *\.*  . . *  *.\*.*\...\ * ...\   \..\*.. .*\. .\*\.   \ .....#
#* .*... * \..*.. *  .**.**.\.. ...   .*.\*.*..*.. \*.*\.*......\*.. .*...\..   ..\ \ .\**    **.\*\.  .#
#.\ *..... .*.. . *\..\* *.. .*  * . \ *. *\. * ......\.*..\\\\  ... .\. \*.*.\..*. .\ .. .*\ \*. . . . #
#\ .*.*  ..\   *..\ \ .  . \*.*\..*\....\ * \.\ \.. \...*\.**   ..*.*.. * *..  \ \. .*\.. \* \.* \.*    #
# . \ .\*.\.\*.**  .. \ \ . .***\...*.\*.\  \. *.  *.*.\.. *..***..*\  ..  ..   *.\ *.\*.** . .* * ..R.*#
# .. .* .\\...*. .. .\.\. * ** *.*.*. ..**. ..\. . \..*. \ .. .*. .*  .*..* * .**.* . *...*.\  ** .. .**#
#* **\.\*.\ *. .\*\.. .  ..*.*\....    \***\***\\\.    *.*... *.   . * .. ..*\*\...  \*\...\ * \. \*.\*\#
#.   * *\ .*\*. . .. **\... \.*   \. .  . . \..* *. \  *.\ **..*\.. *.**..  ** .*. .\ .\.. .\.. . \. . .#
#  . ..* .*. .  .\ ..\*.** . .\.. ..  . *\ .\\.*.*.* *.* .\ \.*.*. ** ..*\.*.* .. .  . * *. .*. ..*. ...#
#**  *.  .   . ....* . *\ ..***\. .\ *. *.. .\. .. .*\*** *..\...  ..* .\ .\*.*\.\  ..*.*.** ****.*\.  \#
#.*.*.\ .** . . .\**..*.*...\ ..   **.  *\.*..\.*. . .*\. *.   .\ \ ..* ..**. . .  *  *\...*\.*.. ...\ .#
# . . . *.* *\ \* *\  .*\.\..* ..* *.*  .**.*  .. * .**\.*. \.\...... * *****.\.*\ .*...\. *.  . *\   ..#
#..*..\ ..* *.* ..***...**** * * . . \..\*.\***.* . ...\* . ....\.  **\ *..*\.***. *.  \*  .  *\** *   *#
#\#.  .* .. ..**. .*.*\.*..* .*.   .*.*. .. *.*.   *  ... ..\ * ..\ ... .\ ......* \. \.*... .. ..  ***.#
# * *. \ ...\.\...* ..*** *.\.*. * ****.*.  . . *\ *  **.. *. .\.\* .* .\....\*..\ . .*\.*   .... * .*\ #
# ... .* *\*..\ *\. * .*  ..\ .* ..*.\* .**. . .*.*\.. *.. \*.\ .*\*   ....\.  *    . .* . .. *\*..  .. #
#. \. .. ...  \ ... .  *   . .*..*    *...***.  . . .*.* ....**... ..\   .**\ *...**\  \*...\* . .  .  *#
#   ** .\*   .. *  **.** ** \\*  * . .**.*.....*.*..*..... *.  ..\ *.. **  . .***.....  *... ..\.** .*\*#
#.*.*\***  *.*\.\  .....\   .*.  . . ..**..* * . \*. * .  .*\ \***\.* *.\..*\ .\...*\..* \....*. * . * *#
# *.\...* .*.. .* .*. *     .**** \.\ *\  .* \    ..\.*. .  *\.*.\*.. \\.\ . *..* *.. \..** ...*\*\* ** #
##..* .*.. .*  \.*.\ *.   .*.....\   *. *. .\** ..* . * *\. .  * *.\ ..\.  \ \* **......***.*..\**#..\.*#
#* *.\*.\*  .*. ..\*\. \ ...  \** **.. ***  .*.\ ..\ *. **.\*\..   .\ . *\ ....*..* *** ...\*  .*.... #*#
#. .. \ \**\. . . *.* .*    .. .\*  \.....   .\  . ..*.* .* *. *.* ....... .\*..*......\.  ..*..*\.   .##
##. *.* #.  *  *. .**. ..\*  ** . .#.*. *\.. * #*. *.**.**. .\\.*\    ..** ..*... *   ..*.\ *.\.\*.. .\ #
## \\*. *   ..#.  *\.****.\ **  * ..*...*  .*****. .\ .. *... * .\. *.  .  * . * .*\.. \. .**..*\.* ..#.#
##..*## .#*. \#.*.*..#.\. \..\ *.   ..  * \.*.... *.*..... *.\. *  *..** .\. *.**.. .\.\*..*# ** *\. *#.#
# ### # # #**.*..  *..  *. .\..* ..\. .\ *. .#  ***\.. \..\* **\  ..* .\# .. .\* .**   ... .\ \*.*\ **.##
#      #   #####.*\    . ....\. **.* \ # .**. \*#\ *  *..\...... .* ..... *   *\  ... *  .* *#.. . .*\*##
#             ## *.*.*\ .\.\..***. . *\. ..\.*.. \..*.*\\ ****\\ **\ .. \ . .\.\.\. \***. .***.\ **.\*\*#
#            #. \. .**.    *.. . . *  *\\.\* ..\  . ..*....\.. ..*. .*. ..*.  **\ .\ **  .\*. **.#***#.*#
#             #.#*. .**\.#..\  \** \...**.\. \. .....**. .*. *\*\*. \ .**..**   .  .\\.. ..*... ###.# ###
#              #.* *\.**...\.** \.*** \.\... . . .#. .**#**.\...\...#.\ # .** . *  *. .\.  .. .* .#\#   #
#               ##\##*.. #***...#...*L#*. *. ## \..#. ###.*.. \.. * *. \..*. \ .. *    **.***\*.*.##    #
#                 ##*.. \.*....\. *.. \*.* .\ .\ ...*##.\*.. *##\ ...  .  ..\.* \**\.\ *. .# .\**\#     #
#                  #.\ # . #\. .\ **..\..# *##### **.*#\** *#\#\..\. .*\*.***.. . *#\* **#\.\.*. #      #
#                   ####.*\.* * . *** #.##*#     ### ##..##*## ###..  ##. * #\ . .#.#\###** # ##\#      #
#                      #\#####***##.###.# #        #*# ##  #    #\*###  # #\  .*..# ..*.#### *# #       #
#                      # #    #.#  #   #            #            ##    #*....*  *\# .\#.#  #*#          #
#                       #      #                                        ## *.*. *##### #    #           #
#                                                                        # *#* #. *#                    #
#                                                                        # .\#  #..#                    #
#                                                                         ### #.# #                     #
#                                                                              ##*#                     #
#########################################################################################################