##################
#             #*##
# # # #   #####*##
##*# #.L## *....##
#*..\#\#.\*\.....#
#..#* ... .*..*#.#
#.*#. *.\  ..*# ##
# . *  ...*.\. # #
##*.\.*.*\.#*  *##
##.*..*...\ .*..*#
#\\ \ ...   *.*.##
# * .\. .#*\*.**.#
#\.*.* . .* .\.*.#
#. .* .**\.* *\*\#
#.\.. ..     ....#
# *. .\.\ \. *   #
#.  *  *R..\*...\#
#\\\ \.*..**  .\.#
#... . .*\**.  *.#
#*\.**\ *.....***#
#*.\.. ..*. .*...#
#..    \  .* ..*\#
#*  \.\*.. ..* **#
#. . * \  *. **\*#
# ..\..*.  ..*  *#
#*\. \*..\ . .\* #
#..\ ...  .  * * #
#.\ ..\. .   * \.#
#\ .  .*. \..**. #
#  .... . ..\.. .#
#\  *. ..** . .* #
# *.*\ \ \.* \*. #
#  ..*\*.\   *.  #
#.**.***  ....*.\#
# . *.    ..\.*..#
#.\..* *\ **.* . #
#\*.   \ \   .\*\#
#..  * * .\. ..*\#
#*\ *. . .*.\ *.*#
#.* . ..\**.. . *#
#\.*  .*\. . .  .#
#*.*....*.. .\.\ #
#..*.   *.\ . .*\#
#*..\*.*.. * .**.#
#*    \.*.\** .*\#
#  .\    .\*  ***#
#\.\..\...*.* . .#
#\\*\.*\* ..*..\.#
#.**.\.....**\  *#
#.\  .\. *....**.#
#... * * ..\ ... #
#... . * *\ ...\ #
#.. .* \ * \.\*.\#
#*   *..*.*. *  *#
#   . .. \....\  #
# *..\ . ...*    #
#.** **\    .***.#
# .  .   \. * .* #
# .  * \.. \. *..#
#*.. .. *. .*.. *#
#.. ****.* .*  ..#
#\* .*.\.*. *.** #
##################