############################################################################################################################################################################################################################
#       #. .  \.\.\.       .\ \ ... ....\  \*   **\ ..\* ..*  \ *      *.... ..\\..*. **  .*......\ .\ . .\.\***\* **\*. .  .\ ..*. ..**\ \* *\.\.\. .   *. *****.. . \.\    *\.\   .  .  ...* .*..\..\..\.* ..\.*  \  ..\.#
#        # .  .**.  \**.  *  ..... * ..... . \\..\. *\ \ ..*... *  . . * .  \..*\*.. * *\* .\**.* . .*.. . *.*..*.*\...*. *\ .  . .\...*\. *.... \..\*.. . .**..\*\  *. * \.** .*  \ .. ..   *.*..... **. ..\ . *.*..\\ . .#
#         #. . *..   ..\. .*..*\ .. ..*.* \ ..  ..  *..*.*.* *  . .\. **\...   ... * \ . .\. *\.*\ * \   *\*\ . .** ** ...\.. ..*    *...\ *.*  *  .*\.*\**  .**.*...\.\* .\.\  \.*..\..  \.*..\. *.  \.**   .**.. .*  **\.#
#        #*.\ ..*.. ..*..\*..***. .. .\..*..* *.  .*......*.\...   .\..\..  ..*\. .*   .**.\*\**.. .....  . *.  *. *\*.  *.\. .\     \.   .\**... .*. *.\\ .. **.\* .*\.. .\ . *. .*  . *\. *  . **.**  \. ..\*. .  . .\  *#
#        #**.   ..*\.* .. *. ... *  ...\*.\. ..* **\ . *  .  *   .*..\..* . . ..   .......  .*. ** .\ .     *. **....* .*. * .. \ .\  * .*  .**\ . . .   \..* *\  . *.. .\*.**\. *\* \ ...... .***\... \...\**.* * ..**. ..#
#       #.\**.** \\..* \.\ ..  \\.  *  *..* *\.\.*...  . \\\.* ...\  .\\*  *  **..  ** .\.*.* .\*.  *.\. .*\. .**. *  \*.*.\ *\..*\**..  *\. .  .  *  \* .  *\...*..**  *..*.    .. ...*\ *.\\ *..* *.\.. **\.\*. .\ ** \\*#
#        ##.. .\*# .* \   * .  .*.* .*.\ *  ..\. ...*.**..*.\. \. .\....*\.. ...  . \***..*  \\**\.\*.*.\*. \ .\.  . . *.\* . *.\..\.\.\..*.*.\.* *\.   \ \.. *\ *....*.\  ...   *..*\.*..* \. * ...\*..   ..*\*.\ ...* .\.#
#        #\ * ***\ .* .\* ***.\.. ...*  \. *..* \ \** **. **. ...\  \ .\ .    .. . . ..\ .\*\..**. *\ ..\ **\* * . \*.\.*..*\.. .*\*.\ .*..*..  *\  **.*\.\   .* *    .\  ..\.* .. ...**.\**.\   .\......**.   .\.. . . *.*#
#       ##..*\.\.*\*.\****. . *\ .*.\\ ** \\  ..   *  * ..*..**     \**.***... . *..  .\.*.* .*..*\...  .\...\*  .\.\*  .  . *\*..*.**  ..*.*\.. *  **. . . .* .\**\* *. . ***.      .*\.*  \. \.. ..\*.**.*.*\.. *.. ..\  #
#      #*\ \* \* .. **...\*.*.. .   *  \..\*.**..\*.\.\. .. .*\**.*....**... . *.    .. ..**.**\.* **. ..  .*.\* .. ..\. .*  \.. .* *..**...* . .\.. . .**\. \ ..\   ...\.\.*. .**.\*.*..**\..*. ** \.\ .\. .. \\    \.\ * #
#       ##*.* ... \    ..*.... *.\*...* \..***\. **.\****.   ..**.*.**. .* *. *.   . . .......... ..*\. .\  .* ..*   .***..\*  *\ **. ...*. *. \ .  . * .*.* .. *.. \  ..  ..  \.   . .  *.  .. ..\. . .*.. .. . \...*.* * #
#       #* ..**.*   \*. **.*..... *\\..* *.. *   \*..\*\.  \**.. \..... *.*. .. .*. . ..   \ *\ . .  .. .*.**.  ..  . *\.\ ..\ \..\.*.  *.\ ..    *.. *  .\. .\.*   .  ...*.\ ..* *.  * ..*. \..\* *..\ *  .**.**..*..\. .*#
#       #\ .*.* \.**..  \*.*  .\  .*.*  .\*.*.* . ..  ... *.* *\*.*.*\ *...*..\.  **. .*..  .. .\ **.  . . **\.* *.*. .\*... .*\.  *.\ \.\ *. ** *.   .... . * *\. *  ..  ..\.... ...\. *.. .\   . .*\.\*. \.....\ .* ..\.*#
#        #\ .*. ....    .. *** .. ..\ *  .*  ..**.*. .\\  . *.****  . .... ..*...** **.\* **  *      .\   ..\. .*\.\.. \.*.\.*.*.\\.** **.**.*.. .*.  ..\ *. . . **\ **. .*. *  *  . .\\ .      ..\ ****   .\  .  \*.*\. *.#
#         ##\. . . *.\   **.*.. \*  ..*   .*.**\*  .  *\.. .* ....\.   \.\.  .. .*\..\.. . .. .*   . *.\.. ..\* \. .*...**.. . .  . .\ *.\.\ .\ .\...* .**.. ..*.*.**.  .*\  .... ...*.  .\    \  \.\.\\. *\. \*.  .* \   .#
#        #*\.\* . *.. *  .\ *  *   .* . .. . .. .\   .\.* .*.* *  . .*.\ *. * .\.*  * . *.  *...\ * .  .****\ \ . . . .*\.* \ .. \*... * * .*..\ *.*\*.** . **..*  ...\* .**. ** .  ..* . .* \* ****.**.. .. **.*\.**\. \* #
#       #\    \ *.*....** .\  .. \. .\ \ * .\*.  .\ .*..*\*.\. .. \  **\.\ . .\  *.**** ..**** \  . . * * ...\.. .  **\*...*. *\.*.*.  **. ..\\. . * * \    ..*..*. *\   \..* ..  . \*..*. *\...* . .....\.\ *. .*...*.\*. #
#     ### .. *\. \.\..... **..\. . *.  ...** . ..\. *\ * .\*.   ** .**\    .. .**.\* *.*..\...*.\*.\.*\..\ \  ..* *....\**\.....\. .*. .  . \..**.*. ..... .  .\..**  .*.\ \. \ .. \*..*\.*..*. .** .  *\.*  \.***   .*.\. #
#    #. #\*. *....*...\. ... . .* .\.\.*..*\.**.\  \\.*. ..\ \. ..   .*\.**.** *. .**.\.. . ..**   * *  \.\... .  .\. .  *. \ *  .. **... **.\ .. *    \\...*.**\*.\.*\***  \ .*\*\..\..*.*\ *   ...*. * .*. *\ *\.\.*.   .#
#  #  # *#   * .*\ ........**\. . ... *.\.* .**. * ..\ \   ...  \.* .*...\..*\*.* .*. ...* ...\.\\ .. \.*\.\.* \** ..* ..  *.**.*.. .\* .*...*.\* ..* *. *  . ..* *\.*.**\\. * .\...*  .  .*.. .*...* ..\..\ \...* *....\\ #
# #*###\.. .  *\... \ .*..  \ . \...*.*.  * ...*. ..\.\ *** \ .\..*.  . * .** * \. ..  .\**  **.\..   .*.***\... .  .*.. . . ..\.**   .*...* ....\*.* \ ..* . *** ...\*..\. .. *. . .  \ \ \ *\.** .*.* **..*\.  \..  \   *#
# #..   . .*.*.  ..*. \* ..*.. .    *  ** .\ *\\. . *  * ..*\ ** .\*.\.** * \  \...\ * *.*. ..*  .* .. . .\\*..*\ * ... *.. \ *\ .\  \*. \\ . *..\. \*..* .*.\\\.. *...***. ** .*.   *\....*  . .\ ..*.*...*.*.\ .  .   . .#
# #\.*\* . ....**\ *  .*\  ..\**  ... ..*. ..... **\.. . * . \.*   ..**.** . .\...\  * ..**   .* .. *... ..*.\ \.*. .* ..\ .. ...\  \..**.*\* \  \ \..\ . *. *\.  *. ..\... *. .\ \..\.*\ * *   .*\ .. **. . .\ *  .* ..** #
###*#\..\  ...*..*\. .*.\***.*.. .* \. .... *.*.*.. \  . \.*\*  \ \    **..* \... . *.*. ... .\  \  .* .*.\.*. * *.  ..\ .*.*.*\.   \ .** * ... . .. ..  \.* *.  .*\.. * .. *. ..* *\. ...* .\ .\ *.\.*  .  \  . * ..* .   #
#...*..   * .*.\ .. . . *.. ..  ... \. .**  *... *  *\*   *\ .*. ..\.***. *...*\ . \.  .. \.  * .   .\* .\  **..\. .. .*.\**. **..*   \ *\ \ ** . ... *.. *\.* * .. .* . \..\.  .. .. **....\*\.\*\* *.\.\   ... **\ ...\  #
### #\   .*  . ..** .\ *..  *  *. ..   .*.  .* **\ . *    . .**. **.**.*. .\. .. ... \**  .\ \\   \  *.\.*.\** .   *...  .* \*.\ .* .\.*.  .... .***...*.*\*.. \ . . * * ***.*\**    .*\.\.\ .*.  *\*.... *.**\ **. . .\ ..#
# # ###. *\. . . *.. ...*.*\\* .   *..    .\*.. *..* ..*\..  **. ....*.  ...**   . .\. .** * .*...*\.. .\*.\*. *.  . .. **\ *\ ..\* ..*\.* ***. \ *..  .....*\..\.*  .......*** . .\  \..   **\ .*. ..**. \*.*..\. *  *. * #
#  ##\.*..*  *** ...*. . .**  .  \ *....*. ...\*\*...*\.\... *\ ** \..  .*\ .\* .** . *. . *\.\  . .. . *.*..**\...**... .....* * .* **. . *\.*.....* * .**.***\.**\ .*.\  *\*. *.\  *.*\  .*. .. .. .*. .* ... .* ....... #
#   #*  . ***...\ *\. *.*\\**. ...\ *  \**\*.\*.***\. .*** *\. **.\.*  *  .  *....   .*.. ..** ..*\ \ \ .*. *.\  .*\..*\ \.*. .\..\* *..\ . *.  \*. .*\.\ * . . *...*...\... ..\.. .\*\*   ..\...\*   .*\\.\. ....\.**\. *\#
#    #.  ****     \* *. .. \ \**  .*. \**.   ..*  *.... .* *. **.\ ..\ \. *  *.* ** *\...   *. . .**.\..*\  .\**.... *\* *..*  .\ . .. *** *. * . \ .  * ..\*\.    .*.*\.\*.** .. .* *.** **\ .*...*.  ... .* .. ..  ...*..#
#     ##***\. ...\ .*. *..* .... *\..*..* .    *.*. \.  **...*\ *  . .*. ... . . *. .. \**.\.  .*****  ....\*. **.  ....\.*.\ *  ..   ...*..*.*.* \.*  .* *.....**.*\*.. *.\*. . .**..** *... *\  ..   .*  *. \   ..\. *...#
#      #.*.. .#.    .*   *.*.\*. ..  . ..*\  \ \*.  .....\.  **\*..\. . \ .\...*\ ..*  .*.\.\..*\*\*\ .  * . * \...\.  \**.\...*  . *  \*.\ \.\.*..*.\..   \ \  \ * .\ \.. .. \ .\...... . . **. *\   . . *. .\  * \. .*.\ #
#     #*.\**..*# .\***.* *. .\\ ..*.* .  .\ \ ...    \. . .\ .\ ... .*. .**.*.*.  .**   .*..*. . . .***.\.\  . ..\ ..* \ **\* \. *....**.. \   ..  . ......  \.* *\..* .\    . *..  .\  **\ **\ ** . . . .. ..  .\*. *\*  \#
#      #\#.* #**\..\..*\..\ *.\   .... .\  ..*  .*\**..*.. \.\.  .. .*\ *.... .  .*.\\\ .*. .\  \ . .. ** * \ *.\..\** ..*...\.\*.\  \.**  ....\..\ . \ .\* *... .*  . .........**\*\ .\ .. *.**\. ... *..  \   * .  .\*..*#
#  ######.\.# . *  *** \. \..\.\. .. . *. *. \ ... .** ..**.  **\ ..**... .  ... *..*.  **. \   . ****\.\*.  .  .. . .*\*...*. **.*.\.*.  .  * ... ** *. ....     *. .\ *.*  *.*\... ... *\*\.  ..  . *..*  **.*.** .*.*   #
# #.  ** \ ..  *.**.....*.* . *\**.   *.   *.**..   .* .\**..  *  \ .. \**\ *  . *\..*\\.\. ..\. ..\.. \ * . * \. . *.. .\.\..*\*.*. ...*  ...   *....*    .*\\.**\ \.*..  \.*\. *\*.*.  .*  * * ..\ **.**..*.** .\.*.*.  *#
# #. .. \   ..#. **. .**.\. ..\ ...\. ..\.\* .* .**   . .\\\ ***\*\ . * \. ****.*... \.* \. \..\ * .* * *\.  *.*\*\.*.\ *..* . ...\. **.. * .\ . . *. \* **\\ \.* ..*\. .    .  .*.**\* .  ...\. *  ***\ \*\.*...* *.* . * #
#  ##\ *...\ *  .\. *..\..* .. .  .. . ..  *\  ..*\. ..   ..\.*...\..\.\..**.\. * **.... ..*  ****\..\.*. .. . . *. .\.\..\.\   ...*....   * . **  . *\..*.*.*. ..*\.. .* .\.*\**.**\.*.. *.  ..    ..**\.*. .\**. .*.. \..#
#    #.#.\.*\#*\ *.   *.* * ..\.*\.. *. \  . ..  .*\.***\  \.*. *\ .. *....\ .* *.**\.* .. \...** .**. .\ \.**.*\ *.. .* ..***\....***\  ....* .*.  .* \..\*.* .*  *\\.\****.***. .\.\.\.**   \..*  \*...*\.... **.*.*.*..*#
#   #.*#..*. ..... * ***.. **...  * . *.  .*.* *.\. ** *  .  . ... .*.\..* .  .\..*** ..* .    ..\** .\. *.\.*.  *  . .. .  .. \ * ....**..\*** \ .  .\.* *  \ .\..\**\.. ... **  .   .. \ *\*..\* . * *... **.....**.*.\ .#
#    ##.* \.*.*..\..*\.. \ ..\ ..**.. \ *..* ... .  \..*  ..**\\ .*..*...*.*..**...... .*\  \ *. *.*. *  . * ..*\* .*  .. .*.. .*.**  **  \* .**. . * **. \   \****...\**. \  .*..\.\ . * . ...*.. .\*\. ***\***.  .. .*.  #
#    #\.. **  . *. *\..  ....\.  .... .*. .*.. * \.\ * . .\**. . ... .  \***\*.  *.* \ *  . \    ...*.*.* .** .\*.*\.**  *\**\..*. \ ..\*..**\**\\.*\. \.*.  ..*.... .  ..\. \*.* * . *.\. . .*\ * \.* *..*..*\. \  *.. \*.#
#   #\ .#...  *.\. ....  ..  *... .\.*.* .    \. . * ..\ . . . *.*   *  .*..**\  .\ *.** .*  \\  * *\ . * .\* ..\.*\ *. .*..\ ..**\.. . .* *...*\  *.*.   ..* ...*. .*..*....*. \ **\*...\..  \*.*  *** ****.***.. .*......#
#   #. .. *.. .*..  .*. .  * ..\...*\. **.*...\. .  \.*  * ..*.\.* ..****.\*... ...*\...\.* *... .\...  . .*.\  ...*.... \.\ .**** .* * \.*. .  *\. *\*\.** ..  *.\*\.\ . .**.... \... \.* .\  *. .. . *. .. *    \....\  *#
#  #.  * ..*.\*... * ...*. *** \   \..*....\..*\ * \....\. .\... . *\.... .* \*  . .. *\ .  .*.*..*..* \. **... .. .\**.  *.*\..   *..\*.*..\.\...*.\*..*\.* \ *... * .\...\..\ . ..*  . ....  ..\...\ .. .* *   ...\*\ * *#
# ##.*##** .*... . .   ..* \.*\.***. ..* .*  .\ .*. \ .\  \\..\..  .**.**.*.* * .*.**\. ..* . .*.\  *.***\*.. \ *\.. \.\. .*\ * \. * *.\....*.  *.....  *.*...\. ..... .*. . ***\.* .\.\ .** . * ..*\...\  .\.\*\ . ...\..*#
##.. \***   *\..\.* *.*\\. . \  \*\*** *\**.\**...* . *..\.\.\*.*  .* ******.*.. .....*. .*\  *\..\ * .***.  . .\. \  . \\  *\  **...*..***..*..*... \.*.\.. .*.*..\  * .  .*\*.. * \ .*.*\.*\\.* *\. .   \. .... \ *\\.. .#
##.*  .\\\. \  \ .. . ...  *  .*..\**..* ** *.*.*  .*\.\*.\ *..*.. ..\.*.  . . *. \...\. *..  *.*..\...**. .  **   . * \  \.. \*..... \*\**\*.. .\ .. ..*..* **  **.\*. *.. ..\.  .. * . . *.  .. .*.\  *..\  .  \..\.\....#
# ##.*  *...***.   * * \****..* . * *. . .  *.. *\  **\** *.**\.*. \.  . \ .\.*\. *..\**.* .****. *.***.****....*\ .*.*..   *..*. *.\ .*..*.*\  * ...  *\\*. ..\..* .*\*.\   \*   .  .*.\  .   **...\. *. ....*\. *.*...\ .#
# #*#. #..  **#.**\. * *.\\*. \. \.. .  .**\*..\.*\ *..... ..\*...... ..* \ .\ **\.*.  **. *.. . *.\ *.\.. .\...... .*\  ** .\*...\*..**.*.**.\...** \ *  **\ ..\*.***\.  ..\.* .  \**..*   ..\... .*. *.\*.   \   .. ...*\#
# #.# **.\ *\ **.\.  .*.*.\ .*. .   ...**  *.*.* . . .. . *  ** .* \ .\*.. * ...*..*.. \ *..*   .* . *.* .. * .*.. \ . .*   **.. .. * .\..\.*.*. .\.*. .*.* .. \*\* . * **.*. *..*\..*. *.  *\. **\*. \..\*. .\ . .   .\**\#
# #*  \*.##*  ...     . \.*.. **.  *\* ...\ \* *.**\.\.\ ** * .. .\ .*.\  ..  *\\**.  ....*.\ ..  *.\*.\.... **. ........ . .*.\. *.\  ** \  ***   .*\.*..***. .*.*.\ * .\*.. \*..  *\*\.....   *  . \..\ . . *   * .. ..**#
# #\. #.\*#. **. .\.\ *.*\* ...\*.**\.\*.*...* *\.  . . \..* *\.*.. *.. *.*.     *..\..\  .\***.. .*.. *..\*. . * * .  ...*..**  **  ..*.. ..**.\ .*..* .\.\  \.*\   .* . \*. ..  \ * *  . .. * .\. \.. .  . \ \*.*\. \.  *#
#  ## ##.\ *....... ** *.**   \ * *\**.\ * .\*\.* **.*\.** *.**\. ..*** .  .   *.. **. * ...\*.. .. *. .\\*.\  ..\.\* **.*. *. \*  \ .. .\   .\.  *..**\ . .**...   ..\*   . \* .  \*...  * . .  .. . **.\.   *..* ....* ..#
#    #.*\**..*.#\ \.** .*. * \.*#***\ **\  . .* ... ..  ....\ .*.   .  .  \. ***.* ... * * ... *\ \ . .. *... .\...*. .\..\..* .. ... ..  .\. ..\...\.* ..\. .** .*  . .  **\.....* \..  .\.   \ *. * .. .\*  .  *.\.\ \ **#
#     ##.#\## .####.**#\* .. ... \*.. ***. .* ** \\ *.\*.\ . .*.*...\  .. ...*.. \  .*.*\.  *. *.**..*  .*      ****\.\. ***\. .   .*..*  . *\  .\ .** \**... ..  *.\* *  *\*  \\.\      .*. .*.*. *.. .\  ** .* * *.*\ \ *#
#       ##*##  .##***#\. \.\\ ..*.*..**.  **.\. * .**\**\.*..\.\ . .. \.*.  .... . .\ \    .\  ..  . *\ ..\.\.. .*.\ *.\..\... .\ . \  .\* ..* . . *\*..*\**  . * .\ .*.*\.. \. \. * \  . ...\. *\   ** .*\*.\ .\. *.. \...#
#        #.# ###  ##*#*  .#*  *\. .* .\ * .. *.*.\  . ..  ..  **\ .**   .\ \.**  *.*.. ...*  .. .\   . ..***.*\  .** ....* .*\* . ... .\ \**. \..  \..\ . .\\.\..\* . . . .\ **  .**   R   * * * *****..*. .\. *  ..*. .\.\#
#         #         # #\ #\\*.*.  \*\..\.* .   . *\ *.. *\*. \..\....\***.*.... \..*.\.. * \  ..\.*  .\*.. . . ** .. . ... *.\ \. . .*.. ......  \*..  ...   \.\*.\. .  ** *.**.. *.  \ .. .   .\ \.\.. .. ******..\.*\ .\.#
#                      ###.*#.. ...#*  . **\.*.* .* \. \  .\*...*...*.*.\*. .  \.  . **..... *\  ** .**\.  *  .*.    .   ...   . \.**\ * *.   * ....**..\  * .  ... *  *.\\.\..  *..  . ..* ..*.. .*.*. .  *.\. ****. .. * #
#                        # \#*\*.*\... *  .* \ ..*....\.  . .\\.\. *  *\ *.*.\....** ... .\..*.\*.* **..\  * \.. .\ .\* . .\*\ .* . . *. .\*.  *. \ ..\.  *\.  ..*   \ .**... **    *.* \ .   .   *. *\\..  . ....*.\*** \ #
#                         #. ... \ *.\.\..\.. ..\.. **.. ..*. *.\\* \...*. .* *   *\**..\*  \.. * ...\. .\*\ **\*\ *.  .  *.*.\.   ..\. .    **. .*.*   \... .*.*. . .\ \\ *.\*.\..*  *.. . *\* \*.  . .*\***\. .\. ..\\..\#
#                         ##.\  . .*..  .  .****.   *..\ *.*. .  ..*..*   . .*.*..\.*\.\..\*.*\*  .\. *\. \ .*.**.*\. * ..\..\\..*\* ..**\.\..*.*.*.... ..* . ** .. *.* ..\****.*.*\.*.. .  \....**.\*.\.*..\     \*.  *   #
#                        # ##**\\. . ..*. . .*\.*..  .** ..***.  . . *. \ . .* .* ..\.**\.*\ ...** .\.****.\ .** \.* .* .****.\ . *\ * .. . *** .\. * .*.*..** . *....* \.\.\*.*. .  *..\..\.\ .**\. \  ***  .* ... *. ..  #
#                        #*##**  .*.**..  *  *.....   .\.. . ..  .. .*. * .\*..* \. * ..* * .*.*.* \ ***...*.. *\.\.* \.. \.\ ** *..\.\  .**... *  *. ..*. *.  .* . \..*.....*. *\. ...\ .\.**\... .... \... ..*    .****  #
#                        # ##... #. \  ..\*  .*     .\ .... *.. * *\.* ..\. * \.\. \.\\ .*\.** * *..\.\*   ..* .  * **. .   .*...*.* . \* .\****** . ..  ...*  **.. ....   \ *...... *  * . **.\ . *  *.....\\.*\. \....* .#
#                       # \** * .# ... *  .** * * * \..**. *. .\.. \.*\*   ..*..\..\ \   *. \. **. . .** .** .**.*. ..**  \. .\.\.*  .*.*  ***\   .  **. . \  .\...\  . *\*. * *  ** .\ .   ... ..\. **.\\ **.\.  \  .. * .#
#                        #.\#\. *\ .\  *  .\. \*.. .\* .*  ... .  . \.**\ *...*.*****\ \  .\.\ * .  **..  .. *....*..**\*\.\.. *...\* *  ..*.\  \.  **.\ *.. .  . ..*. \.*.\*\\.  \*   \*  \ \\ * *.*..\  ...* * * .. \....#
#                         #..#  *..  ..\ .  \ ..  *\.  *. . ..  .   ..\.. . . .*\ .. ....\* .... *.... \ *. .****.* ......**.\ * \* . ..\ *. * \\*\ ** .\. \*. *... ..*. .. . . ** .    *  .  ***  *....* .* .\.  .  .. *  #
#                          # #*\.. * . .#*  . .***..\...* ..**.. ..*   ....   ..\ ** *\  *.\  ..***\    ** .**.\*  . *. \..\  ..\..\   **\.. \..*.\ *.........\ \ *\**.. *.. .*\...\    . .\.*\.\\.....\*.\  \. .*.. *.*. \#
#                          #\###..*  **  *..  *.. .\. . . . .   . *.. ..* *****..*.....     *..\.\* *.\*** ...*.\ * . . ... .. ..*. **\*.*.*\.  . .** . .. .  .\....\ .\..**... .\ .*. ...    . *  * * *\*\ \  .*\  .*. ...#
#                           #   #.*\ *.*.** \*.\    . *    .  * .*. \.*.*.\...*\****.*\ .*... ***...*.*  .** *.\. .  .* ..  *  *.. ... .\* \. .\.  ..* . .   ** \.*....   .. .**. \..    . .\\.*.*.. . . \. .  . .  *\  .  #
#                              ## ...*. .\*. . .\*.  .*  .\*.  *.*. **... *\. \..*..*\..\. *\...\. \..*   .\\**. \  . .  **....*. *.  .   .. ..\.\ \\***. \. *.\ .*\\..  ..  *\**.. \*.*. * .  .*...   . * ..\    .\...\   #
#                             #.  \\ . .*   \*..\.\ ..  \\.\  ....*. .. \ *.\.. *.***.*\ . ....*.  *\.*.\\*\*.*..*.  . .  *\ .....  . *** .\ *  \*.** .\*..* .\ \* ...* \\ **\...\** .\ .. .\ ...*    .**. \.* *** .*.   ..#
#                           ##*.#\  \ * * ****\*. *.* .\.*..*   .. .\.\ \ *\*.*. \ .\ ..\  *\ ..*\ * *..**.**.*.  \   .*\ .. *  .. **  *.\.* .. *.*.. .*\*.*.\ ..\ \ ....*..*. .**.\ ...\ .. *   . .. *...\.*   .\  .  .   #
#                          #...... . *. *..\.\ * ..*.   *....* *  ..**. .\**... *.     .. .. .  * .* . *.\ . .. **** .. \...  .. * .\ * . .. . .**..* *.  ** *..\ . .*\  *.\.*....\. .\ .**.** * ** . .\.** . .  *.. ** .\.#
#                          #...#. *  .*\**. .* .  .*\  *** . ..  *\**. * .**..  **.* ..**..\\  ..  .    ... ....**.* *\  \..\ \    ..*.\. .\ \. ... .\.  .*.\*  .... . * *  \...\ * .**\..\ *...\..* \  . .  ... . .*** ***#
#                           #\.# ..*  **. .\.*.* .**.\* ... *.* *. .\.\*. ..*\. ...\.*.. .. ....*\ .\.*\ *  * .\*\. . * ..\\. ..*. .\.*. *.*.. ** \ .  .\** ..* * .  \\. .*.  . *.....\   . ..\ . \.. *.*  **..   *.. . .*\#
#                            # ..  .....*\** ... \.  *.*. . *.. .\ .* . .  *.*.*    .\.*  .\. ..\.... *. *...\  ..** *...*. ..\*. .*...**.**\. .\*\ *.. *.*.  .\.. *. .**.. .  .\*    . ..\  *..**....  .. .*.    ** .. ..*#
#                           #  \**.*  *\. .*..\*\  ...\.\ * *.. ..*\*\..* ** *.*   *.  * \ . *..\. .. ..\\.*. . .\*.**.\*.. *  .. .  ....  ... * .  .*... . .**  ...*...\\ * .* *..*.\  ** .  ..**.\  .\  * * ..\* *\ **\  #
#                        #  #\*# . # .*.***.. ..* .\.\.   \..\.\ \...***. ***.\  .   \.\ .*.. . *.  **.***.. *.. .*..*  .***\ *\.. . **...   . . **. *.  . * **\...* ..*  **. \*\.\*** *... ..* .. *.*   .\..\..*\*.. \ .**#
#                       #\##.##  .\ ...\.*\.. ...\  \*\   .. *.*\*\ ... .  .\ *\ ***\ .*..***   \ *\. .\. *\.  .**...*\..*... .. *.***\  *\.\*\*\.. ..\. .**.\. . **\.**   .\..\ . *\ \  .**\..  **..**. . .. ** *. \*..***#
#                       #.*. **  .*.*.   * .. . \...**   .   .** .\*  **. *.*\.* **..* *..\*\ *\.... ..\. . *\\*..**\..***.*. .  .* ...... .*.... ..* **\.....*.  * ** .\  **. *  .*...\.*. **.* . .*.\. *\.. .\  * .. .*..#
#                        ###\.*.# ..*..* * *..*.... ..*.\\**. .. *. \.\ \..\.  * ...** . * \* \...   \  *.   * \* . \.**..*.*     .   **.\ ..\ ...* . *..*.*. ** .*.. . .\\*...\.* .     *\ ..**\..\.\.\...*  ****\ ..* ..*#
#                          #* . ...\  \.\.  .*.***.\ *\. .*\  \**.  .**.. ** ....* **** .**..\\*..*.\*..\** .* *. **. .\ *. .. . .\ .*.*.  .   ...*.   \ .. **\.. *  .. * **...*.\    .*. .. *.\  \.\.*.. .*..*.** *. *. .\#
#                           #.# * *  *..\   ** \ . ...*...   * * \***.. **\.**\* ..*... ..*.. . .... ..  .\  . * .. *\.......* .* *..*..\  *.\* ....*.*.\ .***  * \ *   . \. ...\.. \.*  \ \ .\ .  ....\   .. ... ..  .. *.#
#                            # ###\*  .  *\*.*\\.  *. . ...*.\ *. .\*.. \. *.  .  ...*  .*..**..  *.  .*...*. *\* .  .. .*\*** .*  * . ** . *.. * .*... .* .\. ...\ * \   ..*.*\..**......*..   . *..*. \\    *.*  *...*\.*#
#                              # .***  \*. *.**.\...  .\ . *\ .\.** \   **.*\ .\ .* .\ . . *.   **. ** .***....\...*  .* .*...  * \**.*..   .*.\*  .\.  .... * . .  \\\*.\  *** * *.\\ *.*.\ . \ \. *.**. .\ \......\ *** *#
#                             #.* \.\ . .\.. *. ..   *.**  ....\\. ... ***\.* ....*  ...*  *.\.*.. *..  ..\  ..* . .*.\.* .\*   * ...\*   .\...  ...  .*.. *.* . * .....**  .   ..**** *\. * ... .*.. *. . \..*..   ..* **.#
#                             #*.. .*\  *.\ ..\*  .  * *.. \ . .**\.\....  ..   *  \**\... .... ....***. ...*\..     ....*.*  ..* .*. *  *.*  . **.*\ \.....\*.\\.. **.......**  \*.*.\*... *.\.\...  *  *\ *\**\.*. **....#
#                             #.#. . .#\.  * \ .\\ \ .  ***..\. .\  .* * .** *. * ...\. *\  *.*. . .\..... .* ..*  .*\..\..\.*  .**.... *... .\..\.  **.** \.*.. \ ...*. *..  ..\ *.. ..*.\. .**.*  .\** .. . *...\..* ..**#
#                             #.\*\ **#.   \\  * ... * *.**\..  .*\ ..**. *\..*.     . ..   ..*   *\*\.. * *.\*...* . *\* ...*\ * . ..*\\.*  ... ..\. *.*\ ...  *.\ **\  \  . .\.. *\. * . \.*......**..**\.*\. *..  *.\. .#
#                              #####\* # * .. .\.* * *\.\**.  ....\..\. .***.....*.  .*.\ .\..* * ..** **.... *.. . . \ *..***  \* . **  .*.  ..**.. .\. *. .  \.  .\.\ . .  . *.\ ..**.\ *  .* \.**...\.*. .  .*.*.\ *  **#
#                                  #*#.***\\.\  *..*\. \.*\* .*\* .* .*    .  .*. .   .*.* ...* \ . *. *.**\ \\ .* \. *  *...*. .*. .\.** .  *\ .. \.**. ..\.* **   .  * .\* ... ..**.. ** \\. . *. *... *. . .**.\*. . .\.#
#                                  ####.*.*   \. *.*.  . .*\  .. .*. ** *\.   *\. ..\*\. .\ * ...* .  \..*.  . .\*  \*. \.*\ .*   ...**..  ... \* ..\ **. **.\*.\.....* .\    * \.   .*\.*..*  *...*\** \.  ..\*\***..**\. #
#                                 #.* . . \ .. \ \ .* .\ \. *.*.*\.  .  . **\ .. \\ ...  **.\ .\.*  *.*\ .   .* *... . .. . . . . .  .\\*..  .*.\.\.\.\.\\.*.. *.  ...\  *.\ \. ..*.  . \* .* ***\\.*.**.. .**  *.... ... .#
#                                L ..\.\**.. .*. .**..  *.\ ..* . .\* . \ .*\. *.. *  \  \*.*.*.\* *\*...** .....  .   \   * . ...*\    .*..* .  .. ...\.. ..**\\* *... ..* \..* *.. * *.*\ .\* *. \. .. \*  *. **... .  *.#
#                                ##***\ ..\..   .\.....*\ *.  *..** \\...\ \..\ *  * *...* *..*. *\.*...\..*    .*  ..  \..*  . * . ****.* \. * ..*  *   .   \.*...\*.\ \ \.** . \** **. .*...*.\ .\..*  ..\*.. \.*.\ . *  #
#                               #. ..   ..*  \ \    \  \**.*  .. *. .. *  ..*   . **.\.*.\ ....* .**..* \ .*** * . * .  *.  ..\ . *.\. . * .\\... **.*\  .\ .  *..\*.  .. *\.\   ...*.****.  .**. *  .*\ \..* *..  * .  *  #
#                              #\*##* \ .*.  .\.\ *\   .. ** **.... . *****..*\ *.**\  *. * .* *. ... . .****\**.. \ *.\ *\  \ .  ..\  \ *\   .\ *...**.*  \ . \.. .\  \*\.  *\.\ .**..  .. *.  ..\ .****** . .  .  \.... *#
#                               ##  ##.*..*..**.  .. .\   *. .  .\.   ...*.  ...* ... *.. .. * .\. .\  \...*  .. * ....  * . ...\ .*. .\ . .. .....\* \     . **\*** .* .*..*. .* **.** \* . * .  ** *\...   *  **.* *\* ..#
#                                   # *..*.\*.. .*\\ \.  *.* .***.\  ..*.** .\..***.*....  \.*..** .\**. *\ .*.* * *** .... \ .    .  **..*\. .*\.*..  * \. **.* .*. ... \.\.   .*.*..\ ...*.\.\*\**...*. .\ \. *. \ *    \#
#                                  ##*...\ .** .\*. .** ...    .\ **\ . ..*. ..\.*.*.**\. .\\.*\ . \...**. . * .\*\ ..  .\...    .  ....* .* * .   *\... .*\\. . *.*  *  ..  . \ **....* . .    .*\.\  .*. **\**...\.* ** .#
#                                 #* .  .#. .* \.** *.. ..**    . ...   .\. *   \.\ . .\*\*  *. **   *..\* .*\ ...** ..... .. * \..\  ..*\... \*   \....* ** .. **.\ .  ..    \.**......\\ .....  *...  ... ..\*...* *\ \ *#
#                                  ##**..*\  .\. *.. . ...*   .\.  ** \. ***.  ..**  * .* .\* . ..\....  \..\ .*\...*.*.***. . ..* * \ .. . \\ ****    .\.*\..  .*..   .\\ *  .\.*\*\.  .** . . .*..  .* .    ...*\. * .. .#
#                                    #. .. .. . . .\ . . *. **. *\. *..\ .. . *. *. .  \.\... *\ \ . . .*  *.\ . . \.*. *  . *... .. ..* \**\  \.*.\.\.*  . *   ..  .\*  .\ .\  \**\*  *..   * \\. . .*.*  .* \* ..  ...*. #
#                                   #**. . \** .*   ..*  \ \.\ .. ..*\ .  *. **.   *.***  .*  ..*..** .\*.\.  *.. .. ** . \*\ . . **.* \ .* * . .\ *    ..* . ...\   * .....*.* ....\\ *.**. *\ \.***..... *.  *.*. \***...#
#                                    #.*.. . ...***...*.\.\. *.     ..**..\. .***\   \.   .*.  \. *\.   .*    * *. * \* *. ...   \ . . .. *.\ . .\.*\. \....*\ .. * \ . *. **.  *.... .\.*.  \. *\***.. *\*.\ .. . ....*. .#
#                                    ##    * * *...   ** \. \...*. \ ...*.**.**.***.  ..\   * . \*...\* * .  \.**  .  .\.\* * \*....**.\* .. *\  . .. * \*.\..   . \. \.. ....\ **.\. \...\*. . *..* ...\.. .. **.. ..**.*\#
#                                   #**  *\##.*.\..* * * .\.. **... . \.. *..\*. \.*  \*. *\ \  .**  ..\\.\* \ ..*\*\. .\*\**  \*\ .*.**..** .* .. . *...* .**..  \.*..\*\.\.*... \ .. .\.\ ....***..\. ..\. \*\*\*  ...**.#
############################################################################################################################################################################################################################