##########################################
#*..  \ **\  .. \ .\... *\  .*.  .\ . .. #
#...  *.*.*.  \* ** .*. *. .  . ... .*  *#
#\*.\*  *... *.\* .\ \*     ..*\.\  ** \.#
#. ..\. .  *  ..**..... *  ..*...*\ ..\*\#
#* .. ...\ *.*\* *     *.\.   * *\. ... .#
#\ .\. *\.   * . \ \**\\\. \  . \.  * .* #
#.  .*.  .\*\...\. .*.* .   .. .*. *\  ..#
#. .\*..\*.. .*. . . . \*.  .  ..*.*..* .#
#.*.*\*\.*.\ * . .* .\  .\*.* . \\..***..#
#*.* *. **.*.*\ . *. * **.....\* *.*\*..*#
#  ***.    ..... \\.\....*. .. .\.\..* ..#
# ..\.\  .  *.  .... * *.**\ . **\.. .**.#
#  .**.\.. *.. * ...  .  .   .\*.    .**.#
#\**.* ** **. ...   .\*\.\..*\... * **...#
#...\..*\*  . \*  .  .\*\   *.*** . .. ..#
#..\*** . ..  .*\.  *. \.*  ...\. .*\.*\*#
# \ ..* *\..\* .  \ \.\ .. \ .**  \. .*. #
#\*.  . .**\.*  .\.\  *\ .*.  ** ....\   #
#...*. *  .  .  *. . *.. *.\*.  .\ \    .#
#* \..*\ .**.\ *. .\.    \   .  .\*..  ..#
#\ .  ... . . .*\ *...*\       .*.*   \ *#
#    . .** *..   *..* *.*.   ....*.\*\.  #
# \.*. .*. . *.*..*\..*..\.\**   *...**  #
#* .*  .*  . .*\... * *.\*  **. .***\**\.#
#.\ ***\\ .\....  \\. .\** **.\.*  ..\ .*#
#\ **.*.  \  *.*.\  \.**.**\..\.\   \  **#
#..*\ .\.  .*.*\*\**   *..\.\**\.\ ......#
#\*..*\ *.  . *.**. .   .**..\** **.*.\*.#
# \ \..*..  .**\ ... .\.\.\ .. ..*.**. .\#
#\  ..\..\  .  ..... ..\*..*\   . *...\. #
# ...... *.. ***. .. . .. ....   *.***.\ #
#\ .**.  * **...*. .\ . .*.*. **..*.*. .\#
# *. \*...  .  \.*.. *.*\.*.\... ..*. .* #
# .**.*...**.**.\.  .... *\..   .  *.. *.#
# **. . *....\* .*\  \   ..  *. .  *.\ .\#
# .*...\. .. *.  .* * ******* .* **.*.  \#
# ..  *  .  ...\.  *.....\.. **.  . .*   #
#.\  *. \.\*\*\*.. * .**\* . ..* .*\*.*. #
#\.* .* ...\.*.\*\*** \..**. **.\*.**..\.#
# \.  .* \. .. *....*..* .. ... .** *....#
# .\* \.. **. \ . .* \*.  .* \ **.*... * #
#.*..\.* .*.*.\.* .*\.\...*.\.... .\  * *#
#.. \..\.*. .**..*.*. . ..***.\  ***\ . .#
#   . . .. . *\..*  * .\\*.\.**\...... ..#
# ..*.  * *.* *....\. ..****\*.**\. *..*\#
#.. *  . ..** ..*.\ ..* .... .*..    . ..#
#\**...****.*.. ...*....  . \ .**..\\. . #
#. \*. ...\\... *  .**.   . .\ ...* .** .#
#.*.\. \ .* . .. * . \..*. *.*.* \**  . .#
#*\... .\*\* *.\....  *  **\     ..  ..  #
#. *\* . **..\ . *  * * *.\.\. ... \ *\*.#
#.\....*.... * ...\.  . \\***.. ..* .. * #
#.. .**.\..  *\    * .  ..*.....* ... \..#
#  *.\.*  *  .**\.*..\ . ....*\.. . *.. .#
# \ ..\\...**\.. *..\*\*.*** *.. .  .  ..#
#.  .\.*.* *. .\.*\.** ..... *\. .\.\.. *#
#*. .*..**.\.* . * .\.. \  \  *. ***\*\*.#
#*   .  .. * . \  .\. ...** .\ .. ***..**#
#.. *.\*.. ..*.*\..  * . ..   \\*..*  ...#
#\. *\..     ....\\ * ....\\...\* ..*.*\ #
#   .  . \.\ \  * ..\*. .*. ...\. * ..***#
#*  \..*\**. . ..\ \ \. .  \*  *\.*\*. ..#
#\**.  .  ..*\.\...\...    .  ..  . \* .\#
# .. .**\..* ...*. ... .... *    ...*. \.#
#*.*\ *. **.* ...\ .*.\...\\.\***.**\ . \#
#. * ***.*. .. ... .\ .*.*. .  * .\.**\.*#
#*\ .\\.\.* ..*. * \.  .... .* * . **..  #
#.\..\  .\.   .**.. . . .\*  ... ....* . #
#.*.\...** **..** \*..*\ .. \*.. *   ... #
#\. *.\ ..  .*.* ..**\*.\.... .\..\  ...\#
# ... .*.* * .*. **..*..*  \.\ . *\*  *\ #
#* \.. *.\ . .*   ** ..\* \.*..**\**  *. #
#... ..** *.**.*\\.\.*  **. *. ..*   *.. #
#*.\  \*.....\*...** .\*..* *...*....**\*#
#.*\ *.  *\*... .  .\ \.**\.\. \*.  *. **#
#.**..*\. .. \ .* .*..  *\.* . ..*..\ \.*#
#**  .... .  *..*\.. ***.  .\\*. .  .  \.#
#.\   .  . .*..*.**. .\ \ .....\.*\..*.. #
# ..\  . *.\* ..\.\ **\*.\    * *.*  .\ .#
#.*..  ...  .\* **.\. .\...*.\* .** *.. .#
# *....  \  *\*  ** . ..\.\*..*  *.\* \. #
#**. \  ...  *..  ... .\ *..*\*.** .. . .#
#.. *. * ..  *.  . . .  . ..*..\*\*.*.  *#
#...\\*. **.... \\  .*.*    *. **....*..*#
#* .* .  ...\. ..* \.. .*   \. *. *. ** .#
#*\ .*.*. * *  .\.  *. ...*.. \.*\.\. .  #
#\...* .\** ..* *.\.** *  .\ .. .  .  .*.#
# * *.  \*.*. .** .*\. *...\ ..... .  .\ #
#\. ..**..*.*.*.\ *.**.\..\ * .. \**.*..*#
# ..**.  *\.* .*.*.  * . .* . \ . \.*\. .#
#. ....*...**.\. ***  .  * \ .*. . \. . \#
#.\ * . * .*\*   . ... .. .. *.\.. ..*. .#
#*...* \.\  .. *\  \.**\ \*.. * .. * .. .#
#.   . ...**\**\ * . .\   *****. ...**\. #
# *.*..*.\  . \.. .. .  \ \*.*.  .\ .\*..#
# .\*. .*    *.* .\**\.  . **.**  *..\. .#
#**.*.*...*..\*.*** ...\\ .*..*\  .**\.* #
#......*  .. *.*\*.\ \.*\.**\** . ..**.. #
#.*\*.\\  .* .\. ...*.** \ ...*.\.   . .\#
# * . .\ *.*  . . * .*\.*.\*\....*\.*\***#
#*..*.\ *\ *. ..\ ....**.* .*. ....\. .. #
#   ...\** .    . .. *\. *. .. \..*. .*.\#
#.\ .*..* .\\. .\ .  *.* ..*..  .    .. .#
# \..** . ..  .\**.. ***\.\*.**  * \ *\*.#
#*..\. *  . *. . * \. .. .\*.\\* .* . .\.#
#*...\** *****\ .*. \  . ... *...\*   . .#
#*\.\ **.*.  ..***.\ \  \**\ *.*..  *\.**#
#\  *\....***. . .   ..* ..*..*.** *.....#
#   . . .\ .*  . . . *\*  *.  \.  *..* *\#
#\*.  .  . ... . .. *. .\. **  . .\ * \**#
#*. \ **  \  ..*\ ..\.*..\ ..***.*. ....\#
#  \ .. .* .* **.* \ .**.*.. **.\. \*..* #
# *.. .  .*\....*.\  .*\ .  \\ .*   .  \ #
#\.*  .   * .   ....   \...  .... *.** .\#
#\  ..  *.\ **\*.      *.*.** .\**\* ....#
#\ **. ..\  *.*. \ \ \ . ..*.*.\.. * .*.*#
#.\*.. * ..****... . ........**.\.  *  \*#
#*... \ ...*\*\ . **.. . * .*..*.  \.   *#
#.*.. \.* .**.  .  .**    . ...  . ** **.#
#\\ ..  .....*\. . ..* ..    \   **\.....#
#.  ...* *. *.    .*.. *\ .*. \* \*......#
#  ... .*.\*.\. *\*.. \..*.* *..\* . \**\#
#**\   .* ***. *.*\ *..\ \*. * ..*.**... #
#.  .. *. ...\ .*..\. **..\  * *.\\  *..*#
#   \...*. \  . .  \ \.\.*** .. .  \..\ .#
#\ * \...*.\ .\\.. .*.**\...*. .\.\. .\.\#
#.*.*.* .*\  * ***... *..  .***.. ..  ..*#
# **.\.*\ *. . . *..  \  ..*\*.\  \.*  .*#
# .\ .*.**** *\... **.. .*\. .\*   ...**.#
#.*..\\ *..* .   .\*\\   \*.. ..*\  **..*#
#. \  \.*.* .*.* ***.* .  \ ..\  *\..*. .#
#\ .* .*  .  ..* * . * . **\. *\...*.**. #
#  ....**. * \ .\* \*\* \. ***.. .. **.. #
#* .\..\**.. . . *. ... . ....\.\ *\ * .*#
#..**.  **   .. ...\ \  . .**   . .. ... #
#   .\*...\ .\  \.\. ..\*  .*.. **.* ..**#
# ..\.. . *\\ **.*\*. ...\. .\   .*.\ \.*#
#\*    .  .** . . *.*.\ .** **\.  \*..  \#
#.. ..*...*..  ...\** .* *.. * .\.. . . .#
#\  ..* ...  \**\ ..*..  ..***  * *   ...#
#..    .*...\..\.. ...**..**\***..*. ..\*#
#*.\*. *.*\\   *.*.  \.*.... . .*\*.  . .#
#. **... . \. \..\.\*.*..*.  * ****.  **\#
#. ..  ..* .\ .  . .. *...\  . *...* .**.#
#...\. *.* **..*. *   \.*  ***...*... .. #
#\*.*. **. .\** . . .* *\  * *. .*.\..** #
#* \.. *..  ... .\  .. .*...* .. *.* \..\#
#. **  \  *..\.*.*.  \..* .\.. .**.*.  * #
#. .. ..\..\*\\... \. . ..* \...***.*   \#
# *. *\.. .*. ... .   ..*\. ......\*.\*..#
#\*. * \ ...*.* . *\*.* .**   *\. .\  *  #
# ..** .   **.\.* ..**\ \.*.*\\*  *\  ** #
# ..**. \ *.\ *.. **.**   * \  ..** . *. #
#.   \  .*.\. ..  .*.. * *.. \*\..**.. *.#
#\.* . .*    \* .* .   . ** ..* .  *..\  #
#.**. .\*  .*... . * \ . ..\. ..* \*  ** #
#.\ ..\..**  ** *  .***\ \ . .. * ...\*.*#
#*.*.*.  *. \ ..*   .\..\  ...\..* .  .*.#
#..*...\*.*. *  . \. . . .   \* \ ..  ...#
# \  *  .....\.* * . *  \\ * . *.. \ *  \#
#\...*.\\..  . * ..* \*..... *.  \.  .  .#
#.\*.  ..**\* \.\*  . \.*\..\..\ .   \..\#
#\  *\ .**. . \ *..\  .*....*..**\.*\   .#
#.\ .. *** . .. .  **.*.\..  . *\. .*.\.\#
#...\..\...**\.    .*\.. \ *.\ .  *.\.\.*#
#..*. . *  ..\ .  . . \ .\*\ .*\  . *. \\#
#. . . ..    ..*..* *. \ ..    ..***.    #
#..*. ..*\ \*\**. * ...* ..*. *\*.* .** *#
#. ..   **...... *..\.*. . *.*.  *.*... \#
#.* #\*\.**\ .  .    .. \* *\*. .. .*.* \#
#. \**.* ...**  . \ .\** .*\ .* #\ \\ .\ #
# *..*  *  **.    .\...\ *. .*.*.*. ***.*#
#L#.#.\.\.*.*  .*\...\.* **.*.  .  * .* .#
## \.***. .**.\* . .\ \* *... \***\..  . #
# #.*##. . ..  .. .  \ .\. * *...\**\\.\*#
# # \##  \   \*  * *. \#*..* *#*.##.* ..##
# #.###...  *.*  \. #*# ..*\.R.\ ##.*.####
# #\# # ##  . ..\.*# # ##.#  .* \.#..*.  #
#  ##\#   ##***\ \ #     # #\   # ##.#*###
#   #**.\#  # #.#.###      #*\ ## # # #  #
#    ####    ## * **\#      ###  #       #
#             #.###..#                   #
#              #   #*#                   #
##########################################