################
#  #..\##.#    #
#   #\#*#\#    #
# ## . ....#   #
##..*.. .##    #
## \. .*#      #
#.*...  #      #
#*\ \.\*###    #
#..*\. * \ #   #
#.\. *.####    #
#.. .# *##     #
###......*#L####
# #.# **...**.\#
#  #*\ .. \*.\##
#   ##*. **### #
#  #R**. #.#   #
#  #.*.**##    #
#   #.#.#      #
################