########################################################################################################################################################################################################################################################
#*\.. *\.**... .*.. *..\*. . . ....**\\   .*\ \.\  ...*.\.\.\.   .. *. .* \.***\   *.\*. ... . \ ...*... .\. .* *.... *   .*  ... .**  * .. .    *\ **\. \.\ **.. **** * .. .\ .\  *\  ***.**.  \   \ \.\. .\*.\ ...\. ...\.*. . .*.. .*...\# ###..#   #
#...* \*.**..*\ *.. *.* * .  . .\. .\.* *.*\*.  . .**\....   . . *. .. .* *.* * .*\.  *.\* *  . . .\.. \*\   **\. ..\ * ..\* **. ***\ .**  \   *.\   *.  .\  .* \....\ \ \.. ..  .  *. * *\...* \\ *  . * .  *\... *.  *. .*.** \ . .  * *..##*\#.\#   #
# *\. ..\.. \.  ..  ...**... . ... ..... *.  *\..*\.*.\*  .. *** .\  .\.*.*..*.\ ..\. *. . *   \.\ * \... **\*** *     *  .\*\**. .*..\..*....**.******\** .\ .*....\...\ .* *.    \ ....* **.. \. .\  .  .\.\.. .\*.. .\\.*.*.*\*..  ....\. #\*# #    #
#\#.. . *   .**.*  *\. .   .  * . *.* *\ . *.\.* .\.  ... \.\.*. \**... \*.  .*  ... .*.  *..  ... *\ **.*.. ..*  .*. *\  .*. .*.\ \**  \*\* .\. .*...  .\ .\. *. *.  \\.  *..   \** .\* \*..... *..  .*\..** \.* *.. \.... ..\\..*.*.. *.  \**..\*#   #
#*#*..*.. .*. ... *\.  *.*. *.* * .\.  .... * . * **. .\. .*.** * .....  .  ...*.* *.**\  ...  **..  ..\ ... ....* *. *.*\..* *\.* .. .\.. \..... .\* .\   **\ **.*  ....\\*\**.  .. \** .\  .\...**. .. . ..\...  .\ \.. . ***  .. .** .  ##.\ **######
#*.*...  *..*.\..\..* ** .\...****. .*\.\ \*. \ *\*\..\ \ ...* ....*.\ .  .\ ** \* **...** . ...\  .\.*.****\*. *\.* ..  . *... *\.. *\ \.*. ..*. \....**\ \ .....\ .*.*.  .*.*.*\. ....  .. . *. *...*  *.\*... *.  ..\*. .\.. . \ ... ... **  * ...\.#
#* *... \.\.* *.*..   *       **\  *** * .. .*. . ..*. \..  *. . \*.. \ *. .*. * .\*.*. .* ***  .**  . \..*  ** * ..  \** ..*. ...\*    .\.... ** ....  . . *. *.\  ..*.*** **. ..\.\.. * .**\.... .* * .*.  .  \..** \.\ . ..**.\ *.\  \.\ .   .#.#####
#. ..\# ..  . \.**\* *   . ..  **.\ .*.\ .\\ *. \. .**\.\ *...*. ..*  .\. \ .\*..\. ** * .\.\. . *.\ *. ..\\.*\ .* ..\. . .\.. \ . .**.  ... \**. . . *  .  \ \\**\\  ....** ** ..  . . .* ...  .\ .*.. .. *\..*.\\..   .\. . .*\* .  . .\*** **    #  #
##.*.*.  . \\   \\.\*. ..* ** *... .* .....* * .. ..\. \. .* *...\ .     .  ..*\*. .*. *.  * *.* . *  *  ** ** ....*..\..  *\ \.    *.\..  \ ..** . ...  \ *.* \.  *.\*  *...*\  \*.* .\***.\*..\. ** .*\. .  *.**   .. . . .\*. .\...\.\ .\. ..*#.#   #
##\.*...\.  * .*** .**\ ...\..\\\ \ .  **. \ . *\... .\ \ *. .. \...\  \..*\* ..\*. .\ .***.*.*.. *. .**.*\.... ** *. .. . ..\ *.**.* . .**.. \.. **\. \\ *\.*\.*. *. * .*..\.......... ...  ..\ .  .\..\.* .**.\.*.*.   *.\* . ...  *   **.**\ # #    #
#*.\.*..*.\... ..\**\...* *    *.   *.\..   .*. \  ..** \ * .**\..*.   . ..\*\. ...*. . ..*. \***.\*..** ..\..\ .....\ *.. ***.*.. .\ \* . .. .  \* ***.....*..*.\.\. . \\. **  * .*   .  \. \.. \....*\*. \  .\*\...\\ *.. .. .*.  .*.\\.*\.\* #      #
#.  \\  .R ..\ \\  ...*.***. .\.*.. *   . ...*.*...  *.\.*.. .\ . \.\  \. \..*\  \*.*.*.**....\ .. .. .. * * * . .*  ..*  .**. ** .\..\.   .** *  *\*.\.\..... .\.*   .\ .*.\. . ** .\\ \..* \* .........\.  . \ .* ...\.  . \..\\ . *  .\.*\ ##       #
# \ . *  .*. .*....*  . * *\ *  *..\\ .. *\\*\. .    *** ...     **\. . \.  .\. * *.*.**...*. *.*.  .* .\*.\.*  \.. .\. . .. *.*\..* .  ..\.\ .**..**   .* \\ \ *. .  . . ** . * .. .   ..** .*\*. ..  ...  *.  .*.*\.. ** ...  *.. .. \\.*.    ###    #
#*#\*\# ... * *. . .*....*   .\ .*.\. \\..*.  *..\ * ...  .*     .*..\ * *..... .***. *** ***\* ...*  .  ..  **  *\.\ ..\  .\....\... .*\. ... .**\  . *.*\. *.*. *\ *.\  **\* **.  **. \. . ***.\. .\ ..  \.\ . ...***\.. ..\.**...  . * # . .*.*.#   #
### **.\.\  .  \.  *.*..\.. \\* \..*. .** .. .\*.*.* ***.* .. .*. \. ...  *.**.. .*. ..* ..*... *.*.* **\  \ * \..\ . *..*. \ ..\*.  ......*  * *  .**.*.. \ .. .\*** ..*.\.*.\..*  ... *.  ..*...\*\. .*.*\* ...\ *.\.  \\.. *.*.*.\** ..\ ..*. ##    #
# # *. * . **... ...*.. ... .. \ *\.*.\***  *\ .***.*.. *.*.*... .**.  .*\ *.*\ \* .   . * ..*. *.*\. *  \ ...*. *.....*...  ... \  *..  *.* ** *.\*.\..*  . \* \*...   ..   . ... ** .* ...** *\**.\\\*.*...\  \\.....  ..* *.\**..*.# \ # \ .\.  #   #
##*\.#\..  .*. . * ..* *.. ..  ....* * \..*...  * *.** *. ......**.. .*...  *.*.... \.\* **\ *. . .*  *.*.* ..\* ..  **. \***.\ . .. *\..\ * *..*\*.*. *  .\ .\..\*.\ * ....* ** \..  ...  *.\ *..\*   . * ....\.. .. . .*.* .\.*..*..\. * .#  .*##    #
# *.\#**. * *  \ . ***. .\.  .\\  .. ....*\.\..\. * . *. ..*..  .    .*\. ..\\ .\    .* .\.... ..**. *  .....\ \.*\**\ .*.* *\.. * \ . . ..\ .. * . *. *.*.....*.*.   .. \ .* ..  .   .*  \..*\ *...**.*.. * * .*.   *..\. . ...*\*\  .*..* #\* .#     #
#\*. **..\ .*\ .*. . .\  ..* **. .*.*.*.\.  * \*.. . . ..\.**\   .*. ..** .  .*\.. . \.*.  ..\.* .*. .*\*....* .....\.\*\ .\.  *... .*. . .* .. . ... **..*  . ..*.   .....  .  ....  ..\...... *\  ** * ..... *. .*...\. \* .\....  ......... .#      #
##**...\**..*..* .* \ .  . .**\ \*.\**\     *\..** ..\.*  \.. .\. ...*...*\ * .\ * .*. ... * ...\*.\...*. *.*\*. \*... .*\ \   .  .*   *\. *\.*.  .\\*.*..**  \*..   .*\.\ .*\ .  **.\. *..* ***. ..  .*.\.*\.*. .*. ..** .\... **  .* * . *.\..#      #
#.*.*.\ ...*.    .\.  .***\*....*.\  .*.  . .* ..*. *\ \**.   .* *.* \*.\.  ***..     *   \...  *.\*\.\...  ..*.* . *  ...\ \* . . . .\*.  *  .* .   . \\  *. . . ***.. * **. . \ . *.\ . *  .\.  .  .**\.* . **  .*.* \...**   ..*  .\ #*# #*# #      #
#**.*.. .  . ***\\ ***.**  .  .*.*. .*.\    .\ .. . . ..*.  ..  \... .\ *..*..*\\* .*...\ ....\ . .   ..*. .. .\.  *... *\..* .  ** . ** *.*   ..  \ \ .. \..\** \..  *...* *. .**..   \   . . *.\**\  ... .\  ..***\\. .*.** \ ....\ ..  ..#..#       #
#\ ** **\...\...\. . *... . *\... .\\... **  .* .*    *\. . . **\\  \  ... .\. *\\ *\ *.. \.  .....* .. .  \*.. .* ...* .*  . .***. * .\.... *.  *.**.... **.  ...*...\. .. ..*\*.\.*.. .  *.* .. \. .  \.*... .. . .    .  *... \.\..** .# .\#        #
#..... \\...   ..*** ... .. . *\..      ...   ** \ * \.**.  . *...  .\* * ..* ..*   * * ... *\\. *  \    *\. *\...\...*  ** \   ..* *\...\\\*.\ ... .\  *.\ . *. *. .\.  ...  *..\. ..  *  * .* .\. . . * * .    *\  \ .*.. .** *. *. *\. \*#*#        #
## \. ..\. ..*\..\.*   * *\*. .*...   \ **  . .\ .\* *.  \.   \*\.*  \...* \*.  .......  . .\ .\.*....\*\ ..*... . .\**.**.\ .  \ ..*.*****\.\***  *** **.* **\  . .**. ...  . \  .*...  \..  .*   .. **.\*\*.\***..*.*..* \ \ \*  \..* \.. # #        #
#.*  .\ .\.*.* *.  . .*.\.* ... \*  .\*..*.  . . . . \.*. ..\ ... \.  . \ ..*..*  ** \\* ...*  ***.  *. *.. .**.  . ..**.\..*..\  *..*. *..* .*...* .. ...* .. . ..\** .  . *.   ..*.  .*..**.*     .\*..*\.*. .\.*..*..\*..* \ . . .......\ .#        #
#.*..*.\   . . ..    ..*. .\. ...*\.\ \*\..\*.\*  ..*.....  .*.**...*\.* ..***.*   *..\....*\.*.*  *..* .  *\*\*. \*   .*.*..  .\.. *\**\ \.  \.** ..* .*..* *....  ..*..* **\.\.*\* \ .*..\. . * *  ..\... .* ..\.* . .  *\. .  \ * ...##.\#\.#       #
#..\.*\.****. \ *....\ .* .*.**\ ** *\**.. **.. .. \.* .* . *....*\*\***....\..\..   *. .. \ .\ .  . **.\*.\ . *.  .* .*\\.\..  . **\*.*. .. \......*. .**.*.*. .  ***.***.\..  **..... * .***\*.*\  .*  * . .\ \* *    .\. .**.*...\* . *..#  #       #
#.\\** * *..**....*\**. .  . *..**.*  .... ..**\. *. **.* *.\ .* . .*... .\ *.\*** ....\ *.\.* . . \*\.  .\.\. .  * **..**\..\.** .**\\.\* .*\ * *  ... ..\*\. .  ..**...****   .\.. \.\. * .*..*.\ **...\ \. .*   .   *.*  \. ...\\ .. *.\ ...#       #
#.\..  * . ..*..... ..*\ .\ ... \.* .  **\  **..*.*.\.* ..*..* \\ ..*  \..* .  ... .*. .*.\ .** *...*.. *. **..\*   *.*..... . ..\.*\. **.**\. *\*.*     .**. ..\**.*.   *\..\.  ..\..\.  .*...  .*\. . \.\.** .*..   ....  . . .*.* \**..## \ .#      #
#.*#.*.*.*. .*.   * .\.*. . .* .   ...**.. ... ..** * . ....\.   . .*    .\   .. * ....** .*....\  .\   ...*\.    . ...*\*..* .* ..* *\*.. *.  ... .*\... ..**...**.**   ....*** \.*\. *  . .\...  **\.\*\*  **\. .\. * .**. \ \*. .  \.*\ *\ \*#      #
#*\.*.\ .. .***\*.*\\.*...\  *  .  .. *. ... .** .*\.* .* \... * * .*\.. ...  \  .  *.  .\ .*\   *  .* . .. . .\ * \. .. .*\.  *.\*\   .   .  *. .\ *.*.*.\*..  \**\ . \.*. \.**.\..* ..\*    ..**.*.* . .\  *. * *.* .\*.\*.  .*.*.\ .** .* #####     #
##  .  #*\  \*.... . .*\..*  .. *\  ..\. \*.* ..  ..*\*\*. ***.*  **.***... *    ***.* ***.. *.\...**.* *.*. . ..\ .\.  ..* . .. **  ....*  ..*   .. *.. ***.\.....* ..\ .\* *.\. \.\ .*.. **.* . ..*.\  *\ .** \ *** * .*.. .**.\  .*\.*.#.\. #..#    #
## .\  .* .* ..* \.* *. \.\ .\...*\..* .**..  .  .  . ...\.\    ..* *.. *....*.\.*.*..*..*.* \**.  *  . . \.\ .**. \*\.....**\..\... \*. .  \. \*.**.\..**.\* ..   * \\. .**...*. *.* **.*.\*. . .\ *. \ *..  *\  *..\..\* *\*.... .\ #... ..\  \*##   #
##.*\ . ...*****\..*. \ ...  *. ** .  \ \... ..\***.* .\  . \  . ..* .\*\** *.... \.  .  .\\*..*. ..*. * *. *  *.  ...\\*\*. ..\    \ *  *.*.\ .....*...*.\*\*.*  .\ . .  *.\..* *.***** . ..\  * .\.. ..\*. \*   ..\. .... *\... .\. .**.. . . . \.#  #
# #.*.***\.  .  .   . .* *   *.*. . \.\..*.....*\. . . . **.\  .*.  .**.... *..  ....\. *.  .  **\.   .  .  \  ....*. *..** \.*............\*.** *\ . ..\. ..*.\*. *. .  ..*.***...*. \***.    . *  ***.  .*. *.   .  *..*\**.\ .* *. .\..*..  .. ##   #
## *\*\.\*\ ***.\ ... . *\ . * *.. *  . . . * .\.\ ** .* \.*.\ * .*...*... \.. .\** \. .*  \ * *...  ..\*.. \ *..*.. *.*..  *  ......... *\ **...*  *.**  . .*.*.** . ..\ .\.. **..\.*.**\.\*\ .** ***.. . .* ..    . \*.* \.*.. \ .*.    .\ *\\##     #
# ##\*#.*. ....**  .\ *.\.*.  ..*..*.. .*.  .**..  *.. * *.\ . .\*....*.  *\* *   .\**\..\*.   .\ . \ .. .\..   *.\  .\\.\ .* .*... **  .........* .*****.\. **.\..   .* ** \***... *..**.*..* \.. **.\  \. .. .*.   .....  ...*\.\...  .   ..#\###    #
# #\.*... . * ..\*  **.   .\ \. .*.   . . *\ .. ..*. \..\*.*.*.\.*.\ * . *...*.***  .\* *.. . .....*.*.   \ ** ..*. . ****.*\*\. \.*..\.   \**.\ .. \..*..  \..*.  ..\ . ... *.\*\. . \*. *.*.   * \... .*\.   *.*.**.\**..**\. .*.  .  ...\*.\.#* #   #
# #   .*  ...*  . ....*. . .\*\   .. .  **.  . .\. \. . ..*. *. \.  *\* ****.* *.  .... *\..\.  ***. .  * \ * . \**. .*\.... . ...*. ...\* ..\..\*  ..*\**.  *\* * .*  \   * .\.. *.*  \.\.\ .**.. .*  *.. . .\.*...\ * .* ...  *..\**\***..\.## # *#  #
##\ #  . . \\* **. \...\*\. *... **   .*... *..   \...*  .. \ \*.\..... .*.\\.. \. ***  .**..  \..  .. * \. .\ * . \  . . \  ..** ..***.  \ .... .  \**..*\ .. . *\ ..*****.* **..* ..*. *.  .\. *. ..*\..\..*  .  ..* \ .\. .   * *.\.\ \  . .###.#   #
##**#\.*.  .\*....\ *. .*.\.\*..*.**..   * .** . ....*.. .. . .*** \ .**.\.*.**..\ \*. **.\ \*\..\  ...*.*  ** .     * .*  .\\. .*..*..\.* * *\..  ...*\\. .  .. *.*. .*..\ . . **... . ..\* * . \.** .. \.*..  *  .**.*.*\  .. .*..*.**  .*\#*\*.*##  #
#*\##*\*\ *  .  .. *....*... *.. .. ..\\ . ..\ * ..****..\...* * .  . .\* .*.*\. . ... ... ... .. .* .* ...*...\...*.***. **.* . . \..*.\  ..\.. *\ * . . .\*. ... *  .\ \. *. .*. .\* \ \*...**  ...   ..\*\.*\ .  *.   ...*   ...\. ...\ # .*. .*. # #
#*.##.*.#....*. ..*.\. \. *  .. .*   ..\. * \ *** ...*.*.*..\. \ .\.    . *.\. ...*.  *  * .* . . *..*. **.. . ..\ ...\ .  *  \...\. \. *\ .  *... ...    .*.*   . . \*  .*\..*.*.\\.\  .  ***.*..*\.  *.  ..***\.****....\*...\*..*.  *\* .\\.\* # #  #
###  ##L \**..\ . .*.**.\*.    . *  . ****.   *...** \... *. . ..  ..*\.*\      * ..* . .*... . *..     ..*  \\*.  *.\*\ .*.  .\..  **. ..*\*.*\  *\ **\ ..** *  *   \ \*.* .\.\*..**** \**. *... ... ** ..  *. * .*\*\*. ** ...\**\\...  .. ..*#*##   #
#      #.#.*..***\. ... ..**\*\... \  .. \  . ...... \.*..* ** . .***.. \*..**. *   *** *   .**.* .  ***.   \\*.\ \  *......**. * *.\.    .. \...*. ...* \..**. \*\.\ * ..**  \.\*..  *....*\*.*.  ..\.\*.\*\** .*\\   \*\ .**\.. .. . .\ . *.. ##     #
#      #  #*\*.... \ *  . .. ...*.  . . *.*. ** .. *  .\* .*.*  * *.\.*\.\.\\*... \*.**.. *.***.. *..* *. . .\... * \.*\  *. ** .*\. *. *\*.*   ..\*.... ** \.. ... ..   *..\*.. .*\. . *..  .*... * . .\  **.\ *\ ....**. .\*.\* .\. ..* *..**#       #
#      #\.*\. .\ *   \ .**. .* *...   **\*\ *..*   \ .*.*..*..  . ......*.* .**. \...*..  .*..*.  *....*  \.*  *.***.*\*\.*. *\...**.. \ .*.\. ..\**\ *  *.\ **.*    * .*.. ..*.*\  .  **\.... *  ...\  *.\*.*..* ..* ..*..\..  * *..\ *..\. .**#      #
#       ####\* \ *..*.\.**.* .** .**.. *...\\ .   \.*...*.\**. . . *.**.. .*.\.\  ..    ***\. .**.*    ...  .**.*.*\...\. .*\ ***...**   \  ..   * *. .*\. ..\.*.\  .*.*.  . \ \..  .\***   *.*.    * \.  .... \ .  . \ .\..\*.***\\. .***.\.###       #
#        #*.*.\ \. \.** \** .\.\\.*. .....*.*.   \.\*.. *\ .* . ....*. \..*.\  *... .. *\*\*\*\ . .**... ..  ..\. .**  *\.. * *\  *. * * .\.  .  *..**  .\* *  . .*.\.....*. .*..\ **** .  \..\.*** .. . .** \ ..**  ....** ......*. .**\. *# #        #
#         # **...\*# **\*.*.* * \** \.\..*.... ....  \.*\ \..\ ** *\*  \ *.\ . *\*.  .*...*\*\* * *....*\.****\*. *.\.\.****. .\*.. *.\.*\**\ . *.*.**.*..* * \*.**.*\\.* .\ . ..*\*\*. * *. \. . \ * .\*.*\ ..* .**\*\ .**.*\\  \.\ .....\ . #        #
########################################################################################################################################################################################################################################################