###########################################################################################################################################################################################################################
#    #..* .* .**. . \. . ..*.. *  \ *.  . . **.. \.   .... .\.*. .....*  ****.  * .*    .. \.\ * *.\ .*\\.   .**\...   ..   *.. *. *\ * ..*\.\*\*.*. **  .  ****...   .\ .    .   \ ** .. \.*   .***.*.*.*  .  ** .*\  .*\#
#    ##\*\..\*.\.  .  \ .  *.  \...*.. . .\..\..  \   ..  . ....\..  ..*.\... .\.*.*..\ *..*. *...... ..***.* ..* .  .  .\  ...*.   *\*\*\. *.* \**..\.*\.*... ..*.   **. \*.. ..* .   . .\*. * *\*. ..* . \ \... .*.\*.*.#
#   #.*... *.\.. .*.\\.. .. ** \.**.*. *.\*.*.. .\. .*  *   * . *..\ .*..**   *.**.* ** .\..  **.  \ .*.\*. *\ .. *    .. ...\..*\.. *  ...*..*. .\ .. .*  \ \ *  \ * *.. .\*\. \       .....\..\.. \\.*\.....*\  .**...**#
#   #.*  ..*..*\  \*..  \ .... . .*\.*  \*.  *\ \.\\ .*\. \.*\.*...* *\*\*..\.** .\*\*. *. ..\.*.\*\.*\.. . * . *.*\ .*\  .\.  ** *..\*.* *** ...  .** *..\. .*. *....\.. .*\.. .*\ .\*. ** .  ..\*.*..* **. ..***....\...#
#   # \#.   \** .   .\***. ..    *.. . *.\*.. .* .*\*\.  . *. **.*\*\... *\...**** .\\.*.\..*..**.* . *.** ..**  .*. *.*.*    .*\ ... **. . .*  .   *. .*\*. .*. .\ *... . \* *\*\..\.*. .\.. . \  .*.** .**.* ..   * *.. #
#   ##.#* \ .*...\..*.  .. *.   *.*\. ... *  . .**. * *.*...*..*\  *.*\ .\*.  *.*.* ***\ **\. * ...*\ . *.*. \*\. \. .*.\.\ ** \.\...*. . *  .*. .. **\ . *\  .* *..****.*\.*.... .. ..  .\ . ..*.\.\...\*.* .. .   *.. \*#
#  #  . *. .*..* .  .*.\ *. .. .*.. . *..*...  .**\*.\.......***.*.\*.*.*\*...*\*.\...\...\.. ***  *...*.**.. \ *. *  ... . *. .\**\* .\.\... .* \ *\.*. *. *\  .\.. .\* .  * *.*.\\ *.. *** ** ....  . *.... *.* ...***..#
#   #.*..  .  **.. * **\.. .   .*  *. ** ....*\ ..  . *.*. *..*.*** * . ..**..\....* **  *.*\. **..\*. .\. ** .\*...*.\.\*...*   .\ * \ .*\...* *.\.***.  *... . . .***.  ..\..*..*\.*.**..\*.\\*.\.\*  ..\  .***.**.**.\*#
#  #*...\..\ .  **. **\*.. *    .\*.. .*..  ..*..*. *.* **..\....... \.*  ..   ..\ *\..*..* . ..*  .\* .  .*\* *. .\*\*\ .. . . *..\.*.  \    * ..  *\..* ..\ . . *.\.\*. ..* .\. ....*\*\.. .*..***.\**\**\\*....*\*.\ *.#
#   ###\ * . \ *.*.  ..* ..\.  \.*.\.  *.\... ..\..\. ..*....\**.. \.. ....\  \ \. * * .* .\.*. .  .*  ...*\*\..\*  \ *.\   \ *.*. ..\  .*.....** \****..   . \ \*.*..** .. . * . . \.*.\  .. .\*..* .*......*.. .*..* . .#
#     #\..  ..\\..\ *     . .\..\...   ..\ .\.. * \.* *...*.*. * .. . . *.*..*    .* . .*.***.\*\  .*\...\.*... *. ..*\ .*\ .. . .\.\**\.. ..*.\* .*...*  .\.*  ..*.\  . * . ..\  * . .\.*  *. .\ .*\ .  \. .*\ *    . .. #
#   #L*..  ..  . * .***. * \.*** *. ..    \ *\ \*..**\    .*.\ .\..   *\ **\ *. .*. .   * \.. *.. . .*..* ..\*.   *.*..* .* . *...*\.* .  .   .   ..\***\**\.\ . *. . .. *\   \ . *\.***.*.\**. ..**..**..***.*.. * ...  .#
#  #\*..*\.\.  .\ . *.**  *. * . *\   *. \  * *..  ..*   ....   . *\\.. \.*\ .  *\*\ .\*. ... . \...  .*. .*...\ *. \\.*. *.* **\. ..*** .*.  * \. \..\**...\.   \*  .\.  .\ *  * ..  *.\.*...**.**... .\..  *. ... . \* *#
#  #.#*. . .   . . ..*\.  ....*...*\. *. .  ...\ *\.... \ \ \.\  *.  * *. . **.\**.*... *.*   .. * *..  .  . *. *.   .\. ..*.\...*.*.\** ***  ...\**\*..*  .. .....  . * ... .\\.\... .*\.\.\.*.\...\.  .** *.*.\.  *...\.#
#   ## .*  \ *  .*\* **** \..\..*.\*..*\.\. ..* . *.\*\. *   ....* . .\.\.*...**. .\*.. ***\ . . \ .*   . . .*  .**\ ..\. .. \\. ....* .**.\..*  ... *. \.**      . . .\\ .\.*.*. * . * ....* ** \ \ .\ *....** .* \  * *\#
#     #\. ..** * .*. .\ . * **\*.*.. ...    **.\. *.*\ ..*\..**.*. *\ .  \**\\...* *..  .\\. * ..*\**.\ \* .\.\. ... .  ** .* .  .*.\\. *. .....*\..*\*..**..*.* .    *... * \... * ... .   . \.\\..**.\ * .*.\ .*\.*.*.. #
#    #..*.** *. *..*\  .*.. . *\*..   .. \ \.. .  .\..    * .*.. .\**. .*...*\*. ...* ** .** . ....\\ ..*  .... . .\*.*\..*...*\...  .  *. **\\  . *.*.* ..*.. *. \**.*** .* \.\ .**\.\*..\  *  . .* * .... .*\*.\  ..*...#
#     # #\ *\.\\.\..***... .  . .. \ * . .**...**\. *...\ .\ \  . ...** .* \* *..  * .* . *.\. .*. .    .\ ...*\. * ....... .  .\ . **....... . *    .*.*. .***..*.*..*.*  \ ..* *.. *.\.\.. .  .\ . .** .\ *\*.*.   *.*\.#
#     ##*#.* . ** \ *.*.**.. ** . \*\.. .*  .*. *. .*.\*.\..*..\. *. *.*.* \* *  *** .*.   *.*\..  * *\. *. **  .. \*.  * .\  .   . . * \*\. . .**.  \* . .\**\**  .*.*.  . .\.  ... .* .\ \.. ..\..* * *..* .*\.\.*  * . #
#    #***\*.**\.. *.**..\\ .. \* .. . .**.\  .. ...\.  .** \.\\.. .* * * ..*... ... \..\ .*..** .*.* .   **..\   .\ .\..*\. ..*\* .\ .\.... *.\.\.*\*\.\.*  .. .* . . . *.*\.  .*. . *\*** *\**..* ..* ...*.* *   ..\ . . #
#    #*.* ..*..* .* . .*\   .**..\\ .  .\.*   *   \ *.* .*  \. . . .\.\* ** *\**.  . \**  .. .*. \*.*** .*......\ .....* *\.* .*** * .*\  *\  . * .*\\. ..   * ..\.\\\\.* .   *\*.\. ...\..  . .\.**..*.**. \.*.**\* ... \#
#   # #*  .\.  * \\. *\*..\  *.\**.  *... .  .*\*.. ****.*\ *.**. * .  \ *... *\*.. \.*.\*\   .   * ....*..*\.\  ..   * ...... . **   * *\...\  .  .. .  *.\.*.**...* ..*.\ \* ***.\. *. .*    * \.\**\*..    ......\* \.*#
#  # #.. *. .\.*.\*... ..\ .* *. ...\...*.. \ *..*  .*..\. ***.**....* .\..*.*. \*.. ** *\.   ..  **..\ \.\. ..\  .***.\\..\..* * .   .*.  .* .   *.    ***..\ ..** .\\ .* *..*...** .*.\*.  *..* .\...**.  .*  \.\*  \. .#
#  #...**** .  * **\\*    ***.\** \*. .*\.. \ \....\ \ .**.. . .*\  *.\ \*\* * . . . ...\. *\.. .*\.\. *. .. \.* * *.*  **. .\* \ ..\ .. *.\* .\*  **  *\.* *. .*. \ ..**. ..  .. *\.*. . \  ...\.*.\...\.    .*.*\..  . *#
#   #* .*.*.** * \.*\ .\. .  \*\ \. \ ...\*.... ...*. *.\.*\.*\ ...*..* ..**. .   * \ .  . ..* * . \  ..   ..  * * . *.\*.\.  *. .  *\ * ** .  ..**....  *. .. *\. .*. \...\ .\.\*.*...   .*. .* ....   .\ .. ****.**.\  *#
#   #....*\.*..\ ..*..**.\*...\  . ..\   *\ . \ \**\**. .  **.*\* \* ..\     \.\.. \...\  * .  .*...  *.....\.\\ .  .\*...*. . **..\.  ..\ .\   ......**  . .\..\ * ..*   *  \.  . .*  \*.  . *\ .\ **...\*..*...  . . * .#
#  #* . .*\ ..  .*.**.*.**\..**..** \.\ ***.*\ ..\..*. .*  ....*\ .*. .*.\  *\ ..... .  ....*  \*\..\.\*.\ \**  ...*\ ..*.\...\.\ ..*\**..... *    *\ . .. ... \. \  . ** . .* ..  ** \\..\*.*\ *\ ..\.\**.   .\ ***   * *#
# #..\..# *#. .****.. *...*.\. . .\     .*. **.\ . ****.\.   ...**...\*.  \... \.. *...  . .. *....\.. *.. .*.   .\ * . .\* \ . ..**..*******..  **\.   *. **\ . .\ *\ * *  .. * .*..*.*.. . .\ .**\ *\..*\  . *. *.\.\..\#
#  # .*** .  .*.*. . \..\ .... .**. * \.*.*....   \..**.*\   .. .*\.*. * .  *.. \* *. *\  .\* *  . **\ \ ** \ . . **  \*  \*\\.*. .\..* . .* .*.**. \.\ \.. \ . *..  \ . .\.* * \.*\ *.. .**   *** \.* .... .. .  \*\*.*  #
#  ###. \ . .*  **.* ..\. .   \......* .  \.. ** ..  **.* .*\ * ** *\ ..... *\. .  .*.*. .. * *.\..\*... .  ..**.\ ... .*.*.* ..*\  .*.\*\..* **.*  ..*.. \. * \..*.\.\.  *.. .* . *.. .\ ...  ... ***\  \..\. ..  ..* . .#
# #.. .\. *\*.. ..\.\ ..\\ *\...\.*.*.  *\. \.\\  *  .. . .*. .\.\*..    *. .*    *..     . ..*\*..... ..\..\*.*.*** \ \.*\ . *** .*... \.. . \.*..    *  ... *.. .  ..\. .. *\*\  .. .     \*.. \...\*.... . . .**..   \ #
# #\  \  \*....\.**.\**...  .    \. \*..\.. . .  * \.\ *....  ** *..   *..*. \ *. *...\*.*  .*\..*  . .\*    ** .... .... .. *\.  \. .**  .*.\ .....*  .\. \. .  ..* \ *...\. . ..    \  \  .. .  \\ *.\ .. . .. .** . .. #
# #.# # ..\.  .. .  .\**  \ *. .\. *   \*  **.\. *.*\ ..\.\*\..**   **.* .**.\.\ ..  \ ... **     \ *  ..\. ..**.\.\* . \ .  .* ..  *.  ....\ ...   .  \*.  ..\*.  * ..*       *.\**.*.... \\ *\\* . .\.*.\..  . *..   \*\#
# #.** *.*..   .  *\.  *  . . .* *  *....  ..    ...*.\..*.\ \\  .* \ *. .\**  .\...\.   \  \ **.\.*. . \.  \ *  * **.* ... *. *.. ..*.*.  \   * **\ *. ** .*.....*..*\   *..*\*.*... .*   ... ..*.. ***...*. .*...*.**.  #
#####*.\.*\.  \*.*     *    ..\.**. . .* *  \.**  .*.*.**..  .  .  . .*.\.**  \*  .*.  ..\* ..* ..\.  . .*. *.*\ .\.. ..**.   **. ..*. .* . ..*.  .**..**.   .\*\ *\.*.\..\*...\ *.\  *\   . .\* ..  ***..\..* .\ * ...*  #
#.  *...*..\. *.*..   .\*.***\ ... **. .*.* *... * *.*\*.\ . .*   .\ **\**.  *.* *\\    * .  .*. .***.* **.\  *\*. .\   ...\..\*\..\*.  *\ **\  *  *** \  .\**.  *  . .*. .  \. *..\  \.. .*.   ..   .*\.  . \. .\**.\ .\.#
##. \.\.\.* * . * ..\. *\.  ....\.*.. ..*.\..  \ .\.**.\*.  . .** \. .. \*. *. * .. .* *...  *\\.  . .*.. \   ** \   .\*. ....*\**  ....\   \.**.  \**\ . *.**.. * .\*\.  *\ .. .*. .. * **   . \*.   .*. \. .*\.*\* .\\ \#
# #\.* \...\*. ..   .*\.. *\.*.  *. .*.....* ... . .*.  *. *\..*.*.*.. \..**.... *\*\*.. \ .\.*.*.*\.*  * \****. ..  .* .\..... * .\...  .... .\ \.\. . . .*.\\\.. \...  . *  ** ..  . .....*.\..  . ... . . *.* *\. . . .#
# #* .\.\\ *. *\ .\.\.*. .**   .*\.**\ .\. .  ..\ . ..\..\  ..\.  ..*  . . ...   *..*.\  .. ..**.*..*.. *  ....  * *.\   \ .\* *\ \  ..** .  *.  .* .    \..\  . * .  .\ ***  *. .\.**.\ *  *    \. .\*  **. *\  *    \ . #
#  ## # . .. .\   *..\. .*** \* * \..  . ..**.    .**.*\   *.*.   *.... . . ..  .*......  *   \** \ ..*  *. .. *..   ..**   .... *..*. .*\ .\. \ *\    *   *.\.. .   **.\.*..\ *\ *. .....\.*.  \.*.*....   .. .**...\. *.#
#   # #\ *  \. .\ .\  ...\... . ...**\.*.\ .\.\ .* .*\..    ***..**** *.\ * *.  . .. . ***. .\ *.*.* *.\ \.....*\*...  ***\*.   \.  .\. .... *.... ..  .*.\.*.* . .* .\ * \\  . ...   . **..\.  .*.\.*. *.* .\. .*. ..\* \#
#    ##*.#** * .   .\.* \... . .*..... .\..*.... .\.*... .  .. . ..*. *.  . **  \* .\.*.*** \ ..\.*...**. . \*\. . .\\  .. *.*\*.\* *..*  **..*    *\* . .\*. ** . **\  * ..\.  *** \..* ......\*.\ ..*.. *.... ..\    . .#
#      # ...**.    .. \\ . * \**... *   *****\  *.*\.\ **\  \.\  .**...  ** .\ ..* .*.. ****. .. \\ .  \ ** **   .     \*\ ..*..  .*. .. *.. \..\..\..  ***\*. *..... *\.. . *\.... .\ . \.   *..** . . * . **..*\ \**\   #
#     # .*. . *\..**. ...\    *.  .\* * *..*..\*\*..* ...  . \.* .\.   **.  **   * .\*.\ *\. ..\*   **..\.*\**\* ...*** ..  .. \ .\.\ ** .... .\*..***\ ....  \*.*\ \ .. \  ..* .*. *.  ..\ ..*.**.    .. .*.   .* .. . .*#
#    #* #..  \ \*\ . .*\ .   .*.\. ** ..\*.. **\.. *.\.   . * . \\ \ .  .  .**\ ** *.\ * ..*. *\* \.*. .. . .* . \...\.*... \  ...  ..*.*.\. .. .*.*...*  .\.*.... *...  *. ..* .*  ** .* .\.*.***.\.\..  *.\*   ..   .  *#
#     #\.. . \ ..*\  ..*.*  *\. . \. *...\\..*\*  .*\..\.\...***. . \\..  .  . . ....*..\.*\ ....*. \*.* .  *.. .. \ . \ \  . \ \  \  . .. .\*..*\ *\.  . *  *\*.\ \.*\.\ ***\.  *\ \.\ *   * *\...*\.***.. .** *.* **\* .#
#    #\***.  \ *\*.* *\... .*.\.* .*\... . .** *.*...\.   \  *..*...*. \*.. .*.\ \**\.    .. **   . . .\.  *\.\  .*\  \ ..*.*.. ..  *. *\ \.  .  * * .  *.* ... .*.   . .*.*.*.*\  *.**.. \\....*\**   .\ \\..\.. . *. \ \#
#     #\.* *. \..*   . .\..*..  .\\ .*.\. . . .\...*\* **  \*.   .\... ... ..* . .*. ...*  . . ...\***\. . . **.\....  .\*\*   .  \**\ ... . *\.. \. .\  .\.* . **  ..\  .*\..*...\..* ....  *. ..** .*.* .* .  .\*..\. ..#
#    ##* .\.*\.  ...\*\ .*.*. *.*.  . ........ .\.\.*.\..  *\. \.*\*..*   .**\ *.**   *\.*     ..*  *. ..*\***\\. * \.\ .***.   ****\ \.*.* *. *\...*.*\ . \.*\\*.   .. .*\ .\.* .  .. * **\*.. . ... *\..\  ...**.\*. .  #
#   #.    . ...**.***.\.. .*.\......*\ \.  *.. ... ..**.***\**   \.   ..\\ ..  ..\....*  .   . * *.*.. \ ....*  *.* .  . ***** **\.. \ *...   *\*\. \..*.. .*.**.* . .. .\.  .  \..*  ... ..\. ... .  ** **.. \ .\***\..\\#
#    #\##\ ** .**.. .  .* .  .... .  .*.\.**\. .  .\*.  . *.*...   .*  ..*.\**\*...*. ...  ..*....\..\...  \\....*.\ \*. \ * .* **.*..*\ .* * .  . . \..*. .\..*.\\  * ...**\ .. . .*** .  **   . ...**. .* *.. *.. .* . .#
#     #*.**\* .***. ...*. * .*.\ ..\ * . ...   .. * . .. ...****\  \ \...\* *....\*.  \ \. ..\ .**.\.. .* . .. *.* *.**\*. \  ..\* .\..\.. . \ \. .. * \..\ *  ..* \. .   \.\  .\*. .. . .**  .* .....\\..**.  .*  ..\.. .#
#      # \* . \*\.. . *\.*. *...\.*....* * *\ ..\ *  . * .* ....*.....\.\ .\. . \ *.*. ..*.\ .  .\*. .  .*.\ \ .\. .*.* .\ .\..*. .  **.\*. \..\.*\**. . . \.* .*.\... *\.  ....*\ * ..*  .. ..*..  . .. *.*  *.* . .* \*.#
#       # *. ...  \ .\.*\.\.\. ..*\ *.. .. *..\ .....**.  ..  * . *\.  \ \.**.** ..   .\.. * *.\ *.* \ **.*\..*  *  . *. . \ \.  . **..\****. \ \.\\.. \.\* ..\ . * \. .. .    *...\.. *. ..*  .**... \\....\ .. ...   . .#
#      ## . . \* *..   .*\..**\*  . . \..\  \ *. **...**.*....   .*\* ..\ **.\** ...\.. .  ..  . \.  . .\*.\*..*\ *\ .* **. *    \***\\ .. .   . *\ ..\   ..  \ *.. .. *.\. ..\.* * .. .  \*...... .\. . \* *     ** *\.. #
#     #***.*. ...\.. .. .\*\**.. *. *.   *. .... .**.*....... ..  ..*  .***..*.* .\  .\\ *. .  *.. \. ..*..*..*\ .  *\..*. *..*. \..*   \.. .\.. *...\...**. .  . *.  \* **\ *.*.* . .  .\.*..*\\..*.  *\..*.\*.  ** ..*  #
#      ###*..\... ..    .\.. *\ ..  ....\.*\. .. \..\. *.\** *\...*.* \. .\.*... \......** * .*. *..*  *. *..\.. * *..  .*\** *.. .\***. * .    .*\..*    .* *. *..  .. **..*\ . **..   \. .. ...*\..* \*\..*.\. ***   *.*#
#         ##.. \ .**.\    .\ .* .***\.\**.......\..*.  *. *. \ *. .\* .\**. *\.\ .  . .**.* .*. ** .*.**.. . ...*\ .\.\ *.** *. \  .. .\ ** *    *..*\ .. ** .    *.  .*..* **.* .** * \. .    .*.*. . ...*\.*** ...*. .* #
#         ## .     .. *   *  \....\.. .\.*...\... .* \.*\ *..*\. .  ..*. ** \.. .  ..  *.** . * ***\.*....\   . ..\*  . . .. . *...  .** .. \*.. .**.*\*  . . .*\....   .\.*.**.\ .. ...\.\. \\......**. \.\*.\* ** .\\\ \#
#        # .  **** **\..\ \  .\  \.*..\*.* .** **.\. .*. **.  .*\ \   ..\ .  \**\*.*\.\.\.. .*\...**...\ \*\ *  *.*\*.R . * .\....**  *.. \. \*\ \*.\. * ** ..\ * * \**. .*.\ *\  *.  . ** .  ****. ....\.  ..***..\* \.\.#
###########################################################################################################################################################################################################################