###########################################################################################
#.\**\ ..\ \ **\.* \. . .  *.* ...*  \. . \. \.**.*.  . .. \..*.*. .  .. *\.\ \.  * . \..*#
#.*....  ... \   .. \ .\. . *\\ ..*.**\ ...... .. *.... ... *\.*.* ....*\\.*. .* * \.\.\ .#
#* ...*\*... .  ..*  .  ..\*  . \*.*\.. . *..\  . ...\..  ....*.    *\ .   . .***.*.  \ \\#
#. .* **. \\ \.\....* \.  .\ *  .\ *    ***   \.*\.\..***.\...\*. .  . .*  \ ..\.*.** \...#
#..*\*\.*.\\* ..* * .\..*.\. \\   ..\.\\...  . **..*  .*.*.  *\..*.   *  .. . . .\ .. .  .#
#.*. *.* ** .** . . **..*   **..*.* .\ . **.......*. .\... \ \ . *.\ *      \ * *** **.  .#
# ** ..\ .* ..\.*\.\.**.. ** . .\* \*\ \.     . .* *.*.\*.\ ..*.. \  \ ** *..*\. *  .\ \.*#
#*\.\**** ... \..  .. . . .*  .**. .*..  *.*..  .\ . .. *  **.  ..*. ..*  ..\* *   .** ..*#
#** ***..*  ... .\.*. *... .\... * *.\* \. .  .*.. *\*. \. ..\*\   * ..\. *. *\*. \ *\ .\.#
#* .*\. \**. \   . . *\ **. ..  ..**   .   .  ..  ..*.\.  ... . * *\*.\.*.....   .*..** ..#
#...*  ..*.  \ \..\. *   ..*. ..*.... .\. . ..* *  .. *  * \.*\.\ \ .\ \*\*  \.\ ..  .*.* #
# .*...* \*.**  \ .*\.  *\ .   ..\* \\  .. . \  **    *  .\.  . *.*. ..\.*. ..* .\ *.*..\*#
#  *. .. .. \. *..**.* * . .*\ *\.*.\.*.\    ..\\.. *.. . *\*\  ** *\ *  .\  \. \* . .  *.#
#\*...... *.\. .\.*.*..*\ ..**.. *.\ ...*  ...\* \ .  *. \.. . *......*\.\ .*.   .* .*  ..#
# *** *.**.. ..*  ..*.* ..  ..  .*   .\   \.\.*. .\*\.***  ..*.\*\*.\ \  *. .\..*.* .*.\ .#
# .*\\..*...\\..\* .. * *.*..   \.  *  . *.**.. *\.*..\.**.... * .. . .. .* \. ..**\ \ .. #
#\.***\*...\ \\ .\.. .\..... **\.  *.*....*.....\.**  .\*.\.\.**. ..\.*. ..\. **..  ..*.\ #
#. *.* . ..**.*.*.     \ * . *\\  \.\..\ \. . .*. ***. .. . *\.. .*  \.* \ \* .. ...*.* \.#
#*.* .  \ .\. \.*..\\*.***..\*...*   \  * . .. *\..\.\ *\ \*\.*.\*.. \ . \. ..** ***. .. *#
#. **. *. .*  *... . ....*. .*\ ...\   *. \.  .**..*\**.\.... .  ..*....**.***..* ..    \*#
#\.\* .\  ..\  * .  .*.. .*... * ...*. .*.   \*\  \.* *.. **..* * .   *... .\*. \.. . *..*#
#.  *\  . ..*  *     .  * **.*..**\.*. *.\.*..*..\.\*..   *. .*.*  * . . *.  . .*\.  .....#
#. .**.*   \*  *. .  *. \...*.* .\ \*  ..  .\***. . .\  * .     ..*.. .**.\.\*. \ . .* .. #
#  . *.*... \.\**\. ..*\.*\ ***..** . . * .   .....*\.**. **. **..* .***\.. *.*..****.. \*#
# *\  .* *\.\.*.*.   *.* ..\..\ \   .. ......    *....*    . .. .\*. . . **.  .. ..\ *\..\#
#  .. .\*.  *\..*\  ...* *    *   ..  .  *.\*\*. .. * *\.*\.    *.. ** ..*  .. *......*..*#
#\**.*\..*.*\.**.*. ..*... ***\*.\  ** \*.. .*.* .  *\.  ..* ..**  .\.\.\.   .*.** .    *.#
#*.. .** * ...... . . ... **\. .. ...**.. \. .*...*.*.  * * *. .\. .. *  ...*....\  . ..  #
#..\. .*. .*\.*\\ .* **  *. ** .*.*.\** * \. \.\* ..* .*.*. * . *. ..\.*   .*..\* .\. ...*#
#\ .\. .**\ *.  .. ........*....* *. .\ .    .***.* .. ...*.**  . .\\ .. .*\....\* *.. *..#
#   .**  ...\  * *.....*. \*.\.  \**\.  ..\.* .\ ***.\.  *.\*. . ..**\  \ .. \  ..** * .* #
#.\.\..\*.** *.* .  * . .**..    .... ..*.  .    . . *..*.*\.  *\ *. .* .\.* ..  ..* .\  \#
# * .*\... \ *.\.. .\.  .\** \ \.* **.*\. * .       ..  .   *\...*   .. .   *.. *\*  *  .\#
# .* . *. * \* .  *\*   *.*\ .. \.\*.\..*..\**   * *. \*    .. *..\. . .  .\. * .**  ... .#
#. .*.\.  .... \ .*.* .*.....*\ . . . .....*. .  ...\  .\** . \   .* \  .  .*.* \.. *  *. #
#*.... .. * .\ .\*. .\ *.*. **.*.*  ..\ *\*.. .     .  \ *  .*.**...*.. ***.* *\* .\.* .. #
#.** *.  *. * .\..     * .* .*** *. \\. ... ..\.*\..\.**..*..* *.*\ . *.*.*...\... .\.\*.*#
#\.. \ .. ...  . *.\. .\ *..\..\    . *\* . \  . ..\....\. .*.. \...  \....\ *\.     *.\ .#
#*.*\. *..*\*. **.\ \  .\.* * ....  * . . *. *.\  . ** *.*  ... ..\. * \  . \.***.  **.*. #
#... \.*. .* *..*  .. \  \.\.**\ . .*.*.*.**..*\ \  .\*.  ..*  \ * . * . . *. ..**.. ..*. #
#..    .\**. *.\ **.    \..... .*\\..\..**. . ** .. *   .* \.*.*.* .*.. \...\***...  .\ . #
#.  . * ... \... .   . .** *    *.   .. ... \ .\. \    .** .**.. \.* .\ ...\.*\**\*... .*.#
#**.*\  . . *  \. \. *.**...* ... \..*.*..**    \\.\ \*...**.*. .\ * **\ **  .**.*\ .\ *\*#
#.**.   .... .\.\ .*......  .  \.*..* *...\*.     .*.\.    ...** *.* ......*. .* .*\..\ ..#
# . *.\ .\  . **....   .\\   *  .  *...*\*..*.  \.\. ** *.  \*** *.* .*.*\*. . **.   \**\ #
# \..*.. \ *\  \**\ *..   ...*.* * \*..*... *.*..\ . ..\ . *..*\\  .\..**.** .\**\*. **  .#
#\  * *..\.\. * **..*.\.\  .\\\\.*.\....... ***\. \* .**.  .* .* *.*.**\. **.\ .\..* .\.\ #
#*.\*.* \..*. ...\ \ ..*. *. \  .*.**\*.  * \..*.*\. ...\   . ..*.\..**   . .* *\.\.  * *.#
#*\ .\*...\ *\ **.\.*.**\. . . .*.*....\*.*  . .*.\ .  **.\  . .\ *.*\.   *  **. *.. .*\..#
#. *\* *\* \*..*.....** *\**\ . .\.. \*  **  *... ..* *.\**.*....\. .**  \.\.* . .   *..  #
#...   . * .*\.* *.  .*.*.*\  .*..*.\\ **...\*..*   ......*.**.. .\\ \.\*.* *. ... .\.. \ #
# \.. . \\ .*  **.  \....*\.*.*\..* ....* ....**.  . *\*\.\*... *  . .\*..**\ ..** \.* ..*#
#.. .** .\  .\...* \...\ .*.**\.  \  * ** .  **\**  ** .. .\..\ .\ *. *\. ... . ... ..\ ..#
#*.*\.. *  *. *... .*  .  . . \.* .. \.....  **   * *.. * ..  ..*..*.*. .*.  .   \* \.*...#
#..*..*.*.. . .. .\\. .. *  **....\ .  * *** .. .*. .*..* **.\ \.  *  \. \ *.\ \ .. .**...#
# .* ...\ *......  .  \ ...*...\.\..  ..  .. .* ....  .*\.**\* .. *..  ..  . ..*.  * *... #
# **.**. .\  * ..\ .\*.*.\ **\...*..*. \ . .*.*.*..* .*. ..\    \ . \* .  .* ..*. .. *... #
#*\  ... .*  . ..*  .\..\    *.*.  ... .*..  .* .\..\ ...* .*\ *..*. \ * . ..*\. \.  *** .#
#.***. \....\.  ..*\.**   . .. ..***.\. .*.*. * ..*\. * .\. .*.**** ..\. .\ ..  *.*\ \*  .#
#*..... . ..*... .**\**\*  ..   . .* . ...\.**. ..**\ . \  .*. ..\ *  * * .  .. ..\  *\.  #
#.\.*.*. *\.*.   \** *.** .*  .*   ..  *\*....  \*...   .*.***\   *. .*\*\ * .* *..** .. .#
#**\ . . **.. .* .*\*.\.. .* \*\ \ *   ***.\.. *.\** \.* *.\.\*   **..**  ...**  .*   *\ .#
#***.   *..\\.**.\.\... .*.\..... ..\.. *. .*  .. ** **. ..*.***...   ..* ....  ...\* ... #
#. ..** \.*.* * *. .. \...*  ..  .*\.*\ . . . . *. *. .\*   **.*    *\.\*.\ ** * .  .\... #
#\.*.\\* *.\.\ .  ...*\.\*. * .\. . .*.*   ..  . .\**..*\*\.. \ *.\.**\ ..*\.*.*  *....*  #
#. \*  **.***.\ **.* *  .* **\ *\.**. *. * *\ **  \ ** .\\.\.\.*...\..*\.\*\ . .*.*.\ .*.*#
#\  . .**. ..  *.\.*..\*\ *. ***.**.\.*. ..\.\.. ...\.* ..*.\*\. *.  *.** . .\.....*  .**.#
#. * .**.     .. ...\    ....\*.*.*.   .*  * *... .*. .       *  \ .\.... *   .. * .* .\  #
#\ .\*...*\.  .  *.\*. .*.\.. .*.*..*...\.\.*\*** ** . . *  .**...\\. .  .... *. . *\  . \#
#. * .**.**\ \****.**. **\ .  *.*...*\ .  . .*\*.  . *.*.... ..*. ..   *. * ***.*....   .*#
#\..*.\ *\. .**..   .\.... *  **.   .**.**\  . .* . . ..*\.*\*** .**\*\. .*\*....\**\\   *#
# . \* **.. * ..*...\. \*  .  ...  .. . .* \*  *. \  .   . .....\.*\ **   .\......*..... .#
#    . .\ *\ *. .*.  . .*  .. *. \   *.*.* *. ..*..   *  \ *... .*.**.*   .*.*. *.*\ \... #
#**\ * *. .. .....*  ***\..* \.\ \.  ..*.. .*\  \   **.\ .*.\* .**\*\ . .  .  *  *\..\    #
#*.. . *   \ * \ \.\**.**.*.\. .\.  .*. .. *  ...*\\.* ** *..   .\. . *.\ *\* \..\ *\.\***#
#....*\* \\.** . *. .\..\.***\. *\ * ... ...*  ....* ...*.*\ \\.\**\. \.  . . .\   .....*.#
#*\  *.  .\ . \. ** ..  .\..*.*.. .\ *\... *\   ** \ *  ..* *.. .*.*. ... \**...\.... .. .#
#*.*\.*\.   \.\*.*  \.* ... *.. ..***. \*. .. * .*... .  *.*\.  \. . * .*. ..* .\ . ***..*#
#.*..... *\ .. \ .  *   ** .* ..  .*.. *****\ *\ .***\ *..\..*\. .  \.  .    \ * ***\*....#
#* *..\..*.* *. *.\\.*\. . \*.*\.\. .   \.\ *. .*. ... .    ....   \.* *. ** . **...\*** \#
#*.**.**  .  .\.*\ . .  .. .\.* *.** ***  . *...* \*.\ *\.  .\** ..*.*..\ . \ *.**\*..\..\#
# ...*\. . .. .*.   **\ \  * *. ...  .*...*\. **.  *. .*.    ... . .\*...** ...\** **.... #
#. ...**   .. .\   \..*\.. .*...*.*. *....\ \ *.\.\.*  . **.  \** .*..\.\.* \\  .. \...*.\#
#*..\ .*..\ \ \*.. ....R .. * * .\..\.***\  . \*. . ..*\ ..\*....*.\.\*   .\ **\*\\.  *\..#
#. ... .*   ..*.. .      *\*** .*.\.*.....*  ..* ** *.\*\ .*.*\ ..****.* *.  .***.   *..\ #
#.. .. .*. .  \ \  * * . ...\. .. \.** \.*.\*.\..**** ...  \. **.*.*..** . ..*. .\*. ..   #
#.\  *. ..  ... .. .\.\.*\. . \...\ \ .. * *.\. \. **.. .\\  \.*..**....  \. ..  *..\. .  #
#...*\** . * .   \ .. \*. ...\ *.**.. \*...**\ ..**.. \.. .. ..**\\ **  .*  * .\* *.. \  *#
#***  ..  .** .\ ..\ . . . . *.* \*.\.\**...*  \..\** *\. *. ..*** .\*\.*..*\\  *.*.*\. ..#
#\ \   \\*...**.* \..*. \  .*.  *..\ ..*.*. .*.\... *.. \.. .. * *   **......\ .\....  *. #
# .*\....*.. .\ \*...  . *...  ..    .** *. .*\ . \. .\*.* *   . . .  ..... *.. .* *  *\. #
#.\ .*..\.. * ..\.\.\.* *.* *\...*..\.*  .* ..*   \ . *. *. .*\..*\  \\ **. .... * .*.  * #
#\..*.* . *\*\  ..* .*.*.\**.* .*\ ..*..* . .**\ .  *.   .**\**\*. *** *.... *.\ * .*. *..#
#\ \*.\ **.*... *..  . ..*.**\ .... \*.*\ \. *\.\..\.  .* *\ .. . ..\*\**.. .*\*.*.*. .. \#
#.\*.**..\*.*.... .*  . *.*..\.   ..*. \*\. .*\\ .  * *.* ..*..  . \.\**\ *. ..*\.\.... \.#
#...\ ..* ..   \\ *. \.\\ ....   *.*. *.**.*..  ** ..*. .\  .  * .*   \..**..\ ..\ ..**\..#
#..\.*  \ ........*.  \.   .... .. .* . .***. \ *.* ....*.. . *\  *   ...\      \*** *.* *#
#  * .* .*.*  \  \.....\  *   .* \  .. . * .   .*.\*.*..\*.**..*  *.**\**...\.\..\.* *.*\.#
#  . \..*. \.*.\...*.. ...*\ .\. * .  \*..\\*.. *... *. .... ..\.\* .*.**\  . *.   .*.* **#
#.   .      *. *... * .*\.... *  . *\ ..... .* \*.  ..   .. \\ *  .\.*...   **\. \ ..   \*#
#*. . \\..* *\.*  .\.  *.   . \. *\. . *.*** . .**\*\.... .*   . *   **\    ..  \* .*.. .*#
#.  \ . \ \\.. \.\.. .\.  *  *\. **.* \****.  . .*... \\..\..*\***.  ...* \\. .*..\*\. *\.#
#. *......\\ * ..* .\*.  ..*.*.. .*.*.\**..     \*. \..\.\ * **\.* .. *\*  . . .*\. *.*.  #
#*.*** *\*  .   *. ..\ .** .*... *\ *\ .*.\..\  .*.\.  * ...* *.**.  . **  .**.\ .**..*\ .#
#*\*.*\* .  **  **\*\.....\*..  .\***. .**\*\*\... ..*.*.**.... .   *.\...\ *..*  *...... #
#* ... .*.. .. \.. \..\.  .*  *.* ...**\ .*. .. .  *\**...*\ .. *. ..*. *\*\. *\ \*.. ***.#
#.*\*.* **\*\ .\.\ . *..*.*. *. ..  .*. *  .  .\ \ \**.   \*.\*\..   *    .** \ \.*  ...\*#
# ..****.**..** . .\..*\*.....\.   .... .\  .**... .*.\ . * . . \  **\*. *\*. *\. .\. .***#
#\*....\ ..\...\   ..*\..* .*.  .*..*\ .*.*. *.\*\\ .   ***.*  *.*.\.. . \ .\*\.\\..**.. *#
#. \. ...**.  .*.\*   .\...  *  .***..*..  .\.    **... \.*.... ...  ..\... .\*..* .* .*..#
#...\.\ ...*..\*.**. \ . .* \\.\..**.  *  .. .*.\ \.*.\ .  .\ .  *. *\**.\*.\.* \. .**\. .#
#*\   *.  .. .**...*.*.**..   ..* *.\..\  .  .*..\. .**.  \*.. . \...  .*..*..* .\ **.. *\#
#.. .\.*.. \ ...   * .  ..\.   .*.*.*.*\.  ..  ..* \ . \  ..   .  *. *\  **..\. \ .*. * **#
#..\ .*.*\...*\.\**. \..  . * .*..  \.** **\  **\.*\..*..\.* .. .* *.... .*.\*\..\.\. * ..#
#** *\*.. .   .  \\... . * ... * **.. ....* \**. ...\ .*\*.... .**\  *\ * * . ..\... *.* .#
#*. . \ . *   *\.\*   ..*..\  .\*..  ... .* .. .  ****.*.. ...  ...***.. *\ .  ...  ..*..\#
#*\..\***** \.. .**. *..*. *.\*\.. ..*\*. .*  .. .**.\ **   *.\** ..*.* ... * ***.... .  *#
#***\ *** ..... .\.*\.\ .\*..\..*. ..... . *.. .\...* ..   \.  .. .\.\.* \\.. * .\..* * .*#
#..\.*\ .* * .  ...** *.  **..*.\.*.      ..*\\ .   *\..*\. \  * .    *.*\.  .*  *  .*  \.#
#. * *. * ...\.\.  ......*..\\*.. ..**..*  ..... **..* *.* * ..*\.... ..\.*.  *\** *.\ \ \#
#  . \**.\ *.. *.**  .*.\. .  .* \**..* *  *\..*.*...  .\*.\ .*. \.\*. .**\*  ...*.**.. .*#
#\.\.*.. * . .. \ .**..  *\*\ .*\.\......*.\* \.  . \.\.* . *..\  **.*.   . ..\ . ** . *\.#
#. * *  \* . .    .....\.. ..  . .**..\ \....*.    *.***.  \. .*..*......   .. . \** * ..\#
# .. .. ..*\  .  . .* *\*..*\* ...*. ** .. \.\.*  \.\**. ** . .\* .\. \ *... .\*..*\ .. ..#
#\*  *.*  . .*. .. \.\ .\  .*.\ . \.\...  . .*\* .   *.   ...*. \.*.. ..*\..*...*****. ***#
#.* *. ...  .*.\***...  .\*.. *.\  . * . ...\....*  ...\.* \ .*.. *\. ...  *. .  ...**..**#
# . .**. * \ *.  \*\*.\ * \ . .* .  .. \ \. .  .*....\***..*..\ \..* *.\ . .  \ *.\\.**\**#
#. .*   *.. .....   * *.....*.. \..**. ** ..*\ * .. \ \. *.*.\*... ...*... .\*. .** .\. ..#
#  *..* . *. * *. *.  ...\..   . \*\   .. .*. *. ...  .. ****\*. \*\  *..*  .*.* .* . * . #
#. *  ... .. . **   .. ..*\.* *\ .*. \..\. *\**  \*\\  .\*\.*  \ . .*.\. .***. *  .*..\.\.#
#.**. . \.  * .* .\\. .\ .*.. \ \. ..* ..\.. *. *..*.* *\ .\.  .  ***  ..*.*..\ *.\    .. #
#...*..*...*\ *.*.*.. .. ..**  \.\ . . *..*\**...* .*.\.*.  *....\.*.   .\ ..\* ....**. \.#
#..*....*.\...\ **..\ ..\.*.....   .. *.\*. .\..*.***.  *\*\.\\*.. * ..* .  . .* . .**.\..#
# *.*..  *. ..*.*..\*.* . . * ....   ..\.*  *.\\.*..* \ * *...*     .*\*..***.\.*.\ *..   #
# .**.*\*.\..\**.***. .**.. \. **\.\   *.\. ..***..\.\  *\* *..***\. .  .. .*\.\. . ..\.\.#
#  ....\ \\* .*\.... ..**.* . ...  . **. *\ * \.. * ... ...\.. ...*    .\.  . \**.  * *  *#
#.* **     . \  .. \.. **     .** \. \..  . ...*..*.  .*. *\. ....*\**  .\* *..  ..* * ***#
#  ..*\*... .. .\. . *.*. ...\  ...*\\*  .*   ... **. *. \.\\.\**\ . *  .\*.\*\..  \ ..***#
#* ... .*.*.* \ **.\.*  . \ *.*.*\*.*.. \*.\*\.  *. .*.\ .. ..*.*..... .* .**\*.\. \ **\..#
#.\.  . . \ . . . .*  *.* .* *. .\..\\*... .. * *..\*....\ *.*.*. .\* .  \**..\... .   . *#
#.* . \ \     .\. .\. *...* .  . ..\... *\  .. .\.\ . .  *...  \ *.**.  . *. *  .\. .* * \#
#*.*  . ...\. .* * .* .. ..\*.\*. \. \. ..\.* *    **   ....\. .*......  ..*** . *  ....\ #
#\\\.** \.\ \... .\ *\ \ . .. ..   .*  .*.... \ . .**\.\ ..   .... *.\ ...*... . . \* .\ *#
#... ..  .*. .*.\*  *...\.   ....*  . **. .. . .* .*\.*.   ** .\* ** *   ..\   * ...* *..\#
#.. *\ . *. ..*. * ..**. * .*.. ..***  .\. .. *.*..*. ** *..... .\.*\. .\..  *.  .\\. .  *#
#\*. .*.\* * *.*\.*...*.\ \ * .**. *.....\.**.*..\.\.  \ *.. .* ....* * ..  .*.\  ..\* .  #
#..*\*\. .**.....*..\*... \..\ .. ....  .**\ *\.***. ... *\.  *\.** .**  ***\*.. . \.\  \ #
#*..* ** .\ .... ...*..*.  *\. .\   .**.  . **. ..  . \  * .\  ..\.  .** .\  \.\*\ .* \  *#
#.  .\.*.   * * \ *. * \   ..\.*. .\*.*.*.. \\*. . \. .*.. *.. \.** .  ..\.*.... . ...*  *#
#.   . .*\      ...*.. . .. \* .. .\.\. \ \**\.. *\.**.* * .*.\   * *.  *.*. \ *..\ ...\  #
#\\..* *... \.  * *\      .\ \*.. ** .*   .*.. .*\  *\\.\. ***.* .\...\ *.*.  **\ * \* *. #
# . .... *\\\ \**.*\  ..* \*....... .  *\\.\.\* **... .*....***.   .*.*.\*.. *\.* \...\...#
#.\.... .\*.\*. ..*  \  ** *... **** . .*.. . * *. \*....\ * *.**.*.**\. .. ***....\ * . .#
# .\* ...  \.. .. ** *.*.*.. \*** \**   **    \ .  .***  . .....\**** .\ .  \. .  ...\*\\.#
#  * .*.\* . . *.  .*\*.****.\  . ...* ...  * .. \. .\*  ..  \ *.*\   *. .  .\.. .....   \#
#  .   . *\. *. *.\*\**...*...*....\*. .\ *\.   \.. * . . \.    . *.***\. ..\**..  .**\.* #
#.* .\.  \ * ** \...** .\*.\ \.*\** . .\ *.. . *.\. ... \ .*  ** ...\.. .*\ .. . **\.....*#
#*.  *\.\*   ..*.*\\.\  \.\*.\ .*..  *.. \**.\..\.*\...\.. *.  * .*.*\*.*..\\*\**** .*. *\#
#*#\  #.* \**.  **** .**\ *  *.\... *.**...**  . *\...*.. .\..\**\**\.\..*..\. ..***\.**..#
##\...*#*..*.\ .\.*. .**  *..** .*. .**..\...*\.\.... \. \ **..*.. *.  \ \ ..\.*...\**.** #
# #\..\*# *. .\. .*   \. .\. .* ..  *..* ..... *  *\.     .*.\.*.. .  . * .*.**\.\  ** \.*#
##   .## #*.  .\**.  *.\  .\.*..    **.* **.. .* ...  .**  * *  .  .\*\** ..*.. *...*.....#
# # **#  #.\. .*.****\ *\. *\.\**  *.* ... . ** \ \ .*\*.  . . .\ \.*....\**\.. .\* . \  *#
# # ##   # ..* * \...  *   ..* .. . *.  **\....  ..\ *.\*.\\..    .. .* ..**.    *. *.** \#
#  #    L.\*\*\**.*  . .   \. \.\. .* ..\..*\..*.*\ **\ *  \ *.* .  . ..*..... \*.  *.* \.#
#        ##.*. .  *.*\. .*.\.*..\*. \ . ** .*.\..*.*  . * *.. **\\ *    **.*\. .\..** * * #
#         #\. ***.*\. .* **.*. \.*.* ....* ..\* ....*\ ****\.*. .  .\.**\.*.*.\ \ .. * *..#
#          ###.*\... .** *. .\. \.... .*.. *\*.. .* ** ..** ..* .. *.   **.. .*.\*.\... **#
#             #.* \ *. . .    *** ****\**.. \*\.\*   **\* \ .\.. ...*** ..*   * * .....\..#
#              ##.\..\.  . ..*. .\. .....   .\...\.. . *.*  ..* * .\.*    **.  ... *\..*.*#
#               # .. \\ .#\  \ \ *..*. **  . * .** * *\*\. .  **..*  * \ *.*. * \... ..***#
#                #\*\ * .  *...  .\*...** ...*.*..   .* *..\ **.***. .*. . .. ** ..\.* .*.#
#                 # *##\ *\. *\.  ..\ ** ..  . . \. .*..\.**....* *.* .. *... **.\..\.* .*#
#                 #*##...\   * \.    ...*. ...\ ..   .. . *.\   * \.. .*...*.*.  . .   .**#
#                  # #.#\  . .\ . .. .. .\**\*..\. . *\. . \ . *\ \  *.**.\*. .\*\*.  * .\#
#                   #.*. \**. .**   ***.  \\.     *\.**..  ....*\...* **\ .**  ...\\ .**..#
#                   #    .* \.*.. . .*\.\ .*..\\ .. *   \ \ .... .***..**  *  .  .* * *.\.#
#                    #\*\ #\..*.   *.. . .*.   \  . \  ..\. .. ..* ..*.*.   *\*   . .*..  #
#                    #***\**..\..*...*. *.*  * .*\\ .**.* \ .** ****.\.*..\...*\.**\ *. *\#
#                   #..** .**\**\.\ \.. .. .**\ \.**\...***. \* ..... .*. .. .. \*...   * #
#                   #*#\  .#..*\. .\. .\ .\.\*    **.   ..*  *. *. \  .  \\ .*.*. * * .** #
#                   #\ . *###***.* ..\\*.  ...\\.  .*. *  .  ..*.*..  \... *.. *  .. *... #
#                    ##*..*\.*\*..\   \.*.*.\..*.  *. * . ...*\..*. .  \ ..***..***... .\.#
#                    #..\ *#.#  .\.. ..  .***. .*\.\ ..\ **\ *.* \*..**   ..\. *.*.\.*..**#
#                    #.\#.. \\.*. #   .*\ ***.  .  .* *..\* ..*.**  .** .\..## *#*. *\ ..*#
#                     ## ### # *\ .  * #..\.#.**   *.*..  * .\ ..  .*..  #.\ . .* . ..*\ \#
#                           ##\. \*.#    \  \ *\\*.* \. .*\  *.\  . ..\..#. \##.#.  *\..* #
#                            # . .  \.*#\.##.**.\.. .*...*... *. *.*\*# *##.# #  .  . ...*#
#                             #####\ **.*#.. *. *..*...**.*   *. #\*...#..#.#  #.\. *. *.##
#                                  #....# ##**\ *.**. .*  . * *.\  #### ## #  #\    ** \.\#
#                                  #.\* #  #*####*.. ...\*\ .*. .#*#         #*..  *\*.*..#
#                                   #*. .#  #   ##**.\ \ \  . .\\..#          ##*\   ...*.#
#                                    #*##      #  *\.*\. \* *.#.*##            #* ..\ * #.#
#                                     #         #*.  .*      . \#               #\* * .*#\#
#                                                #.**** \#.#**.#               #.*#.\* ...#
#                                                 #\#..\ .*####                 #. ..#\..*#
#                                                 #.# \  ##                      #  .#*####
#                                                  #*\ .**#                      #.## #   #
#                                                   #\. #.#                       #       #
#                                                    ##*##                                #
###########################################################################################