######################################################################################################################
#                                                           #.#                                     #                #
#                                                           #.##                                  ##*# #  #          #
#                                                    #      #...#                                #\..##*##.#         #
#                                                   #.#### # * ##                                #. . \ #*.*#        #
#                                                  ##\**.*##*. ..# # ###  ##     #  #             #* .# .#\ *#       #
#                                                 #\. *. # \.\*\###*#* *##. #  ##*## ###         #*#.    # *# #      #
#                                                  #.*.  .\. *..#\..##..\\.**##...\#*#..#        #*  \ *.##. .# #    #
#                                                 #.##.. .*\*.\  #.##\#*# ####***. \   #        #**. ...* # . .#*#   #
#                                                 #\ ...... . . #.*\. ** .*.#..*.. #.*##     # ##.** *#\.*\..  *.#   #
#                                              #   ##\\..* ...* *.* ..\.\\*  \#*.**. .. ##  #.#. \ \ ..**.. . .*# #  #
#                                             #.#   # .\\..\ ..  .\   #\.\. ..*\*..\ #.   ##...*\.   .*.*\*. . . # # #
#                                             #*#  #..  .*. .*\  * .\*\ \  \**.\ .** # *... ..** ...* .\....\*  .**.##
#                                             # # ####  .\ .*... ..\*\. . ..#*. \..\...\. #*.\.. \   *.. .   **.#*## #
#                                            ##\## *.#  . *.*..  **.*.**.  \.* .**\*#..#\* * .*  ..\ .* *.* ..* ##   #
#                                           #*.. #*.*.\..*. . **. *.. .... .. \*.. * .* .*.\  * * .*.  .. \  ..#\##  #
#                                           ##.* #.#.. *\. .\..**. .*  * .*\. ..*.. * . .* **\***   *  .. . .\*.*#*# #
#                                          #*# . ..*  * #\* * *.\ .*..\..* *..  .* \.  #.*.*\.\.\. **.. \ *   . .#..##
#                                        ##\*  **.. .*\..  .. *\*. *. .*\. .  * *.*.  **.. \ \ .*..  .\ ... .. *\  \ #
#                                       # .#   ... #.*#  **.\\. *.\.*.*.\    . \  ...*.* ..... * \.  ..*.#* * .* *\**#
#                                       # .##.\ \\ . **.* .. \ .  ... .\*.\.**\.\   *... ..\ ***\  **.\....  ...  .*##
#                                      #.  .*.   .*.*.. .\.* \ *. **.. *..***.\  .. . *.\ .. .* *\**.  *.*.  \.*.. \ #
#                                  ##   ##* *** ..\. .\.*. *\..* .....\.*\...      . . ..\**\ .   ..\*.\\.  .. *. .. #
#                                 #\.## ##*.**.  ..*. . .**..\*.\\*\... \**\ .* . . .  *.\*.*.*.*.\ *. ..**.*.\  \ .*#
#                               ##***  #*\.**.\.* ...  .*. *. .** . *\ \....* *.**. *.  ..  ..*.. ....*.  .** **..*\.#
#                              #  ..**..*  ..\  ..   .. . * .* .\   . *.**\ . . *..*.  .. \.  ..  . *..  \.\. \   \**#
#                        #    #.# \.*##. .\  .*  \*.\*\ *   *.\  *\   \... ** .* .**. \ .  .\*.  .. *\*.... *\. .  . #
#                    #### #  ##*  ..\\#   .\.** \* .\*. .\ .\. \.. \.   .*.. .*...*.*\.*\\  ..* ..*..**.\ *\*.     \.#
#                   #\..#..## ..\*\#.*.#*\.** *  .  .\  **  ..\\ ..   **.  ..** . ****...\*..*.  ... .\*.*.*..**  *  #
#                  # #\. ..\#L   ....*..** \. . . .\ .*.\* ..**   \.* *.*\...**\ .\.* .  *.\...\..\. *.*..*. *\\   *.#
#                 #.# .\ #*.*.\#*\.  .  .. \ .  .*  \ *  .\. .   *.*\ *... . .  \**\ ...*.\...*.*. **...... * .*..*. #
#                # .# *  *# .\*\\  .   . *\... .\. \.\....\.\..* \....\\.**\*.**\.* *. *.* ..\* .  \  .\*    .\\* . .#
#               #* *\   *** ..*\.\*   .* ***. . .. .*** .* .*. * .\..  . ...\ .\**... .  **....* **.  *...\ .*. .  \ #
#              #**.** . *..\. .\. * * *\ **  *..*\ .*.*  . \.*** ** * ...* **   .* \.   *\** *. *** .*. . . *. \.*..\#
#            ###.#\ .*\ \......  *  * .  .\  ..  ***.*.* ..  ...*\.****\*\. . *. ... .*..*......\..*.. \   ...*. ....#
#   ####    #* * #   .* . \*.* **\.\. * *.* .\ .\.\. . .*. *\   .* .*.\.. \.. * . .. .\ *.\*.*\ .. . .. .   ....\ **.#
#  #\..*##  #*#**..  *   ...*. \..\.. ..... ..**.\.\ * ..  ...***.  .*..  .*\.*   * ... .*..* .*   .\* *** .  \ . ** #
#  ##*#\..# #.*\. *.**   *. ....\ **     .\   .... .*** *  *. ... .. .  \*\* . *\......*  \ .\.\ \ *. .... . *.. \.* #
# # #.*.\ # #  #.\ \.*\  .* . . *.\.\ **  ...\ *   \*. ..\ * .\ * *..\.\.... .**.   *.*.*. . .* .\ .*. **\\ ..*.\. *.#
# #*#\. . *#. *.\    .* .   \. ..  .*\ .....*. . * .** .   *.*. .\**.*\.* . *..\ \\..\. *. **.\  .* ...*** .\.   ..**#
# #* *   .. ...\.   ... \* * .  *..  ..\.\.. *.  .  *\ \* *. **.**\. \.  ..\*\   .  \. ...**. *   .\..\... *... *  ..#
## *\... *\..\. ..**\  \. . .  . ** * *. .  *..   ....* * . \.* * * \ \ *.* .... .*..\. *...\    .* . * * .*\ *.. *.*#
# #\  .\. ..*..* \ *.    .   ..\ \..\ ...** ..*.  *  .\*.   ... *\.*. .\. **. \*..**.*\ .. \  .\*.  *..  * . ... *. .#
##. .*\.\.   * ....\** .       . .  .. \ .* . \.\. .. *  .....*..**. \.* ...* ..*.*\ *..*  *. * ... *** R\\   **\..* #
# #...*\* \*.. *\..\ *  .** \ * .   * *\* *.\ .\.. .\**\*.\ .*.**.\*\* . .\**  \. \.... *.*. .. **. **\\*.. ..*...\.*#
#\. *\..*.\.**.. * . *. **. .*..\.. ***..*... *\*  .*.\ .* .**\**...*\.*.**..    * **     .*..  .** *..\.*..\ *\** *.#
# **.\\**\*\..\*.. . .\  .\. **\*.\..**. . *. .*\  .. .  .\.*. ...* **\ ... ..*. . ..\*.*\*\ .*\*\. .\* *.. .  *..\**#
#..\...\\\\..\*\.\. * *   *..* ..\\\ .  ..\  . . .. *\*.   ..\.* .  *\  .*. . . . . \*. ..\.. *..  \*.       **\.\..*#
#.  ..\.\ .   *..*  .*. \ .. . .* *.*\   .. . .. ...\*       ..\  .**.** ..\*  .\.*\ . . .*  **.. *..\ \...****. .*\ #
#*.*\. *..*.\ .  * . .\.  .\*.\  .\ \.  * .  \   \ . ... **\*\* *.*.*  * . .. *..*.*.*\..\. *...*\*  ....\*\**   ..*.#
#.***. **\ . *  .\..\* \ * . . \ *. ***..\ . .  *  ****    *\ .\.\* *. \*.. * \ \ \. \  \ ..\.****.  \\\*..... *. .. #
# ... *..*.  .\.**....****. .\..*. *.\. \.\  .* **...\.\\**.\ \ ..*...*.*\ \* .*.*.*\.**. *. **.. ****\* *\  \\..  \.#
#.  . . ..*. .. *.. **...\.\     .** ..*.  *\ ..\.. ..*  .. **   ... \ .* . .\\.*....**..\*.  . ... ..*.*. **.\*.. .*#
#* *\..**\.   ..*\. .* ..*\.** **...* \*   .\ .* .. .**..* .*.\.. .*.   .  *.   \ .\*.. \*      .* *  ....\.*\.. \. .#
#.. . *..*.*\.. .** *..*.* ....*.  .  \ * ..*.\ .*. .*.*... .*. \\  .  . .. . .\.***. *.\*** *.\...*  .\. .**** . . *#
#*   .\  *..\ \ * ..\  * .* .\ **. *....\ *.\..\.    ..* *.***.*. * . .. *. \* .\. *  ..*..\ .\.. **\  \ \***...\  \.#
#.\\   .**. *.. .* \.* .* .... *  \\. . **.*. *.. .** *. \ . **\   . * *..*\...\. *. ****\*.. .*..\*..*.**.**\  ....\#
#\.. \**..*.**.  *.\.. .. *.*. ..  ..\ \ \ .\ *\   . *.\ . *... . . **  *..    *\ .. .*...\ . ***.** \*\... . * .  *.#
#...   .*\. . \... *\ .*  ..  \**  ...\....*\.... \* . . ..* * *.\.\\* .. .*.  \*..*.\ .*. . ..\  ...*... \.*\.*\*\  #
#. .\.  *..* * \*.  ..*.\ ..\ *.*.\. ..\ **.. *.*. * *.\ * * .\. * .**. .\.*\..* .*. \.\. ** * **\ .*. .\  ****..\...#
#*.\  *\.  \ .\.. *.** .*.\ ..*..*. .\.. **. ..*   . *.* * .*. *  . .\*.   . .\\   ...*   *. .*......\ \ *.....*. . *#
#.\.*\.. *. \ ... ...* *.. ... ..\* ..  \.\   \ .* . ..*   \*.\*..* * .  \.\. ..** *.\. *..\*\*\..\. . .. ..*.\. * \.#
# .*..**...*..* *\  ..\.\.. .  * .*.*..*  . * . *.*..\ *   ..*\*   \ **\\...*. ... .\. .. * .*... ..\ *.   \\*   ...*#
#*...*. .  ..\*...*\**. ..\\*  *\ .... ....*.. .***. .  \ .   ..* .. .. *..\.. .*.\. .\..\* \** *\*..*..  \. ***  \..#
#.\*.. .*. *. .* .. ... *   . *. * ** *** ..**.*...*\*.* \.\.* \*\  ..\ \.. .   ***   ..\.* ..* .*.     * . *.*. *   #
#.*.\   .\.   \. . ..\\.\  .  *.*.  ..*.**  ..* .....*\ .\....\...*.*..*.\ ..\. .\*   *\. .. \.**\** **... \**.*. *.*#
#*..*\*.\  *  .\. *. ..*. *  .*...*.... ...*.\...**... .*.*.. . **. .. .*        \.\.****. .\ ... \.*\.    ..*\..*.*.#
#. ....   *.**\ * \* \\.  **.\  * **.  * * .*. *\. * ..** \.\ .*\.\.\\.*..*.*.  .. *\.. ** . . .\.  .\ *..  ... ... .#
#*    . ******. .* . ..  *...** . ..**\ ...**.\*  \.. *.**. *  .*... ...\*. ...    ..\ ..\  .\***   ..\*\ .. .\ *.* *#
# .*\\** \*.\.\ .*\ **..*.*..\ .* . \* ..  ***.\    . .\.***  **..\.*  . *.. .\*.. .*.****.*.*  .\. **** .  .*. ..* .#
#\....\*\*. .\.*.\....*..  .**  ..  .*** .\  *    * *..** .\  .\.**.* ...\.*\ .. . *.*.*\.\ *\** ... .\.*\*....   . \#
#...   . .. *. . .*\..*.\  .*  . .\*.*\.**.. . . . ***..\   * .. *.*.. *   *  .* ...\. \. .. ...  . .\.*..  \   ** ..#
#\   * \ .**.\.* .*..*\ ... *\\ *. **. \..* .*\*.* .. \.*..*...\.. * * *.*..** \ . *..  . *\ .*.  ** .\...  ...*\. ..#
# .* \*.  *\* .....*... *.  . \...***.\   .\.. .*. \\.. .***..* \.\....*..\*.\\ .  ..   **\ . **. ..\.*.*\ .    . .. #
#\ .*  *.**\. ...\ **.\...**\   ..\.*. \.*.*  .\.*.. *  ... **... \ . ..\ ....\*\.**. \ .*..*..*.\ ** **. . *  \*.*..#
# ..*\... ..    .. .*** \*\\ .\\.*.\.*.\.*. ..\. **. ...  ...\** *..*** *  \ *....*.   . . .. .\  .\*.. \ *\.* .*\**.#
#\**.*  \*\* \.*...\.*\ .....  \ .\.\****\ \* .  *.*.  ..\  *.....   ..\  * * .\ .\*..* \.. .**\ . .**.\...*    . ..*#
#\...* *.* . ..\* .*....*\..*\*.      *.\.* *.. .. .*.. .\. .\\*\* **\ * *\*.   .  \ .**\\ \* \* \. *\***\    ... * *#
#..\*  .**  * ...\..    **.\. ** .....\ ** *.* ***..  . .*. ...*.. .***. .... *  *..\..\*. .*. \.. \.*.\. .***..\*.*.#
# \.   \.* *.  .\*. *\..*...\... *.**\ \ . **. \**\  *.\\.\  * .**. *.*.\.**  \\..  \ ... .*  ***.*.\.  **.*.*.**. \.#
#  **.*\***.* *.** \.\. ..\* .. .\\.*  .  *...\ ..*\*\\ *\\  \ .*.* .     * . *.* .\  .*** .  \..*.*  . ......\...*. #
# ..**.  ..*.  ***  * ..\. *  .  .. .  \**.*.*. *\..*.  .\*\*...* .\\ .** *  .*.....\ *...\**\.\ \.  **. .  * . .*.. #
# .. * . . . **.*. . \...** .* . *. \...*...\ **.* *.\.*****... *\   *..\.\  .    .*.*...*..* ....\*.\.. .. . *. *.. #
#\   .*.\\   ... .     * \..*.**\.**..  **\ .* \**. .* . ..\*. *.****. ......**.....\...**  *\.\. .......*\*.\.\ *\\*#
# .*. .. . **.*\. \****..*  *..*.*..*\**..  . .....\*....  .. .. .*...\  *.*.*\* .*  ..  .*\..\.**\ .... . \..\* .*. #
#  ...*..**. .\ *...*.. \... .\. *.*. .\ .* *. **  .* *.  \..*\..*.\*.*\.**\  ..\ .. ***  \.*.**.. * .*** .\ *  ..\*\#
#\**.**.\.*.  . ..\\..*  **.\*.* . ..* .... .***  * \\ .*  . ..* \.** ...* .*\ \*..\ ..*. .....\* *. .\.. ..*.  * *  #
#*..\   ..* .\*.\   \ *. \ . ..*.\* **   ...\..*\   . **.\*.. *. .    .\... .\ .\*\ \. .\*. ... \ ..  *  ..\.. .. .\ #
#*\.. . . .* .*  .* .*.\   .*  *.*\ *.** *** .*. *.. .\......*. ..  \*  ..  .... .  . .*.*..\ *  *..  *   *\* \*.  .\#
#. . *..*.*.*.. . *. \ ** \..* * .. *\.. *\........\.   ... .. * .  . *.. .\** *.*... \   .***.*****.. *. .*.. ..**..#
#* \ .*..*.... .\\.*..\*  *. . .\.  . **.\  . \..**  .. *.. .***. \*.*..  *.*.\* ** *.  ...*.. ..... **.***..** *..**#
#*\. ..\..\.  .*** .*..   *..\ .   .\..\   \...\  . \ * \*\. .**\   .* \.\*. \.\* \ ** *  .   **.\ *. * \.\   \ * \..#
#. ..* ..*.\ ....* .....\\*...**\**\  \. *\*\ * ** \.*\  .*   ..  *\ .*   \**  ..  *.**.\*  *.\*..\.. ......  . . . *#
#  \ \ * *  *. * .  . .*..**.*....*.. .**. ...* .  .*\*.\ \ ...  *\ * *.  .**. . \*\ *\.* .\  *.\   .  **  ..*..   .*#
#\.... . ....  .. * \ * . \ ...* .\.\ *\\   \.. \**.\...**\ **. . ..\**. \\..**  ..\ ..*.  .\*.. .\** \. .\.\.*.\**..#
# .  *\.. .\* *.\*\ ..  * \*.\ ..*. ... ..**.\ * ..*  *.*\. ..*\..* ..*. ..  .\ *   \.*   .*.*.*.\*\. ..\* *\*.\ *.\ #
#* * .\  *  .\.\.* .**..**....\**\. * ... *.. ..\*.*.*......\.**.*..**.*\* .....   ..**  ...*.   *. *\  *\...\  **...#
#* ..**.*. *.**.... .*.. *.\.* *..  .\ .  *. .* *\.  .*  . * ***.*..\.....  ** . **. *** . **... .. . .\*.*.\  \*..* #
#\.. ... ..**.\*\*. *.  *.* **\..\*..* ... . *\ .. ..*. *. .\. . . . \. \. ...  \* .**  .  ..\ *.*.* * .*\.\. .\.**. #
#.\ ** \.  .\ .\.*  .* *....... *... .\ .\   . . .. ****\ *.*.  .    ... ** .\.. .  ..        ....*\..  \.. .\ .  .* #
# .\\ *..\.  .*. . **.\. *\\..\...**.  \. \. .. *. .*. .. ..\  .. . .\ . .*\.   \*\ * \. .. *. .\  .. \ \ .**..  ..* #
#\.*. ..*.    ..*. ..**     .*.*. **   ..* \  *\. * ...*..     **.*.. \\ **.\.\  .*\*\.   ***\. ** .*\.*.\ ...\    * #
#. .  .*. *. \ *...**...* .* ..* .**  .*\.  *.*  .**\ ****..*\ \.*\  * .\...*\ \*.**..\.* ..*.* .\ .\.\.. * \ *.** . #
#.. *\ .. ..\..**. .. *    *.\ *.\ *\*.   **  * \..**** ***\.\. \** ..  .. *\ \ . .*...*.* *  .\ *\.* . ..\   \* .\\ #
#  \*.\ \. .*\   . . *.....*.*.*.*\*..\* *.\.**   *\*.* . ....\ . ..*. * . ... ** \. .. \.*..  ..\.* .  ..\.* *.  . .#
#\ . *.\..*\ ..**\.*..\\.... .**\*.*  \   .. .\ .    \. ...\ ..\*.. *..*..*.\. .\*.**\ . **..\ .\. * \  . .\\.\.\..*\#
#* .*.*.... \.*...*\  .. ..\ . *   . ..* *.\...... . .*** ..  \. \\.** .  ***\ \.. ..*   ...\..  .*\...... **.*.*.. .#
#....\.\* * ..  .*...\.\ ****. * * .. .*. ...* *. *. * ** .  *\\ .. ..\ *\* . .\*...\. \ *\..  * \.... \ .*\. . ..*\.#
#**.*\**. . * * .*. *...*.*.*  ..*.* .... *. . .. .\ *... .\\\ \....\..  ..     . .. .*.*. .\ *.\... .   *. . .** ..*#
#*.\**\.**\*.*.\ ...**.*  * .\.\..\.  .....*. .  **\.* *..*\..  .\.* \.\   .*\.**..\..\. .   .\ \. **\  **\**.**  ** #
#\..**.\*. *.\ ** .\\.  \.*.  .**\  . .\** .. .  *\.*.*.\ .**... . *..*  *\..* *\****\*** ..* .*.*\ \\ .\*.....\ ... #
#.. .\ ..  . *..   ..   .**** **\.. *\. .. *\  ..\ ...*  .\..**\.\ **  \ \.\.*...\. *\.*** ** .* **.* . .***\. *\* . #
#.. ... ..\ \... **  . * *.\* *.**..\** * *..***.  .* .**  **\. ....*.*...\. *. .\..\.*.*\ \\* *  * *.*\**. ** *.. **#
#   *  **\ *  *\ ....\ .*\. . .\\.*\* ..\*\   \.. * ...\. \.\.*.  *..*.   **  ...*** .*.\ .\ . ..* ** **.**... .\ **.#
#*  *...\ \* .* **\*.       *.\   . . .*... .. .  .. *  ..  .  *  *.*... ..*. \. *.\. . .* . \..*. .. . *.... ..*. **#
# \ ...   ..*..\.. .* . *.**\ *.\*. \ *\. **.*.....  \* *...*...**\..*.  *.. * . .  *  ...\... ..   *. ..*\** * .\**.#
#.   *. .*\ **..\..\ ...   .  .. .* .*.\ .....\ ..*  .. **  ...\.  *.. \  .\**.. *..*.. *  . .\ *.*..  * . ..\.* . * #
#*.\**.*..**.. \ \ *.\...**. \.\ *\**.**. .. **...\* .*.. \ ** .   \.....\*. ..  *.***  .\.     * \*.*.  *.  ..... **#
#\...\.\  \* **.  **.. .\.. * *. .. ..... \**. *.* *...\.*.\.*.\ *\ ..*.   * *.. . ..\..\ .   ...\..*\. ...\ *..  *.\#
# \.*\*  .*\   ...\.*.\. . \* . ...*. *.   *\**.* ..\.* *** *... *\.**..\ .. \.   .* .......* *\ .   . .\*\**.    *..#
#\ .*.  * \*\ ..*\*\* ..\ *..\...\\.**. .*  .**. *.\  .*\.* * **....*\ \ .* .. .* *..* .\.** *   **.*.*  .**.\..\.*..#
# .  ..\... *.  ..\ . .*.*.* . ***.  ****..\ *.\ *        \*.\\*. .*.*\    .*.\..*** * *\.*.    .*. .*...*.* .. .  **#
#. \  \ \  \. *..*  .\.* . . .....\.*.... * *  \.*     .\ . *.*. . *. . **. \. \***.  *\*.\..  ..** *..\.* .*.*  \ ..#
# *\*** ... *.*.*.*** \\.  *\ *\ *\ .. . ..*.\...*..  \*  \.\ ..* ***\*...*...*.*.\*..* *    *. *.*\..**. . *...*  \.#
#** ..***.\.\ **.*.\*...  ***..**.*\.\ *.*....      **.\*. .* . ..***..** ..  \..* ***..* \**.. .*.  \*.* \* . .\.\. #
#* . *..*\* . . .\  .*** **\* *.*\\  *..\.\  \**\  *.** .**. .*. .. .** . *  .  *. .*.* . . .... .. .  .* ..  *. **. #
#*\. .. . . .   .*.  .*.\ .....*.*.\*...*  ...*...... \. .* . . .*. .*.*.\.\ * *\  .*...    .*..*. .\  *..*\.*.\ .*.*#
#..\* *   .\ ......\... *\   **.*.\ \ *... .  **.   . \.. . ..    .. *.*.*.. .\\*. ***.**.*.\*\. .* . *. **\ \.*\\.\*#
# . .\**\  *  .**   . .*..  \*.....  .** ...* ..* *..*.*\.*..*. .*   .*  *. .\ \. \.*. .*... . ..*\ *. \**.*... *.\..#
#\  \*..   . . \.\***  .*\  . \ .  \**...  \.** . .  .* .\*  .   \ .\** .*.. . .    *.. .\.*.   \. ..*. .\. . \ \* . #
#. *..**..*.   .. *.\ * * *\.* .* ..*...  *.  .*\... .\..*..  .\ * **.\  .  .\ ..\ .... .*. . * ...*. .*..*. .\.. *..#
#*  ..*.  .* ..  \ .  ... . **. . \.\.  \.* . *.* *..*.. .*  ..  .... *\. ** .\*  * \. \ ..\  \ .\..*\**.\.*.\.*.*. .#
#.. \** .***. **\.. \.*  *.\\.** ..  .. \ ..*.* . *. *.   *.*\  .*\ * \.....\ ..\*.*.*. * \. . *..* ...** .\*\.*\..*.#
#.*....\***\\*......*  \ \ ....*  *.\ *.*.\ *.* \ .***\  .*.*.*\ \ ** . **  ..* ..*.*.*\**  *\... ...   * ...**\ .\  #
#..*******..\. *  *..   .    .\. ..\*\. .*.....*...\.. *.\ .* ..* .\.  ..*.*\ . ... *. ..\  * . * \..  *..  ....*...*#
#* \..*.*.*\ *  **\.\. .*..\** . .. . *..*  .**\. . ...\.   .. *. ..  \.*.\*\*. ** \*. .. . *.\...* *  .\.\* * .* . .#
#\*  \. \.. .*\ **.. .* \  ... .. . *.*. \...* ..**  *..   *  \.**.*.*..\.*. \*...  .* *.* .*.  . * .*...**..*.\.\. .#
# *  * ..\* ......**...  .** .\   *\.***..*  .\ .** *\. ..\... **.\\... ...*.    \\.*.****  .*..*\.. ** ...*. *.\.*.*#
#..  *  \.\.* \.*.***.* .\..\ .\**\ *.. *.. .  . ...*  \.*.    ** *  **.. ..\ . \ . . *....*.\..   \ ** *..**.. .*. .#
# ..\. .   .\.*...\\*** \. ....* .. \ *\ ..\. . ..*.  ***.* .. *..***\.** \.  .*. ....*..... *\ * *. **...\.\ .**\ * #
#\*.**  ..\ . *.  * *     .\*  *\ **...*****\.\ .\. * \\..*  *.*\. \. \**.. . .....\  .* *. *.. .*.*.... ..**. .*.**.#
#.. *. * . . *...*  .**\. * *  *. *..  *..*\\* . ..*.\. .\.\.\.. .\.* ....\\*...   *..*.*...* **** *\*...* .. ..\... #
#.* . .* **  ..  . * .. .** * **... .\*  *.* ..*\* **...**.. .\*\****..\  . .    .*\ *\*** ...*\.*..*.*  ..  ..****..#
#* .   . .*... .  *.  .  **. *.**... ..*...\..  ..\...  ** * . ..*\.* \  . *\ .*  \...*...    ..\*. * *\  \  .\  . * #
#\ .. .  *\.\*****.\ **   .*\* ..\. . .*.***...*  .\\ ...\*\    * ... . .**.   *\ .\ .  \*.*......\..*\  .\ *   * .. #
#\**.... ** .* ....*  * .** .. .\.\. .*....\ **.\ ..  **..\.  *.... ..  . ...\.  .\ *\*.. ..**.*  *.  *..  \.*.  *.\ #
#....\*\*.**.**..**...* .\* ..\*.\*\ *.\ \.**.. .... *..\ * ..***\ .* *  . .. \.\* * .\ .** ...***   *\. *..*.\\ *\..#
#* .\**. ..  . \\...*..\ *. *\*.. .. .\. * .* \ .*\* *.\  * . *.. .*. . \*   *.. . *  *..  \  *.\*\*...**** \*.\.\ \.#
#.. .. ... . \.  .\*\*.* \**.*. \. .** .\.\.* .  ... ......\.\**\. * ... .*  *\  . ..*.\\ *.. *.. .\. *..**\...\.  .*#
# ...* *  .**..   .  .\\ \.*..*\.    *.*\ .** \.**.\ ....*. * .* \ . \... .  *\.\ *. .* \. **..   .* .  *.. *.*** .\.#
#*\..\*.*.*...**\   ......... .***    \.   **\**.. *   *. ....\.  *\\ *. ..\ .**  \.*.  *. ..*.\ ***.*... *\*. ..*. *#
#\*.\..*\**.\*.. . .*. \**.. \....  \  *.**..***. .  \. .. .\. *  **  \...  \\..\ *** \*.* *.... *.*.*.*  *.\ ..*\*.*#
# *** \. .  .\ .    *... ..    .*..  . \...  *.. \\  . *\ .** \.** .\ \*  \..   . ..\ ..\**\ .\.\ .... *\*..   .\ ...#
#***  .***. *  .\.\\..\*...  .\.*..  .\* .. **\*\.....\... *.   ..**.. ..*.\. *\*   ..*\**\.\.** .....\.* . .* .*..*.#
# *  *\*...  ...* .\  ..**\ .\ \.* .  ..*....\ \.\*.... \ .\  *   . . *. \ *. ...*.**..***.\* .\**\.*.....* . \**.*\.#
# .  .*..  .*.... \...  * ..*  .\.** *.*\*.\*\. * *\ \. .  * ** *  ..*. ..\.* .  .*.\.\.**.** *..  * .\  \* * .\.. .\#
#.\  ***.. *.* \.  *. * .. .*\ ..... . \**.*.\  . * *.\ .*.\..\.\ ..**.*  ...\*  ..   .\** . .*   * .*.  ....*\ ..\ .#
#.**.*.. .\. . ...  \.***.***.*     * *. .***.* . * . *..* *. .\    .. .  .\\...   * .**..* \ ..* .\ *.*  .* *.  .\*.#
#\.\...*... . . \..*.*.\***.\*. *\\.......\\*..\. . \.\*   *  ..\ *\  .  * *       .. *.\*..*.**  * **.  *\. *\*.   *#
# .... **\ ..   ..*..**...** .*.* . \   .   .*. *....**... . .. .*\.\ \  *\. ***.     * * .\ . \* ...**  .*\..**\.  *#
#.  \.... .*...* .  .*.*...\  .**\   .. *  * ...\*\..\.... **  **\. ..  .. * ..\.\...**. \  * ...**. ..\ **..*.*.\**\#
#* .**...**  *.*  *\**..*.   .*\...\ ** . \..\ **.* . \ \. .. \*. * * .*\. .. *.  .\.*.. * \.   .\* \ ** \*... . *.. #
#.\\.* \\\.* . .* **\*\ \  \*.*  .\.* .  .*  *. ..\  ....*\ ..  *.\\.*.. .*\. .  \.  .\.  *..\..  .\ ...*..*.*\ .\ ..#
# ..** ..** *   \ .... . *..*.*\.  .*   * . *\  .\\ ..*\*.*\** *\ . ...\. .*.\.* .*.*     .*\ ...\ *.**\. \..\. *.\. #
#..*..\ ...\. \. . *.**\ \ \...*\.*. *\..\    * \. .*.**..* .\..  .  \.  *...*\.. ....     .**.. * . \.. * .\.*\\....#
#\\.*. ** ***\.* \ \..\.*\..***.  .**. . .. .*** .* *... *... *.\   \ . \...*\.** .*.* .\***\.\. ..  .\ *.\**.... .*.#
#.**.*.\.*.** . ...\. *..   * *. .\.*.\ .** **.. *....** .\.  . .. ..*. .\. .*\..  ...* *..*..\ *   *.* .\.****\.. \ #
# *.  .\...*\ .**  .**.. *\..\.. ..\*\* ... ..  *..  *.*.* **...\*. .\.\\* ..*\ .  \  ...*.\  ... \   *  *.*\*.  ...*#
# **. ..****.*..  . *. \ \* *.\ *.**.*\  \.. ***.\.*.\.\* \...   *\  *  .*\**..* *.*.\*  .**. * .. .* \**... . .\....#
#... . ..\.  .* . .*\\  *\. *\.** .  . .* *.. .. *..\ \. \*.* .* ..\.*.* .*\.\....*\* .** .....   \\ . .* ..** \*\ ..#
#\**   ..     ..* .\ \...  .**\** *    ...*\*   . ..* . ..\.*... \. \.*.  ..\ *..\ *.\ ** ..\ .\.  *\ . .*.\.\* .* . #
#*.\\.\\*      **.*...  .*.\ *.*.\. ... \** ... \..\*.  **.**  .  *\.. . . . .*.  ..\...\* \***\.*.. ..**\...\*.\....#
#*..\ ... ..* ...\..*\.\ .*..**.*   .\*. *  * * ... *.  .\*\..\... .. *.** \\*.  ..*\ * ** ..\..    .\.*.  . ...   .\#
#*.\... \ ..***\ . ...*.  * ...\. * . ...* .\.. *.  .    *... ..*    \* ** \..\ .\ \** \.\* ....\.  . ..** \*..\\ *..#
#.*     .**...*\.\  .\*.\*.. \..* .**.  \*...\ ..* ***  *\*  *.*\ **. . .. *    ..*  \*.*.**. *\*. .\ ..*.*.*** . **.#
#\*.**\ ..*.... .\** *. ... **.*...\.* .**.\  .\ * *. *....\.*.*. \ * \. \ . .\*\..\ . .\.* .. *.. *.*\*.\..*.\    * #
#\* ....** *.. *.*\....\ .**.* ..  . .\*\. **  **.*..*.\.  . .\..\. .. **.    . * ...\.*...\* ..  .* ..\ .** \.*.... #
# *...\\..**  ....* *\\*\  \. \ * .\.  . *\.* *.*\*.  *.. ...   \*..   ***.**.\ ..*\ * . **..\.. .** *   ..*.  *.\* *#
#..  *   .. .. ....\. .*..*. .. \\**  *\..*..\... .**\ \. .*. .\.*.. **.*.*  .*.  . **    *. .*\ .\*.* .  . ..  **.  #
#. * .*.... \\.\\.* \  * \.... *.*\. ..**.. . . \ \.**.  **.\  .*..  ...  ..**.* ***\.   .. ..\*. .* * . \* ..*\..  .#
#\ .*\.  *.... . *.\....*  .. \.*.. .*....*\.\ . *  *... ..    ...*.\* ..*   ...  ..***. **.\*. *.*. . **..*\ *. .*.*#
#.   * .....\* .*\*\. \..* \....**\. ..\.**  \..*  *.*..*.  *.**..** .   .\*** .* . \..* *. . *  ...*  .** *..\*\.**.#
#  . \*...** .**** ..\. .*.. ....\  .    .  . ...**. *  **.*. *\ **\\*\\..  *.\ **..\.\*....* .\  **..\..\.   **. *..#
#*.  .. ..**.*..*.  *   .. . *. *. ...\*\    \.\ *\. .*\....\*\..** . .    *\ ... *..\. .\*..\. * \*. .*\**.\...***. #
#*. *.   *.\*....* . \ .\\..  *.* \.. *  ...\  *.* \ **.**   *. *.***. *\ .  ..    **.\. *.. .*..  *. \.   ..*\ .**  #
#.\ .\\*..*. ** . .\   ..\ .*....*.*. . \  ..* . .  .*\ ..\.**.\. .\*\ ***.*..\.\ * \..\..   .**.\ .*.  ***.*. ** \ *#
#.*.  .\. * \.*    ...  * **.*\.*\ *     \*...\.* ..**..*\. **.* .*..*......  ..**.*.  ..\. .*..* .**. .**.  *\  ..*.#
#.*\. \   .***\. .. *  *.*.\  .*.. . . **. .    *.. *\.. *  . .\.*.  . . **\ .\   ..*. ***  ** ..**\.*\**\*.\.*..****#
# .   .*.. .\*.\ ..*.*.\. *.\.\\.\**\**. .\ ***.*\..* * *. .*..*..*\.*.*...\  . .* *.**....*..**\..**.* . * .  .*\*..#
#* *  *\ .\...\  . . . .**. .. * ...\.*.   . \* *.  .\* ... .. ** .... .*.* ..\ *.\..*.*. ....**. .\.\  **   .* *\. .#
#\  *.*.\ \  .*\* \**\.\*\*.*   \ .\.\.\ .* ..\.*.*..*    * * *.*..\.\*..\.  ...*.*\..\  . \.*...* *\.. \.\..  \*.\ .#
######################################################################################################################