#################################################################
#\ *.****.. .\. *    .**\.\\  \.*.     .\. *\..\ * .  *#. *# #  #
#* ...*  *...   . .*  \.*.. .....\  ....*\*.* *  \   .. #\** ## #
#. .\ \\*\ ...  ..*..* .*.\\*****. ...\.**.. \.*\ ... \#  *. \*##
# . * \. .. .\*\ ..\**  *..*\... \  \..**\**  .**.*\  .\ ..#*#.##
#*. *\.. *\*.  \ \....**. .. **. .\*.\.*\ . \..**\**..*  * .# # #
#**....\. * \ *..\\.   **  .\ \  * . **.*  ...\ . . \..**\ ..#  #
#.... .. *\\  . ***\ ...**.\  .\..* *.*\\** ...**  .. * .***##  #
# \. \ ....*.*R ..*\  . .*.*.\. *\* .**.. \ *\.*.*.. \ . ..*\.###
#... . \. \**.. \   **\ * .*. .  ...\.**  . ...* ..\. .   .\*..\#
#* . . . . *. *  .\. .**\.. . **  .\. .*\*.\  \.**.*\ ## \ #*#L##
#.\.*  *  . .... \.*.**.     .*\ . .\  **   \   *. **.* ## * #  #
#\.* * .. *..**** ..\** ..\   ... \..  ..   . .*.\ *.\.....* #  #
#.*...\.*** *.\*.**..* \*.*\ \ *..\  \.*\..* .\..... ..**####   #
#################################################################