##################
#    ##     #*#  #
#   #* ### ##*L  #
#   #..*. #\#.# ##
#    #.*#***# ##*#
#  ###\.#\..# . *#
# #**# * *. *. ###
# ##.  *  ...\.*##
##* \  *\ .#.. ..#
# #...   *\.\. .*#
#  #*.\. .*\*.***#
### #..  \..*\..\#
#*\  *  . \ ..**.#
#.....\ ***.. .# #
#*\. **.*..   ..\#
#  .......  \\* .#
#\*.\* ..**\.\   #
#*.**.\. ****.  .#
#. ..\ \..*\ ....#
# ..*..***\*.*..*#
# **.. ..* \...\.#
#\ . .*\..*. ....#
#*\ .**..\\.  . .#
#**.\ * * . * . .#
#\..* .*.\...  *\#
#*.\*  . .*.\ \. #
#. .**\** ...  * #
#*. \.... * \ \. #
#.*.*.  \.... *..#
#.*.**  . * .    #
#\.*  .**  * *.. #
#. *...\*. *.* *.#
#. . . .\*\.*\.*.#
#\... * ...****.*#
#  ..... .  .. \.#
#.  . .*.*. .*...#
#.   .*..*.\ * .\#
#.\\* .*..  ..\  #
# **..\.**. .\.  #
#\ **.  .* *.**\ #
#*... .. *..\.*.*#
#..*.*\* **.*\* .#
#..  *.. .*. . .\#
#.\ *. .  \ . .*.#
#* \. .\ ..*. *. #
#.** .*. \..... .#
#  * \.. .. *. .*#
# *.*** .* ... * #
#\. *.\ \.  * .*\#
#  .*.  .. .* . *#
#   *\*  \.\.* \.#
#   ..*...\ ***. #
#*** .. *\*. *. *#
# *.\*.*...  .\*.#
#***.. *.\.**.*.*#
# .     *  .**. *#
#.\ . .  .\. \*.*#
#  .. . . ..\..\.#
#.    *  .\ . ...#
#.\ *.\.  .   .\.#
#.*.*\. *.   ..* #
#\. . *  ***  *..#
#. \. .\\ **.*.*.#
#. *\.  *  .*. ..#
#\ .. *\. *.. *\ #
#.*.. ..  ..\ .* #
#*.***.*\  *..\.*#
#...*.*.. .\.\ *\#
#.. * *  *.*.  *.#
#\***.\**\.. .  *#
# ... .. .  ..\**#
#\ *\*.\  . * . .#
#.\*.*\*. .*..  .#
# *...*.  ..*\   #
# \. \* . .\** * #
#\\.\.\ * \. * .\#
#.*.....\*.**.* .#
# .* .  ... * ***#
#. * .   *  . .*.#
#\ *\  ..    \..\#
#*.\... . *.. * \#
#.*. *\.\..\ .\..#
#..  .\**...  ***#
#..* *. ... ....\#
#\ .*..  \*.   \*#
#. \.   * ..  *..#
#**.   *    \*.\*#
#. * \*... . *..\#
#. . .\*. .* \ \*#
#  *. *.\ .... ..#
#\ *  *\. \.* .. #
#. ..*\ .  ...\.*#
#\ .\\.\    *  *.#
#*..*   .*..**.  #
#..*... \.*..**.*#
#*\.. ... *\*\...#
#**\. .\  \.... .#
#\..\  .. . \ .**#
# **.* *.**.*...\#
#\***.. . * ..  .#
#...\*  *\.\ \* .#
#* *....   .*....#
#. **    .\.. . *#
#  .*\\.\    .* .#
#\*.* \..*  .*. .#
#   \\. \  **\. \#
#  \ .*   . .*\..#
# . . . *\..*..* #
# \.* \ **\ *.\  #
#*. \*. ....\*\.*#
#. \..    ...\.**#
#* \.\.*.  \  **.#
#*\.\  * *. .\...#
#**   ...\....\**#
#.*.. \*.*. *.\.\#
#**....**. \* ..*#
# ..*\\ .  **.\ .#
#\  \ *. *\.\ .. #
#. *..*  .*.*\ . #
#\*.\*. \* * * .*#
#**.*... * .\  *.#
#\. .*.*.......**#
# *.. *..**  .*\.#
# .  . .\ *..*.**#
#  * ** .**.\\**.#
#  **\* .*. .*\. #
# \ \ ..\*. *\. *#
#. *...*..    *\*#
#.*... **\  *..*.#
#.. ..\..*.\   ..#
#....*.***. ... .#
#*...* .*..*\ ..\#
#*..\  \. .**  *.#
# . ***.*\. *\..*#
#  *..*. .*\*   .#
#\..*..\. ... ** #
#*\.* *... .*\...#
#. \.. ** ..*  ..#
#. .\ *.**.\.\* .#
#* .  \..\.\.*\* #
#  .\ ...  ****. #
# \ .\*.  \.*..  #
#. *\.. *\. ...  #
#* ..\ .*.*.** . #
#*..\.**......\**#
#*\ ..\\...   **\#
#.*.* ...\ ..*.. #
#\  *.* *.. *** *#
#  ..\..\. . ...*#
#*   *  .*\. * ..#
#*. *...*** *.   #
#*... ** .   .  *#
#.. . *. \.. \   #
#*. ..*\\.\\\ . *#
#.*\* * \. .\.  .#
#..*\\..    .\  *#
#* .\*..**. . .* #
#*\..  ... .* ***#
#\.\ ... .  . * \#
#.*  \*.*.\*.\.\.#
#\ *...**. ..   *#
#.\ .\ ..*\. .  *#
# *    . ..\  *.*#
#  ..\..\*.* *.. #
# \\. . .***. *\*#
#  \* ...**.\*\.\#
#  ..* \ ..  ....#
#\. .  *.** .*\ \#
#. \.\  ...\*..*.#
#. .. .. \ *.. \.#
#* .** .**..*\*..#
#*\... *\.. ..\\*#
# .* * .. \ *. ..#
# ***. .. *.*.*.*#
#.. \*\.\. ..\.**#
#  . *.\*.***  ..#
#.*. .*.. ..  .  #
#*  \*..\ . .  * #
#.\ ..**  .\*.*.*#
# ..\..* . ...* .#
#*    \ *\.*.\..\#
#.*.* . * .* *.  #
#.\** ..*. . *..*#
#\. *. *\ .. *. .#
#  \** . \*.\.*. #
#  \ **\ **.*\**.#
#R.* .\. ***.**\ #
#*\. * . *..*.\ .#
#*.* * \* **\   .#
#* * . .. *.***. #
#.*.. \ *\...*...#
#..   . \. * **..#
#.  . .****....  #
#\.\ .*.....\  . #
#.\*. ...\ *.   .#
# *..\.*.* .\ ** #
#\. **\\ .*. .*. #
# ***. ** *\ \..*#
# *...\.\..    **#
# *.  * *\.  *.\.#
# ** .**\\*. \.\*#
#....\*.. . . *\*#
#\  . *..*.\.\.**#
#* .  \.\. . ****#
# \** ..* *.  . .#
# \.**.*.\.     *#
#* **......  *..*#
#.\*.\ .\.\*. *. #
#  . * ** *.\ \*.#
# .** * ..*\.. ..#
#* .\.\.  . .*..*#
#..  * ..*\  . \ #
#*  **. ..\*. ...#
#*.*..*\.  *. *..#
#**. .\*\. .. \. #
#..... .   \...  #
#\*\***   .. . . #
#..* .*\.* ..\. .#
#* \\*\.. .\    .#
#.\...*\  *.*..  #
#*. \. .\  .**. *#
#*\ .. . **\** **#
#\  .**\ \\... .\#
#**.  . ...\. *..#
#.. \*.   ..* \  #
#.*\ .*..  *.\. .#
#\**\. *  *.. * *#
#\*.*\*.\. \\**..#
#*.*\*.  .\. ..*\#
#.**....\ **.... #
# **\..  .* *... #
#\\*.\ \*\*.\ *\ #
#* *\ ** .\  *.. #
#. ...** *.**.. \#
#  *. *.\* . .* .#
#\.***. . .*. ** #
#.....   *\.\.. .#
#\ * .\... ..  . #
#. .\ . .*  .. ..#
#** .\  ***. * .\#
#.\.  * *\.. *..*#
#\* ... ..*. ..*.#
# *.\.\  ..   .. #
# ...*.** .**  .*#
#\....*.\ *\* *\\#
##################