#########################################
#             # #                       #
##L  #       #\ #                       #
#*.##.##      #*.##                     #
#\  ... #    ##. # #                    #
##.. .###   #. ..*.#                    #
## #. \#*# ##..\.#  #  #                #
#*\ \\.*..#*#*  ..#.# # #               #
#\.* ##\*##* #..*   .##\#     ##        #
#.*. .* ....#. * *.. .*. #  ##  ##      #
#.\\* #   ..**  ..#\ ..\. ## #\\**#     #
#*   *.\.**#***\ .  .. .#  #*..###      #
#*.\\. #.........\. *\  .. \#*\. ###    #
##*....*  .*\. *\.  .*..\.*\.* . ...#   #
#  *.\*  .*\   *..\* ... *\##.\*. ####  #
#*....\.. * \  . .**  .*...  \  . \. .# #
#. \ .  *..\ . *\.  . \.\*\  .\*\. .##  #
#.* .  .**\. \ .. .   .*... * ..  . ### #
# * ..***.....\\.\.*. *.*   . .\   #\\*##
#\*. *\.* . \ ..\ .\*\  \*.****.*\. .*\##
#**\.. *\**.* \ .\ ... .  ..**... ***..##
# *..***.\.  .\.*...*\.\ ..\.\.\ \.*...##
#\\ .*\..**.*\. . .**. ***\...\*..**..*##
# .   \ ..***.*   .** ...\ .  ...* .*.\.#
#*\. * .\ .*. ..* *.*\..** \*. \  * ..  #
#.. * \.\.\**. .* *....**..** . .*.\. ..#
#. \  ...  ..*.*\\... * ..\...\.\.\  . .#
#..\ *\*.\*. * \*..* .. ...* \.*\  \.R**#
#\\. . . \...* .....*..* **. . ..  **.*\#
#*.. ..*..*. ...* **.. *\. . ***....*..*#
#\. * .*.\.  .. .** .*.. . .*.*\ \ \.\**#
#....*..\*.*  *  *.. * .. ....\. \* \  .#
#*  *  .*...*\.*.\\*\   **   . .*\  .   #
#. \*.***  .   ***..*.....\. \ \**.   \.#
#\*.* *.*  . *.\ .\** .\..*. * .  **\ .*#
#...\*... * ..\ .  .*. .\.\ .\ *\.....\*#
# *\*.  ...*.*. * .** **   ** *.* . . **#
# . .  *.**.  ......... * .*.* .\*  **\*#
# .   ..  .. .  \.\*.\  * \.*. .*.* ..**#
#*.*.*.*  .  \ * * *  .\.*\. * .\.\ .\**#
#..*.****  .*\ * \*... **..*..  ..*.... #
#*.*\*... .... . .*\ . . *  ..\.*..\ ** #
#.  **. \.\ .   .\ .*  . .*  .  .*.*\.. #
#  .*..\ ..*.\.   .\..**.*..**. *..\  *.#
#* *.\ .. \.   \ ..*\**.\*.  **\\.\**.*.#
#...*.\* .\. .. .\*. \...\. \.\ . *..  *#
#.  .*\.* . ..\. \. *..... \.*\*  \\....#
#\*..\....    ** . .\*.***..**.. *.* .\ #
# \*\ \ ..  *\*..\.**..*.*. ..  *\...  .#
#.*\*  \ **.*.* \...* ...*\.\* \\  *.. .#
#.  . .*\. .   \  . *.. ..*   \ . *\**  #
#\.\ .\ ..**.....\ .*..    ..* \ .\*...\#
#.\.*\ .. *..  ... . *\ *..\ \ .*.. \.. #
#. .\.* . ** *.. .*.**.\.  *  \   **\ .\#
# ** *..*..\..\..*..  . *...  ***.. . .*#
#..  *.*.*\  \ . *.\ .*. ..\.*..  \*   .#
#  \.*.... \*. .*...* . *  *\.\*\ .*.  .#
#.\.* .. *. .. ..\*    \.\\* ...* .*  *\#
#*. .. * * * *.****  . * . ..   .. *** .#
#.   *  .... \..\..* \ . * \ .\*.**... *#
#* **.\. ..  . ***.... .\*.  * . **.**.\#
#.\ . *.     .\.*. .. .* . ***\ .*. ..**#
#* .*. . \*   **..  *.*.  .. ****..\ ..\#
#.*..*\*\ .\*.** ...*..*\.\ ...**. ..  *#
#  \ * . ..***.\\   *. ..\*\**\ .** *. *#
#** ....*..\.  .\.. .  .. ..*** * * *.**#
#.. .*\.\...\ *\. **. ** .....  * .\\** #
#.\. *.\*.*.. ... .. .*.* . **  .   .*..#
#\.\.  .... ..*\    . .\. * *. \\    ..*#
#.*.....\ ** \ *.*.*.  .  .* *.. \ ..\..#
# .. . .. .. ... * *...  *.*    *..\**..#
#   .\**\\* \*. *.**\.\\..\.\ **   .\*  #
#.\.  .*.\.\ ... \.*** **\**. ..  \  *  #
#**\..\.\  .*.\. \ ..\ ... **\ .  . ..\.#
#*. . **.*\.     . \\.* . .*. .\.*.\. * #
#.*...\.\..\*.  .\*.\ .*  \..* \ **\..  #
#..*....   *. .*. \.. *..\  *........  \#
#.\.\.*...*   ..  .*   ...* ... * .  .*\#
# *\  .*.*\.   *.  * ...**.. .*\ .   .\ #
#**..*.\ .\  .***.*.\   .. ....... *. . #
#**\.  .   \ **\.\.. .*\*.* ... ...\*..\#
#*. * *\. **\*.. * . \.*\ *  . . .**. .*#
#*\**\.. .***.  .\ . .\.  *.\ ..*. ... .#
# ......**.\.\*..*...* \ **  *  * *     #
#..  .\**.*.  *.\* \.  *.   **...  .\* .#
#\..*\...\* *..** \ . .* .. .\. .**  ..*#
# ..**\.* ..*.*\\ ..\ .. *.\  ..  .. .*.#
# *.\*.   .*\*.* \\. .**..**\ * **..  .*#
# . *...*  . *......*\.\ ... \*. *\ ....#
#\..**\ *\.\*\* \\*.\ \.    *..\   *.** #
#....\...*.*. .* **.. .   . \  .* ..*..*#
#  *..**...*. *.*\. *\ * * \** *\ *..  .#
#*\.*.*. \...*\.*\.\* *. ** *  ...*. .*.#
#. *...   *\ ** **.*.\*.*..\.\..*\..\**.#
#.*.  **. .\......*... .*.  ****.  . ...#
#*.*  .* ..\. . ***..\. .  ..\.***\ .\ *#
#***\. .\.. *   ..\.. . \*\* . ..*** *..#
#...   \  * * .\ *..*. *.. .*** .*..\...#
#** \.. ..* *.*.*\*\...*.\  .\. .***.\ .#
#* *.\  **.*\.. ..\.  ...  .  .* \ .\..*#
#.\* **\ .*. *. *.*\  \*..*. \ *.. * ..*#
# **..  .\..*. . ..* \.\.. *.. .. .\.  .#
#.....*\ .  *..\. .. ..... .*  . *\ . * #
#\.  .. \*. *.. .* *.*...* **  \ ...   *#
#***.. ... *...\*... .*. * *\...  *\.*.*#
#.. **.** ..\   \.*   .*\.. *. ** \... .#
#**.*\. **.. .** \ ...*   .\*.\.\ \ *. *#
#.\..** **.*  .*\* \\ .*.* .\\.*.  **.*.#
#*.. .\. \\* .*. ...\* .\* *.  ..  ..*. #
#.\. *.\ .. .\.* \ ..   \**. \    . **\*#
#. ..\ ***\ *.**\*****\*.\*. ...\.*..\.*#
#  .\ \\.*  . .\ ..\  \* *\.. *  \*... .#
#*.\.\.*..*\ ....*.. . ...\.** **...* ..#
#**.\..*. ....  .*..*. *\ * **  .\ .. * #
#  *.\  ..* * .   *.  .*.....\.*. \  .. #
#  *  *.  **.*\**.*.*\ ..... .*....\.  .#
#  . . . *.. ..*\.. .\*** *  .*. .*. \.*#
#   .* **. *  *. . * .*..*.  .. \ ... .*#
#\ * *..\.\.  *\.\.. * . *.\.  ..  **.*\#
#...\... *. * *  *.*  \ ....\..    ...**#
#..\ . ..  ..**. . .\...    .*\  .* \ ..#
#  .  .*  **\.\  \.  \*   **.**.  **.*. #
#\. * \.  * *..*.*   *..\**.\*.* *....  #
#.*\..  .\.\   * * .*. \ .. *.\..  \ ..\#
#.*.  ***. *\\....  *.. \.\..\\.* \.* \ #
#.**** *.**..*.*** *.\   \  **.*\ * *  .#
#*\**  \..\*** ..**. *.* .. *.\.....*...#
#**...\*..*...*  .** *** *  ..*\.  ..*. #
#.\..*. . * \. \...\...* ....*..*..\ .* #
#.*\.\.. \*..**..  \. \.\..*.** . ..* *.#
# *  . \ **  * ..  .** .. .\*.    . . .\#
#\ ...\. ..*.\. * .*.\    ....*.*.\*.** #
#     *.* *. .\*.. *..**.. \.........\  #
# .*\***\ ..*\**.*** .*** ... .\. \. .  #
#**.*** ..  .*.\*...  .*. . \*.*  \ .*  #
#\ .* .\*\\**.*..*\*.. .\.  **.*   .*.  #
#.\.*..*** . \. \ .  .. .*. ..*. . .*.**#
#..*. \..\ ... * * \..**. .   * .  ..**.#
#.****.  .***. ..*\. .**\    *..*.*.\.**#
#**\  * .  *\ * *.   \.\  ***.  ..*\*   #
#*.*\ . *.  * ...*\ . * .*.. . ** ... ..#
#..* ..  .\* \* **\   \. .  \....  \* ..#
#**  \  *..*..*  *.  *.*  . .*...**.. \*#
#.. * ......*\  \.. .\.*.*.  .*..*. .\ .#
#*.*.\* .**.\.\  ***. \..*  *\. * .*..  #
#***..*. .  * . \....*.**\. \  ...... . #
#*.\..* .  .. *..... . *.*.*\.* .\..*.. #
#*...  *..\.\...\ ..*  **.** \*.. *.. \*#
#.. ..*. *\\.   .** * . ..\**..\.*..*. .#
#.... .\*.*..* .*.* . *.*\ ...  * .*\* *#
#. \\.  . *\. *  .* *\.*.. *.. .  ** .\.#
#  . \  ... . .  *. .*.*.. \. .** ..\ ..#
# .*\.* .*\*. ** ..** ..\ *. \..\ .**.*.#
# \  .***. .\  \.*  ..  ..  ..  \\ ...*.#
#*. **. .. .\ *.\ ** .    *.\  .*.\..\* #
# * ....\  . .*. .*\\ *\. .  . \.  . ..\#
#  *** \ . *.\*. *.**... ...\...*..     #
#\* .....* .....*.\.*.\   **.  *.\.  .**#
# * \.*\..  ...\ ..\.. .....*... *\   *.#
#*.  *\.**.*. .. *  .*\  * ***\.*\ *\ .*#
#.\ *.  .*. *.\\*.**. . *.*** . *... .\.#
#.*\**\*.*.\.. *.  .\   .\*...\ ..*. .  #
#.*\*.**.* *\.\**.*..**.   \.\*\.*\  ...#
# ..*..\*...  ... . ..\ . .. *   .  \.*.#
#  ** .*..*\\. ..*...\.\*. . . .*  *...\#
#..*\*\*\*..   .*. .\ \ . ...    . .* ..#
#***.***..*..* .\*.\\**  . \.\.\ . .*\**#
#*.. .*..\. \**. .  *.* .\.. . * .\...*.#
#*. . .*.*\..**. \   .. .***  * ...\  . #
#..  * * ... **\\ *  *. ..\* . * .* *. .#
#\. .\ *.*.*\..*..*. * ..**.\*.\ *. .*  #
#. . .*\* .\ ... **  .**..***.. **\**.  #
#** * . .\ . * *...\ \..\ .*\**.....** .#
# \.\ * \ * \*... ..*.  .. .**. . .  \..#
#\.* \\     . .*\ ..*..*. .\*..  .*. .\.#
#*\*\.   .*   . .  .*.\...\*     .\.  * #
#..* \... *..  *\ ***..  * .. . *\.   ..#
# *.\.  ..\** .. .\.*.  ..\.*\ ..**.*\  #
#.*\. .*. . * \ \ . . *. *.**.\\ ..\..**#
# .. \ .  * . . .....**\ .\..\.\*..*.\ .#
#\.*\... .***.*..*.* .*....\*.  \**\. \ #
#..***.   ..\.\\ .*.\ .*\  ..\ ... *.*. #
#. *\**.*... \* *\.\** \..* * .  ...\. .#
#\.*. ... **..* \* . \. . . ...* .\ \*\ #
#* .\.. .*\.\..*.. ..*.  . .\. \.***...\#
#\. .*\ ... .\*... \.. ..\ \*.\ ...*  . #
# .\ *.\.**\ *\..\..*.   \.. . \.*.\** \#
# * .*\  *. . . ... . .* *.  * . *.**  .#
#\ . .* . \  .\ . . ... \*. \*.\ .*.*\\*#
# . ...\...... .  ***.\. .  . ... . **.*#
#. **... .\.*.  . .. \. ...* *.\.. *..*.#
#* **.*. ...* ..... ..**\.\.*\** .\.   \#
#.*.\. \  . \.\ \  *. .\ \* ....*\.  *. #
#\* .  ..* .\  . .  * ..*\. \ \.* *...  #
#.. *.\ .. \.* * *.\..\ . *....\ .\..\  #
#\ *\ . .*.  \...\.*...*.    .   . \* **#
#..  ..\* ***.*\.**\.\ .\.*  .*. .\.  . #
#* . *   *  \.  . * ..*  .*\*.*\. * \* *#
#..* .* \.**.* .*.\*... .*. .\ . ... *\*#
#.\. *.* .*.. **.\.*  *.**\\ .  ..\*.*.*#
#*    .. \\* ******. * **.*\\. . . *.. .#
#\ .\ ...*.*..*\ *..*...\ .   .*  *.   *#
# ** * * *..*.**..\ *...    *\***.. **\\#
# *..****.*.*.**..  ..\.**.\ *\..  *\.* #
#**.*....\. **\** .**   . ..*.  ** \.**.#
#\.*****\   ..**.. *\. *\  **. *..   **.#
#... ..\*. . ..  .*\   *\....\\*.  \*.*\#
#\*.*\  .*\   * ..*.*. .*.****\.*     ..#
# *.*.* ..    ..* .   \ ..  *.. \* **   #
#\\  **     *\ ..   *..\.*. *  . .\  . .#
#*\. * .. * ..... *\.\.**.  .  * \*\. \.#
#.. *.  .\.\*. *\.**. \. \ *. *...... ..#
#. ..*. ..\**......*\  *.. .*..\ .* .* .#
#. \....\.*.\..*..\ *.*.\.* .\.  .**. \ #
#* **. \* .\* *\***  *.  .\ ...\. *. ..\#
#. *.*  ..  . ..*.*\**. * *\ .... * \*  #
#. *.   *...*. * \. ..*.\...\ .........\#
#**.\ .*.*\ * ...... .\..  \. .     .  *#
# * ..\* * ....\..\..*. .  \. ..\ .  \**#
#\.*\  \**\  .  \ .  .. ** .*  **  ...*.#
#.*..* .\..*. .*.\ . *\*** .. .**.*.   \#
#*.\. .\.*..*\.... \ *..*. .*...  * . . #
#***\.\** .\.  \  *..*.\ \* **\ \.\..  \#
#.\ .\*.* * .*\*.\.    . .* .\.*  *.*. .#
#\. . .\.*\   .....\ *  .*.  **.. *.*\..#
#*. .*  ***..   *\.. \..\...*..   **\...#
#* \\\**.\*   . ..*. . * \\.\.. . .*. . #
#*\.. ..\..**   * *.** .\.   .*..\ .*.. #
#**. \ .**\...  . \... .... .\.* ... .\ #
#\\   . **\....\ *. . .*.  *...\.  . *.*#
#**.*  \*. *.*   . ..\.*\\\*.* * \ .****#
# .*. ...\.*  ..  \* .\.........*. *..\.#
#\ ...* .....\.  \ ....\.\.* .\*\  .  *\#
# .   \ \*\*\ \.\  .  ..*...* \.. \ \..*#
#. ..*. .\ . .*. .\.   *.*\\. .*.. *.* .#
#....*\.\ *.*\   .. .  \..   . * *..\.  #
#*.**.  \...... ..*. .**. * .....* ***\.#
#**\. .. .** *..**.*.*  \*.\ . \.*\*....#
#*\*. *.  **.....\.... *. **.  . \.. *  #
#\ .\*.  ..*.  ..***.* . *\* \ \ .  .*\*#
#########################################