##############################
#                       ## #\#
#                      L*.#..#
###                    #..## #
# \#                    #..#\#
#  ####                 #  * #
#*##*..#        #   ####*\  .#
#*  .##        #*### *.##.. \#
#**.*#.#     ###.*..\.**. .#.#
#.*.#.*.# # #\** .*\.\*...\\.#
#\. *#.\.# #\*. \.* \ .*.\.. #
# * . .**  \... ...\ ..#* . .#
#..**.\ .\#.\  . *.* .*.*.\*.#
#.#*.. . . *. * **.\. . \**#.#
#..*.\.  ..*... . *... .  *.\#
#\...*\\.\*. . *\...**.. * ..#
#.....*.*..*# *.. \* .\ ....*#
#***.\* *.\.  *** .*. . .**..#
#\*  . .* *   #.*  *\ . .*.*.#
#.  * .*.\.\ *. .*..*  .*\ ..#
#** .\*.. \* .* *.* *..  .\  #
#\. .*\ * ...\. ..*... .** ..#
#*\*\   \. .\ .\ \ * . **\*. #
#***. *\ \ * .*.. .. .\.\ .*.#
#\.. *.*\.   ..\..   .  ..\.*#
#.   *..* . **\.*. *.. \.....#
#.\. \.*.. ..\ *.\...*\ *\.\ #
#.*.** ..\..\  \*..   . *.\ *#
#*.**   \   *   *.  ..*.\ * .#
#..*\..\.. .\    **\.**   *. #
# .... * . .  .\* **  * *. * #
#   *  * ..\ *.*..\\\*\..   .#
#...\\*.\.. \\*.. ***... .   #
#..\..* .\.\..  ....\*\    . #
#.*.* .\ ...  * \\ .*\**   .*#
#  ..\\**.\**** .*  ...**.. .#
#**  ...\. . \* * \** *..   .#
#* **.  .\**  ..   ... \ \ . #
#. ...\. .. . ...\  .. . . . #
#.   \*..*    *** \ . . .\*\.#
#..\ . . *  * * . . ..** .. .#
#\ .. . . ..  *    **\*.*.. *#
#\..\ \** *.* . ** .\*.*.*  .#
#*\\   . .*..***\.. ..*\ \ * #
#.  .  \.  * .*.  * *\\ ...**#
#\** * *  ..\*.*\**. *\*.....#
#..\\..\ . * * .*.*... .  .  #
#  .\.. *.\.*\ *..... .*\ . *#
#\.\. .*\..\  *.  .*\. * \  .#
#.\\. ..  .. \.**. . ***.....#
#\.. ** ***.\.*..*.**\.     \#
#.*\  *... *.*\.*..*\...*.\*.#
#\.. ..    .\. .** *.**\... .#
# * .*.\ *.  \\...\*.\..*\ ..#
#\. .\ ..\. *\*... ...   *  .#
#. \*.** ***....*\. *...\* **#
#\.\ \..  ....* ..*\...*.....#
# *..     \.. * \\*.\... \  .#
#.**...  *..*.* \ *\.  .. ...#
#  ..  . \. .*.....*  *.\.*..#
#  .. \. *  * \ \**..... .. .#
#.* . . ..    ...**.. . . .. #
# .\ \.**  ..*...*.  . \.\ * #
# ** \*.\...\.\*\...* *   ***#
#\... . * *.. .  *\.. *..***.#
#.***  \\ ...  ..*..\ . .\.\ #
#\.*.*  .**.*\* ..\*... * * \#
# *..* \***.*...  \\ .*\ ..\.#
#*.  . .*.*. ** *..\..**. ...#
#*..\\****.*.\ ..**.* *.* ...#
#.* .*\.\. . ..\..*\.  \.... #
# .\..*..*\* * . ....  .\.* \#
# ** \. *. . * *.\...*..* \ .#
#\*.**  *\* ...*\..*.* *. ...#
#*.***.*\.*.* .\ **\.*.*\.  .#
#\ *..\   .  . *  .. ...*.  .#
# *\...*.*..\  .\.  *.\ *. ..#
#.. \*.. \..*.* .  *.\.*\ . .#
#\**..\...**.\.  ***  *.*.***#
#..*\ *...\.*.**.... *.*. .*\#
# **.*\  \. \...*\ .\ \.**\ \#
# .*\....... **.*... \**.*\*.#
#  ***. **.* *\    ...\.\.   #
#\.*...\ \... \. \ \*.*     \#
# ***. *..*\*. \.\\ * .**.* .#
# ...*\*.\.. ..\* .*. **\ ..*#
#\ . .. **\*.*\ .\**\\. ..  *#
# \ \..*\*. *. .*\.*\.* .\...#
#.. ****.\.*..  .**..*.. \.  #
# * * .\.* ***..  .*\. ..  .\#
#  .*\ *.....\.. *...* .  *.*#
#\. . .\ ..... \. . .\.**.  *#
#*\  *\ * . ***.*.  **\.  .* #
#   .****\\.*. *..\.\ .  *..*#
#\ ...*...*\ .*\.*\ . *.. * \#
#. .*....\..\..\.*.\ *** *\\.#
#*.\ *\ . .\ * . * *.  *..*.*#
#* *.*...**. .\  .\.**.**.\. #
#..* *  *.* * *   .   .*. ..*#
#\ . **\*\. ***..\...*\.*..*.#
# .. .. *....\.\  \ *. .  .. #
# * \*\.....*. *\\ \. ..\.*  #
#\. .**\.  * .\. . .  . * ** #
#   .*\. .*.\.* **.  .. .\.*.#
# ..R* ** ......** ****.\  .\#
#\ *.  .*. ..* . *.*.*.   *. #
#.**.  ** . *.\.\*..*.***..\\#
#\.. * *..   *.\..*\  *.\.*.\#
# \  .***.*.\*.*\.*. *.  .. .#
#..*\ .....* ..***. \*.  \ \.#
#  *..\. ...\ *....*..*..  . #
#*.. *    \*. ..  ..    . *.*#
#.\*...*.*...    \.\ * \* .  #
#* *. \ *.\  . *\.* *.*.\.  .#
#**  *\..* .. *.*\\ .\* .*.*.#
#**. . *.. *. .*\  .. \... . #
#.\. . .*  .\*\ *  *.  .\*   #
# .*.\ ..** ...*. *\..**.... #
# *.*.\..*..*\ ..\*. ** ..   #
#\  .\...*\*\..   ....* \*. *#
# ..  .. ....*  .*.\...* * ..#
#.\.\. *.. *. *  . .  .*   ..#
#*.. *.\*\*.* ...*..\ *\**\  #
#*. ..   ... .*\ .*.  *.*\ ..#
#. *. .*...*\ * .\.  *. ... *#
# .\.\   *\\ *.* . * ..\ ...*#
#. ..*  **..\*.\* .    .*\  *#
#.. ....... **\**\ . *..\..  #
# .* *..  **  ..\ *.\.\\* . .#
#\.**\.*\....***   .  .***.* #
# .*.....*.* * \ .\. *.* .*.*#
#.**..*... *.. . ..*..\* *. *#
#*..*.* .\ . * *..*\ . ...\*.#
#\. \. ..\. *\.*.\.* .  ..*..#
#  . .\    **. *\. \ . *\*.**#
#*.*  * *.*.**** .\. * \....*#
#.*.. ..*.. .*.* .*  *.**  \.#
# \.*** *.\\. **\..\ * .*.*.*#
#\ . .\ .*.. *\... . *.  *.\ #
#      . *..  .*.\ *  .**..  #
#\*\*..*.. \*. . *...* ..  \ #
#\... **\* . ***..*. ... \.. #
#**..*.*..\.. . ....*.* ..  *#
#*. ..\.* ..\.\    .*.*. .*..#
#.* * . ..* .      *.**.  .. #
#***\...\**.  *  *\.  \. *\ *#
#.. ..**...  \..\ ..* . **\.\#
#..  \.*  \.*.\..**..\**.**..#
#.*.\...* .*.**\....  .. .** #
#..\* * .     .*   \******.\ #
#*.   \ .*\.\... ...*  * .  \#
#* .\* \\..*..\. . ..*.\  \  #
#* ... \. .....  * .\. . ..**#
#*\*.*.. .*.* . \ .* *. \ **.#
#***\* \*.*** \... **\....\..#
##############################