###################################################################################
#.\. *...\\*  *.\...*. \  * ..*  .**..\.*.*....*.\*..\. .. \ .  *...*. *.*#    #  #
#.. \. .. ..\ .\..\*     ... ..\. \.**.\. *.  .** .* .\.  ......*.     .\.##  #.# #
#*\\.*...    .*..*.. \*.*\.   . * . *. .\ .*\\*.. *.*\.** .*. ..  \. \*..\. ##*\.##
#* . ..\ \*  *.  .. .\.\. *...\*.** ..   *\*.*..\ *..*. ...\*  \ \*. .** * .*...###
#.\. *....\  .  . . *.  .\**  *...\\*.*\\.**.*\  .. \. *..\*. .  .\ *..\. . .#*#**#
#... **\.*.\\ *..\\*. . . .*. .**.  . . * *. \ .** ..\*.*\.**.* * . . ##  *.\ .\*##
#.. .  .*.    \. * ... . *...\ .\.  . * \..\*.**.**.**.**...\..\*  .\ ...\\ ..*.# #
#** *. . ***. ...*.\** ..****\      .    \  .  ..*. .... .  .  ..\* .*\*\ .\\#* # #
#**  .\ *.* *.....  .\ \ *\.*  * .**.*..* \ \..* .*.\**.*\ .\.* .. .\..\.   .###  #
#\. *  \* .*\.*\ \.  .*  ..\.\*. \.. .**. .*...*  .\  .**.*  *..\\  * \ ***\\##   #
#..\.*\ .\ . .. .  ..\..\*.*\..*  \ ***\\* *. **.*. *..*. .*.\ ..*...*..##.* #*#  #
#*  .*..*..  .\*.*....\......*\* ...*.\*.*\..\... *.   ..* .\*.. .*\.. \*  \*#. # #
# *  .. . . .\. *. ..   **\. ***.  . * .\*   ...*\   *.\.**... .*\.*   .*  .#\.\# #
# . .... ** . ..* ...\   \*\.. *    *  .***.  *\*.\..**..*\.. .** ..*.\ ..**.** *##
#\.. *. \.*\   ..... *\*... .* .*....   \*..\*\*\  *..*  * .\*...*...* ...#.\ *.# #
#  \ ** . **.. \.*. *\*..*\* *     *  \..*.**..\*.\.. *\.\*..* * *.  .* . \...##  #
#   \.\ ...\***. * *\***...   ** . *\..  .\.. **...* .\\  .. ..*\ ..*.*\ \#*.#    #
#.  **.\.*.**\.... ..*.   ...\*. ** ...  .  . .* .**.*.*.\. * .  ..*\.*  .##.#    #
#*.*... .\ .*. ...*. .\*.*\*.. * ...\\ \ ..*\  ..  *\...  *.** .   .**..*...##    #
#. . \. .   .\ ***.\. **  .\.... * \* .  \*.. ...  .. * .\ \*.\\*\.*   ..\*. *#   #
#\* \  *. \***.*.*\. **.* \. *  *\. .  * . .. *..\*.*.**  * . . *.*.   *.*..\ #   #
#*. ..*...*..**.\.****.*  . *.  .*.. ...****  . *.\ *\*.  . * . * .* **\.#* ..\#  #
#* . **.* * \.*   *.**\ ...\*.  .\****\ *...\\*.**  **\\ . ** .*. \#\.**\#* ###   #
#\.\.*. * **. *.\ * * ..\* * *\   . ..** \..*   .\. .**. **...*. ..\.\.\.*\#      #
# ** *.\**\**.\.* .*\*..     *..* ....*.\ ..  \ *..** ..***\* ....\.*.*.*#* #     #
#.\*..\ .\.*.*\..  ..... * * \*..   \ .   \*.\ ..\... * ..\ \ ** .#\.\# .## #     #
#***\.**. \......* *\ ** .*. . *\**..  .* .* .* \     ** .  *.*.    \##.# #\#     #
#*.*  ..   .....*. .  ...*... ..*\R* ***** ..** ..     \\ \*..\ .. \##* #  #      #
#**..\**.*  .\ *.\.  .  .**.*\.*\.\\.*\ .. .*.. \*.\..  * ..  . *###  ##          #
#**\\*.* . .*..***. ..\.\.\  .*\* .. ... . ..\   ....  .*  . ***. ..\#            #
#**..  .  * * .*.\ . .  *. \.  .\..\.\. \.*..*  \ * . . .... ##.##*...#           #
#.\...*.*.*.*.\..** .\. *.*.*.   .\*... *\\\.* .*\ ... \.* .. ..# #*##            #
#. *.**\... **.  *\. .* . *\.* \* . *. *.  .   \ **\. \..**\..#\#  #              #
#*....* . \.\  \ . ...*  *..*. ..***.. *  *\ ...*.*...   \....\###                #
#\.  .* . ..*\ ....** \. .*\.. .. **..    ... *.\**..\*.  .. .*...#               #
#   . *    .\*\...*. *.*.   .. .....   .  ..  ..*..*\.. .\#\. ####                #
#\** \\ .  \.. *.*.* *    .\* . *..   **.*. *\...\.*   ..  .. #                   #
#..\\. ***..  ** ..   * .\*.*  ..*.***... ..*.* ** *\** \..#.#                    #
#\\.*. \.... *. ... *.... .\ \.* .*\.  .\.* **. .\.**  .  #*#                     #
# *. ..   .*\\\ .\.*.    . .*.\*...* \ . *.\**.. * .*.\.*....#                    #
#\.  *\..* .    \. * * ..*.**.     * *.....\ .**\* .* **.####                     #
#   .\  ***   . *..\ .*   .*.. . * *\   \.\ \*.**..* \.* \#                       #
# . * \\ .. \ .\ ** *..\\. ... \ *\. .  \*..*......... # #                        #
#   * .*.**.   **. *\  .. .*\**\  **.\ ..#  ..   \..\..  #                        #
#\....* *.\.\ *\**\  .*    .* \*.  . . *  \*..\ .#  .*\ \.#                       #
#\* .*..***  **....***. .*.  ...\. *  *. *...\..*.\  #*# #                        #
#...\.  *.*\. *\*\.. .* ..* \.\ .  *\. \.. .  #   *.. ## *#                       #
#\ .*\ #* .  .. .**\*. .. ...  *\*\* ....*    #\ .#\ ## . #                       #
#*\ *  .* .\*  *\\ \**\ .** .\ .....*  \*\ \*\#***.. ## L#                        #
###################################################################################