##################################################################################################################################################################################################################################
#. \.  ....**.. ..* **\.**.\**\.. . *. .**. .\* *..*. *... ..* ..\ \*.   \..*.*.* *.. \ *.*... .\..*   \* \ *.. *...\ *\ .. ..*.*\.\\ . * .***. .\.\*...*\. ...\ *\.\....\   * . \*.   .\.* .\ .***..\.\.** ..   .* *****. *#    #
# ..  .   .... *. .*.*. .*   *** . **. *.*... ....... \*...\ .* . ..   **  *. *  *.* .\.. *..  \. *.  \.*.... **.\* .\\.\. .*.**.*\*.\.* .\**\   . .\.*.*. .  ..\ .. .   . .*\   ...*\ . **... .\.**\. .....\. .  . *....\\#     #
#.. **  ..  \ .... .\.\  . \ \..  .  ** *.\.* .. ..\ ....     . .\.*   .*. .     *.*.*.   .....*  *\* .*..* ..*. . **\. .* .*.***. ...*.*...* * * .\  .. *\ .*\ .. ..  .  **.*.. *\*. *.\*.\. .*.*.\. .*. .*..*  . .*\. ..##     #
#\* .  * .**.\.**.. .\*...\\*.\. *\* \** .\. * ..*  .   ..**  *\ ..*.* *..*.\ * *\.... ...*.***.  ..\    \..\...\ . .*\. \\.\*.\. . * .*.. .... *\.* \ . ..*\... .*. .*\.*.*...  ***.*..*... .* . .*. \.* \. .*\*\* .*.#.*# #    #
#*... ..\  . . *..* *. \..\ ... *\***..**\***\.. .*\ .*.\*\.. **....  .**..*  \...**   ** . .\.  *...   .......* *.\ .*\.**. . . **\.\*\ .  *.\\\  .\*.* * *.*.*\..\**..*. .\  **\*.*.*\ ... \.\  \.** **\*..*..*.\.**.***..*#   #
#. . * \  .  ....  *.....\ .\....**.......**...*.**. *   ..\........\.*\.* .\ . **..\..*.*.*\.\\*.  *\*..    .*...\ ..   .**....*. .  .*\ .\...... . ..\ *\****. . ..\.* .   . .\.... .. . * .  . * .\* **..\*.    \ # .** .#    #
#  ...  ...\ .*. \**  **** * .*.*.* **. . ... \* .*\....\  .\*...*\...\ \.\. \  .\. **..**\ **\.*..*.*...\*  \..***...  *\.. .. .   \. ..\..*\.\     ... ...**\ * \.* ... **.. ***\..* ..\*  *.*\ .* *  \* ..\. ..* *. .#.##   # #
#  ..**\ *. . *.*.\..*.* . . \.\. .*.** *. .* .\  ..*. *..   .\.. * \*..\\.** .*\   ..*.\.. *.* \*.  .\ ....*.. *..\  **.*\.* .**\* .\.     ..*. \ .**.  *.***.. *.** ***\..*\.\..*\ \ ..*.\\..*  *. *.   . ..  ... ..  \ * # #*##
# * *.. \.\*. ...\. *.*  .. *.*.*  \. * . * . * . ** . .*    * *\*\ ...*.\.\. ..*\ *\*.**.. *.....  *. *  .*... .  *..*\ ..*.* \...*.  **.*. .*..... .* \*.\.. \.. .   \*.**..*.\ .* *  ..  . . **....*.  \*  .\* \.... ..#*##..##
#  .   **..\  * .   . .**   ... . ..*.. .\. ..\**.**.\*..\  .  * \ . * .* ..** ..*\ ...*.  .*...****.\... .\ *.\  \**.....** .\.  **.\..* .. *.... ..\.**.  *. *\ **\*.. .. .***   ... *** . .**\.*.****\ \.\\..\*.*\...** \ .*# #
# .*\ \. ****    .  ..* \*.\..*.* * *.. ...   * ..* \.**.*\..   .... .....*.... \* . * ..   . ..\* *   \  .*****. ***\ .. ..*. . *..     . ..*\*  * * * **.*.  .. .*.**  ... * * \*.   *..* .**.. .**..\**.*\*.. *.. \. *. ..*. ##
#* ....\ ..*.\.**.\.*   .* .   .**.*.***. * *. .\*.*. \.\.*\ \.\ . . ..*\ \*.*  ..  \**. *.. .*.*\..\.\ **  .. .\.*.. *... *.**. *\*.*\ .   \ \.*.\\*. \*\ *  .  * **. .* ....\.*.. .. .\\.\*... . ..\..*.* .\  \*.\*...*\\***. .#
#*    . * \.\.  .\ .\* .**\*\**..\..\...**. \ . .. * .....**\.\. *.    .. .. *.\.** \..  ..   *.*  *..  .*.**.*  . \  .\.... **  . .\*. *..*\... ..*.... *..***.*.\ * \**. *.\ ** **\ *\*   .\. .*. ...\*..\*   ..**\. ..*\*#.####
#..\..*..\* .**  ***..*..* ..\*  *... . .*\  . .**\  \*\.\..*.*  .\.****.*  ..... . *.. ..\ \ *.  *. * *.. .. .\  *..*\.** \.**..*  .*\   *. * ***..\.*.\ . *...*... * ..  *\.*.* .. ....\*.\*... . *. *\ *.....\*. .. .**.. *#  #
#.\.  **...  . \.*\...\ ... **\ ..*..    .  .*. \ ***.*.*..*. ..\*  ....\.. .. *. \...  ..*.. .. *    \ *. *. **.\ ....*... . .   \**..  \  *.\.*.  * .     \.\ .\ \*.\ *****..\* *.\ .  .  *.*  *  ..***.\.. .  ..\  .....\.#   #
# *. \..*\  .. ..*.*\... .**.*.* \ . .*.** * . .....* \.\. .. .... \. \. .  *.\\...  *\.\** \ .  .** .**.*\..*\. .... \....\..*  ..\  *. .*.. .. * \..\ .***. .**.  ** \*..\ .\.*..*   *\...* .*\\ ..* \.....* .\ \**.   *.*#    #
# .  ..* *.*\.   *.* \   *.* *.*.. *   ** *\     \.   . .  \ *  * *    *  . ..* *    .... \ .  .  .   *. ..\*.. \ **\\ \*\. * **.\..  *. *\.** .*\*\* ** ..\ ** * *\.**...* * .\  **. \..**\.  ..*\\ \ .*\*\.. .* #.. ...* #     #
#. .\**.\...\ .***.. .*\R*.. ***\  . ... ..*...\*.\.\  *.*\*\.  .* .\*\\...*. * ..  .*\  .* \*.  \\.. ...\ ..   .....\ \ . .**.. *..* .\*.. **** *. . ..** *..... *.\..\ .  *.\....\*\ \ .. .*....\.. .* *.*\..*.*  #.\L.\#      #
#\ \..*. *\..*.*\ .* ..*\.. **..*.*\\   \. ...**. . ..\\..***.* *.  *..*.\*. \*.\ . ** *. .*....\..\..\*..*\*  .  *. *\. \\.*.  ** *..* ..\\.**.   \ *\.\. ..\.   ..*     .\. *.  ... *\ *  ..*. .*\**..*..* * ***.*\  *.#       #
#\ .  . .*  \ .*..   *.\.. * . ..*\.*  *  .*\..... .\ ..\....*. . . . *. ..\* .    .*. ..\. ..*\. .* ...* .*.... *.  *.\.. *. *\. .*  . \\**...*....*..\ ..\ .\..  *..  .\ .* *  * \** ...\  \. ..\.*\..*\ \ .\... *..*\#        #
#. . ..\.* ..*\ **\ .\.. *\\  ..\.. ...*** \.. ..   .  *...*\ .*.. ** .**. . .* \   .*. . \ *\.* * *.\  . .***   . .\\. .*.\. \.. ..\*  ...***..\.\ . \   .*\*. * *  .\ ** *\*\ *.\...\** *\* .* *. * * \. .  * .\ ..\.#         #
#*  \*.. * .. .*\.*.**.  .*.\ *.*  *.\\**.*.\ .\ **.\*\*. \ **..**\.....**...\ *.*..*  *.\. .*..\***.**..\*.\\ * ***... .  *\.. ..***...\   ..\ \  **\. .\.\ *\ *\...** *\..\. *.**   \. *. .**.*.* .*\.\.\ .\* .*\  .#          #
##################################################################################################################################################################################################################################