########################################
#              #*.\. .. . .*.* #    .**#
#          ####**#*  .# *..*\* .\ .**\*#
#         #. \#\.#.#  **\**. *....\... #
#        ##\  #*.**#\  * ... .\*...\ \\#
#  #### #.\  .*.. . . *.* .\ .**.*.*.  #
# #... #\  .. .  **. *.*. ..*\.... ..* #
#  #..#### # # ....*.* .*.\   ..*. *..*#
#  #.. .#.*. * \....**. . .*.\* .\ .*..#
# #\ #...* .  \*  \. ..* . *.*.\ * ..\*#
##\ .#\#\...  .*  *  . *.  *.*.  \  **\#
# ##L*.. *.*.\**\ .\   .\* * ..* ..\.\ #
#  #. \.* . *... *  ..* .* . . * *\ * *#
# #..\#*.\ \ .\. .   .*...*   *....** .#
#  ##. .\.*.. ..    .\. . .  \.\ .  . .#
#  #.  **  ... .. .*..**\.\ . \* .\ \*.#
#  #*.... * \\..\. *. ..*** **..... ***#
#  #.   \ #\. ... .  \ .*.**.*.\. ..*..#
#  #*\*. *. *..*. *. ....... . ...*.*.*#
#   #R#. .  **..**.  ..*.\ *.*.*. *.* .#
### #\. .*  ....\  \.\*..  ... .  ...* #
# *#* .. .\    .. *\**..\*.. .. . .*\ *#
##.\  **.* .* \.\**...**. .**.. . *.*.*#
# #.\*.*...\.* \ \.\*\.\***.*\.* * .  *#
#  ##\  *.. ..  *..**** *.* \** \  \ **#
########################################