######################################################################################################
#*\  ... ..\*.  \.**..\.  .  ****..\.\.*.**\ *\\.....\ \...\*.***\*.* .*\.\*..  . ..    *.***. * .*..#
#**.  *\..*..  . ..\ .   ..**..*. ** . . .\. \..* \. ..  . **\....\.* .. * *.*.**..  .. *..*\. * ..  #
#...\ .\ .    . . . \.* .\.*.\\* . . .. . \*\.. .**\.* *.  *.**.* * *...\. ...** *. . . \* ...\** . *#
# \*.  . *.*\. \ \\  *\ . ..  \* .  **.  ...* *\ *.*..\. .. *\ .*.* . *. .* ..*..*. *\   ..*..\\.**.*#
#. .**.*.*.. *. *. * *  .*.....**.**\.. **\*... .* .**  .    .* . .   \..*.*..*...\..*  .\.*.*. .....#
#*.*.**. *\.\ \\.. * *. *\ *\ ...**.   .*..*\ \ **\ \. .*   .*. . *  \* * .\** \*...\* ***.*.. .*  *\#
#*.*\.. \ .... .*\   .     . .. *.. ..\ .\*. ****...   ...   .    .. .\*.*.  ...*.\ *  ... . . .\* **#
#.*.  *\  .*\  .**   .  \*R ... ..* \ *..*. *.*..\*   \* .\.\.  * . ..** ..\*.\ .* \.   .*\* .**.\   #
#   . .. .*. . ..*....   ... .*\.\.*..*. .  ...*\ . \\*...   \. **  * ..\***. .* .*.  \.\.  .   ***. #
# \.\  \...***..*.**    ....\*.. .*.\ * .*.* \*.** .  .**.. *.*\. \*\\**  . * .. *.   .\. .* \ *.\\*\#
#\  .   .* ..*\. *\ *.\  .\ .\.* \.* ..*... \. . .** ....* .. ...  . .*. *. . .**. .*\.* .  \* .. ...#
#    .\ \.\. *. *\**. ** \.. * .\ **.  ...*.**  . \.\    *.. \*\.****\.  .*  \  ..*\... *. ..** .\ \ #
#\.*. *..*.\ .*\.*** .\.\.  *\ *\*\. \.**.**\. .\ .  \ . * . . .  *.*.*.. .. ..*\. *\**.\.\**.\ *.\  #
#.**\\....**.\** ...  *\ *      **.  * *\.*.  *....\ .. *\* ..   \.\*\*..*\  \.\*. .\ .\*\ \.\. .\  .#
#.\*.\ .**.* .*.   .. ...*\  *\\*\.\**...*  \...  \ ..\ ...\. .* .*.. .*\..**.* *... .* . ..  ... .. #
#....*..*...* .*..     ..  *...\*  .. .\\\... \*. ***...* ..*.  \*\ *. ....*.***.*** .. \  . *.\ . * #
#\.*\. .\. .\    . *..**\.***\...  \**  ..*\. . . \***\...*\.\ ...*\\. \ .*.\. **. *.* \.\.* \....  *#
#* . .  .*.. *. *\.**.*\*.*\  .*.  .\.\..\ *\* .. .***   *.*  . *... .* . .\ \..* *..*  \* .   \....*#
#\  \... ..* .. ..**..  .\\  . *.    .* .*.*.\    .\.  ..\..*.\  * **..  .. * ..  .\ .. \*. \ * *.* .#
#**. .  . \**  *.*\.**\\ .  *. . *.    ...*.* .*..\** ...  .. *\ *\**.  ..   .*.*..**.* ..... .\. \  #
#\***.  .\....  *.. *** \.  .*\ \**  . .*.. ...*\.*** \ *. . **. \ . \ \   . ...* **... *..\.\. . ** #
#...*\   **..\ *.\**...\.* \.\ **\\.*\...*..  *.* \.. .\*\. ...\\.\..\ .  *  **..*..\.\.\ ..\ ** ...\#
#** .. * .\. ...* ..  .   . \ **.  .\ *\..*** *.. .*.***.. *      *  *\ *.*.*.......  .*. .\*.*   **.#
#.*.*... .   \*\.* . **   .  *** *   ...* ...\...\. \.... *.  \.**.\ .. .**\*  \***  \ .*.. .*.\...*.#
#*....\*  *  .* \\.. .\..   \\.* *\** **...\...*\.\....  *\**\.\*\  *. .\..* *  \.\.\.*.**\ .\   \*\ #
#\.\*.*. *..**. .* \. .*. .*\*\.*..*.*.* * * *.\*.* ** \ ..   ....\*\*....\\.*\..* *. .*. * \.*.* ..\#
#. .\ *  * .\**** *..*\..* . .***\\*\  ..*.  .. .*.  \*\ *    .\\. ..*... *. .* \...\.* * ..\ *....  #
#** . * . *...*.\  .*.. *...*\ ..* .*  *. . . \. . . ..* .  \    \ \*.*. ..\....\*\... *\*  *.\..\ \.#
#.  . \.*.*  .* .. \  **.*.* . \ .\*   \ .*\*. **   .  .. ...*.\ *...\*\*  *\ .. . * \ *..\*\*.   \.*#
#*. ...**.\. \.\..*\..   .....*..   **\...**. . . .* \.\****\..*\** \*..*\...  ** *  *\.. *.\.\     \#
#.\.   .* .\*... *. .*.\**\  ..  .\ \.*  *.*....\*.. .. ..*...\.*.\*. ..\*....*.....**.*.*.* *.. * * #
#..* ...*\..* *\.\.*... ..* . *\ \....\ *. .  *  .** ***  .\ ....*.\  \ *... \.  *. .*.. .** ... ..\ #
#\.*\*  . * \...*. ..\. *.*\ ..**. *  ..*..* ...**.\*.*.*\ ..\....\..* *..*..\.*\.\**  . \*.\.  ...**#
# \ *. \  .\ ..\.. *** ** \  .. * .* ...*  .\  ...***.. .. ***.*\ *.\ ** *... *... .****\ ..*\ **\***#
#\. .* .*. *.***. .**...\   * .\*  *\*. **\*.\* . .. ..*   \.**\. \ ..**\.  **. .*  .\..*   . ...* ..#
#* . .  .   . ..*\ **.*\.     * .*\.*.**.**\. *.*\..   . * .**.** .\.*.. .. *\ .. *..   .*.  ***..   #
#  * .\.\     .* * ..\. .*..\..*..\** ***. * ..***..\ ..    ..*... \**\.. . *  *.  .*\ **\. *\**..\.\#
#  .  ..*. ..  ..\..\   .. . *\\. ... ..**...  \ . *.\ . .  \ *\.. .  .  *  * \.* *\. ... . . ... *..#
#  * \\ * ... .. * *  *.\ *. . .**\ *. \..*...\.* ... *\\ **.\** *.* .     *\. ..*****.*.. . .\ .\.  #
#\* *. .. *...**.  ...*.  ... \\*..**.*. .\.. . \... *\*\*...* . .   . .. *..\..\*. \* .*..   *\*... #
#.**..  . \*. .*....* **\   \*.***\.\ ... .. \ ..*  .. *\*.*.. **     ... .   .. .  .\*.* ..\..*. *. #
#*.*.*. *\. .  ...* *\.*.. * *\.... ****    ..*.*. .\. * *\. *.\\ . .* *\..\ .. ..* . ..\  ..*\\.....#
#**. .*. * ...*   .\ *...*.*....*\  .* \*.. . *..\** \... . .. .*..\.\**....  ....*  **.    .*.\ .  *#
# \. .\* .  .\  ** . .\..*.. .  **.*....    ....\. . .\ .. .\ .\.  . *\... \. *.**\* .. ***.* .* * *.#
#.*.  ..*  *. *.\*.\  .\ *.*.  * \.  *.\. ..\  .. .\.. *... .   . ..*...*... ..*..... \*\*  .**.* ..*#
#.....**.  *..... ..\*..**...   .\...\ \ .  ..*\ * . \*..*. ..\*...\.\ *.. .\ .*\  \........\....\**.#
#* .\**.. ..... **\**..\.\...\ . . . *.. .\.*.... \*..*\*\     .. .. . *. .** ....\. . ..  .. .\\ .\.#
#.\ *.\... ....\*... ..  .\  *\ . .....     ..  * .***.\. .\** \.. **\  ..*..*.\*.*\   ..* .\  ... . #
#\**..*.\ *\    * . ..\.  .*\. . *  *.* .*..  .*.. .\\   .*.*\  .  ..*.*...\ .. *.  .. *...  **...   #
#*.. *. \**.*** \.*.** * .  . . ... .   *.* ..\.. ..  .. ..\* * ....\.\..*..**. ..\. ..*  *\.*\ . ..\#
#**. *\. \.      \***\ .. \ *. .\..  *\ ...\ ..\ . . * \  . *.. . .*. . *.. .* .  .*.**\ \***. **.\..#
#..*.** .* \  .* ..***** *.\* .\ . .\*.\**\\  .. * * *. ..  .\ .. .*.* ... . \*.. \.\*. \. .* ...*.*.#
# ..*..\.*...* . . \  .  .*  *  \ \ ....**. \  ***.... \.* . .\..* .*.*.\ \  .. \..**\   *.\ . **.   #
#..*    ..*.*. *  .. . . \. .. *\. .*\ .  * .\** *    *.*.   \ *..*\.*. .\.\ .*...\**** *.\.  .* \.  #
#. * .\...*\******.  ***  *\.*.. *.*\.* ..  *.*... * *.*.*  \ ..***... ..**.*     . *.\*.\ *\* .*..* #
#*\..  . *. **...*. ....\.....**.\  *.* .*... .*.. .*\*.*. . * .. .****  ....  *.* *.\ ***.*   ... **#
#..  \.*  *\ * *  . *.*.\.**  \..*****. .*.\.\  ... *** *..\\.\.*. ...* .*..**.. *.\ .*\.*.\ \   \ \\#
# \\ .. *..... * . *. . **.. .* .*. .**.....  .. *... ... .** \..*.\.**\ . *.    *.. \..*.*.* **.    #
#* .**.  *... *. \ .\   \.* .*.\ \ .\*..*** . * ....*   . *  *...* **.  ** .**....\ .  \*\* .   \.   #
#  ..\ **..***.*... *   ...  *...... ..\*.  ***. * ..\  *.  .**. *..* .\\. .*..\  . .*........\.... \#
#*..  ...\..\.  .*  *.**.*.*...*.  *..\  .*.\..\* . . .*.\.*    .\*.*   **.*.\ * .\* .\.. ...   *..* #
#\ . \.*.*..* .. * . .** **\*. *   ....\* .    .....*.**  *  .\*.*.*\   \*\.\**\*. *\  \*.. \\*** \.\#
#* ...*.*.***. .*.. *\ *..*.** *  **.   .. **.* . *..\*...\*\ ** ***  *..    ....**.*.*. **.. .\  .* #
#.\ .\. * .   .\.\ .*...* .\ . ..*..\ ..   *.* .** .  *. * .  *....**\* \. ..    .\ ..*\**..\*   \.. #
# *  *\.\. .*  ...   \*\\*\*.  \..**.*.\ \  ... *. .*\..   .  *\*.\ ... ..*.**..*\ .  ..*.*\ . .*   *#
#*** ...\.*.\* *  .**.***  **.* \\*\..\. .  \*  *.\.. .  . .  ..\*..\* *.\  ..  . \*...*.*.*  . ... *#
#...*.*\**. * ...* *.*... ..  \..*.\*.  .. *..\*\*.\*\*\   .*.*.  .   *.**\  . *\. .*\ .\.*** . .  *.#
#\.\.\..*\  *   *..*.*.. * \\*.**.* .. *\...* .. .*.. \. .*.**.. .\..*  *.  .\.....\...*. **.  \.\ . #
#  .... ...*.\.*.**.*... . . ....*..*....*  .*.*.\.*\ . ... *.*. . \.*  .\ * *. .\.. ... *\. * .  \..#
#\** . ...\* ..* .. . . \* **  . .\..\. *..\ *... *.  .. .. . *.\\.. ...   *. .*     *\  .**..\.. .* #
#.*\.\\. .*\*  . \ \*\\*.*.\\ .* \ *.. ... .*.\. *\. .  *... ... .\*.*** .** . . ..* ..\ .*\. .*.*.. #
#.. . . . .*.*..  ... \..*.\.*  .*.** .\. .\.*...\ *. .*.. \.. \  ** \*. *.. .* .\**..\*\ .   *\ *.\.#
#. *  *.  \.**.*  ..  . .\*..\ .  .** \..  .*\ . .\.. .*\. .  *...** .. *. *.**  *.*   . .  * .*..\ .#
#*..* ..\..*.. \ * *.\\  .*  *. .....\..\* \ *.    *\. \.*\  ..*.. * \.*. \**. * . *\*\.\..\*\ ..*   #
#\  ..... *.\ \*.**..*  *. *.* ***    *.*.\. .\   *..\..  .* *\.  ..*.**..*.\****. . .*     .** ..   #
# .*. \. *\  .\*...*\\ ... . \ ...  * \..\...  \ ..*.*\  . \ **  ....* .\**\* .*.\*.....*.\  .*\\*   #
#\.* ..* **.   ..*. *.*\..* . . ...  .. .. \   .  *\ *   *\  .  \ . \ .  .*.* *......  \ \ .*. * \.\.#
#\* \\ *. ..  *..\.\.\.*  . .  \* *** . *.*. \.***\  ..... ...*   * ........\ .* * .  *. **... .**.. #
#.   . ..**  . * . .**.*. *..*. .*... * . .*\.* \. .*  \   \ \*. .*\ . .\*..  *\.\  \ .*....  *\*. **#
#.\ .. ..***.*\*. *...*. \.* .. * . .\* .  * .\. * *.. . *.. ...   .*\ \*    ..*. **. *. \.* ....\.*.#
#*  \.*\*..\.*..*..** \ * **....\.\*.*. .\ *\*. .* .     . \ **. *....\..*.***..*\..\.\ ***..\  ...* #
#. *\ *...\* ..\.* .* ..* ** *  .\.. *  * .  .  .. *.  \.*....\. .. * . .\\...*.. \\ ** ..\* ** .* *\#
#..*.\\\.\.. *\*.*..\*\.. \ ..*.\*...*  \  \*\.* . ..\   *.     . *..\\  . . .* \  * ..*. \.\.\\ **\.#
#...*.** .  ..*. .  ...\**.   \***. ..*..*\... . **.* *.\.** .*  . .\*.\*\ \\ *\ . .  \.. . .* .. ..\#
#\\.. *.* . *..* . **. .\*.**...\.*. . . ...   .*.**\.. .. *.\..   .  * ...   .*. *. .. \.**\.\ *.\  #
# ..  **..*. *\. .\.*. .*.*.....    \.   ..*\ .*. *.. .    ...... *\ \.   . \.. **  .  \.*.....*... .#
#*\  .***  . . *. . . ...*..\   \. .* ..  .\..**\.*  *\ .*\ *\ .\** . *  .  .*.** *\   .  * *\\*\   *#
#. .\..*.**.   . *. *\.**.*\\ .*.***.***..** .* *** *\..\.  ...\. * ..\.*  \ ..*.*. .  ..*.\**.   ...#
#. *..*. ***\  . .\  *** * .\*..\ *.*.\ .**..**  .\ ....*\ .* \ *..**  ..... \..\\  . .*\** ..   *. .#
# .\.\.**...* . ...  ... *   *  . **... .\..\.\.  .\ . . .. \* \ *.* *\ ..\*. \..\ .*  . .\..\* *. \*#
# ...**. * *..  \* \   *\..  ...  \..  *\..*...*.** . \. \ * *\...*. **\ * . ..* . \.**\  . **.\\.\..#
# .\\..  . \*.   \.. *. . *\ \*.* .. . **\ *\ .  ..   . *.** *\.. . \*.  *.*\.*..*...*\ .  ..** * . .#
#.*.\.* \  . .* . .  ....\  * .*.  \.. ..  **. .. * *   .* \.*. .. .\.* \.*\ ..\.... \**  . ..\ . \* #
#*.**. *. ..*.*.. .. .* . .** .. \.   *.\***.* \\  ...*.*.\  .\.\**.... .  *\   .*\*. ....*  *  . \..#
#..*.. * . *. \. .* *..... .*. \*... *. * ..*\.....  ..*.**  *..*. * \ *\. *.....*\ \* \ \.*.**\  \ *#
##\.* ..  * .*. \*.\. . .\ \... *.\.\.\..\. . ....*..  . \. \.  *.\.  .*.  .  ...\*....... ... *\.#\.#
#.\  .*\*\.*\.. .\*. **  .  \ * * *  **    .. \. *.*.  . .*.... ..*** *.** .. . .*.\***.  . .  .  ...#
# . \.. \. *   . ..  .. .*. ...*.\ . .. * \**... * \.\  .*..\. ...*.**\.\.   * \\...*\.*..\ \.. **\\ #
#*.*.*. .. .*\.* *.  . . . *..\ **..\*..* ...*\. *    *.***...  ..***.\*..   *. ...  .. .**. . ..\ .*#
#** **.  **  .\. ..\.   # .. .\ .. *** \..  *.**..**. \..*.. *  . .*. **. *\..**.. . . . *.*    \.\\.#
#***..\\ *.. **\.***. . #..\.\.  \***.. *\ .. . \..**    * *..*....*..\. ** . .\*.** *  *\ ..*.#\.#* #
#..*....\.  .\. ... *.* \.*.* .\*...*.*..   .**..**..*  .. **.**\ \.\.* *..\..\ ...\.* .\.  .*.... *.#
#..**\. *\*  \**..*...\...  ....\*. .**** .  .  \.**...** *..**\   ..*. **\.\*.\.\*. *.  .\ ..#*** .*#
#\..\ *..*.#*\\** . .\*.*\..#..**.\ .*. .\*.      **.*...*.* ..  **. .*.*\. .\** .\. \. . ..*  #\* *##
##*\*. **.##*#**..*  *.*.#   *\.\.*  ..\.  * * . ** ...*** . *.  *** ....* .  .. *.\...\ .*.#\ * ### #
##*.   #\. \.# .# #* . #   ..*.\.*.*.   *.*\.\  ..\  ..\...... \ \*. *\ .**. *\. ... .*. *. ...#.#   #
#\..*  \*#\#*#..# ##\ .##*#* .*. #*..    \.**.*\**   **  *.* * \. .* * ***.\.*. .  ..\* .  ..*.  #   #
#. ..#..\#*## ## #* ..#\..  .#*.# ## .. *. \..* ...* .** *.* . .*\.\ * *.* . \..*.* **.  .#\ .\#*#   #
#  .....# #       ##\.* .\*\# ##    #*\..\ \ .*   .* **\ . \ ......  .  .**\ . #*#.#*##*  .*L\##..#  #
#**#**#\#          #*\### ##      ##\*.  .. ....* .**** . *.  ...\**.\*\ *.*\  .***#*\**\ ## # # *#  #
#\# #\*#            ##   #       #*\ #.    . .  . .***.  ...**.\.  .\ \  .\.. *\##*\\* *##      ##   #
##  #*#                           #....*.* **.  .* . . \   .\.*. **.. .\. . ...#  ##*#\*#            #
#  #* *#                         #* .\**. * \\..*.. .*#** \....* *.* .\ *.  .  #    # ##             #
#   ###                        #  #.. .\ .*** .*..  .\...  *. *. ... \* . #.*#*.#                    #
#                             #.###\#* *  **.*.. . ..*.. .\...**\.. ... . \ *#*#                     #
#                             #.**** *.* .\ ..*.. #*.\..* .**...* #\..**\ *.\*.#                     #
#                              ###.*\\..\*\#..#.. . .*.*...\ \  * .***.....* # #                     #
#                               ##\   *.*....*. *\ *\. \  ** .* .  . ..*# .. .#                      #
#                              #\*.  .  \  .*\ *#*.****.#\*.*## . . #..## #\ #                       #
#                               #.\ **  ..  **.\ . #\. #*.\ .* \...# .**#\...#                       #
#                               #\.*.#\\ ..*.*. \*# .  #\  \*. .. \.#### # # #                       #
#                                ##..\   **\.*  #* .\***#.*#.. .  # .#    # #                        #
#                                 #.*. \.... . ##.*\.\*##. ## \*##. #                                #
#                                  ##. .  ..** .*** *## # \# #.\.##*#                                #
#                                   ##*  . ...#*####*#  # .##**  ##.#                                #
#                                  # .**# * *.##    #    #*# #..* ##                                 #
#                                ##\ .**. .*..#           #   ### #                                  #
#                               #\.* ...\ * *#                   #                                   #
#                                ###****#.# .#                                                       #
#                                   #*#*#\# #                                                        #
#                                    ##.## #                                                         #
######################################################################################################