###############################################################################################################################################################
#                                                                                ##.*\*#\.* .*\*.\.   . .*   \.\........ .\   .*..\** .* .*  *.\ .\ . *#\ **..#
#                                                                              ##...\*. . \* .*** .**. .\.. .\. .**.. \. ..\  .. .\* \* *\.\*....*  *... *. .\#
#                                                                           ###***.* **# . \.  ..*.\. *.***   ..**.\.  .\ . ..* *. . .  .....* . ...\*  \.\ ..#
#                                                                 # #      # .#*\*.*\.* ..**\ .**.**. .. .* \.\ \  . .  *\ ***....\*.\**   *\* * **.  ..   .  #
#                                                                #*#\### # #\ ** . \.\\  *.... \.*\.\.. \ *   .  .\.\ \**.\*.\**   .  ..   ..**....* * * * *\*#
#                                                              ###*#..\*#*#  .* #*.**. .*.\ .**  *.** *  .\  .. ..\   *   \*\. * * ...    .\*.*..\**\. ...  .\#
#                                                             # * ..#*.#...\  *...*     ** **.*  . ... .. **. . * ** ..\ *\*.\.. .. \ *.. . **.  .\.  .\\ *.**#
#                                                              ###\*... #..*\# ....**\  *\ *. **\  ..  . *\*.* .....*. *.*  .. *...* **.. *.*.. \    \.. *..\##
#                                                              #.\*...    ... \\\....  \   .\ *... .\ \**..*.*.*\.. . *\.*. .* ..\ ..  \. .*. .. .*\**.*\..  .#
#                                                             #. .*\ ..\*  #*#...\ *\. .**\*.*  *\.  *.*...*   * ** . *  *.*\.\.\ \.   .*  \. *.* *..****.\\..#
#                                                             #\#..*.. ..***..\*. *. *. \...***\..***. ...**\.\. .**. .*\.\..\ * ..   . ..*.*****  .  *\.*. *\#
#                                                            # \* ...*......*.**.*   .    \ .. .  .. \\ *\**. .*.... * *.. *  ***\.* *\..**. \*    *.. .*..**.#
#                                                            # ##*. *\.*   *.\....   * \ .   .**...\..\.*..* *.*. \.*. . . *\*.\.* \ ... ...\ *.\.**  *.*  .  #
#                                                             #*\.  ..*\..**. . **.* . . .... *\ .. . .*..*... .*\  \ .\*  . * * * \***\   . **\. \  \*.*** . #
#                                                            #*.#.\ . *  *.*  \....\**\ .**    . \ * .*.\*.*.*** *\\.\ .*..* ..\ *.. ...\..*\..\* . .. *....* #
#                                                           #.*  .*.*** .*.*\\.    .*.*.... . . ** *   * *\..*\\ *..* \..\\* *..*.  .  *  R\ .*.. .  *..  **. #
#                                                           #.#\ ..**.#\..*\. **. \..\. . * *\*.\**\.\** . .** *    ....* *. \   . *   .*. *\.\*..\.. . **..  #
#                                                            # # * ..  .. #..\**.\    .*\.*....* .. \*.   *..* .  \.\.\.\*.*.. *\  .*  **. .*  . .*  ** .*.. .#
#                                                              #*  .*\. .. * *.\. *    * .\ \*\* .  \.*.. .*. . **.**. *.* .\ \...* \**.** \..*  ... .* * ..  #
#                                                             ##.*.#. .  ..*.. * . \.*\ \ .\.*.\.* ..\ \.*..\  \.\ **. . ***... ..*\.* *.. .**. .\  .*.... .\*#
#                                                          ###* *\.#. **\\**..  .\  .**.....** . *......\..*. .* . .*. .. .****  .*. \ ..*. *.. ..*  * \ \ * *#
#                                                         #. #\  .. \ .*...\*** \ .*\.. .*.\. . .*** ....  . *\*... .\ .  *..\. \.*.\*  *. .*\.*\.\   ..*.#. *#
#                                                      ### * \.** ..#* . *.**.\ \ *\  *.**\.  ***...\. \ ....... *.. . *..*. . . ..\ ..\\.*    \* *. ... * \ .#
#                                                     # *.\*\.  .. ... . ...\*** \.. .\\\.. ...*.\*. ** \*  * .*.    *\  .. . *  .\... . **.  ..\ \..\*   .\. #
#                                                    #.# *#. *\.   . ..   .*. .*. *\.*. .* \\* * .. ..*\ .  *\.*.\***.*.**... .\*  . *.. \*. **\.\. \   **\.*.#
#                                                    #..  **\.\   *\  \..*...*..  ..\*..\...\  .\.. ....   .* *..\\..*.*** \*  ...\.*.*\..**.*..* . .. ... **\#
#                                                  #  #*  .\*\.. \* *.  *  . .*\   .*.. * . .*\*  .  .  .**.\* * .***.*..**.*.  . \..\*.  ........\ * **  ....#
#                                                 # ###* #..***\ **.** \** * *... .*  \  ...\..\  *\.  *...  *\. ... **\  .. ... .*.. .\ .   *\.  .**     \ \ #
#                           # ###                 #.*\#.   * **  \. .* .*.. *....\..\.. . *\  .* ..*\*\ * * .*.*. .  *...*\*. .\.  .*  .\  \...  .*...*\ \* .\#
#                          # #. *#             #  # \*. .  .\.***.\. **\....*..*.* .**. ...  .....\..* .. *\ . .\ *.*. .*. \..***.  . .*  *.*..*..\.\*** * *\*#
#                          # #.*  #      #    #.##. . *#\.     **.**  *.. * .* . . .*.   . *. .. .*\ *. \.***\.***\*\ . *\..\**.\* .....\ \*\ .\ *.\..\.. \. .#
#                          #.. * *.##   #.#  ##\#\.. *..  * \.*. *** *.\*..* ... . \.*. * ... .  *\**.*. . .\ . .....*  *  . . ..**..*.   .*. ..\ *.\  .. .. \#
#                     ##   ## .*#**\ # ##*.##*. *  .*.. * *.. .\*.*. * **. \ .**** . ..\.. . ...*  .. \ *   .\*. *.  .\\. **   \..*  .*..\  ..*.. . **\. ***. #
#                 #  #..###.##\..*.*# #. *# ##.\.\. \ \.*\..*  ..... . .  *  *. .. . . .***.  *...*\**.   .. *..**..***..*..**...   *\ .*  .\.\*  * \*. .*\.\.#
#                # ## .#...* . . .**###..\.# *.*. ..**. \. \*. **\..\ .\  .    \*\*   *.... . ..  . .*\   \ ..*. ..\..\.\**\..*.. ....  . ..  *..  ..*  ** . *#
#                #.*. .*#\.. \* * ..\*###* . . .\** ** *..  .*.... .. .* \  *  .....*\.\*         ..\ * * *\*.\ *\\  *****.* \.    \\  ***  ... .  *\. \.\**..#
#                 #**. *. *  .**.*.\.*.. ..*   * **\.. \  . \*\*... \. .  *\ ..  ..**.** \.. . \.**..\.\. ..*   *.*..\... ..*..\ .*.*\*.*. \ **. \ ...*.*.*..\#
#                 # .  **.\.*\ * .....* .\ .........\  .  . \...  \ ...* ..***.**. .*\ ..\ . .. *..\** **\.***.. ..**.\  .  .\\ ... ***.\.*..\. *\.  *.*... ..#
#                #. . ...** .* \**\**#.  ***.\.\  *.*.*   .*\ *. \*\**\.*  ....... \..*   . .* ..***.**\\*\..***.\ \* *  \\\* ..    .\..**.\  **\ *  ..\  . .\#
#                 ##..*#\.\.\  *\.**.   *..** . *.. . .*.. ..*...\ *\.* .  .* \  *.  ..\.   . \ .*..*.. *.*.** \..  \ * *  ..*. \ *..  *.\. *.\**.. *\ *  *...#
#                 #. * #.. .\... *.\**  ....*.*.. ... ..... ...* . * .\   *\......  .   ... .    .. .\.\*.***. . . \ .\ . *...*  *\.\. *\ .*\ ..  ...*.. .... #
#                  #\\  ... . .\..\..*\   **.  ..* \. .....*\...\  \.  ..*\   . *\....  * \ * **..*.\*. .*...    .\..* .  \   . *.. *.*.. *  * \.*.  .*   \ .\#
#                  #*##\ *... .* ..\*. *.  ...**..     *..  *\.\.\*.*..  .. *\*.... *\.*\*..*...**...\..*.. *.\  *.. . *.\. \ \*. * \.. .*\ *. . ....... **.* #
#                   # #.#**.*. .  ..\.  * . * *.****. .***..** *  **.* \..   ....*  ..\\ * \*\....* \\. . ....   ...*.*. .     . ..**. ......\ .*  ..*\  \..*\#
#                    # . *.*. **.* **. .* *\. ..*..\***..***.\\** .*.*.* .\  * \*.*\ \..**  *...*\..*\..\ \\** ***..\ . .* .\  * **  . ** . \* ** **.*\** .  .#
#                    #\...*\* *... *.  *.. ... .*.\*. . \.**.     \\ .*. ..... .....* .*.....\*.* . *. \ ..\.**\..* .\ ***  **\.. \..* . **  *..\.****.. \ .  #
#                    # .*...* \.. *.. .  \*  .. *** ** \  *** *..... ..* \. \ \..*\*. *.\..\ ..*.. ..   *\  ..*.* \ *\.\ *\.*.. .\..\..  ** \.  *  .\.. .* *  #
#                   #  *\ *..\.*. .**** .... .**...... .  .\...* .*\ .*.\**..   ** * ...*...  .*  .*..**.. . ...*..*\  *\.  ***\   \  \.\*.\ . *.\.* **.....*.#
#                   #\.*.*\\*..  .\. .* .\..* .\ *\\ ..*..* *   **. \.. . *.* * ..\ \***\.*.**. \* \\....*.*    * \   .*\..**.\. .. \*....  .. .*.... .**...* #
#                  # *#* .#. *.*\   * .. \* . .. *. * *. \ .*    **. *\**\ . \. **  .*.\ *. ... .\ .. \. .  .\..*\  \...*. *..* *.\\  \ *. \* .. \*..\..******#
#               ## # .*. #.*... \.* .  *.  *\.**.*\ . *. .  *...... .*.*\. .*.\ .*\  *   ...\*   .*.... .  .*.  **\*. .. . **...*.\. ** .. * .    .* **.\*\.\.#
#              #.*#.  *.  \.*.*.  ****.. .** ..* ..  *\.* \     ..  *...*.\\.*. *\ .*. *. . ..\.  . . *  \. \.* *\.**. .. *..\*\ ***  . .*\.\** .. .\.*\ *..**#
#             #* *##\.....\*...\.*.*.. \  ** *.  \ .\\ *  \**\.  * ..**..**.*.* .   *.\. ... ..* *.** *\. **  * ****.*.\ \*.\.\.\..* \**. . . * .  *. *.*  ..*#
#              # .*#  . *\ .*.\*\. .*  ..*.\ *.*    *.  ... .. ...\  *\.*.*. \       \.. *.. * . .*..*...\......*.**.. . .*\..   **..  . .*.*.\ .  * *.\.   . #
#             # \*#.***.\ *\..*..* \.  ...\ . .  **.*  **\. .*   \ ....\.\.*..*.\.*\*. *  *. .   \.* *..*..     ..***. *. *****.      \** \*\ ..* .  .*\.\ .  #
#             #\**#*L .**.\\*.. *. ..\\  . ** .*..\.*  .*..  * **..  . .. .* ..\\*.*.  *  .  * .\. *...   . .\\  .\.*. .  *\ *.. * . \. .  .\  \... .**.\ ..*\#
#            #* **.*..*.   *\..*.* .. * ..\.  *. \** *.. *. *. .  \. * .. .*.. . .\. .\...\ .*.*  * . ** ..\..\.. * .. \*. **\   . \\.*  .   **.\ .* \. .  \.*#
#            ##. .##. # .\.** .... **.** \.\.\... *. .   **. \*\\..  .* \ .\. . \**..\ . .* ..*...\. *..  *.. .\*...   .. .. * * ..*. . ..\ .** .. * . *. ..*.#
#           # * .\.  .\  .*... ** \.* .* ...  .... *.......\..*\\\.  **.. ..   *...*.    *    .  .\*.*.  .. ..**  .*.\*. *  . *.  *...* \\.....\ * ... .*  ..*#
#          #.*  \#**   . . \.*\* *.\*  .**\ .  . \.*.\* * *  *   \.  ** .**  **\.. ..* ** \...   \ .   .* .*  . .*****   .  \..  **..\.*..  \.** *. .  * \** .#
#           ##\ .*.\ .. *\ * **....... *.*  ****.  . *\ .\. ..***. ..\. **  .*** .*\. .* *.*  .*  . *. .  .*.*. ..*.*.\*.*....*.  *.\  .*.  \ *..*\.. \*.  \ .#
#            #.* .... . .. ..***.   \  * . ...* *   .*. ...\.\..  * .   .*  .*\\.\. ..\.* .... . .. .*.*. .***.\.\.**.*. .*** \..*** \.\*....*.. * *\. .\ .  \#
#           #.*.\**. \..*..  *\*  *.\. . *\*.*. \  \ . .. *\.*\ .* . *..\* ..*...* *.. .\ * .\...***...* **..*.**.\\ .\\. .. \..\..*.*.*.*.  .** *.. .*..  .\*#
#            ## ..#. . ..  . . .*\ ...\*.*..\*\*...*..* ..\.  . *.****.  .*.  .\.**. *....\*\.\. ...**.\.*.***.. .* **..\** *.  . .. . ** *  *...\ . .*.**.\ .#
#            #* .*    .\.* ..*..\ *. . .*\  *...*  . ..**\*..*\  .**..  .*  *. .**.  . .* .....* ....*..   *..**\.. *  *.*.*\*. .. ..\* * ****\* \ \*\.***  \ #
#            # * **\..  *.\ .* *..**.**   ..\***\ ..*.*.\**  . ......  \ * .\\. .\. .**..\ \** *\****.**.\...\  ** ...* *\*...* \ \..*.. ... ..*\. ..* .\* \ .#
#            #.  \.*\.... .. .\.\ .\*.. \ *..**.  ... *.. .  .. . .\ . ..*\.  *\.** *.***\... *...\.*.*...\\ *\*..** .*.\.. *\.  .. .** .. *...\ \ * . ..\....#
#            # .\ .** .* \ *...**\*..    .*.*..  .  ...\ \. \  . * *  .\ .. ***  ..\*\*....\ *\ .....****. *.\*.***\.*..  ..* *  .\*\ ...*\*. *.*...*.  *** .*#
#           #.  ..*\.\.. .\.* *** ..\ ... . .\.* *   \. ...*.  ..* .\ .... *** .  *.\*\.*... .. .\ *\...*\\.. ...*\. **\\.  .\*. *..\.*\**... *..* \*  \*. ...#
#          # #  . ** \ .\***... .*...*\  .  .  \.\... *\*..*..*  ...*.. ..\... \.*. *..\... *. . * .. .\.  ... ****...\  \.** **.\.*....**. . .. **.*\\  *. .*#
#          #*.  * ..*.*  .**.*  *.\. .. .*\    .  *.*\. ..\*..... \*.. .... \.\.... **. . ..\*\. .* \\ .** \\. ..*.* *.*\.. .* .\.\.. *.\   \... *\ * .*..*** #
#          #. * \****.*   .\\  .. *.  .. \  * \ *\.*\..*.\**  .\ *\* *.   *\.*    ....*.\ .* **..\..*.. ..* .  **. \ . .  \ .. .*.   *\ *.. .\ \ .  \.\  .... #
#           ##\..* *.\.** .*.\\.\.*\.  **\ .\ . ***.    . *. ....\.*.\*.....*.. .*. *..\.*\.*..*. ..\*\  ** *\..\*...* *** . *...  .*** .*\\***.\*.*\*  ....* #
#           #\*.*  .*....\ #  . .*\  **.   .**.*. ..\ .   \ .. \  *.\ ..**\ .*.**\ .*\*..* ..   *\*.*\\. \.**.\ ..\..\**  . * .\  *.*.. ... .**... ...*\.\ .. #
#          #...\#** .   *. . .\   *\ ...*...** .*  **. *\ .\ . .\ *.*.***.*\  .**.\..\*. .    * .*.\.*..*.*.\...  . *.**    .\.... **. *.. . .. \ .**\**    *.#
#           #* # *.*. *.  *   .....*\**  .\ \..*. \..\*.  ..*.*   **  .*..* *.*  . ....*..   *.\ *..* **. *. \..    *\... .** .  ...***.\ \.\\  *\ ..* .  ..\ #
#           ##*#*. ..... *\ *\*.. ..*.. * \ ..\*.\. *. ...**. .\.\..\. .\* ..\*.** .... *  . .\. .  . ..*\* \.* .*.* .. \**...* * \. ..\.*****... * .**  .*\**#
#         ##*** \  .\ .  . ****\ *.\ .* *\..*\ \ *\.* \ ...*\ *.\ * .  \ .  * ***. .*\...  *    **.*.  ..*..  .*.    \ * . .. .\*.\**.\.\*. .*  . \. *\*.*****#
#        #* *\ .\.  . ..\. .\*.* . ..*. \  * * .*\  ... \  .. \...*  . ***\\* \*  * .*.. ..*... *\ .  .* .*.   \ . *\.*.... .*  *\*.. .. *.**\  *. .*. \... *.#
#         #.*#\*** \.* \****..\...  \.** .*. .\ \.   .\*... . \*\...   .* . .  \.*. .*  ..*. \ *.*\  ... *.*       .  \.\**\** \* * \... .\....*..\*.\  ..**.*#
#        #\.\ .. \...*....*.\ .*.....  *.\ .\.   .\*   .\. .. ..*.*  *  . ..  * .. *.**\* .. ......   \ ..*. **\ . *.*..*..*. . *\\..*.. .* \  . .. .* * *.\*.#
#        #* *\*.\.\\..\.\** . *. *\.* .. ..* .   .**\*\*.*\**. .*.*\......\*\\ . .** * .. .\. .  ...***.\ ..\.* .\..*.   .*\. ..**\*..... .\.  .*\ *  *\*\ *..#
#       #\*.. . **.* ....\.  . *\..**.*\....\ . **.     \.*.*.\ * *.*.    ...\ *\.. \..*\.**.**  ****.\*...\.*\.\.**..* . **\. .... . *. *\ *   *  .\.  .....*#
#       # .*..* .. ..*. ..** .\*  ...*. . .*.*\** . \*.*..\*. ***.* .. **  ..  \.\*\ .\.**.* \.  *\** .\   .\*. . ** ..*. *..    ..  \*.  .  . .****  * \.* ..#
#      #\.*#.**\...\.  **.* *. . **\... .. .*. .* \*.* .*. .* ..\\. \\*.\ **  \  ..*.\ * * * *. **\..* .   . .* *\ .*. \**.    .**.. ...  \ \ .*. .. *\ *..\ .#
#      # ##*\#...**.* ..  .\*.*  \\ *.*..  **.\ .\..*  ..*  **\   \ *\*\* \.... \.\  *  \ .\..*. .*.*..*..* . . . ***....\ * .. .*.*  \   .  \. .*....**.. .\ #
#      ####.#**.\....** * .*... * ..* .** *..**.... \ \ ..\*...  * .*........ \** \* *.  ***... \. ..  .\... *....\..   .  ...*. * * ..  \.. .. **.   *\ **. .#
#     # ..# #\ .  .....* **..*. . ... .** \. .... \ .*. ..*   \ *** **.* ..\. ... .\  .. *..*. *.  * *... . .\* .. .*.  *.*.*.*..*\* *. *.*.*\* ... . * ..** *#
#      #\*# .#.\   \* ..\**. * *\ . . ... *\..  .. ...\..*.  \   *..*  *** \.\  *\ .. .*..*\. \.\ *.***.. \  *.  . .** ** *.*.. \..*..*....\*.* . ..\.* ...**.#
#      #*..  \. * *. .  *\..*. ...   .  .***   \ .. **.. .\ . .\.*. *. \..  *..\. \.\.\*\ *.* .   . .\.* ** .\...\**... . .\. . \ ..... .. . *.  *.\  *.\.\...#
#     # ** .#..\\*.  . .***\*..*.\***... *...\ .* \ .**  .\ .*.*.  .\.\  . .. *. ..*.\.  ..*..\.\*** **. *.  ..\ \....    *.. \ .  \.. \ .   **... .. *\ .. .\#
#      # *  .\....  \*\. *...  . ..*  **..\.\.. *\ *  . .... \.* \.** *.\ . . **.. \  ..* ....\.... *.....*  **... \.  *\* . ..  .. .*..* .**.. *.* * ..\  .  #
#     #...    **\*..\. \.. *.  \ ..* *.. ..* .  ..   *  *.   .** \ .\\*** \\.*.*.\..*.\ *. .*.  *.. . .**.*.. *. .\.\...*\   **.\ **.***  ..* \\.\....** *  . #
#     #  #**  .\*.  ** ..****\.  ** *.* \* *\  . *.  ** \ ***** .....**..\..\.  **  .*\.\.  ..*\*\ \**..\. *.\. .*.*. ..\.* * *\..*****.\ *...*.  *  .*.\.**\*#
#    #\ .\.**. ..*.*.*\*..*\ *..\. **....\*.\.*  ..\ \ .*  \.*   *\*\*.*. .. .\**..\ . *.\*.*.*.\* . ...   . *..\. *.... .*** *  \ .*\\.. .*  ...\.*. . ***...#
#     ## . ..**.\.*...*.\ *. *  .*.*\\.  . ..*\ ** ....\.*..*.\.*  .** \.*\.  *. .. .  .*..*. .\..*\.\  ..*...  .. ...   \.*\..  ..*..*\.*\... . * ** .\.\...*#
#     ##. *. ..\.\.*.\.\*..\..\. . *. . *. *** ... .. . .*.**..\. *.*\*. *.*. .**\.. ** ..\.*.*.**\.**.* .....  .*\..* \   . ..\   . ..... * *  .* *.*  ****..#
#    #*. ..*.... . . . .\.\ *... **.**. *.*.*....*  . *\..**.*.. \**. .\.... * ..**\**. *\.\.\  .*. .*...  .* \ .\. .** .  ... .. **.** .\....\  ..*.*\* \** .#
#     #. . *#* \.\* \..*... *\..\.**...\. . .**\ *\ * . **........ **\*.\ .\\...*.*... .\** ** \.. *   .\..*.\  * .*   * .\   . *......\ \\***.*.. ..** .*....#
#      #.*\ #  **\.. *\\. ...    *.*  **.\ .*..  \... \ ..\\.*\.  .*. .*. \. *  .*.* \.\ .. ..\.*  \*  .*\.** ..\*..\ *. .. ... \.* .. * .*\.** \ .   .  .* *.#
#   # #\ .\.***\..*.\. *  *. .* ..  . . \  . **.*** \.  . *. .  .   * ...  . *\...*. . .. \ *. **.. *\  .. *.\ .**\ . *..... *  \ .*.  .\ .*..... . *\ .*. \.\#
# ## #*#. *.***. *.\   .  .. .\  \..  .*.   \.\.*.. .*.*.....*\ .. *.\* *.  *.\ .*\.  *.* ....\..*.**  .\....*\ .. .\ .*.*  *\\*.. ..  .* ***...  \.\ ..\ \...#
##\.\......\.\.*   .  \ \ *. *..\.\\** .*      *\  . .\ .*  *..* .\*. *.* \*. *.*. *   ..\ .\ .  * *.\*\  \  **.* ..   ..* ...*** .*\   .\**. **.*. .\ .* .*. #
# #*. * \ .* . * **.**.. *  \ * \. .***   .*. *..\ . *.  ***. .* *\..***. .\\ . .* *\\. ***\*  .  .\.... .... . .*  .\*   \  ....\ ...*\.* . ......*\.\ . .\ *#
##*#    ..*..\ * \ ..*  **\  . ...*.*.*  \ .  *\..\  * . ....  . . .......*\    *.*.*.  *. **\.. \**  *. ....\.   \..   ***..*  *\ .**.\.*.*.  .....\ .*.  . .#
##..\ ..* #\ . .\.*.\*\ *.*. .. * *\... *. .\.\*.  \*. .. .  .... * .**** .* .*\**..    .\.... *** .\... \  *  \**.** .*.\..\.\**.*  .\ .  .\.**\.*.*  ..\. .*#
##\#*...*   \ *.  * .*..*..*.\.\.*.* * ..    \ .  *..*\ \.*..\ **.. *... ...\ .**\.*\*\. *.\ . .\.\\.. \   *\.   .****.... .* .*  .\. ** **  .... .*.* \*.  ..#
##\.*\..* ....*..*\* ..* . *\...\..\ *.. . ... ..\..*.... * . .**. ...  .\ .. **.* ...\..** *\.** .. * *..**.***   .*\.* .* .  . \.  . **.*\*..\*\ *..*\. . ..#
# #\*..** . . . *..** ... *  .*....\ . .\ *...*.\. \  *\  ..   .  * ***.\\ .. ..*. *... ....*. .* .\.. .*.*...*  .* ***.  **  . *.   . \... . ... .* \.*\.\.. #
#  #*. .*.***  .. ...*  ** \** . .. ..* *   ....*** .\  \. .   . .* . . *** \ \*..*.\ .\  \\.*. .. .. \ ..**\.\.  . **\ **\. . *.*.\ *..\.*...\   **  \. * . .#
#  #\#  . ... \.\ .  .*\.*.**. . . *.** .\* .\. ..\. \ ... \. \\. *.  *.**\ . .\. ...*..  .\ *.  \.. .. *.*..** \ * .*  ... .    . *\.....\.   ..*.\ .\ *  . .#
#  # #.# .*.. * .\. \..* .* *\ .*..*.*. \...\*\. .**\.* * .   ..*\\ . .\ . .*.   \ * ..  . .. .* . \   .. \*\ *  .\.\..\ *** \ *\ *.. \.\ .. ..*   ...**. .*.*#
# #  .\ *.\.*..\. .\. ..*.. .. ..\\.**.* * .*\ *.*....*.**\*.\. . .\ *..*.. * * .. .\**.* \ .\ .*... **  ...  . *  * *. \ *.*.\*.\..\...*\*..  *. *\...*.. \..#
# # \  . . \. ..\  ...  .. .*\ * . . \ \*..*.  . .   ** \. *..  .  . .\\\ .*\\..*\   ..*.*. ..*. ... ..  *** *. . ... \\... \.. \..**\*.*\.*. ... ..  ..*.*.\.#
## \##... *.\.*. *** \ .. .** .*.. \\.*\. ...*.  ***..  .\ ..*.\ * . .*...\.*\..\.* .\. ... \* *.. .*** .\.. ..\*  ..*.. .\ . ..** ...\*. .  \.\ ...\ .*  . .\#
##\  . **\. .*...*.* .* ..*..**.** . ..*...* .\.. \. .   ..\ ..*.. .  **. . . *.*.\.*** * .*..*...  ...  ..  **..* *.* . *   . \*. *.*.\. ....*.  .\ . .\..  *#
##* .  \......\....\  \.  .*.*\..*.. \ .**. . *. . .. .  * ..\...   .**\.\..*.. .***.. .\   **.\ .. \  .*.\.. .  . *..*  \ *\.* \. .*.\*  .*  . .*  *       .\#
# \.\.  .* *\.*.   **\..\ ..*.. *.. .. ..\.* *.*  ..\ .**. *.*..   ****... \. .*** .     \..*.*  .\.. . * ..*  *.*.* . *...*.....\* .**\*  \ .\ . *..... .*   #
### #\*.\.*\ *.   .*. ..\....*\ ..   \ * .. .**  *.  . .\..  ...   ..... \ . * .*.. . ...  .\*. \.**\.\.. *.* ..** . * ....*\.\. . .*\* .***. .*.\\ ** *. .\*.#
#  ##**.. ...*\.\.*.  *. ** ** \*.  \.\.\* . *\. \*\ * *.\.. *** ..*\\.*.  *..\..\ *   . *\  . ......*  \ .*\.*....***\.  .*\     \ **...    *.\ \***.  . \ .\#
# #. .*  . . \\ ... # .*.\* ..  * *. \ **.\   ..*..*.. *.*\...\. * ...**. ..\.* *.*. . \ \   *.\*..*..\  ... \.    \* *\  ... *.. . .*.  *\ .. *.. **  .  .* .#
#  #.  ..\.*. \ .  .. .*  **  *.*. * *..*\.\ * .. ..*\.... .\ .. .**..*... *. ...\\ . \.  \ \. *. ..*\\.\ \*   .* .. .*.   .*. *. ..*.\  **....\..*.* ** * \. #
#   #.*\\* #**..*\ **.** .\*..\   .\  . \. ..** ..\ \.\. * .*. ..****\. .*\* . *.*  *..** .   .. *** *..*\.*    *  \*.*.    *.*\.*.** .*\..\... \...  .  . . .#
#    #**\###.** .*. . *.\*..... * .  .*.. ***..\.\**.*.  . ...* ..*.*.\*.**.\ \.*.**..\\ .\.****.*\. ..*..\*. \...*  *..  *..       . ** .  ..\*.  ..**. ... .#
#     ##\##. . **\**  ...     * . ..\ *.*..\ ... \..*....  * .*  ..  .\.*.. .**..***\.*..*\ ..\ ..*\ . *\...\*. ...***.\ \** . . . *...** *.** .. ... * .  ***#
#      #* \  .*.. .. * . \**\.  .*.** . *... *....*** * .\  ..*.... * *..*.\**. .. .**.....*  .**.. ..\**..\ .\. *..****..**\  \.*  \ \.....* **  . \.*. ..\. #
#       #\ . .#\..   ...\.  *  . ....*...*. ***\.\*.. ..  .  *. * \*.*\..\**\ *.. . **\ * .\...\.***... .** .*.* . *.... *\.*.*.*** .. \  .*  *\  *. *.*...\..#
#      #\.  *\** .  .\\ . .\*.*.. . .\. ........* .\**  * .  .... \. .* * ..**. .\ ***. .  . \***..*\.*  .\ .\*..\\.. .. .... .\..\..  .* ...* .\*\ .. ... .* #
#      ##*\ . .\.\**... ** *.\....*..  *  .*  **\ .......** \ \**..\ *\*  **\\ . .*. \.   \ *.\..*...     .\  ..\.*..* . * .*  .\*. .  \.   *. .*. ..\*\.\.\  #
#     #*\*\*.  * *. .\. ... .*.\* \  ... . .\ .*. *.\ *\**.. *..**  \.. \.\..\. .*.  . .\.. \*.\.   .. .\.\.\*    .  .  ..*.* ***..\*.*.*\. .\.*\  .**..  . * #
#      ##.#..#\.*.**  . \*.. . *\..*.*.\.*  *..*   .. .*... ..\. .**   .* .\ ..\.\  .\  *****..\.. .. .*.  *.\ . .\.***\ \. . ... .**. \.. \.**. \* .. ***  .\#
#        # #**  * .. \  ..*. .*\*\ *..\. *.*.*\... .*....**\ . \..\. *  . ...\...*  **....\*. ...    .**  ..*.*.**.*..\  . ..\. .. *** .. * \\*. .*.   \.\ .. #
#           #\#\.*.   .*. ..\.*** *\*.** *.*. . \ * ***..*...   **    **\.\** . ...*...\** *   .*.\.  .. .  *\.*.* .. .*.*..\ . *\.\...\ ** . ... .*.  .      #
#            ## ..* **\ ..\ **\.* \ \ ..... ..*.*....**. .*.. .\.  *** . ** ... .\ .*\. ....  ..\*..   *. .\. \.\.* . **.. .\. .  ..  . \.*\\.......\.** .\\ .#
#            #...*. ..*  *.** *.**.*.   ....  **\..*... \ .*..\..\....\\*.. .*. * \ * \* \ \*   ***.*.*** .. ..\...   *  * *  \* *   . .. *** *\..**. .\***** #
#           #    #..  . .*.*   *.\..\*.\*    *\  *.. \.. * *. .  *\.*. ..\  **\\*  .*  ... . .  *.. ..... **\. .***.*..*..*\.\...***\  . \..\*..* .**.\*.*. .*#
#           #\# *. .  *. ** ***. . \..*.*..\.* .... .  **** \**  * .*. .*.\ ** .  ..\. ..\. ***   . ..   \....\..*\*.**.* ..**\**.*.  \ *. .*.\* ..\.  .. .. *#
#            ##..\\*  *.\..**........**.*.*.*  *.    . ....\*. .*.. *  .*\ \*  \. ..* \...*.\..  * .* *...*\.\   . ...*\*.   **\**.*. .\..\**\****. *** .\ *.\#
#            #*\. .. **\.\***\** *\.. .\... * \.. .  *\*\.* \*   .*\.\  .\ \. *.  ** \ \  * *.\.\.* .... \**\*\ * .  ....*\.....*.\.. **\*..\.*..... .\ .. .  #
#             ##.* ...\.* **....*.**  \  \ \ \.* . \.. ..*.\ . .*.***  *.**.\..   \. . ..\*..\* .  ..*  ..\.*\..\...**\.**  **.    .. **...\  .  .*. \*. * . .#
#              #\.*   .\  .....*.  ...  . \  . .***    ..\ . * *. *.\.**.*...   * .** .\**\  .****.*.*\ .* .*.. * *\..*\ .. .*.    . \ \. ..  . ... *.\.*. \. #
#             ##\#\ .# * *\ ..*   ** **\ \.   .\**. .  \ *   .\..\.\ *.. . .**. . *...  .\. .....\** ...\.\* \. \   ... ..** .*..\. ..*.\  \*\..\  \.  ..\ . *#
#            #.  *.*.. *.*.**....\..\.* *.\  ..\.**. .*.\. ..\...  .***\ *  ....* ..  *. *\  \ * .. . ...\***\. .  *\ \.\ *\ *...  .*.*  ..*..\.* *. *   .*  .#
#             #.##.. *.. .***\.***  *\*  . *. * \\.*  *. .\*. *\.  *..*.. . * \*   \. .* .**\\. .**\.***  .*\.**\\...* .  .  * ..  ** ..   .*. .* *.*. ..*. . #
#              # #\#*\ ..*.\.*...\  .* *...**.\ *\.*  **      \ *.*. .. **  .*...*\   *\..*\**.. \*.\.\   *\. *      .**  ..*. .* *..\.\   *.\.\  .*..* ..* *\#
#               #.##* * *. *...\*    .\.\..***  . .\ \*.   ..... .*. .  .*. . ***.. ..*.\ . . **  *.  . .**. \. \  .. .*.. .*.\ . *.\**.* \**  ****. .\* .  .*#
#              ##.\*\\..*..*  \.*... \*\...*\\. ...* ...* .**\*.. . .*   **. **... *\  ..  ....*  * *. .* .*... .\ * *.*.\. . .. **  .\......*\  .\ .... * *..#
#             #.. .\* . ...   *\ *. *** .\*  .\   . *\  .*.  .*. * . . .\.*.*.\...\.*\. .**.*\ . \. ..\... * ..  . .\ .* \.. * \..\  *. .*..*\. . * . .\.* . \#
#             #\#  \ **..\.* *.. *. ... * *   ..\. \..*\.*.. .**.    * *... ...*\\. ...  ***** \ .  .\*.\*...... ** .. . .* .\*..*.  ... . ** ..  \ *..**.  *.#
#              ## *# #\#..*.*.**..  *. **...*\* ..  ...* *\\ .* *  . * \  .* *.*.. \  .. \....*..*.. .**.**  \ \ ... \  \   .*.. \\ .*. .*..\  .\..*\* .\\.\**#
#               #.# ##.#  ..\ .*\ *\.\ *. .. *.   .   .* . . *.*.\ ...\.*  .*.*..**\*\.* ..**..\**..**\*. * *..*.  . ***..*.*.*.    *\\.*.*..*  .* .*.... \.*.#
#               #.#   #.\. . * \...* .\  * \ * .*   \. .  ***. .\* ...  . *..*...**.*...\ ..*  . *\.. \. *. . .\ ***..*\*..*.*\.. *..*\*.**. . .\  *.     . * #
#                #    #\**..*. ..\..* *. ...*\.\.\..*..*.\*\\ \ . \*. .   ..**. . \.\*... . .**. *.. .\.\ .*.    ...\*...  .. .*.\.*.*.\...*. * * * \.*  * *\ #
#                    #..# **.* **\... ..**\ .*. *. ....\..\. .**. .. . .\\*\\..*\*  *\*.. ***\..\...\.    ..*..\**  . \ ..\.   .\.\*.* *. \**.  *.**.\* *.**. #
#                     ##..#\**... .\      . .*  .*\ .* .\  *. .***.*  *..* .*.*. .\...\  .*.\ .\... .  *\.\ . ***\. .\  .* \****\ *...\.. ...  *.. . ..\.\..  #
#                      #\.\*.** *.\* .\.  .*..** **. .** .\.  * .**    \.\\.. *.\.* . *. *.*.. .. ...*..   *   \*.\ ..\*.. .. .*.... .* ..*. * .\. *   .\. . .#
#                     #*  . .#..\**...  .* \ .\**..  *.*... \...\.*\.. . . *. ..... .   ..\.* .. . ..\*.  . \.  *.* . **.\ *\.  *\. ...*.  ...  ..*\. * *\   \#
#                     #* .*. . \*..\  \  *.* \*\..* *.\**\ .. *.. \   *. ..* .. \ **.\. ...*.\ * *  ...*..**.* \\\.. .\.*. \** * ... .*... **\ \. *.*.  ...*\ #
#                      # *.\.\\.   . .**.\... * .*.  . ...*.  .   . *.* *\*. *.\...*\...*\*.**.\ . .  *.\\ *\.*.\*\..  . .\\.*.. * \ *.*   ..*.. .\*\.\ **.. *#
#                      # .   .\*..\* .*.. .\**.\ .. . * .***.* ....\.*.*.*\  * . ...*. .* *.. . . *\..  .*.** .*.**..   . . *.\* \ . ...\ .*..\. ** **....*\..#
#                     ##.\.*  **\.*.*\.  * ... . .\ *    * *.*. .*** ..\*\  *..\ \ *... **.**\*..\..* .\..***. *\ **..*\*.\.\*  \ **  .\.. .*\ \ .\**...  ****#
#                    #*. ..\ \...\. ..* *...\ .\.**  ..*..** .   ...   ..* . . . ....  ..*\*\ .. .   ...  .*.. .  *\ .\*..   .  ..*\ .... \\ .. \\.... **..\**#
#                  ##   *#  . \.*.. **  \.\ . *.*\.*..\. . .*.\  . ..... .\*  .*.. .*..\\... ..\  * \ * *.**.\\  ..* * .\** ***\  .***\. ..\.* .*..* . *....**#
#                 #.##.#\ .\....\*.\*. \\. . \..\*\.  . . . .*.. .*.\ \ .*\.*..\..  .* *.**\ ..*.*\ ...\* *** .  . . *.\..... ..   ***.\.*.***  *  \   .. \*..#
#                 #**.##*# .. .. .\..*. **...*\  .*...   . .\*.  \ ..\   *.....*.\**\.. .* ..\\**.  . . . .*\  .\*.* *..*\.    .   .* .* ..***  * **.*.**... *#
#                  ##.**.#\.. *. *.. .. .\.\ *. . .\*\ ..* ...  *  .\ . ..   \*...*....\. .  .*\.  ..* .. .*... .\.\ ..\.. ** *.\  .. .. .**.*... .... .. .  *#
#                 #*.* #...  *.\.*\.*.. ..   ...*\ .\. *.\  . * ..* *\. .\*. . ***...\.**  \*.\ . . .* *...\.*.**. .\.\.*.**\ . *.*\  *..  .** *\ *  . .\. **.#
#                  #*# # # *..\**\...*.\ *     . *\*.\.  .* . ..* . *. *...\.*.*...  .* .\ .** *.*  *... .  \.*\.  .  ....*.** \*\. . .* *...*  *..\ \.\.\..\ #
#                  #\ ## #*.\.**.#*\.* ... .**\  .  \ .\. .\.**  \  *.\. .*. .. ***.* .  . \  *\***....  . **..**.\*\... .* *.  . *\ .*\** .\. . .. .\*  *  ..#
#                  #.#  ##.. .**\ ..\. ** * ...   **..***\*.*. * .**\.  . .\ .*.***..\* \.   \\*...**\.\*  ..**..* *  .  *. .*. . . .  \*.*\  \*   \**.. ....\#
#                   #  #  * ***\.\ **\**\ \*\ * *.**.  .**\..*.*\*.. *.. \*..***.\.*\*\*\.* **.. *\*.\*\*....*.\ . .. *\*.\.*\.... ***\. *\**. ..\..*\.\\.. * #
###############################################################################################################################################################