###############################################################################################################################################################
#.\ \\..*\*..*..\\.. .* *. *  \. .. * *\..* .\* ... .*   .*. .  \. ****.. ..  *\..*  .. * *.* \ * .\.*  . *.\..*\.   ..... .  .*   \*#                        #
#..*.*.\....\**\ .**. **.\... .\.   *\..* .* . . .\. .  *.\\. ...* ... .\\* . .  \.\ ..\*      **  **\.. .\*  **...*.\ **..* *\..\###   #                     #
#.*.*....*.*.\.   \.. *\. .\\\   . ..   \... .\ . *   .*.  ..  . *. *.... ....   ..  .*.\*\. . .*\ \. . \.*. *... ** .*.* .... \ *###  #*#                    #
#\.\ .\  ...  .*.\.*\ ...* .*.*\  **  ...***. **....*.      *. .*\.*..*.....\*\  *. .* ...*  .... . *\*\.\.\*\*. \.\ .. . *   *..*. *## *#                    #
#.\.* ..\ \..  \..*...* .. ..***.*..**.*\* *.\.* *.**.  .. *\ * . .*  .*\  .**..*.*....*   \ **.\ *..\   * *\..   \.*.\* *#\*.*. .**.#* #\#                   #
#..*..  . .* *... . . .\ .. .*\. *..*  \ ..\.*.*. * ** .\.*. ..* . *   ..   .*. . . *...  .\* ..*\. ..\**...    .*   *..   ...*   \...* ..#                   #
# .... *.. *.*.*.    .* .*\*\*.  \.\.   ..**\*  ..\*.*  ...\ *.\ *.* * .**. ...\ * *.*..*.\ .\ *.* \ * .\**  \   * . . *.\ *..\\*..*. .* .*#                  #
#..* **\. *. * ...*    .\*.\.***\.* . ** .*.** *.* *** * \**\..  \.**. . **.**.  .*\*\ *.*  . *. .* . \.....*\ ..\..\*..   .  . **.\. \  #\.#                 #
#\.**\  .. *...   .\ ..***. ..**. ..*.*...*..\ *.*\.**..\.\ .\*.   *\  \ ..**.*.. . .. .. *...*.. . \..    \ .*\** \*.\\ ..*.\ \.**. . *.#.#                  #
#. \..*.* .**\. *\.  . .\*  \.**\* * .\ .* * *   .** **.  *.\ . ..**. .\  ... . .    \**\..  *..\* .. ...*. . .. .** * **  .*** ...\*.##. .#       ####       #
#\ . *.**\.**...*  .  \. .\*  .\** .*.. *  \*.\ . ..***  ..*\*  ..*....**   \ . \...* . *\  \.\.** **. ...*.. * .  \ .  \.  ***** * . \   ..#     #\. \#      #
#  .*..** \.. .. \*.\ .** .. *\*.*. . ...\ ... . .  .. ..**.. .   . \.\. *.\  .. \...\*\.*.  *..**.* \ *\ .*\ .\* *.**  *..*. *\.\.   #  .*####  #\#*\ #      #
#* *.  ***. .\ *  ** \ .* .*  ** \ *.* . .  *.. .... ..* .......  . .      .  .* .*. *  *.* \.*.*.\.\...*  . *\ * *.... .  \. .* #. **. \ \#.\*###.#*##       #
#.**.\  \.. ..\  ..\   *....\.\. *\.*.   *\.. .\.\*.   .  .*.* . \  \ . *.  *...  .\.. .\ .\\..*. . .* ..\*. *..* .  *   .. *. . ...*. \ ##... # #\#.*\#      #
# *....\. .  ... ** * ...\* .  .**  .\.*.\.*. . \.\ .*..  . .  *. \ **** *. \..  *\**  ** .*  \.*   ... .... * *\.*\\. ** . . \... ..*.. ..\*\*#.#.. ##       #
#. *. *  .**...* .\ * . . *  .*** \ . *** *. .* *\  *.\  .. ***. *  *.\.*.\....  .*\\* *** .   .*. .\.*\* *\.. \*.. *\.\.*\ .. *\ . \\*.*.  **\.\*\#..*#      #
# \.*\* . \. .*. *..\.*.  .***    \  .. ...  \* ..*\.\ * ****...\*.** . * . . .  *...\.\..*. *..\ \.*.... ..*... \  . **\* .. \...*  *.\*. ....  .*.* ##      #
#*.\.  \* ..* .*  . . \*.  ... .    .*\  .  .*..*\ .  ***..*..\..  .**....*.***. *..*.\ .  . *..* . .\  .\ .\   ..      ..\.\.*.* *  *\ .**. *   *\.\\.\#     #
#\..* ..**.*. *.\*  *. \..*..  . ...** ... .. * *\*\ . . . . *  ...\. ....*...\   *...  . .* . ..  \ *\ **\. .    * *  * *..\**.* \ . .\.***.. \ **.\  #      #
#.\.*.  \. * **. ..\* ..\.. * *   .     . * \* .* . .. **   ... *..   * .*     \   \.**\ .\ *. *..*\ *.*. \  .*.\.  *. . .* ..  *\..  ..** . .* *\. .#\.#     #
# ...\.\..*.. *  .*.  .. .    *. *. ..\*...  ...\**.   *. . .\  .*  \\.  *  **. ....\.\.*   .* *****.** .\  **.* .    .\ \. *\... .*.\*.\*\*\.##.** .  . #    #
#* \*\..\ .  .**. .*\.....*. .\... . \.. .* .. \ ..\\*..* .*  .\.****.\ .\  ..\*.* .. \ .   *  *.... ....  .\*...\**\. \..... .*..\.. .* *.\* \#*.. \..  #    #
#*..*..\.\.*.\.* .*** ..* ..*....  ... .\ ... . * *.\..\....  ... . .\*.\**.*. ...\ \..* *.. *.\. .*  \ *   ..*.*. \ .. .*.  \ . * . **.... *.* . * .*...\#   #
#.*\* .* * .\ .\*.* **. *\ ..*.\.\*   *..* . .. .\**.\. *. . . .\*\ *. .*.. .  ..\ * \\  *** \. \..*\ .\ *....*\.*\. *.*.\ * \  . . * . .. \\.. ... .*. .#    #
#.  .**.*.*...*.. . ..*\. *\ . **.* \*  \. **. \  ..*. *.*...*\*  * . * . *. *. .... ***\*.*.. * * ..  ...  * . . ..**...**\..  *\*\.*** *\....\.* . *#*\#    #
#. \..  ... *\. .  *.. *\ ..   *...  . ...\... .*   \ \*..  .  **.**..\*. .*..\*..*\ \\..*** .\*\.. . ..\* .* *.... . .  ** ..* ***.\*. ..  **   *  *. \.#    #
#.\..\  .\.\..\.** .*\.\*     .* .    * .. *.\..* ...* \ \  \.*\ *..  . . ** **.*.\ *  .\.**.* ....\*. . .\** \ *.** *.\ *\ ... .*\ .. . * *.*  *. \. .*\#    #
#***\ .*  \.  *..  *.. *.*.    ...**.\.* ***.. *.  \*.\. ..\...\  *.\\   ..  \. .. *. .** .\... \*  **..\ * \ .*.*.*\\. .*.  **. *.*.... * \... .  .*.....#   #
#.\ .\....*.**... ...  .*\.*\ *  \.. .   *\.*  .\. .... * *** \  \.*.*\  .***.. .**..\ **. .  \*..* .**   .*..   . ..*.....\\..\ .*\*.* ..*....#\.*..\.#..#   #
#.\*  *.* .\**.\*\*\\  \*..**..... .\\ ...**  . .*** **.  *..*.\\.*.\.  *.*\*.* .*.*....\.  . . . ****. ..\. . ..\\ .*\.. \.****.\... .\ **.*.. ..*\.#* ##    #
#. .\. .\ * \.* \*.*\. *** *.. \..\ . ..* *. .. \.... .** .. \ . .. .\..*.*.**..*.\*..  .. **... ..... .* *.... **. .\. .*\***..\.*. ..\.*\.*..\. \* .#*.#    #
#  . .  *\ ..\.  **..\ . .  **.  * .*.**. . \   . . *. ..\ \ \. .***. . ..* ..**.\*\  . .*\...*. **.**\....\* \\ **.*... . .. \  .\ \\ . .*  .\. .. \#****#   #
# .   ..   *\  *.\.\ .   . .**  *. .* .*... .\ * .  .\\. .\.\.    **.... .* \... *. *.\ ...\*..*\..*.  ..  .\. .*..\*.  \   ... .**  . .. \.  * #*\. \* *#    #
# .\* .**\ * *.*..\.. **.*..*.  .  \***.*.*. *.*.\.  ...  \ ..*.  **. *...**..* .**..\*  .\ .\ .*.\\*.   *   .** ..\.* *..*..\  \.*\..\ \.. #*.****  ##*##    #
#\...* ..* .\  ....\\...  .*.*.*  *****  . .**.... *.*.*.*..**** .. \\*.\... **  \... .**. .\..*..* . . .....* *\.*  *.**...  *.\.****.   .   *..*.. * #. #   #
#\.**.    .  .. ..  *.*.\*...  .   \. \ *.. ..* \*.*...**.**\..\*.\*. . .****.* *..*** *.. .*\*.* ..*.\.\.**..  ..\. \ .*\. . \ . \.*. .. \ * .\ .\. *.. **#  #
#*.** ..* \  .\*\ . ..**..  *\.. *..*....*  * . ...**\. *.\.*\...* .. * ..\. .* ..*..\ ***.**.***.**.. .  *.\..\* *. *..**.. \.  ....   .. ...  .*\  .     .# #
#  . **\ * * * .**. . ..* **  ** . .** ... *.\ \ * * ** ..**.  \*. \ ..* * *.**. *...*.\..*\ \..  .*** \*.* *.. *\ .\.*.\..* .\ \  .  .*.* *...*\ * * .*.*##  #
#**\ \..**.**.  *.... \\..\*..*.** ... * *\..\* .\\\.....**.....*. **  .\* **.* *. . .    . \*.* *.*.*\.\******.. .  .\. *\*.   * .*..\.* *.. *....    ***\#  #
#...*..*.***....*.\.*.  . ... . \. ..  . . .\ *\ * \ ..\ ... \*.****.\.  *.\* ..* *. *   .**.**. . .*\ .*\.. ..    *  .*.  .\. .\ .*.\ *. ..\ *.\\   .#.\*#   #
#*.... .*....\.. \  . * ** * \*..  . ....**..\.. * *   .\\.*\ .  ...*..  . .*\.\*.\.\**. .* \ \*\.  \...*..* **.*.\*.  ..\... ...* .*...** **..\**.. \   #    #
#*\ \ *..\.\* ** . *\ . .\ ....  .* .\*...\ *.\.*\.... . * * .\.\.*\. *. .\ ..\..*...*....\\..  \  ...*..  *  \.\.\.. **..\** *\ .. . . \..\*\..*\*  .\*#     #
#...***  *..*..\ . \.*.* ..*   .\ * *  \ *. * . * .\* *. *.*   .*.. ..*   .\.. * . \**..\ . * .  *.*. .. .. .   **  *\. ** .. * . \\   *.\  ...* ..* .*.##    #
#\ ..*.  **.. \* *. ...* \ .\.. .**\. *.*\ *.. ..* .  \**\..* . \\   \.  . .\... *  *\\.**. *.\.\**.*..\\.. .*\*** **. \...*     *...\ .\.\*  *.  * . ***.#   #
#. .\*\.\.*.   . . ***.. ..* .   .\..*. ..**\    \*\.  .*.  . .*\.  .  *  * .*\ *.*\. . \ .*.**\ .\.* \** *. *.*.*\....\ *. \. . ...\*\.***. *. \.\. ..###    #
#.  *.*.. ..  ...* *** * . \  *\ *.\\. .* \ \.   .**  *  *** \  .***\  \ .***..\.  . * \  .**\.. \.\ .*..\.....\.*.  * . .*  .. *.*\ \*  *. ..* .    .* *#    #
# .. ..*\* ...*. .*. .\.  ... . .*.*\.*  \..     **.  .* *..   * * .  .\  ..**  . .  *.*.......** .  ... .  . ..*.****..*...*. .\*.*.** . .\ ...*\#* \\.#     #
#  \  \..*  *\.\. ..\.**\.\   *  . *.*. \.. \   * ..  *.  * ** *\*\ . \. .***\    .**\..*\.\ \  .  . .\ .\   .**.  *.\. .**..**.*...***.*..*.\ .\* . ### #    #
#* . *.\**. .*  .. **\\ .  ..*\ .  *..\*. ...*  \ *\..**\*  .* .*..*  . \ ..* ..* *\...  *..... ... * * .*. * .* ..\  .\ .**.\**..\ *.*.* .\\. *.*   *# #.#   #
#*..*** ..*\*.\.\*.  .\.\ * *.*..\  .\.  .  \   ..*  ..* \ .*..*. ..\**.. ...***..  .\. ****.*.. \. .... .*.*.*. . ... ..*..  \.*\***\**.\* . \ **. .# ##.#   #
#*... \ ..\ **.    *..*...*.* \*. .\ ...    . \ * . *.\  . . .\. *\\ ..*..\* .\ .* .\.. .* .\.*. . *....*.. *.\ *  ..   ***..  .* ...*.. .* \   .*. * *.. .#  #
#* \* .. \.. .  . \.*\   *\.**..*\.\ \ . ** *  *.** *  \*   .\.  \ . ...\**.* *. ..* \*.\....... *. * **...*.*. . \.. .\..**\ *\.  *\. .  .. *.*..  #.###*#   #
#  .*.  . .\. ... .\.** *.. **. . *.* * . ..* \..\. * \.. *.*.\.*.. . *\..* .***\.\ . .***.*..*  *.\.\.** ..****.. .... *. **..... \\... \\ .* .* \*.# #*.#   #
#. ** \.   * .. .*   *. * .*\..\* \.**.  *. \*.\ .*..\ \. .*...\.. ...\....* .*\ .. *.\\* \.** .. ** * \*    .*.*.*..**.*. *\.. \* .  .. ..  .....  *.#*..*#  #
#.\...***  *\.**.\\*.....\...  .. \*\..*\.*.... .*\. * .   ... .*..\..* .* .. \\*   \*.\  . *   .    .  . \....**\...\\.. *.. . . .*. .\. \ \  ....*. \..**## #
#.\.  .*......\......*..\...   . ..*    ..*.\ . *..  .\ *. \ . ..*. . .\..\ . . *.\ *...\*.   \\  . ** . *. ... .  *** ....\.* *\**..*   \. .*.  .* *.*.*.\#*##
#...  *. *.* \.*. ** .\\ ..  .\***.***..* ..*..*\ . * . *\ \ **\**. \ *...\ *.*   . *. \\. .  .  \ .. *.\.. ... . \.*\.**...*.\...*\ ***  .  \**.  \..* .. #\.#
#\ *.*.\ \.. ...*\.** *  . ..*.\.. .\  .\.***.   .. *. \**.  ** *.. \  \..  **.\.  .**.\ .*\  .  .   \*. ..\     .. .. \*.**.....**....\.* ***.. .* #.   *.\*##
#\.*  *\ .. *      \\ \\*\ *\*..*\. . ...*** .\.. .\\* *.. *....\  . .\.*. *.* \.\.*..**.*. \...*\ \*.**\\*. .  \.*. .  \..\. *\.*.\\\**.. .*....#.\  ##\.**# #
#.**....\.\..*\..\* .....  ***. *. .\ . \... .* ...... ..*****. .*.\**. ....*.*. .*  .....\\* .\* ... **  *  . .***** .** . . . **    *.* **..*\ *\..\##  ##  #
#\.. \  . .  ..\.  .. *.  .. *.   \   .  . . *\   *  *  ..\**. *\ *.*. ***\.**\.\.\*\** .\*..\ **.\ *\**.\.\ . *.*\..* ... *  *... *.**\.  . **\*\#\## #\.*#  #
# \. ... .\ .\**.\. ..**\.*...\* *. ..* *  \ ** .\. \..\.*.\\ .*. . .\..\...*.** .\... . *\\.* ..*.\.*.* . .* \.\.*... *.. . *  .. .  *. .***..*.* *##  ###   #
#\.**\.*..\.  .*   .... . \*  .* ..*.\* .\ ...\    *  .\.* *  .** .    . \.*.*.*\*..*    .*.\. \ \..*.*\**..**. .*\.**... .*.*..\\.* ..* ...\\ *.#\.*\#       #
# ...*.**.. .\.\    *** \   **.* \.. .  ...\  *.....\..**\..  * *.\ ..\ \.  * \*.\.*...* *. . .* ..   .**.**\...\*  .....\*  \* *...* .* \ .. ..*##\#*L       #
# \. .*..  . . ...*. .*\\...*.. \. ..**. .. . *.*   *. .  ..  *.\ **.* *.      .\* *.\ .   ..*  * ..   ..\.*.  . .*\.*\. .   .. ...  *\ *.\*. * # #*#**#      #
#*..\ .* .\.***\.\\.\*.....*.\.\ *\.\** \ .* \. .  ** * .*  **.**.\. . .* *. *.\..*.**  *   \*\   .. .\. *\ *.***** ..* . . \ *  .\* . .* *\. #. ### ##       #
#.... .*.*.*.*\\\.. *   \..\* .**. *.* ... * ....*.. \..*.  ..*.. .. . \ ..  . *\  *\.**\  *..* .  .... .\. . \ \**\ *.\\  ..*.***... ... . .\.\ \.#          #
#. *.**\.*  . **. ... *..  ..\**.\\*.* . ... \.\..*.. * \ .  *.\\.\ .****. \.\. ******. ..\*..*  \ \. . * \*.\ ....  .*..\   . \ **\.*.\ .*\.  ..##           #
#.*..\*.\.\.\ *.*..*.*. **..\. *.*\.*.*..*  *..  .. **.  ***.*...\.. .***. .\  *.\.*\.\ . ....\  .* \.*\...* .\*\.... .. * .. ..\*. .\.. \.. .*.**\#          #
#\. *.....  ... . \*..\..\** * .... ..* ...* .. *.  .* *...*\..\ . ***.*\.\..\.. * .  .  . *\..* *...\*.\.*...*..*.\ ** .\..** *.*.\* \ .   **\** . #         #
#.\.*\ *\***. *.. .. \** .*\ *  \*. \ *...*** .\..\* .    .. .  .*.*.. **..  * . \.*.* *  .   \**.  .*  .\ .\\.  *.*\..*.  .\*.....*. ..*****. .... #         #
#\ .. * .* ..\  .* *\.*.*..*.\  \  *  .\\*.. ...*  .  .  . \.*.**. .  *...*\ \ *\. .  .   . . . \   *  *   * *.\. ..*..  ** .   *\ . .* ***..  #*. .#         #
#. *.\.**.\*... .... **  .\. *\ . .*.* ...*.*\.\...*.....\ . .*\ .*\   \.. ..*.*.\... ** \...  . .. ***\* .**  .**.*. . \..*\.*.... **  **..  \. #. #         #
# \.*. ... *.   .\ \.\... *  \..* *.\. . *.*.*.* \  .   .. *..*** .. .*.\\..\. *   \   **.    ..* \ *.. \. *  . .\.*..   \....*   *. ...\.#.. #\ *#\#         #
#\*\* .  *\.  .\. *.\.. \        .* * .*.  .*.**\.. .\. \.*.. .\.*.. *...\\ *.  \\.  .**. .. . . *  .\ \..\.* \ *...\*..\*.  \...\.\**.** .  #\.##\#          #
#***...*   .\\** *.\*\  .* .* . \.. ..*..  * *.*.**.   .  ..\ ** .*\ ..\.*\ ...* \*.*\.*.\.\. . .. .  *. *    *.\.\*.\* .*..  *   **.. \\ * \  .. .#          #
#.*.      *.**.. *\ .\.  .\*\ *  .**. \. ** ..*. *..*    .. . *   .*  **\.*..*.  .*\*. .*.... \.*.**...\.\...*\ **.. *\.... .*.\ .***  .\ \ .# \. #           #
# *\*..  ..\... *..* \. .*. * ** *...\  . .   .*.* . ..*\ *.* ** .\ * .   * \....** ..* **.*. .*.. .     .*\...*\.** .*.* *\*.\ \**.*.  .*.*.  .* #           #
#.  .*  *  **.....\.* . .\.*..*... * *\.**. .. ..\.* .*.\.*.. *\.*. .. .\ . .*. \.\  ...\*.. \\*\ .\ *  \.** ..\* ... . .*.**  *    ..\ .*..* .##*#           #
#\ \ .\..**\. *\.\.\. *.\* . .* *\..\.  .\. ..  *.\. \.. * . \. **.  \ .. * *\.*  .  **.  * ..\.****.. ** .*.. *..   **\....\\ .*.*  **.*.. .#*# #            #
# *.. .. ....\\.\.\* ...*    .\ .*\ ..**..*** \ .  . ..  .   .*\..  *\*  ..\\.* \  **\.  ..  *.**. * . .\**..*.\ ..  *\ ..*...\ *.. ..\***.. ##               #
#.\.\* ** . .. **.   . \.. . * .*.. .*\*.\  .\.*\\  *....*\. .\.\.. *..\.*   ..   . ..*. . ..**.  *.. .*. \*.  **...\.. .\.**  *.*. \. .*.*\#*#               #
#* ..* ** ..\    **\\. ...\ *  ..\.*.. *. \*\. *****. *.\. ..**\.\...  .\..\  .*..*\ .  .*\ *\ \..\*\. . .\... .\.  *.. * .\*  .*. .   .\*#*\.#               #
#.\ .* .* ..** *..**  * .\ .  * **.**..***** .* \. .* .\.    \..       ...*    *...*. ..*. . *\   .\**.\.*\..*. .  ** *. ..... ... .... *# *..#               #
# ..*.\*...*....\ .\\ . . .  **\*. *\.  .\**.*..  .... .****..*\* *.\.\ *.\  .  **..... *. .\* . .**.* . .  ..\..\**... * . *\    *  \ \. *\##                #
#*.\....*** **..**.. . * . *  . ***.  \*...\ \..*.\  .  .. .*.\ .\.\   ..\.\...**\.\..\*.  * .  ***\ **. ....\*  ..***  *.   *\ ... \#\. .##                  #
# ** \ . .***. .** .\ .  .\  ... .**\.\. . **. *. * **\. *\ . .. ****\ .. .    *. \.\*.\   \   \.*.  \*.*.\. .....**\. .. . * ..    *\* ..\#                  #
#*\*   *..*\ \  ** . * *   \  .*\ ... . . *.....*** .\   ..\.**..**.*.*  \    ..**.*.*...\ .   .\.. \.\ **.. *.\  .\.   . .*\   \.\ .*.   #                   #
#.\  ***  *..\*.\.*.\    \ .* *. \ \..*  ..   . ... \ ..*\ .\. \ ...*..  .* ..   *** *.\ * **. .**. . .*\.* *. .\*.. ..  \ *.  *. ..*\*.*.*##                 #
# .\. ... ..  .\  . ..*.... \..*.. ..*..*. ***\\\.* . . .***.  ..  . . .\ \.*.**** ...*. . *.   *.\ *. *. *...*. . *\   *\*\  *..   .*..* ## #                #
#.* .* .     .   \  .  \    . *\ \. .*\ *.\.. .\ *.*  .\ ...   ...*. .* ... . ..*.. *** *.\.* .** .***...*.\.... \ .  * . .*. *.. *. *.. .#.*\#               #
#.* \.* *. *..* .. *..\.**.\..* \....\ ..*.\* *.*..\**\..*\  .\  .** . \* ... *\*.......\ ....* . ****** ... .. \.. .***. ... \..\. .\..*  *###               #
#\*   .**.. * ***  .\ *..\*.*\\\... \ ..***.*.\  . .*. .\..\ *.\.\ .  . * *...*.**. ****  .. .*\\.**.*.*. \.** ... *\* *\  .* ..* . * *.. \.\\ #              #
# . **... \ .**.*.\\ .*. . .\**..\.. . .\. .  .. .* .  ..*.. .  .*.*..\.. \ \ *..**  \.. * ** .   .. *   *  \...\*\  . .  . **.\  * . * . ##\  #              #
#.* ... ... . .*.\.\ .*\ \ ...**\.  .\.  *..\ *\  . .*  *.    *  . .  .\......\.. .*  .. * ...\...   ...*.* .*..\   **\\.*\... ..*.\.#..*#.. .#               #
# .* *. .\**\ ** . . .  ..\** ...\*** \\.\.  .\***\**   * . .\* \*. *\.. \. *\*.* **.   .. **.  . .**. *... **     ... . .. . * \.# \. *. *..#                #
# *.\.*   .****.\.. .*. ... .. \ ..** ..  ***.*....*   .\   *.*\.* \*.* ..\ ...*.\ *.... . .*. *\ * .  *.\*.*  .. .. \. *.. * . . ...\.\.\.*#                 #
#\*   ..  ..\ **. \**\.\.    *\. *..\ . .*\\.*  .  .\.**.\* ... *.. ...*\*. \ **\*.. **.  * .**. *  *.*\  *..\..\. \ **\.\\*.\ ..  ..*.* #*..#                #
#.*..** ***.  ..\. ....*  \...\ .***..   . ..\. **..*\.. **\...* ..*** ** *\.\... *. .\...*. \.*.* *\  .  .*\.. *\ .. * ..**. ....   *** .  #                 #
#\*.\**.  . ... ...\ .   ..\* *   .**..* ** .*  ... \\.\ \..\*. .. *\**..\ * . .\\\.*\ *\.. \  ...*. *\.**\.*.* \.\\... *.*\ .*\  ....... #*#                 #
#.. **.**...*\.*.\ ..\ *    . * .* *\.\.. .* .*** . ... *. ....... \.**. \ *\..\ .. *.\.. \. .* \\. .**.*....**.  . ...\.*. \*.*.* *\ . .###                  #
# ****.\. * .. *.*.** ...*. . . .*..  *\ .\\ \*.*. .*. ...  \   .\..\  .*. \  . *\*. .** *.*. . ..*   .  .\.\*.  .\. \..\  .  . .. *   *\..#                  #
#.*...  \*.* \ *\\ *.*\ ****\*  ..*\ .\. \* . .*...*.   * \ .\ ..* ..\  .. ..\.... ...***.*..  ..\.. **.... *   *  .\..* ... *.*  *.** ** * #                 #
#.*\\  *.*...\..   * *  .. *..*..\.. \  *  * .*..* * . ..   * ....*.  .\**.*  \\ **  .**.....* *.** ..*   ** *... .\. *.  .. .*  \**.....*  #                 #
# \..** *. \ *.... .*\\.  *. ..*\*..\...*.\* *..*.*  . **.\**.\.  \   ** . ..*.  .*\ **\.*.\....*.*\  . .**..\   *\ ... ...* .....* * *** #*#                 #
# .* *.\.* ..*.. \ *..  *..\...**..  *\.*\ .* . .\.. . ..\ .. .* .\ \...\.\ .. .*.*. *\  *   . \. .*.   .*.. .**.*.   * * ***.\*   .. ..####                  #
#   *\ .*. ..* .***.*...* \ **\*..   .*\. . *.*. . \**   \ .**..    .* \*\*\.** . .  **... . *.\ *.. .  . . ..*\* .**.***........... \. ##.#                  #
#..*...* . . .\.**.*\ * .\  .. . ...\ ...\.*\  \ *  .* * *.\.*\. ..\. \.. ... \.  * *. \ *...\ ... .. .*   *.\.**\* ..\*.*...**\ \**..# . *#                  #
#. * \.\. ...\. .. *  .*. .* * \. *\.*  \.*...\.*\*...\... . ..  \ *..  \... ..\..\.\...****.  .**.** \. . .\ .**\ . *\*\  \ ... *.  * *..#                   #
#  .\... *.\ *\. * * . * ..* \**.*.*.. \  .* . *.*. *... ***.\   ...*\ . \*  * . .** .\... .\. **.\.\. **.\.*\ ..   \*..*\ .. \* * .**.*  #                   #
#  .* *. *\  *.\*.*  . .\. .\.\    ** .\*  .\  \..* *\  .\..*. \...*... *..  \\* ** **.\*.\***\...***\*.. *** \ \   ..*..  . *.*...*##.#\.#                   #
#   * .\. .\*. \.* * .\  . ** *..\\..** .... ****\*.**\. .*  *\. *. \.   . **  .... .*.** .\.. ..*.. ..*.\\ .\.*... .*\.. *..\... #*#### #                    #
#\*..\.\ * *  \..***. .*.   .*.... *....    \.*. *..\\  **\.... .  *.\...*\..* * \*. *...* *. **.*.\* \. .\ .  *\ \. . .  ..  * ..*.\*# #                     #
# *\ . .**.\.* *\.**..*.. ..\.. .*.\**.*... ..*. *.* .  ...*.\.. * . .. \.*.*. * . ....*** ** .\\ .\...\  .*. *..... *.*..**. .  *.\*.#                       #
#\..\..\.. . *...*.\.\. ***...*..\.*.*. .. \. ..\. .* .. . .\ .\**.\  .\...**...\*..\** .*\ *   \.\. *.*   .*.\.\.\.  *.\*. .\ * *.*##                        #
#\ . \ *   \ . \..* *\ ..\ \* .*.*\\.* *. *.* ....*\.\.*\.    ***\**. ..****..*..*..\****.*.*\ ... ...*. .*  *.** *.* . *..\.. ..*#.#                         #
#.*. ...\ \. \ .* * ***\\. .*.**.*..*  *.\. .* **  **. * *. *.*..*... .\*.*.* * **.\ ...\*. **.* * \  ..\ *.**....**.\**.* .\ .* . #                          #
#..*  * .\.*..  * ...** .*.\**.\\.\\.   *.. **... ..**\*..*.. . . \ ..  . ..\ . .  *.*.*...*. ..*.   ** ... *\\. .\... * .\.*..#*##                           #
#\*\ *.  * .\**\ .\.*\.. \ .*.\. .. *. .*.***.***.*\.. . .\* \..*    .\.*..*****.. ..  .  . ...\.\..... \*\... .\*....  \  .* #\\#                            #
#\ .\  . .\  ....\ .*.  \.**\  *.*\*.*  * .\.\*\...  .. . ..   . . \ . .  \*.....**   **..**\.\.**.**.  ..*. .****\ . ...  **  \ #                            #
#    . .*\. *.  \.\* \ .. *\.* **..*..\*..  \.\  .\..\..   ... .*\\**.*.  *.*..*.** .*\* ..*.\. .***.. ..**   ...  . .* ..\*##.#. #                           #
#*..**\ .*** * ..\.*\.**\.\.....\  .\**. .*\ ..**.\.  ..\.   *.\* \.    . \ ...\ ... . \  \...* \ * * **  . \\  *\.\* .   #* #\. ##                           #
#*. .* \ . ..\*  . ..*\ *..*.*.\.** ..\. .\  .*.. * .\*.*..***\**... ***  ..*.\*.*.\\ **. .\* *.   . *.. . *. . .*.*\.   .* ..** .*##                         #
#*  .*.* .. . *\  *\* ..**.* .*..*.. .   .*\* .*... . \.*.\..**.*.\***\.  \ .** ..*..***** \.* \..*. .* **. *..  .. .. *\*\ ....  \..#                        #
#.**..*.*..  * .\ .**\* ..*. .*\ .\ *.*..\.\. ..*\ .\.* .\ * ..*.   **.......*. ...*.....\ . .\. ..*\ ..*.. *.   . \..\. . .*.*.* *\.#                        #
#* .* .* *.***\**...  . ....\ .*.* \**\* * \. .\.**..*\....\. ..  . . *  *. \*\.  .*.*\. *..  *\***\.. ..   \ **\*   \..\ . \*..  \*#                         #
#\. .\. **....* ..* . . .. \. \... ..\ ..\   .*\ *.* **\*.  *  *\*...\ \*.*  .  .\ *\.* ***** ......  **  . .  .*. \*.  ...\..   *##                          #
# \.. *  .\\****.*\**\ **.*   *. .*. ...  \.*.**.*\*..**\ ...... .. * ..*.* .  ***..**.*\*.*.* * ...\*.\.\**.. * .* \.  .* . * ..##                           #
#. .     *.\.**\.\**..*.. . . ...\.. . * * .  ..\. . ....* \ *\.\ * * . ***.* *.\** \. .**.*.\...* .*. **.\.*  * *   .*....**.* #*\#                          #
# .. .\  *..\.\* *.\* \.*.*  . .... * \*.*..** .  *\   . ....\ * ..*.\. .**. .*\*..  .\ .. \*  . .....  *   .\..   .*** .  .\ \***##                          #
#* *\.****.*.**.\...\ .\* .. * . \..*\ . \\ **.* .\.\ *.*..*\*.* *** .. .... ....*.**\* **... * ..\ .\\ .\*.**. ...*.*.#  ** ..* **.#                         #
#.*. .\ *\. *. \*.** . ..  . .***.*****. .*** \..*\.. .\.  ..\.\...\ .  \.* ..**.***. \.\ \  .\.   ..     \*\ .  .\*\.\* .##*. .* .#                          #
#\.\ .* . * . ..*\...*  .* * .*.. ....\\ .*..*  ... .... ..\ *\ . \.\ . .* *. .. ...  .\ *.  \  .*  ..\ \. ***.. .* . .#*##\.*#.\\#                           #
#**...\*\ .\ \. . *. ..\ . .\\...\\**** . \ *.. *.\ ..*   *. \..*..\..*\*. . \. *   \\..\. .\.  .*  .... * *\..\. #*\ *..\.# ##*#\ #                          #
#.* *..*   .*.. .. . *.* * *.*. *....* \* .*\.*.* *.\..* .  \ . ...  ** ...*.. ..\* *  .*.*.*. **\.... . #\....  **.#** #### # # ##                           #
#   ***. .. * *\ .. .. ...\... \*.. *** * * ****.  \..\.\  .... * *.*. * *.*.\*  *. . .  .*.. .*.** *.*  * .  **\***.## .*# #                                 #
#*.**..**  *****  \ \.   .** *\.* * \*\ * * *...  *..\ .  *...**\ \ .* \** ..*.  ***. .* *.*  **.** ...* ...**.* #....\#*.#                                   #
# \..\.\. ..***\.\..\ \\..*\... .\*..\.. \.*..*.. .*..    *  .** *.*..\ *    *\.*..*****\.*. *. \.*\ .... \ .*.\.\ . *..##                                    #
#\     *.. ...    \..... \. .\..\ ..*. *. ... .*  ...* \..... ..*.*.**.*.. \ .. \*\.*.. **.  *. . . ..*** .*\.\*##\ * ##                                      #
#* ..\ *\.\ . . *  ****  *.\.*\. ** . \.\* . .*.*.*..*\.*.*   .\.***\. . .\.\ * .\.*..*...\..\...*     ...\.***\####\#                                        #
#*  ..*\.\.**\ *.\.\..*\  .  ......\..  .\. ****. .**.*..\* .\*...*.....\.*..  \..\*\*. . . \.  \*\*.** .. *\* .  # #                                         #
#\..\**..* *.  ..  ..* .....*\ .  *.*. \.   .. .  .\\**.\  .. \ \ *.*\* \ .**\..*.....*    *. *. ...*. .\  \.. .#.#                                           #
#...* * .*     .\    .\ .*    * ..*.\*    .*.. . \ * *. **... \.  . *.* . \*.* .. . \*. *. .  **  *\. ..\.\.     #                                            #
# \..**\*.*.\..  ..*\  ...\\ *. .\...\.\ **. \..*. .*\  \.  \.  \ ...*.\ ..\..  ..\.**. *. .\ . \\*  .   . *...\*##                                           #
#* *. *** .*. ....* *.... *\... **.*  *. \*\\ . .*. . .\.* \.\.. ** *. *.\*.. *\*. \**\ .*.  ..\..*\...*. *...*#* *#                                          #
#.*\.*... \*.*..**..*   . . .***.*    *.....** *.. .*.\. .\. ...*. * .\.**..  .* . .*\. *\ ..*. \ *** ...*\  ..#.*#                                           #
#\    .* \.. *.  .* . .*. * \.. \.\ . **..\****..  .    . *\.* .**.*.  ..\. *. *\ **... *  . .*. .\   \\...*.    #                                            #
#**. .*.\.\ . ***\*  ...*..*.* \. .. *. *  .*.*\...  . \ .\...  *.**  ....  \ .**....\  .. .**..  ..*...   .. .#* #                                           #
#*\..*\.*. *.*..* *.  .... ***...\*\.\  .\ \* * . ***  *\.  *.\*\ ...\**   *.\*** **. .. ...*\ .*. .\ .*..\  \*## #                                           #
#.*.*. ..**.*..*....\  .*..*..*\ ** *  .. *...\   ...*....  .. . \ \ ...*\*\*....**..     \*..**.*  **..\ *  .#  #                                            #
#\. * \  .* .*.*...\** .  ..    ..*\*.    ... . * . . .* ..** .*..   *  ..  .  *.\. ..**... .\\...   *\*...\.. #                                              #
#*.**....\.... . *. .\* .*\. \  .....\ * *****. .**..* .\*..*. *\..\ .* .\   * . .* ...\\  \ *  \.\. .  . *#R.\#                                              #
#.. ***. *\ *. . \.\*..\. *.\*. \*   ... *. ..*  ..*..  *\. ...*.   .\. * *. \  . *\. \...  \.. ..\ .*..*. ** \ #                                             #
#  .*\* \\  . *\..*..*\  ..**.. .\* *\\      *. .\ .  *.\ . \.*** * .......   \.  .*\ ..\    \*\\ . *\ .*.  \ .#                                              #
# .\  \. *\  \ *.\..  * .*\.*   *.. *   .\  .* *\  .\\ ..*.\\...\...\*.. * **\*\... *   ..*. .. .* .**.*. .*#.#                                               #
# **.*..\. . *.*.\.. .\.* .\** * ** . **... \.*.*.* .\ .*. . .  . . .\... *.* ..*\*..  *.  .* .  .. .\ *\.**##                                                #
#\*. **.**\...*  .*\  *\.   *.*  *. .*\ \.. .\ .. . **\*. * . *.*   \**** *..  .. . *  .\.* *\.. ** .* .. ..#                                                 #
#..*  .*** . .* .*.  *.  . .   *\.* ** *.\ ** *.*.  ..** .*..\.....  *.*.\...\\ *..\*\\. .. \.*.\ .*.*** \.\##                                                #
#.\*..  ** .. ..*. *.\..*  *..*. **.... .  **. *.\.   *.\ .*.  .. .\ .... .\ .*.\ .\. \ . .*** .*..*\.*** \ ..#                                               #
#..\.   \.**\.  . **\* ** ...\.. ..\  ..... .  . .\. *..   .*.\ .  *  .*\\ *.*\\.. ** .\*. \*\. *...\*..... .#                                                #
#**. . . *\  *.\  **.. ..*\ ... \.\.\ *\ **\.   .* . **\. . \.     **. \.\  \...* ..    ..*.****.  \***.  .   #                                               #
#.\.\* .\ * .\ * ..*. * ***\. . .\. . . .  .\.*.\.** ... \   .\* .. \ . ..* .*.* **   .   *.****..*.*\  .\.*\#                                                #
#....*... .\....   . .*  \.*. *.*.*   \. *.** .** * \ ....*..\    \.. *.\.*.*\*.*.    .** * \...  *.***\# .#.#                                                #
#\.\ . \ \**. .\.. *\.*  *.\ .*...*. \ .\***.* \. *..\* .. . ** .*. . ...**.\ . .. **.*.. ...*. .*.\..\.*\**#                                                 #
#.\ *\... .*. *. *..  \\... . \..\*.*.  .**..\ .  * * .*   \*\...  **.  .*..  .\..... . \**....*. **\* .#..*.#                                                #
#   ..* .  ** .\ \ **..*\* .* .\.*.*\ *  \** .*..*\ *... * .. .*. *.\  ..*.. . **....\ **.*..\**. .*... *.###                                                 #
#*\**\ ..\ *.*   **.....*\  ....*. ..\*.*.*.    \.* ...\*...*  ..**   . *\ \  ...*....*\. \*. .**. *.* .*.#                                                   #
#.. \.. \*......*.*. *. \ . . \.* .** .*...*   .*..  *.*.* .*.\ \.*\* .... .. *\..\ \.*.*. . .\..  ..*. .#                                                    #
#. ...* .**. .*   *.*....\ *  .*\* *. ..   .** ..\ *......*\**.\...*. . ...* \*.\.*..*\*. ..*.*. .  *.*.\*#                                                   #
#\*. *.. \.  ..*.* \*\  \  *   ...*\ ..**\ ..*  \.\ . .\.*....  .  *. *.*. .\..* *.\*.\..  .**\.*## *.*\##                                                    #
# .\. *.*.*.\*\... ...\ *..** *.**.*\ ...\. .**\  ...... ...* .*. \.  .**.\ \  .*.. .  \.\ *..  ***#**# #                                                     #
#  ... ..    ..*.\.   .. .. *.**. *\. *\. .. ..*\.*\ .. * .*\.  ... ..*.*.  . ... * . .. . . .. . #\..##                                                      #
#. .\. **.  .*** .  **..*  ... .\ \...\.*.. .. .*.\.. *.. .\..\ **.* ..*.\ * *   \. **. .  ..  **# ###                                                        #
#..\*** *  . *.. * \ \ ..***\ *\   *.* *.*\\  *  . .*. .* ..*  \.* . * *.  **\.*\* . \ . \.*\#\.\#                                                            #
###############################################################################################################################################################