##########################################################################################################################################################################
#   #\..#\.\.. .  **  *.. ***. . *..*\*\.. ...* .  *\  .*..      .\*..* \ \\.  *..*\ .\. *.*..  ..*.*.   ..  * ..  \ ..*.*.. *.**.* .. .\.*.  . \.\.*. . * \.*  \ *  .*..#
#   #. *  .... . **.*.. *\*.   * .*..*  ..**.\. .\*\... ..*.  ..  .\. .*.*.\*. .\      \.*...**.*.\ . . ...\  *.***\. \\..* .*.** *.**..**...\*.***. . ***\... *.*. . .* #
#  #. \..* \\    *\...*\**..*.\*......\  ..*. ....\* *.\ .*.   \  .    .\*  *. ** . **. ** *..*.\ . \*\.   ***.\**\ \*..  .... .\...\\.*. *\. \ ..  .* \..** ... \. * .*.#
# ## \. #\* * .. .**..* ..* ....\ \.   .     . \.. . ..*  . *...*\ .\ ***.  *  *  \  .*  .*.\\.** ....    ..* .*..* ..*.*\  *\*. ..\ .. . .**..*** \..*. * .  *  . ** .* #
##\.   .*..\.\...**...... .. * \.*.* .\*.   .**\** \... ..\. .*\..*** *..   .*\.\\\.*\..  \*. *..\*\.  .\\ ..  ....\ .....\.\..\  \. **  ...* **.*. ...***. **...  .*. ..#
#*.#*\###.\ \**.\*.  .   * . .*.***.   * ..  *..\.*.  **  * **.  ***...*\\*. \* * \ ...**\... . * .\.\. *.\.\.\\****.\.\**.  ** \ .\..*.\ .  \*. *     .\.\.*** .. ..* ..#
### ## #\..\ ** . ... .. ..  \\.... .. . .\  ..*\ .  *.. ..**..*\  . * .. .  ..*.*...*.\*..*..    .** . * .**.*.**\ .  ..\.\.\...*\..***.*.\... *** . . .*  *\.    \ ....#
#       #*\* .   *\.*  \. * *.*.\..  \* . *. .\**...\.\...\.....* .*\*\*** ..  .   \.* **  ..*. .  ..* . *\ \.* \.* . \.. *.\.\.*.** *.*..\      ... **.\\.*.\  ***.  *\.#
#      #....  . \*. . ..  *. \\ ** .\ . . .*. *.*.  .  ..*. ...*...**\ ****.  .\.  . ....\ . ...*.*\\.. ..* ...   .. *  .... ..\.\.\..*.\ ...   .*\. **\ *.. \ *. .*..\. #
#      # #*#\. \..  ..\*\**..* . \  ..* *... .\.*..   . .* ..* . .*.**.* *. \* .. *\*.* \ .    ..*\..*. ....\..\... *..*. \    ***.. \**\*.*  **.. *.. *.\.**  .*    . ..#
#      #\.##\.\* .\#*  .*..* ..*    *\*.\*\  **\*...*\* **..*..\.*\..\..\  ... \ .. \*. .\ .*.* .\* .\. \*.*\..   \ .*.\\... ..*..\* .\.\\.....* .*..* *\.... *......*.* #
#     #.  ##*\...*.\.  ......\*.\*  ****\*. *.. \*   .   ***.*.*\.**.. .\.*. *.. \.\ .*.*. .**\ ... * *. . ***.* \.  ..*\ \*..\* . ..*    .. \* \...*. *  *   *. .. **.\\#
#      L.#.   *. .\.. * .. . ..*.\ .....* ***    . ...*\.*.\. **....\ .. .**\.  .. *. \*.\  .   ***. \ **. *\...*...\ * **.\. \.  *.*\. ..  ..... .\* ..*..\.\.  .  ....*#
#       ##\. ..#. **\*.. ...\  .  .\ *\*\ **..  .\\*\.\* . *.\ *\..*..\..*.*.\\. . . . .*..  \. *.*\. ...  \ *. ..*.*** \* **\ ** .* .** .*.* .\*  **.\.* *.* .\. . *..\.#
#         #  \#*.*. **   ...*..\*\.*.\* *..*. *.* **. ...  .\ *.   \..**..\ *..*.*.   **.   *.. .*\  *.** **.  . .* ...... ...  *\...*\.\\ ..\ *.. .. .* .... * ..\ * \..#
#          #  ...* ...\. * . . ..  *. . *.\\ ..*.*.. .*** .. . ..\... \.  *\..  \. ..*....*.\ .* . \*.\ .\.. \**  .\. . ..*\..*.     . ***..  *. **** *. .\* ... **.*  *.#
#          #*. * . *    ... ...* . *.     .\.\ . *...*.*.  * \. *.*  ..**...\* \.*  *  ..\......   .  *. *. \.*..* . ..\\...  * * *** *..**. .    ..  . ** . *.\**.\.  ..#
#          #\  \ *\.  .\ \\.  *.\ .\. * \*. .*. *..* ***. ..... .\.\**\ ...\..\.**.*.  . \ *\ *.  *   .*... .*. ..\ .\*.. ...***\ ... \.\ *** ...* .\ ....*. .. .*    **.#
#           # .*..  *\ .\...* .*  ...*...* \.**.*\..*... . .* \ ***.**    .     ...\ .*\... *.**  *.*. **. .*. *\..*\*\.  .  ....   * \.\ ..*\*.\.  .*\.**  .\ **.  *\...#
#          #  *  ..****..** ** * \\...  *\.\ *.. .*...\  *  \*\.*.  .**\.\*\ *..\ *.  .  .  .\. \.  \  *...*\.* *  ..\* .* ...* .\.\.\ *  *..*. *...*...*..  .... .\ ..  #
#         #.*#\ .\ .*** * . .. . .*\*   \  .*******.*\. *......\.\ .*.\ \... \.\. . .\.  ..* *\\   \ . .** .  ..   \ *.    .....*.. .*.\ .*  **.\    .\ ..  **.*\*\*.\.. #
#        ##*\.*.*.**...*.    ..**.\ .   .*  \.....*   \ .* * .*. .....\ .\   \ .  .*\**.\\\.*....  *.* .*....\.. . .    *\ .  \**..\* \****  ..\*  .\*..*\ ...*\ . . *...#
#       #**.   .**. .  . ...\*\.*\**\*\ .\..* .   ...*.. ... *..  \ .  ...\.*..  .**.* ..* .. .  ** *.\   \   *  . .\. *.* ...  * ...  .*.  \  *.\** ..\* *\  *\ .*\... .#
#       #*\ \   .*.. *..\. \   ..*.... .\.. **. . ** *  ... *..\.* .*.  **.....\ *\ *. * ..**.\.*.*..  *\ \.\ . \ \*.**.\.\*.   ** **..\.. **. . ...* . .\*  .* **..**   #
#        #....*.*\**...  \  * .**.\  *.. .* .\**\ *  .. * ..*.  \\....*...   \. **.*\ \\.  ..\ **.**  ...\. *.\\.. * ..  .***\..***..\* . \.\. ..*\*.*\ \*..  \ *.*..\ *.#
#    #   # *\ . .*. .. * .*.* \.*  *....\ ** ** .. ..\. *\ \.**.. \*  .*  *  . .*. .*\ . *\ . \...\.*. \\. *\ *\***. \. **.*.. ... ..   *...*\* .*..***..\ .\  .\ . * *..#
#   # ###*\.*  ..* \ *.\* *  *. ..**\***.  . .. \..*  .     *\ ... .  *\.\. \\*.   *... *\. ...... .*.\.\\..*.* ..\... .  *..\ .. ..*.*\.*.. .\.*. \\..\ .*. .. ....... *#
#  ##* \*\* . ** .\.*.\ .\. ..* . \.\.**.... . *\*. \  .\.. . .\..\..*.*  .*.**   .\ *...*. .\*   \...* .  \.     .\..  *\.*\ .\ * *.*.. *.*  .  \ . .....\ \ *. *\*  ...#
# #*.\ .#*  ..*   ..\ * \  \ *. .     ..\.\ \.*.  .. . *.   .    \ ..\... .\...* *  *.  ..*   ..*..\.\.   ...\\.**..   .\ * .**. \\.\.\.\**. .\.* ..*\..*\*...** ....   *#
# #.*.# \.**.**\*\..*.\...*.*\ *. * \**\  .*.*.  \*. \...\*\****\.* . ..   *.\ .*..\  . .\ .  *\..\ \.* .\...*.***\*\*. *\. ..\****..*** .***  \.* .\.\**....  . * .   .*#
# ##   *#*\** ***.\****\.\\ * *. \* . ..* \.\..*  .*\.  . ..*\  ..... . * *\ ..  \...\\  \   *.. \*\ .*  .   . . .*..\*..\. *   ...*...  .*. *. ***\.  *..***.* .. \  *\.#
##..*..*.. .\  **.**.. * *\ . .\  **. .\. . *\ * \ ..\ \. *  ...*.* .  . ...\..**.. *.* * * ...   \.. *    *.   . *. *\. *  ..\**  ..*..*\* .*. ..*.\.. * ...\.. **\.*.  #
##\.......*.#** . \. .*\ *.  .. . .\  \.*..... *\ ..** .* .***   ..\ ...\..\ *...  \* .\..*.\.. .*. *.* \*.\.\ . .\*..*.\*  \  *.\**   ***.. * .\.**  ....\.\ *.  . . ...#
# #  . .  *.\...  *. \   .*. *. .\. **...  *\ *. * \*.\*.\**.\ .*  *\*\* .* ***. ...*. *. .  *. \..\.\. .. ..***.....\.  * *.*.*\ ...\.\**.  *\ ..... \\\* ...*..  * ** .#
#  #*   *\.\. .  . *. *. \.\ ..*\ *. * .*\ * *. .. .  **  .*.**..\ * ..*. \* *.   . .\..  ..\ ...*...\*.   . *.* *. * *.\*..   .* .  ..*.\.  .* .  . *  ....  . \  \ \   #
# #*## . * .   .  . \ .*\.*.. .*. .  \..***.\.\ *\ \. ... ....   ....* ..*.... .  .**. .* **   .***\..*\ . *\ *  *.. .***..  .. .  .\.\*.**.* *..**....*. ***.* .. .. *. #
##.* \** .\*\...\  \.. .*.. . .\.   *. *.... *  ....\*   \  ** \*.\*.*  *   . *\* \..  \* .. \ .\.\  .. .*\*. ..*.   .**...**..  * ..*** ...\*..*..\*.\ **   . * *.\ .\. #
# ####...* .*  . . . *  .\ *\ .  .... *.\ ** . * * \..   *..**\*.   *.*\ .    .\* . *.  *.*... .. . .\***..*. ... . * .\. **\. . .   .*. .\.. ...\ *\ ..*.   .**... \. ..#
#    #*  . \*  * ..   *.*. . **** * . ...* *  ***\.   .  * . .   **.*...* \.** ** * *\..\.\ .*.. . .\..*.\.*.*.\ .  .  .. ... * .**  \....\.\.**. . ..  .   \ . .*  ..\ *#
#    #* ...  *\...\** . ..... **. .\..  \* *\*.. * *\   \. *\.**.....\.\.\.\..**.*. .  ..\  *...\. ... \.**....*****\*. . .  \ \  *.*.. . . .\.\\ ** ..* *.*...*  \.    .#
#   ##...   ....\***\ **  *.*. *\...\.  *..*..\. .*\ .*.\*..  ** . . . .**   \. ...*  * *\..  \...\ *...*\*    *.. *...\\ \   * \ . * . .\ **.**.  \**.. ..\.. . *.  *\*.#
#  # ****..\.\  ... ......\...*..\ . \...**...   *.***\ *..*  .. ** ***.\.*.*..  ... . . *.*\*.* \ \   ...\  \.. *..*\\.\..\* . ..  .. .\. ..  .\   ...  .. . * ..\..\**.#
#  #*\. *.... ..**.\*\. ..*** \  .\... *\.\..\.\.\.*. *\. . . * \  \.\ * *.. \  .. .  \.***.*...   *.. *.   ...*. \*... .. *.. . . .*\.   \*   .*.R..  * . .  .* *..*..**#
#  #.##\....*.\ .\..\* .... ..  \ * * . **.  .\.  *\* *..\. ..\ .\ .*. .. . \.*.*\  **..\.*\..\. \.\*  . *.\...*\*.. \*.**  ***..\  *....\. .** *. .* ...*\  * .  *\.* *.#
#  #\*..* ***..***.*..  . \. *  .  ..\*. **.  ..  . .****.   ..*  ..* .*. * * .**... *. .*..  .\* *..\.\.\ . *.... . *... \\ \ ...* . \ \.* ..\ *.  * \ \....*   .* ..\.*#
#   ##*\  \ . *.**..* ..*. *..*..**\ *  *\.*\ .  . \*..\\  .   .  . ...\* **.   \**\   **.*\ ..*.\.  .**\*  ... \*.\. ..*   * .  \*  \.* ..  ....\ .\.* ** *....\..*.***.#
#   #\* \ .\*.*\*\     .*.  .*\..**  .. . ... .*.\* **\ .. . *. .  ** *.* .. \  .  .*\.** \* *...* .. .*\....\ ...*  * ...*.....\**.. *.  *.. .*..\ .*.*.*\..*..****...**#
#    #..\.\** \..   .**..\ **.* . * . .  * *. .\. . ... \  ***.**.*. *.*.\   .\* *.**\ \.... .  *. \*. .**.* *\ *.*. .\*\**...\..\.*...   .*  .*** ...*.**..  \*.....\*.\#
#   #..#.**\*\ . \..  ..\..\. \.*...\ .... .* .*\  \\ .* *.*....\..* .***    .*.  *.**\ ** \  . .* .\.  \ .\*... .. .. *.*.* ..*\ .***.   **\.   *\.. . *.*.**.* \..  *\ #
#  #*  .* ..*  . *\*.**.  .  ..*.\\. .  .\* .. . .* .\..*.\ *  ..\...* *. \ .... *\.**..**. .    .    ...\ .*.*.* .* . *...\.. ..* . .\* **\. * ... *.\ .\...\**.. \ \ *.#
# ## \.*.  .**\ *\.*\.* .* .  \ \* *.* \ *.. *.\  .  .  \.*.*\ \. .*\....\.* .*\*... . *.*.\...*\.*\  .**.*..*** ***\ \. *\*\.\ ....  *.**.*  \ * .. ***  . .. .. ....**.#
##.*. *. *\.*. ..\.*..\** \ *\...**.  . .\.. ....\ .. .*. .*. \\* ...   \ . .. ..* **\ .\.**\..** * * *\\\* **\. .*\* ...\.\  .  . *... .\.  *..\ *\** . \.. \.....\.**. #
# ##.\# *.   .\**. **.*.*.  *\.. .    .. ..\. .\* ..\  ... **... .....*.\  ..\ *..... **.***.\ .* ..*\..****.*.\  ..*  **. * *..\ *..  *.** ....*.* .**.. ..*. .*\**...* #
# #. #*..* * *...* .. .*  ..\ .  *  . * .     **\*.....  *...\.....*.  * ..*. **.... *\*.*.*.. *.** ..* * .\ .\  *. *.\*.    .\.  * .\ ..*.**\.*.\*\... *  .*  *. **\.\..#
#  #.** *.  .\.**  . .... ** . \\*    .  .\. .. .**\...* * .\...\. *.**.\*.\\ .\*. * *...*.. **.... .*..*  .* *.*\\..*.**\..***..\*\ *.*..\. . .  .. . .*  \....\\*..*. .#
#   #####*.\\  ..*  *. \. .*\ *.*. ..*  \.\***\  ..* . . .\*. \...*\... .. . . ...**\.. .* *\ ..\..  . ..   \ .\*.*  . \.\  \..\\ **.**. *  \. *. .*.\  .*  .*\..\. .\***#
#      ###\*..*..**.* *. \... \\.\...*\.   *..\*** ..   ***.   .  .   .    \..**. \. ...\. **  .. . ..\ \. \ .  .*. \..  .. .*.. .*.*\** .\ . .  .....\*.. .*..   *..*.\.#
#     # *.*\ ..*.\.\. ..*  *.  ...\ . .. *.  . \ . **  . ..... \  .*.* ..  . *. ..*.\*.....*.  .. ..*\**...  *.**.  *\.  **\ .. * .\.   \ * . ** ***..* *...*** ... ..  *#
#     # ...* *.\** .\  *\ .. .\*\.    *... .. * * *..**..  *..* \.*  .*..  . \*. .**.*  .\ \.\ . \ * .\..\**..*.\\\ .**  .* *.. ** *\*.\. **\ ..\*.....*...*.\. \.\    * #
#     #.\.*..**. *\ \ *\...*.**\\.\*.\.\.*..\ ...**. .* *.\..\******  *.* **\ **.*..*.*\  ...**.** *.   \*..*\.**\\\ * .*.*.. \..**\ .. \*.*.**...*\   .. .* *..\ *\ ..*.#
##########################################################################################################################################################################