######################################################################################################################################################################################
#                                                                               #..  .##.\.\*... ..\.\.** .**.\* .\ .  .*..*..\  \. .\***.\    *  *... *\*. *  .* ..##              ##
#                                                                              # #**\ . \.\..*** .\ *  .*  #.....  *\.. * \...  .*. * .* .#.   .  *.  \\ .** ...*\.**.##        ## #\#
#                                                                            # #.* *.* ..\* ...  ...* \..*\..*\.\. .\.* ..***  **. \* . .\  . .*  .* ..  . \. * \  #* ..##   ### .#\ #
#                                                                          ##.#**..****#  *...**\.* . . ..** **.  . .** . * ..*.*.... *.**.* *.... .  *... **.\ .*  .. .\*###*.*\  *.#
#                                                                         #\ . *.*  *.. .\*.\ ..*.*   .*.*..\*\*\  \..* . . ... *\** **....* ..\. \*  ..\  .*\...\    .#* .*##*## \ ##
#                                                                          ## *..* ##..#\.#* *  *..  . .*.\ .\* . .   * * *  **.. *\.\*\..***\  ....... . .**.\   .  ###* *#####* ..\#
#                                                                          ##. #*#\* ... . * \.\ *.    .... ..** ..*\ ..*  .\*.*. .*... .\**.* .\ *\ ..\***.*. ..\ ...#\  .  .*## # ##
#                                                                         #.\. \.\.\#.  *..**\*  *. *.*... .** .\. ... *.   ....*.** \ ***..\ *\...   .*.*.. * .*.*   *.\ *.*.# #\*  #
#                                                                        #.  . .\**  \.**\..... \.\* .*.\ \*.  ..\*\.*... *\ ** .... *.*.*\  ...\ .\.***... \*.\... * * .*....\..*..*#
#                                                                      ## .#.  .\.* *. \#*.. *.**...   ..  **. *   .*..* *.   ..* **..*. *.* \\ .   *.\. ..*\ *  *... *..**.\ .#\ ..*#
#                                                                     #.#.  \ .*.\*... .\* \.*.*.*. . ..\ . ...*.\*\. *\.**. ** ..* * * .** . ***.  *..*\\..* \  .*\*  \\*\ *. .**. .#
#                                                                    #.. *.*.. * .. .#.\ ** **.\ .**.... . .. .. *\* *.*..* \.*..* * *.\... * . *. *.\..*\\ ....\ * . *  *\ . .\..* .#
#                                                                 ###*### \..\..\.* \  *...\..\ *.*.\*. . * \.\*....\  .*..\.*\  *.*.... .. .*\ .\.* ..\*. ..  . ... ..* *.**   . *  #
#                                                                #..... \\#.  *.*....*\.*\.  ***..\  .   .\ ..*  *\**...*. .\ .\**\. \  **.  .\**   * *.\  \  *  \ ***... ... * . ..\#
#                                                    #          ###***...#. * *..*. ..  .*\... ...*  *..*\..*\ \***\*.* .\**.\*.......\*... .     .*. .** .  ..* ....* .... *****  ..#
#                                                   #*# #     ##\....# \.. .\**  *** .. ***.. * . **\..**\***.*.\*...*..**. .**. *** ...\ ..\ ..*.*.  *.* \  *.. . . .* .\**...\. ..\#
#                                          # #    # #..#.#   #*..**.**  .\  ....*...\ #*\..**.**.*. .  *\ ...***.*\\ \*****\ *.*..*.*.*... *.*  .***. . \ .\ .\  .***.\ \*\*.* *.\...#
#                                        ##\# L# #*#.*.#\### #** ..**.   * *\*\ *\.**\*.*. *...* *.*.  . .. .* .\ **..* .*......\**..*..\.*...  .. *.*  *.   .* .*\...* .. *.. *  \ .#
#                                       #\*.*..\#...**.* #..#\*.# # ***\.* .*\* . .*.\.\* \. \..\.       . \*. .* .*.\. ****.  .... **   *.\ ...   .\.***.  ...  .*   . ..... .* * \ #
#                                        ###. ..*  ***#*..#\**.*.\.\.\ .* *.. .* \*. .\**..* . . .\**. .*  ..*. * ** * ..*.\. .** .\ .  * *\  * .*.\.*..*..\***..*.* *\***.. .*. *   #
#                                         ##\ \*.  #** .##\ .**.*.*** \...\ .**. .....*.....\ .. \ *\ \ \ .\.\*\ ... \  .. * *. * . ..* .\... *.\.*   .\*.*... *\*.   .*\.\** \..\.. #
#                                        #.* .***  \*. **\#*.\\ . . . . .#. ..* . * ....\* .*. *.. .*  . \  \ * . .  .  *   .. .  * .*\.\.\ \.*.. . . .. .***. **..*\  .* ...* .*  * #
#                                         #\**#.\ . .   .  . * ...*.    .*  . \.\****  .*.. .*.*....*\ *\** . .\  *.  . .\**\    **\ **. .. ..    . .**..** ** \.\. ......*. . **  .*#
#                                          #.*. .   . . \. .*. .\ .*.. **. .* .. ....\....** ..**   *.*   \ .. **. .\. . *\ * *..\. \*..\ . *. .  .. .*\*.. .*.\...\ .  * .. * ..  **#
#                                         # . #\  *\*\*\ ..... * . **\ \ \* *. ** ** .*.* ...*..  .. *. *\.. .  \.   .*. \  \ .\ *.\. \.* * .  . *****.*. ..*...*\.   \..* .\.  . .\.#
#                                        #* * ***..*...*.* *  ..*\. \.  * .*\ . *..* .\ * ..** . *..\*\     *.\ .  \. *  \\ .*.. *** \.\....\   ... *.*.*. .. * . .\.... .*\ *\.\* ..#
#                                       # *...   .*.  *. * *\.  ..   ... .\**.\ ...* *..  **.. * .****  * * *\ .  * .*. . *.  *. *. \. * * . \\**....\ *\   .\. .\   . \  ** *......*#
#                                      #.*.** .  *... \ .**.. .\ *.**\ .   .**\.\. .*\.. .\.* .* .*\.*\ .*. ..  .\. .**. .** ..\.* .\* **\.*  .* \ \ **.  *.* .\\*\ .. .\ *\..\*  \.*#
#                                       #*\*# ** ..  .   *.*..* *\*...\ .. \  .\..*\***  . ...... * * .\..**..* **\.*\.* ...  *.. .... *..*.* .*..*... * .*.. . ..*.\ . .*..* . *....#
#                                        ##.  *.* *** .\*.\.*. \...\*\..   .\.**. \..  \..  *.*   . . *.. .. \.*\**** *.*\.* *..\*  . . *..*.\.***** . \ *.  \. ..\* . \ ..**.\ \*.. #
#                                         ##  .\.\*. **   *\.**.*.  \  ..\  *.\..*\*\.. \*\...\\.  . *.*\. ..*\. .*.\....**. .. **** *  \\.*\  ..\*.\....\*..      .. ..\..\.*.*..\. #
#                                        # #\ . . \ .* **\. ..*\*\ * .  \** .  .  .\. **\*.*\. .*\  .*.\.**   ... .*..*. *. *\  . .* * *... .*..\.\*\. *.** .  .....*****  ...**\. ..#
#                                        #*** \..*.* *\ ...* ...*.\.  .*\*. . ..* \ .\***. ..   ...*...*\.. ****. .**... *\ \.*..* \*...*.* *..*  .*.*  \*.\*.. \..*\.\.\* . *.. .. \#
#                                    ###  ##. #.*...\ *\ ....  .* . *  ...*.\ **. .  *.*....\.*\.\\ .  \* .*... .\....*\*\. . . ..\ ***.*\   . *..*. * *.*.**.\*.*\\*.  *.\ *..  *.\.#
#                                   #.\ # #.  * ..\ .*.****.*.* . . .\*  ** *.*.*. .*\.....  *.\** ** *.\*. .. .\.. * \ .\   * **\.*..\.. .  . \. ...*\. . .* **...\.  *.. ..  . **  #
#                                    ##.##*  ** .. .*.*.  \. ...*\.\* ...\* *   .. * **      \*.*. .*.\  ...****.* *. . ..  .* ..*.... *.\**.\*.  ..\. *.* .* *   \...*.  \ *\.. .. *#
#                                     #.\*# .   .\  *.\** .* *.*.. **.....* *.  *..*.\\...* \...    .*.\.\.*.... . ***.\ \*.*.  \.   .\....\*.* . * . ...\ ...\ *\....* .*.   .**. \.#
#                              #      #\ * #*.*.* *.\*. .. . .  .* . *\.* **.*..*. ...*.**\  ..*\ \*.\ .*  *\\. .\\*\* . . *.. .....* \  \*...\** . . .* ..* \*\ .  ..\. .   *.*.\ . #
#                             #*#   ##\### .*.*\. .* *..\.   . \ * . * *.... *.. \   **.*...\. .... ...**. *.  ***.. .* . \... . * \*\. . . .**. .\..\...*.*\.  .**.\\\  . *..*...* .#
#                            #.. ###. ** *. .*  . ..\ * .\\ \.. . ...*... *.\...\ . ..\ *\ ..*.*  .\.  . \*\.***\.*.\*.   .. * ..**.*.\*. *** \   . .\ . *..*. .*\.*...\** * ..*...*.#
#                             ##   ###.#..  .*.. *.\ *.\\.\ .. \ .\.\.. . * ..     *   . .  *. *.  .\\*\ . .*.\*...*.*.\.*\.*..*\** .....*  *..**** . .. ..\... .*\.\  ..**.   .\.\.\#
#                            #.*.*.\ #*\*.\**.*. * .*...* * . ** *.\ *..\*.\.*.  **\\  ..\ .*\*.\ .*.**. .  .*.*..**..  ... .*.\***\ *  .\. ..\ \**  . \ . ..*. \   ***  *\*. .. **\.#
#                             #.#.\ *\..*\.* ...\\ ..* .**.\* *. .\ ....*.***.**  ** . *\.*...*.***.*... *\\ *\\ ....   \.....\.* .*\. \..  .\.*.\. . . \. .*      . ...*\..  *.\.  \#
#                             #*  *#  * *.\..\. ...  ..**.  .*\ **  *   . .*.* ..\..\.. *..*....\* **..*\ *......  **\. . \\.\...*.*** ..\****.. .*  . ..  .*.. .  * .\* .*.**. \***.#
#                             ##.*# # *.* ...*.. .\ \.\\*\*\ .* **\**.*.. *. .*..    . *.*.. *.. . .\. ....\ .*. .\.. ..\..\... *.. * . \....*.*. .*.  .. * . . .*.*  ... ..\*.\.**\*#
#                            #.. ..#. \ .. \ ...\ .* *.* ...*...*.**...\ .  \.*.\ *..\.*..*. .****.  *. \\. . .  ***... . ..\. ..*\*..* .* . .* .   *..* \   \ .   ...*.\   .*\ .*..*#
#                            #    \..\  ..  \ . . .\.* ..\**.\. .*\.*. . ..\.\.. .\...* * *   .    . .\. . \ *. ....\\*  . *....*.*.*..*... *.*\.\ . .*.  * *.\*....  .. . \*\. *.* .#
#                            #\..   . *. .... . *\ * . *..*.\... .. . \*. * ..\ \.* .*\ .\. . \ *.\ ..*.*..\. *\.   ..*\.\ **\ *. .\*.. . *\ *..\ *.\ ***\*..*\...*\ \ **\.\. .  ** .#
#                           ##  \ ***  \ .     *..*  *.*...  .\ **. ......  .\  .\.\.* .* .. ..*. *. * *...*.... \.   .. .*... .. .\.*.\ ****.\\ *.\  *.. .... .\ ** .\*. *..*\.*...*#
#                          #..#*. ..\*. **  \*.\.\\.....*** *...*.\ . \..*.\. *.  .*\..*. .     *****\ *   **.* ...* ***  **.\.\*** ..*\*.\... . .*   ..*.*\.\.\  \*  ... * *  .\..\.#
#                          #. \... . .\ *. *.*.. **  .\*.\**  *\.*\ . .\.* **\** . .*  \*\.*\ \ \ . **\* **....\*.*\.\.** ... . .*\*..... \*\.*.  ..*. *. ...   *  ...* .*\.. *..* . #
#                           #\#.\ *.\  *.. .*.. ...** ***.*.\.*...\...\. *\.**...*\..* .*. .*.  *\**\..\ .*. . \ .\**..\* ***..\.\.* *.  *....**...    \.** .\...  .\ .*.  *. .  .*  #
#                            #*. *\ *. ...... \ \****** **.\... .  .*    *  *.\ .*...*.\*. .*\  .. \ \*..  .\.\...*..\... *..  . . . .\* *  . .  *  .\.***..*** * . .  *..*. *.   * .#
#                             ##.## .... ....  . * *\ *.\ . . .**  .\ * ..**.*..\.. .  . * .. .  * . .  * *\.* .. . ...  . .... .**\***..*..\* * . ...* .*  .*. .\* . \....  \  .*...#
#                           ###**.\ . \ .\**.. * * . .\*. .*  ...\*.. ..\ \.*\    .\ .  ...    *.* .. * .  *\.\* . \... ..  * * *.\..**  ...  \..\.* *.*. \ \* . .. .*.** ..  *. ... #
#                         ## *.\  . ...\ ..\ . *  \ .\ .\  \  .. *.* **.*. .. * .  ..*..* **    \.** ...*.  **  .   *.  *\..* .   \\ .*\\ *. *\..  . *.***.. * . . . ****\ .. *.\.   #
#                        #\#... .*****. ... *. . ..   *\ .  .*\* .*....*. .\. ..\ .  ..*\. . *\  \*.**. \.*\**\. \*\..* *.\*\****\. ..  .*....**. *  .* .*\  **.*.. ..\...\..\*\.\.. #
#                        #  *\...*. .* **.\ .*   .\  .*..*..\*  .\.***....*.\ .. \.\** *\ * ... * . .. * **  .  \* ..** .* .*.**.\ . .\ **\.\...* .* *\.\*  \.. ** . .. \.\.\ .* \ ..#
#                         ##*.*.\*  .*\. . \.... *\ \.\ ..\. .**.  **.\ .\. .\. .. **. ..*** \ \*..   .**. *\*.*.  ...\\    ..\\  *\ .* **. . \..  **.* ..* ..* .    \*.. .**. .\. **#
#                          #\#.. **.\*  *\ .*.\* * ....**\ .*  ...\  *.\. .\ *.*  *\* .. ...\..*. * .*.*.. . ..*.**.  .\. . \*. *  ..*..\.\*  .\*..\. . .*.. *\  .* * .\  ...  .***..#
#                          #*.. ....  . ... *\ .. **  .\ .\ .\.\ *..\*\ ***.*. .. .*..*. . ..*\..\.\.* .. . *   .******..\. .\.**. *..   *.. \* *\\.**.*..** . *.*. .* ..*\ .*\ .\.**#
#                         #.....  *.  *\ *. ..  \.... *.* *....** ** \.\.....*.  . ***..     ..*  ..*.. \ *.\   .\.   *    . .*..\..* .. .*\  \ ..*.*.*..... .. *. **.\ *\*. *..\  .*#
#                        # * * *. .\* .**. \.   .\... .*.*.\*.*. *.. . .. . \ .. **...*...\. .* .\. .. ....*...* . \.\\ \ . .*.* . \* .   \  ..\.  .*\\\. . . . \..**.. .*.  .\* \ ..#
#                       # *. * * **...\..**.** \ .\*.  .*. *.\.*..*\*....\      *\ *. .  .. .\.*..*..  ..* .*. *  *. ..\.*.\ \..** .\  .  .. \  \.* \* . \  .....**..  .*.*  **.  *  #
#                       # **.** *.**\\.*. . .. ...... . .\\\     .*.\. \*\.*\**..***.\    *** .* *\*.\* ** *.\.*.***\...\.\**  \.*.\.\..   *\ \*\ .. \. .. * ..\.\*.* ****..* . *\ **#
#                       #\*\.\**..**.. \...\....\\  *\..\...*. \ .*  .  . ..*... **..*\. .\ ... *.  * .\.* .* . *.\*  \.  ..*  \.*  . *....   ..*\***..\.* ** . ..**..*.. .*... .**..#
#                       ## #*.\**.. * ..\  *... ...*.. ..* ..     *..** *.\      \. *.. .* * ..*. . \ \ \* .\.\ .  \*\.  \.**\. .. \ \.  .\*.\.** ..**. \..*. \ \.\*...\* ** .\ *.*  #
#                      #* . .##.*  .*  .*  **\ ...\ .. .*... .*.. . *.. \ ..  . . *\.*.\ . * .*   \. .   \. .* .\  .*   \*  * \\.\   .*..\.**.....  **\   *..*.   ... . *....  *\*.*.#
#                       # * ....  ...   . *** *. *.*** . \. ...\ . ...* .  *.   \ . \...\ . ..\ ...*\  ...  .\   . .* \ ..*.\ ....**..\.**.. ..\.\.  .*\ *\.*\ .\. . *\*\\ \..*\..\*.#
#                        #  *. .*.\*..*.. .*..* *\*.\. \ .  * *** *.*\.  . .* *.*\**.. *... \*\.*    ..\\ .. .** *..... *\*\. ***.  \\.**.  . **..  **.*.\... .\ ..  ..  \.*\.. . . *#
#                        #.\...*.\.. . *.\.. *\ .. . .\ .**\* **.**.**..**... *..  .\.\...* .. ...* . * * .\..\*.* * * \.*..\...* \.. *.*.  *.\. *..\.*.**..***..*. *  *.. .  ......\#
#                    ##  #.. \ . * * * \ .\*..    .*. \. . .. *\\*...\...* \.... .\*..**\..**  *..  . ....   *.* ...\.\.  .\.   .. . * . ... ..    * . ***..\.. ... ....\*   . .\*.. #
#                 # #\ ### #*.\. .\** .\.* *..* *R*\.  .* *\.*...* .*..*.\...*\ . *.*..\* \*  .. .  *.** ..... .*  . . *\** .. *\.*  .*.* . ..\.\* *\.....\ ...\ ..*.*.* ..\\...*  ..#
#                #*# #... * * *. . .*....\**.. .\.*.\** . ..*.** \.\.  .\..\*. * .*\**.**.....   * \.\.*\ . * *   *\.  \. ** * . *.*. ..\*  .\. .. ..**..* \*\.*\ ..*.*. \ .. ..*\*. #
#               #\..#* *#*.\*\. . *\ ..\*....* \. .  ....\\.*.\*.. \ \ ** *..\.*\ *. . \*.\ ..* **\\ *  * .\**.\* .. . .*..\ *\.*.*.\ .. . \\*  ..  ...\ *   *..**\ . ..\.  .\*\**\. #
#                #*\#**\.  .. .*\*. **\.  \***\.*\*.   .  .\\. *.\*.*.**. **.**.  . *  .*.*.. *\\.\**.\**. .*\  \ ..**   **  .. . .\  * .**. ....*.*.\..\.\..**...*.*.   * ...* \.\..#
#               #..\*** .\ * .\.. *. .\  ....** .*.*  .* *. ...*.......*. .*. .* \    .\   *\* **.\.\  *. \\... . ..*\.. ..\* **\  ***.......\ ..\ **..\*.  . . *.\.***\ \ . . **..* #
#              ## * . \* ..*   .*.  . \ .* ..*  *..*  *..\.. .   * \ ...\ .. *\ ..*  .*.**\. ...***** .* *\*   *. *\.*.  .*.\ .\ .. ...\ .**  *.\..*......\. \*.. \ **...  .   .** ..#
#             #.# #\ \..* \.\ ...... \..*.\* *\.\   *..\. .****  .\.\*. * *\... .*..  .\** .  . .*.  *. .** \ *.\ .  \   *.... .. .\. ..*.**...*   ..   *\.*.*.\* .... .\ ** .**.*.  #
#      #      #*###.*. .. .\ .* ...\.. .. .*\.....*\ ...*..\.....  *\ ... .   \ .. *\.***..\.\  ...\ .. \**\. .*.*.... . ..**  .*..  . .***  \ \ .\  ...*.....  ..    .. .. *.**.\*.*#
#     #*###  #... . ..**.  . ..\..* ..\.\.*...*. . ....\* \.  . \  .\.** **..\. * .. ....\\ .**\*  . .  \..* \ .**\.  *.. *\ ... \  .    .*.*. .\  \*.\\\ . .   . ..* *\. .*.**.  .*.#
#     #.. .# #*.\***\*  *. . *\.*..**..  . ..\. .*.  . .\*      ..*.*..  *.**..*... * .  * ****. . \. *.. .. .. ..* *.*.. . .**\....  \***.*** ..\*.\* .*..* *.\ \.\. ....  .*.* ..*.#
# ####. * ###..\...\  \**  .*..**.\.  . .\.\ .. ..*.* .  .*\ . \\ * . . ..\.*.*..* . *** *..* *.\. .** ..*\. \. *.\**.\**.  \**.*  *...*** .*..\**....  .\ .**.*\..*. .  ..*....\**.\#
##*.\##.#\  ##...   *.**\. ..*..*\..\*. ..*  . \*** .\. \ \. .* ..**  \\*.. ..\...\.  .. *.\ .   *\*...**.  ...***.* ..\..\***..*... .\...*.** ..**** ..\.* \ ***.*...   .*** ** *.*.#
# #..*. . .     \.*\\\ .\. .\. *.. ****.* \*.... .**\ **.* . *.  **.. *\..\ * . * .*\   \ \*..\ .. .  . *  .\* ..\... \*  .... **. * . *.* \*\ ...**. **..**.*\.. .** ...*.*.*. *.*\ #
# #\\**\.\ .** \. .***** \.\ .*.. *.\.  * \. . .....*\*. .  ... *  \..*\ ...\.  ..* **  ...\ .\**.***. .\\ \ \\ .. \*.   *.*....*\.* * \*. * ..  ..\* *. *.. *..*.*   ......\..*....*#
#  #...* .  \..*. \ .  *      *\.\*..\ .\*..**.\ .\ **.*.\.\*...*\. *\** . \**\*** *** .\**    . .  \ .. **. ...*....    **. .\\*. .....*.. .  * . *..\* \..*.\*.\. **.. \  *..\.....#
#   #\.\ ..\  ...*. *. .*** * \*  .\   ..*  **\. **\.\.*....*\ *.  *..*.\\.. ... ...*. \ .*.\ .\ .*.* ... .* * \* *.. .**.*.* ....\ .. * ... * . .   *...** **..* . .. .*. \.\*..**\ #
#    ##   . . *\..\ * *.***\.*.. *.***  .\**.*   ..\*.*...** ..\. ... .*.***.*\.. \  **.  .\*\**. *. \** *...* *.\.. *  .. ..\   ..*.* *\\.* .* ..\*\. \*.* \..*\  * * *.\ . *.***\**#
#    #..\*  **  .\..* .**.*..*   . .. *.  .\ * \* ...*.. ... *  .. . .**.... *  .  . \.. \* **.\\ * . .  . .   .**.\.*.*.\.. .\...*\ * ... **.**\ * . ..  .. *... *. .*** .  .*...*. #
#  ###\ **\**.*..   .* *.. * .\ .\.... .** \ ...   ....\..*  .\  \*. .......\.\*.\.* ..  .. \.*.**.  . * \   \. ..*.* .. *..***..**. *..\*\..\..  * *.*. *.\*. \ .. . ... . *..\ \. .#
###. .. .\ ***. . \  . ...\. ..  .\... .**\*. .*\.\ *.  .**.. *   ..**\ . .... .. *.*.\\. *  . .\.* ..\*\..* .*. ...*  \\..\ *.\...\ \ .   .\ .. .\.\.* *  .\. .. . *. *\*\.* ..** *.#
#. \# #* . ..*. ...*\ . *..*..\. ...\*\*..\..*\. .... ***.* ...\ .  .  . .   \  **.*.**\. ** .\ .*. **. . *.\*.. ** .\..**  \.\* .. .   \.\*. *   .   **\*. **. . ......* **. .*.. .\#
#### ##\# . .\.*\  **   ***.*.  ..*. * .\  .\. \ ..*. .*\.. *.  *  .*\ ..\\.* .**. ..** \...  *. *...* .*\*\ \ ..*.   **..\*....  \ * **.**\ ..*.. .. \. .**\.*   ..\.*.. ..    .*.\.#
#      #. * *.  .. *...... .      .* . \* ..*.   .*.  .**.*\*  **  *. * ...\. \**.*\ .. .*** \. .* \*.  .. . .* .. *. ..  .* \..*   .*.***.  *..*  \*..\*. .  ... *... *  * .*\*.*...#
#     # # . . .\ .**.  *\ .   .\*.* ** *...\* *.. .* . \*. .. \*.*\* .. .* *...   . .*\.. .*.. .*.\..*.  . * * . * ... \  .. .\..\ *.**.*.\.*...*.. . .  . ...  ***   ..**\ *\...*.\.#
#    #*\*    .  **. \**..*   .\ .*.**\ .*\. .  ..* \.. .. .*. ..\*.*\    \**\ \.\ *.  **. ** .. \..  ... .*. * * ..\ * . ..\..\\ *.\. ... .*\.\ * *. . * ..  ..**\.\*\* ... .*\.*.. *#
#     ###\.\..*.\.*. **** . . *.\. .. .\  *.\**\   * \.\ .*.\ \.**\.. \.  *..\..  \ . *  .  * \ .* * ....\.*...* ** \.    *...*\. *** \  *  .  *  ... \. ** .  ... \ ..* .* ** .*.  *#
#       #*. .\ ** .. ...*.\.. ...  *..   *. . \*. \  . ..*.*. ...* .   .  ...  *.\*.  . . ...... . * .**. *. .  \*\*..*.\ *.* \...\.*.\\   \   *....\ .\ \.* *\ \.   *\.* *.*.....\ .#
#        ##  *\.#\*\\.\.   ... *\. . \   \ \.....* .\*.  *.... .\....\ .\* *. *.. *.     **** *\ \*\. .  *...\*\...*. *. ..*  \. .. .... **.*\*.\*  .* * . .\ .**.*.  .**\..\ *  .\.\#
#          #.#*. .*.. *\.*   ... * *. * *... .** .\  . . .. .* ..*  *.*. .*\  .\ . .\**  .\.* .  .. *..  \ ..*. .   \..  .* .*\*. \*..*. .\ *.....\  . \.\** . . ..\.\ \.*.\*..  \.* #
#           # # \ \*..*  *.  ..* . .. * .. .   * ..* . .\ . **   *\*.***..\ ..* . ..*.* .\**\ *....*. \  .\***.** \ .*\.**.\.\..   ..**\.  *.  *  .**. ...*\ \*.*.**  * .\  .\.**.*\\#
#              ##......*.. *   . \.\.*.\. .. * *  . .\. * ..* *  **.\...\\ .*.\   .\**.   ...... * .. .\    .*\...   *.  . *.* \.  . *.*.   . . ..***...  *.* *\***. .. *.  \  ***\  #
#             #\. . .\.**..\ **...\**.\....*  \...**  *\ *  .  ***. .  .**  .**.*.\*.\ .****\.*\*\.  ..  *\    *.......\.*\. .\*.... *.*. \\. \\. .* \.* .... .**.*  **\.. *.. .*\...#
#            #  *.. \. . .\* \**. *\....*. *...**. * .\ ..*.\   \.  . ..** .**...\...*.\ ..* ...\* .\.* . ..*..   * **   \...*.*.* \.*\***  .\...* .. . .  *.**......\  .. . \  ...  #
#            #\*. . . . . .. ...* ..\  \. *. .\.\  . ..* ..*.**.. .* .*  .*.*... .. \.\*.\ *.*  .\  . ... * .    \. . \ \.*. .*.*    ..\\ * . ..*.  *\ .*.*.\.**..\.*\..*\.....\*\  .#
#           ## ... .. * \. .\. **\.....* ..  \ ..* \.  *  ...   * \*  . .. \** **** *\. *.**.*\ *  .* .* ..\   \ ....* .. \..\. *\***.  .*. .\.*\...*. *...** .* .***.   . . . * .\.*#
#         ##..  *\ .  ... .   *.. *\ * *  \ \.   .  ....** \.. **\. \ ..*  .*. *...*..  .* *..*\*.*\. ...*... *..\.* . ***  .*.\.*\*\. ... * . .**.\.. *..... \ * .... *..\   .. **. #
#        #*. \ .*.#\   \.  ..\.*** *..\... \*\.*.* ..\ \ *.*.*  *.  * *\. *\..*\ * \*.. . ..*..  \ .. *.\* *   *. ..  \.*\  ..\*\.. ..* ..*\..* **.\ ...** . *\..\. *. *    * .\ *.\*#
#      ###* \##\.*  ** ..* *\.\*.. . ....  ....\*. *.* ..\ *\.. ..*.*.**...\.. .**\..*.\*  **. \... **. ..*.\ *\  \ \\ .. *\.\**  *  *. . ** **.*.** . ..\ .*** .* ..**\.\.\ \.  *\.*#
#     #*. *\...# *.*. * .* .*  * \*  .  . *  .  *.*..***.*.. .\**..** .*. \...***...*.* . * \*.   **..    \* *.**. *. ..  . .... *.*\.  *..\.*.** *.*  .. .**..*... **\*\ .   \.*.*..#
#      ###.#\ **..\.. *...\.** \ .*.... * ...\\ .* . *\. .\  . ..*..   .   . \ .. \...*\   . .*..\**  .*\  .*\.**. \.  .*. . \.*..*\ \.\* \..\. *\. ... *  ****. .* *.*... .. \ .**.*#
#         # #..***.**\..*\ *.* . \**..  \   *\  *..\.... \ .. *.\** **..  *... **.*..*. .\. .. .\ . .*.... . **...*.*   \..*...*\..**.**..\.*.* ..\ *\ \.. .....\*... .*.  \..... **.#
#            #...\.**.\*..*...*..*. *.*.. \*. *\..  * ..*.**.*\**. *..*.*\*.\.*. \.*\  .. ...**\*. .**  *.*  \*.\ *.\  *.* .* *\ \**..** .*.\.. \*..* \*\*.\.*\.* \*\ \\.****\  .\\*\#
######################################################################################################################################################################################