##################
#**\.*. \.   ..**#
##\ *  *.  \. .*.#
####.*\*.*\ .*.. #
#.\.*.** *.. \.* #
#*\ .*.. * ....* #
#*# \#  *. ..*.*.#
## ## #.\  .* *..#
#     #\.***.... #
#      ##**..\# *#
#       L ....\ ##
#       # *#.*.R #
#       #\# #\ *##
#      #. #  # ###
#     #*\ # #\ ..#
#      # *.##\#.##
#       #\. ##*.##
#        ###  #.##
##################