###################################################################################################################################################################################################
#.\  .*.\   ...\ \ ..   *.***. .*\ .\.\...   .  . .* *.*  ...   \. .*  *   \*** \ \.\*...* \.*.**... *...\ *..\.*..*.*. ... **\.* .*.. **.*. .*\.\*\.. \.**.****\* ... ** \*   ... #              #
#\ \.\*  ... * . \\ .   .*..\.* . . ...* .* * *\.. ..  .**. *\ *..\*. . *\..*\.* ..* \\ \. . ** *.*  .  *...  *.**\* . . **  ..\*. *\\.\..\.\\.**...   .\ .  *....*\ .*.... . .\##.#              #
# **  * \. **\*...\*  .\ *\   ..*. . . . .\*....\....** \.**.*.. \.*. ..**...\** . . .. * .*\*. .\* \.   .**\.\.*. \\. ..*..\.\ .*\** **\..  .* **\*. .. ..  .** ...* .\*      .. .# #            #
#*...*****\.**.\\* .**\. * * \.\*\.    **\* .*.*..\\ ...\*....  *....\ ..\* .*.*\ \  ..\*.\*\.* ...\  .. *\.*.* . *.*..  ..* .* \...* ...*.\. . .*..* \**.* \\*.*. \*.*..\ *    **.\# ##          #
#    \*...\ *\..*...\*. .\.\ *\.** . ..**.*\*. . **\.\*. .\ .***..\* *** *....*. \*  \ *..*..\*.. .  *.\... . . \ * *...*. .\ . *.*  .*\*.\***\ ..* ... .***. * .  ...\ . **..* .... .\.#         #
#\ . .\ .\* ..\*. *. \  .*\*.\. ***  *** ..**.** .*.  ..   .\*\.*... . . .**  \*\   .**.\*.*\.  *.\\ .  *  \\. ..**.. \.\**.   \.*  **.*\*. .\  ...\.\*  ...* * \.*.* . .. .*...**\.*\.####       #
#... ..\*.*  . * *\ *  *.. * ..*.*\ .\.*\.... .**.\.\  ...   .* ..  .  *. ...  *. \*****\*.  ..\.**..* *..\. \.  .\.*..*  .**\*. *. *. \.*. . .\ . ...*.  . .*.  \.*\\\ .*.  * *..**.#*    #      #
#. .\ . . .\ .  * ..** .*.*.* .. .*\*.\.*.. . . .....*..  ..* .. *\* ....* .*\ . \..*....*  \  **..\ .\.*..* .  . *...\.*. .\ . *\*..* . .* ....*.***\..* *     ..*\ . * * **.**. ##*....* #      #
#.\   \\ *. .\ . *\ ..\ *\ .. .\.*.*.*  *.\ .*.. * .\\ .\   * \....\.**.\\ **   *.*.  *. \ \.\ ...* ** *.***   .  .\ \...*...    . \..  . . * * *\.\.**.\.*\....* \ .* .\*\\*\  ***#.*\**.\ #     #
# .*\* *.*   ...\\. \ .**. *... *\.    *.* *..    .\.  . **\ .\ .. * \.. .\.\*....... *\.....*.*  .*\. *\ ... \.*...\  .*. .\  \..\** .. . ***  \* .... .\. ..\ . ..*.. **.*  . \.* ..##*#.#      #
#\ .*. *..*.....*..\.. .* .. **.  \  *.* ..\.  \. *  .   .\ .*\* *\.\ . *   ..*   \*   .\    . *\... *..... \   .\* .  *\  .....   *\ *\  .*.. \ .*.*\ \ .*...\ \  *\... ** \ .\  .\.**.# #       #
#\  *..**....*... *    *\  .*.*. **\*. *  .*\* . . \.*\. . .  ..*. *..\..\ ...**  .. .\.*\..*  *.  * \  ..\* .*** .   ......* \..* ..\.*** ***....\. .... **.*\. .... .. .... *\  *  \#\##   #    #
# ..\ .\*...** * ..... .  *..\****\ . .. ..\.**.*.  . *. .*.*.  *.\..**  .... ..    * ..       ** \.*..** . .\**\.\.   \*..\. .*..\*\*\.*.\*.*  .*\. .\.. .\.*.. *.   .*.*. *..*  .\. \*. ###\#   #
#** * *.**\ **. *  *.\***\* ..\**. * . .*..* .* *\ \ .\.  ..* .. .***. \ ..*   *......\\* ..* ..*  ..\**.....*****.*.\*.*.*. ...*\.**..  ***.  . *.  ..* . ***.* ...\.\* .  **..* *. *. \ #.#*#   #
#*...*.\..  .*.    *\.*.. *.*..*.*.*.  . . \***  .. ..**  .\ . ***.*..*.*  . .\.....*\   .* *...\.*.  *      *..*.  * .\  *\  ...  *.*\ .\  ..* . . .\ .*.*\..*..*\**. \.   ..* .. ... . .\*...#  #
#.***\ . * * ...*  * .*..\\\*. ...*** . .*.  \. .  .\.\* *\ .  .\  .\***\ ** * \..*\.. ***.***.*.\ *..\ * *\ \..*  *\ \*. .*\ ..*\* *...*..   ...*.  * .*\.**\.  * .\ ..\\.  ..  *.\.*...*#.\.#   #
# *.*.**\.   .. .*.\. .  **.*.\.\**. .  ....\.. .  ... .  ..  *    \.*.. ..* ... *\... ..* \*..*** ..  **... ..*....**\.\ \\ .*.\ * ..  . .  .\ ..*\ . .*.\... .*\*\.*. ..  . . .\.. * .\\ . .#   #
# * . .\.\ *\** . \. .\  .**..   .*  *  * .  ***    .\ \...\\..\ \...... ..\.  *..  .\..  ...  \*.* ..... . *..\*. *.\  . \..\  ...    \* **.*.*.. * .*\...\*\  . .***. . *.\ .* **\ * **. .* #   #
#.  . .*\.\...\*... . * .\... ...\.*\   \.**\ .. \.\ *... \.\  ..  *\*\ *\ .\ *\    .* \*.\ \  *. **** *\ *\..*...**  \ \.*..\ ..\*.  .....*. ...\\    ...\*.. . * .\   **   . .\* **\ ** *...#   #
# \.\*.   .   .   .\.\\.  ..\*   *  *\*\. ...\\...* *\..\  .. . *.*..*. **.**  *. * *\     \...*.\..\. ...\. *.* ..  ...  .  .*. **\***. \.* *\ * .*\ *   **. .  ..\ . *\**.\*\ .*.\...*. \  *#   #
#*\**.**\ \.\  ..  *  \ .. ..\. . .** . ..* **.. ..\.\. * .\ \*.* . *.\ \\. . *. .\*.. \  * *..*... .* . *** *...* .. * .\.\*.........* .  **.* . *. .*   .. *.. *....\.*..* .\\* .  .\.**#\# #   #
#. *.\...* .  .\* ..  .*.  .\.* . ..*   \. *\  \.*.\.*\  . .*..*..*  ..  \. *\**.\**.*..  *..  .\  *     **.**  *..\.*\*... .**  .*\\*. .* \. .*\*\*.\ ..  \..... . .** .    \...* .\..\.### #    #
#*. *\.\*.\ . **. .\ **\\ **.*.* . ..\.... . \...\*  . . .*.. *..\.\* *.*\ \. ..**..\.\ * .\.\ \. .\.\***.\ .\ \ ....***\.\ *.\*.. ...\  . .\* .*.*.... * *.*.\. ..\   .*** \ **.  \*...\*.#      #
#*  ....... \ .*.\ .... ..\.*. .* \ *.. **\. *. .. ...\.  .**   .*  .*. *   .* *..  .\\.. * ..* * .\ ..\..* ** \\ . *... \ ..  * ...\ . . .\ ...*\ ..\  \** *\ *. .  .  \. .\** *. ...*. *\#      #
#**.\\* \    *..\..**...* ...  .\ . *.. *.  ...\  .*  .*\.*.. **\.. ..\.*.** ...\.  **..  **.   .   .*\.\*. *.. *  \\ * \.\  .\. * *.  \* * \. \.\.     .\ ..*  \ .\..*.\..*\..*.**   *.\ *\#     #
#***.  ..  . ..**** *.  . .\. . .....*..\\.\ \.**\ ..\... ..  .. \  *\**.\ . *..*. \..\ \.*...    *.*.*.\ *\. \ *\......*...*.*. **.*** * .. \ .*.. \*.  *\  . *.**  ** * .* ...  \.  .\**##      #
#.. \ \..* .  ***.\ ** . .. * *. .\..*..*.* .\ .\*\ \\  .. .\*   .\*\ .. .  **. .  *\....\* *.*.*\.. . *\  .*....** ... . . .*. ..\.*.\..*.. .  ....\. ..\. .\ \.\ .\.  .  \. \..  ***.*.*\#      #
#\. .  .\.\ *\.*\. ..*.*\*. . * *  .\  .*  \  . \*. .\  *.* ..\. *** .    * *.*   .*  . \ \ ..*\ .\.....* ..*. *   ...*  * .*...*\. .*  *.\. ..\..*\ .\\.. \ ...\ ..\ **.**.\*... .... .\*.\#     #
# **.* \*.. .. \.. .**.. .. ***   .\ \*   \ ..  ..* \.**... *.*  ..*\  ** .*.... *\*..*..*. . .*. ..*\*\  * .**.*   \..\ *  ..*\*  ** ...**..  *.... * * ..*\*.  .  . .. *\* **    \    *... #    #
#...**  *. **  . * \*\. . \ *...** .\.*\*.\.**.*. .*R**.**. .**\ . *. \.\ .\..*..***.*\.\....    .*\... *\  *\.\.*.. \..** \. **.. . \. ....\ .*...  .* \* . \.\*\ *.**. \....**\ \.. * .\*\#     #
#  \..\   .**.  ..\.*.**.\*.  **..*\ **...\*.* *\. . ..\.*.\.\ *.  .* ... \.\\..*\.*\.*** . .*. ...*\*\......*  .. \*\.*\. *\ **.*.. .* \..\* \.*\.**** . *.\*\ \..*... .*.\.  ..    \.*\# #      #
#\.. .* ....** .\**.* ..\...  *\*\*  . **\.*...... \. ..* .*.* .\ * *\\.* ...\.*\ ...*\ ..   . .\.\...*.\...\.  **\. ** *. ***.  ..*\ *.....* ..* .*\**\.*** *\..\ .\. .\. \*.**.\ *...#*##       #
# .. **.*.\**\\...*.***\. \ \ \* .   .** **\.* . .. *\.... ..*  ...*\. .   * .**. *.\.. .\  ..\  .  . *..  * *......\.. ..*. .\.*. *.*  \* **\  .\*\\.. **. *  .. \    . . ****\..*..## #         #
#. .\..\\  .\.  ...\....*. ..  *... .\\..\\. .  . \*.. ....\. .*.  .*\.  \* . . . *  *\*.  .*. *.. \.\. ... *\**.. .*...*\*   .** *.*...*\.*\ *. . *\.  .\.*.\ \... .*...*** .. .  * ###          #
#.  . \ .\* .. .*\.*.\\*.\.   *\ * .*. *..\.*..* ..  .*..     ..*****.* *..\ ** *..\.*.. .. .*. *.*\ ..  .. *.\.....* .\.** .. .\.  .*.. .*.** *\  ..*\  ***\.*..\*.*.*    .   .* *\ . .##        #
#* .\*.. *.\ * .* *.    *   .*.. .. .*...*...* . * *.\\ .. \  *.\*\.. * ...*.**\*.  ..   .\ *.  .* *\\ ..*. **..*......  \.  .\ **. ..* .. * *.* ** ...... . ..* .....  \. .. . .. ..    .#       #
#..  .* .\..\.      *. ..*\  .  \ ..\*.* *.\ .*   .*.   *  .\.**.*** .* .* .*.\. ...*  .**.**\..\  . .....   . .***...** ..**. ..     .  . .*. *  \ ....**  .**.\**. .  ..\  . .*  .* *##*#       #
#   . .*.*. .*.* *  . .\ ..\ *.*   .**\..\    .. ..**. *..... . .*.*.   **..** *.\\ * * .*..\*... ..\ . * *. *. . \..*\*.*\.\ **   .    .\ \*  .\*. .  * .\.*..* ..\ ..  .*. *  . .  .* .##       #
#\***.*. *\**\.**.  .. ..**...*..*....** .*\.  \.\**.\.* \.*.  . ...  ...\*.... . **.*\* ...*.\.. * *.**.*...\. .. .\..\. *\.*\*  .    ..*..\   *...*  .. * . *.\  *.*\ * .* *.** \ \#.\.**#   ####
#*\*..* ..*.*.\**.* **\ ...*. ..\.. .  \.*.**\   . * . * * .*\\.\.  ...*..*..*.*.**.   \. * . .\ .**. . . * *.*\ ...    *.\. . .* *. *.  ***  *\*.* .*\*.* **.*\.. ..**    . ..**.     .###  ##.*.#
#... .*\.  \. **. . *   ** . .  ..\  . .*.  . * *..... ..*\.. .\ . \   *\ .*\.  *...**\.   * .\   ..\. ...\ .*. * \.  *\.  \ *.   .   *. *.   **\..*.\*** **.*.*..\.....\  *.  *..*    # ####.#.###
#.*...\.\.\ *.**.*...\ \..* * *.\. \...\*.*. .* .  *.. \ ***. *. . . *** .*..**.. .\. .*..\..\.* *.*. ....*.\.\*. ... .*. ***   \  \* .*\.  \**. .**..\...\. .\*.. . . ..*\. .. *.. ....#  \. .\# #
#\  ...\***.\.  ** * ...*.    .. . .\ *..* *.\.\*. .\ .. .*..*. \ . ..\*  .* *. *.\. .*.*\ ... *\..* .**.**   ...\.. * .*  ***  .\ ... ***\..* \  .** * ... .. .  \.  \ .. .. .**... **  . .\.\#  #
#*\ .*...**. .*..* \  \..**... \.* **\.**.*.* * *\ .*\ . *..\* . .* .  *  *..\.  .. *...\ \. *\.* \*\.\* ...  \ ... .. *.......**.\. ..*.. .*. .\.**.*. .\\*\*\  . * \.* \. ..*.. **.\.*   .#* #  #
#..*\ * \..\.. .*...**.*...*. ..\...** ** \.\ . *  .. *..*..*\.* \ .* **.*\ .   *.. ...\* .*\.  *\.*.*..\.. . *\*.* * ..*..\.*  . ..\. *\ *\*.* **.. ..\. ...\..  .. ..*\. *.*..*..* *\.## \.*#   #
#. \  *\ .  ..\.*. \.**.* ....*. ..... .*. *.. .... **........* *.  . *.***\\.. . \.* .*\  .***\.  ..  \.**   ..*..\..... .. * \  . *..\. *.*. . ..* .\..   . ...*\. *.. ..\ ..\*..* #*.## .\#    #
#.*... ..*. . \..**......  ..\\.\..*.  **. ..*\..*.   .. . *\...*. .. .\..\*\**. ....\... * .\.**..\**.\**.\.\. ..\  ..\*... *\ ..... **. .*. . *.*.**....*.. \**.\. . *. * ...** *. L###\.##     #
#*.. *** ..    .  .*. ..*\*  *\ *. ... .. \.\. .  ..\.**..*. *. *\*. * **..\...\.    ..*.\..   .\.\.*\.*\*..\* \*...**\* \   ..    **.*\*. .\.. .**.**.. ...  ..*  . .*   \*. ... *\*.\# ##       #
#\** *.** .*.\ .*...* \.**..*. *.  .*. .  * .\ \*** . ..*.** *\.. *** .\. .  \ **      \ .  \* .    .*\  **\.. . *.\.\*    **..  . ..  .*  *....*\...* ...  ..\.*\*** .*  .*.\... *.\##           #
# ..\. .* *\...*.*   . *.*. .\.*\  \.\.   . \.*.\ .\  *...*.\*.**\\ \* .*.**..*\. *.*.    .* *. *  . . *..*.*..\*... *.*\\ *.*\.*   \ * * ...**\..\.** *   . .\..*..\*.. . .. .\**.* .#           #
#**. \. . *.*.\\ *..***.. *\..*...*.\*\..   \**...\*. . .*\.* ..*.*...  . ..  \.* \* .\ *. .\. *...*.**.... * ....\ ** \*..*.*. * ...**\.. . ..*.. *..\*.... .   .\**.*. .* *   .\*.**#           #
#\*  .. ...\*..*. .*.*..\.... ..*. ..*.*.*\ .....*   * ..\ .   \\*\.\*\.*. . *. .\\.  . \*\* \*.  \ .* * .  \\...**  .... *. *.\\..* ...\ *\  \ * *.*. \\..   * *.*...  . .\.\. .*. *.#           #
#**   * *..*..*.. . .   * . .\  . .  .\ * * .    ..\**  \**\   ..\*  \.\  **\.\. . *.  **\*...*\  * *.*   . ...   .    *...**. *\ ..*.*\ .*.  .*.*   . . *..  . **...  *...* .* ..* ##            #
#..  *.\ .*\*\ .\   \.. .\\** .\. \   * .  \.  * *.*...\...*. .\\. . *..\ ..\ .\ *. .*\.**..*. ** * . * ..  ..\     \*.   . .  *** \.*..\ .* ..*.*  *.  **.   \ *.\    **\.*\  * . #              #
# *.*....\\* *. .*** ***..*\* * *. .**\  *\.\ ..* .\ **.....**\..**..\   . .*. *.. \ ......\. ... ... * .. .. .***\..*.\ *      \\\. \ * * .*  .*\ **. . \. .*.. .. ..\. \*.*.*.* .#              #
# *... ..  .\*****.. ... .... .*.. ***  \.. . *.*\ *.. ** .\*..*. .. *..*\\.. **.\...*** .*\*.  .\  ...* *.******\.**\ .\.*. ....  * ..\.*  ..* *. . \ .*. *  **\*. .. \*... .# ..\#              #
#*  . . **** .*.**..**. *      *.. ...  ..\*.**..  \.  \*  . .*.***  *  **   ..*\..\ .*.\*. . .\\. * \ ** *...\. **.*.  **.*. *\  **\.*\*..\ .\ .\ *.   .. .\.\.\ .* * ..\*.\ \* \#               #
#. \ *\ .\ . *.\..* .* .\.*  ***.** ...  . ..\.  * .* \..  ....\*.*.\.**.* .  ..*\.*.   .*.**    \..  *.\.  ..***   * *..\ .. .* ..*..*  . .\*.*\*..*...  *.   .* \.\**. .*.  .# *#               #
# *. ...**   * .*   \. . .*\.*. \*\ .\** \ *.  . . ***. * .. *\ * .*. **....  .**  \ \*  **.** **.*\  *  . *. \. \.. *.. *    ...\..*..  **\.\*. . \.\..  .*\ * . **..** *.. . .*##               #
# .  .\*.\.*.\ * **.   *\*.. . .  **. ..\. \ *.  \. **..\.   *.*. ** \..* \.. *... ...   *.*  *\.\ **. .***.  \* . **.\  .\.\   \....*\...\ \*.\   .\.\   *.*..*.  ... * ..\* *... #              #
#\  .\* *.*. *...** \* . .* *. *..* .*  .  .\..  .\\.\..*...\*.\ **. .  * ... * *\*.*\   . . *..  .*. .\*.     *\ ..*. .* .*\. \* * ..  * ...\.*  *.. .*...**  .*.* .... ...*. #* #               #
#**.. .*.  .\** ....**   ..  *.\* . *.* .. **.*\  *.. *\*\\ *\.. \..  *.      .  .\..*.     ....* ..*\* ..*\  ***   . .*....* *.*.**.  *   .* .. .\*\... .**.\.  ..\. ****  .*.\# #               #
#*.*.. \. * *\.* ...*..*    ..*.\.\ * .\..*..**. .. * .*    \.\**..* . * ..*  \* \*. ..* \.*\ . ..***.  ..\.\ .\.\* * .\\ . * * .*.    *..\..*.. *  ..\*  ..* * .... ..*.\.* .*.  #               #
#.**\ \..\*  . .*...*..*\*** \..   .*. ..\.\.*\  *\.\ ..**  .* .*.\* * \\  \.\ ...*. *.. * .*** **..\...\\... *  .* . \.* *\ \** . ** \*.*.  **..* .*\**\.\.*.\ .\. .....*.* \*  \#               #
#* .   ..* .. **. .... *.*.*\.. ** **\* . **.*. *...*\*\\.\.. . \ * **.   ... .\.**\*\.\.\\*.*\   .* ...*..\  .*\*..*..***.\. *\.\..\  .. ..*. \ . *.. ** . * ..\..*.*\.*. .*..*.**#              #
#.\.   .*.\  .  .* *  ....*.*.*. \*..* \\.*  .* *..*. .*...... ***. .\ .\.** ..  \.. ** .  .. *.*    *. ..* **.... .. .  . * .*   * *  **\. \. *. \ .\*.*  *. .\ ....*.*.\.*\.. \ \##             #
#. *.*\..*    ....    ..* .\*\\ . . \  .*.* *....   \.*\.\. .\ .\.   .*..**\  *\\.*  \.\.. .**. . \ \ .\ *\ ..\.\ . * .*. . \...\....*..*..   *\**  *.*.*\  .***  ..*.*....\...* ..\.#            #
#. . ..  *\*. *..\****.*....*.  \..... .  .*\. . *. *.**. *    *. . ..*.. ... . .** *.*   * .\..     .****. *\. . . .\ ..\ \. \  *..* .. *   ***..  *.***. ...*\ * *..*.. ..***# ...*#            #
#. \  *\*.*....\  **.* .. .\*. * ...\** * .\. \ **  * *.**\ .\ ...   \\    **. \.\. .\  \* * *\.. ....*\.. \..** * ..*\*\.*. \ . . ** .* . *.*..\ *....*..**.*. ..\*  * * **.\* ***\#             #
#\* \..*...*. .   *\   .\....  *   . *. .*.*  . *. * *.\*  *\ .*. .\.. \*.... ..*. ..  *.  \ .\....\* ** .*.\* *...   .\   .\.  ..\... *  ....  ...\ *** .*..*... **. * .**\.*\.*###              #
#*... ...\  **...\....  *\.**.*.. *.\.. ..*. .**\..* .. .\*..** **  .*  *.*\  \ *  ...*\..*  *.\.\*.* *......  ..*. ***.*..**... \**  **\ **\*\...... *. .* ***** .* ****..*.** #                 #
#...* . **....  ..*  .*... ... \ \* . *..* .\ *. ..*.*\ * .. *  \.\* *  ..*.  .\.* .**.*.. \.. . .. ...\..   . \*..*. .*. \  ... ..**\*.. .*..*** **.*\***\..* .*.  .*.\ \   ..\#                 #
# .**.. **.   *.* *\ ..*. *.....  * * * ..**.  .** .. \\*\*\ \  .. \ . *\ *.\    * ....\.   \\ ..**  .    * .  ..\... *. ..\\*.. .\.***. .*..*.\..\* .**. *. .*  *   .  *..\ ..# #                #
#  ..\...\. *..  .*. .\ . . .\...*\   * . ***   ..\*  .   .* .*\*\   \...*.\...**\ **\* * \*.*.\.*. .. *..*. \ \*    *..\.\   ..\  .*. \***  .... *. .\   * . \*.*..\ *\**.  ...*#                #
#\. .*  * .\..*..\.*.*. ....   * .\.. *\***.** * **.*  . .\   *... .*.\* .  .*.\.**  ...* ...*\. .    . *  .* *. . ***.*    ...**\.*. *... *. * \..   . . .*.\.... .. . *.\  ##\#                 #
#..*... .  **..*  *. .*..*. .\* .\ \.\.**\.**.. *....* *  .\.\\* .\ *\*..*\. .\.**. \.*..  ...  \ ***\ ** ..*..  \ ...**\..\.*.... ..**. .. .\ .\.. .. * *.   .\\. ..\*.*....*.##                 #
#..**    **** **  *.*.  *...  \.* .\*.*...*.\.\...   * .\.* ..... ***...*.*  \. \. *..***..*. *. .*..*.\  *\\*\\ ....\ . . ** \ . . \.* .*..\.\ * \. . *.*  .   *   **..*.\ \#** #                #
#. ..    . .*\\* \.***\ .. *. ... . **\*..\  \ *.* .*** ... *\**  . *..\.. .* . ....  . .  .*.\.. ....*.\ \* *.\ ...*.*\..  ....\ .*.... \ \.  ...... ..\\* * ***......**\. #* ##                 #
#.  * *.*.. * .\** ..\.  * .\ *.. ...*..  *    .\. * \..\.. ..\. .\***..**.\.   *..*.. *. . *\ .*.  ..\*.\..*.. .**..*. . ..* *.***\  *   \*.*.. .\. ...\ .. .**..\  . ...  .*##                  #
#\.*.\*****\.. . * \ ..  * .**..  .. ..... . .  ..**..*..*  \   . .***. ..* * ........    * ..\  ***  ** *.\* . *\.**\.\ .  .\\ .*... ..  **\.\...\  .*..*\*. \* *.\ . \ *.*## .#                 #
#.*... ...\ \.\ ..  .. .*..*.\  *..\..\* *.\..\. . **. . \  ..\.   .\*.. *. ..  ...*.*\*.*.*\ ..**.\...  .. *** . ...   . .\ *.*.  ...\*.*\...\.*\*  ..... *.. .\ \.. .\.*  \ .\#                 #
# .. *.*  * .   .\  \***.* \\*..\  \.* *\.\. * **.   *.*.  *  .  *.... \ .*.. *.\. \ *..**\.***\..*..   \.*..\.  .... **\\ .\ ....*\*. * \.. .  \** .\\*\ *.  .\ \ *.* * \ ..#.###                #
#\ . ..\ *\*  *. .  ..\.\ *...  ..*.\ ..**.. . *.*\ .*\ .  . *  *. \ * *. **.\ \  .. *  ..*\..... ..\ . .\*\ **. *\..... ..*...*\......* ..*.. ..\*\ .. .**.\.*.  .\ **..\*.  ....#               #
#..*\..* .* \.\*.\. **. ... \.* *. .. **.  *..\..*..*. *. . \ ...*...\ ..*.\ .\.   *...*.*.*.\ .  \   *. * **.*   . \  . **.***\...*. *\*  *.\.\ *.    \.. *  * .***.*\.* .* *\.\#                #
#\ .** . *.*\     * **\* \*.. ... .\  *\..**.**  ....** *.*.. .  . *\*.\*.. . **. \ *..*.  \  . \ .  . *.. ...**\* ..  \.\.... ..*..\.*....  * *.. .* \   **\.\  \.*.*.\.*.**. *..#               #
#\...\  ..\. \*   .*....*...* * \.......\* *  .\ *.**. \... .**.. \..\ *\  . .  *.....\.  *\.*    *\*  .*. .   ...*.*.   ..\. \ .*  *..** \  **....*.   ....*\   .*\... .....*\#*#                #
#**\\.*  \ *\.   *.\  * *.  .*...*  ..*.*. *\* . .*. .\*.\.\**.  \ .\..\.   .  .... **... ...* *.  *.\\ . .    . .**..*.. .* . . **\..*.*..*. *.\   ..*.   \*.*.* *.* * ..  *. *#                 #
# ..\*. *. \**.. .\ ***  **\** . .  ...    ... ** \*  ..*** * **.*..*  .   \ .* *....**.  *..*\\* \.. .**.*. .. .  *. *. *   ... *.  \....*\.*  **..**.*...* .. ..*.* *...    .#                  #
#. .*.**..\*.**  *...*.\ ....\. .  . . **\*.*.  ..... *  .. . *. * \.*.\ \\..***  *\ .* . ...  \...* . *.\.** *.\ .*\..  .*\.  . . ** .*. \.\*.*.\ .**.\*  .*.*.\ ***  .* *.*.#                   #
#.  \  .*.*.**.    * ..** * * .**  *  *. *\*\* . * .. . *.**.*. *.\.\. *..\.. \*.**..\ ...  .. . *..\  .   .\      ..\**.*..* \. ** *\   *   .*\.*.* .\   \*.***...\. **. .#\\#                   #
#\ . .****. .\ ... . **..** *.\*\  *  *.. .*.*. .* \\ \.**** ..\*. . ..\*. *.\ . ..*\ . **\  *.\\.*.**\  .*  .\ **... .*....* . \.* *.*\ ...\.* .* .  .\ *.\ **.*\\ .\... ** .#  #                #
#*.**\..*.  \***..\  ..*...*.. ...***.*\..*\..* \. ..*  \....*\*..\.** \.\..\ \ * . . ... * . *\  .. .*. . .*.  \\.* .*\ *  ..\...* .\.*...*. . .   . *... *.*\.**.. *.* #*\* *##\#               #
#. .*.  \ \ *...**.\   *.  .\\.*. \.*  * ...* .\ ..**...\..***.*.****.*.. ..*   \  * \   .  \ \ ..\  *.*. \. ... ....... \\....\ *\ \* *.   \*   . .  ...  .*..* \*. ..\***.. .** #               #
#\..*  .\ ...\\ \ *  . \.   .\ . \.\\\ . .*. \..   .\. *\.  *. .*...\ . *  \..**...  .  *\ * \ . .**..*.\   * *.\ ** **.   *.**...  *.\.\  * .\..    . **.. **\* .*.**\*.*\...###.\#              #
# . ..\.   * \    *\.*..\. \ .  .\.. .\.**.\*.\   ..*  .* .\.*\ ..\\..\*..  .\*\ * . \*.**.*\.\ \.... .*  **..*\ .\  *\*\\*.\.*\.\**. **.. *  . *  *\*  .*\...*..\.*.*.\*.. . **# .#              #
#*.\. *  . .*. * \.*...*.* ..*.. .\.**.....*. *. .  *\  ....*....  .    .\. *.*  * *\ **.. . \   .*\ .*.\...\ .\ .   ...    ... ..\*. *.\*..\ \...\**.  * ...*. .... \*..*    #.. *.#             #
#.   *** .. *..*   * .*. . \.*  \** .*.  \*. \.\ *.**...**.\.*   *.  ..*.***. * . *.**.\..    \*. .* ***. *\. \....***..*..  . *.. *  *.**\. *.\* ..*\  . .\..  . *.*.\*\*  .. ..**#              #
# . *.\.**. * ..*\*  *. .* .*\*\   \*\   ..\**...***. \ .\\...*\**\ ......\.\.* **.*.\*.  ..* .**\ ..\.*\\*  \...*\*.. \.. . \ \.  .\.* *.* \* * **.\. \ **.*\*** *.  **.\   .\.##.#              #
#.. \ ..** .*\  * . .. . . .. * .** .. *\....*\*\... ..* ..*...*.\. ..\  .... .. ....*..* .*.\ ...   .\.\** ..**\.\.  .*..*      *\ . . .*..*. \  \* \.. .*.\. *... \\.*   .\* *##*.#             #
# ..\. ***  .*\*.*.\\ \**\. . . \.  ***..\ ....**\   *\ . ** .*.* ...   . *\ *\ ..* \**\. *. ... .   * \ *.*.\** ... *\.*\*\ .* *\ \. \  .*..  ...\.. * . \\.\ ** *... . *. *\..# ##              #
#\.  * *..*...*....... ...*\* ...  .....   **. . ........* .***.\ .  *****..*...*.....*. *..*.   *\.*.  .*\.. *.\   \*.*.*. .... . . *.* *.*. *  . . .. \..  *\.**\ *.\. ** \*# #                 #
#.\**..* *.   *. *  ..   *.* *\.. *.  . \ * ..  ..*..** . \..*  .*\ \..* *.**\..** . .*.. .*.  \ ..\.. *\.    * .\*\..\. ***\ * *.\ .. * \ \* . .   .. ..*\.\.* .\ .\. .#.* ###\#                 #
#\.\.  **.  . ....\  \\**.*  *. ....\*. .*. *..\. .\. *..*..*...*\ * .. \..\. ...... *.*. ..\....\ .\* ** \  .\..\.* \**\**** . .*** ..*..* . . ..\**\...**. ...  ...   #*# ## #                  #
#\**\ *.\ ...*\.....**...*\... \.**.*.* *..\ *  * * \\.  . \.  .*. *.   ..  * .\.  . *.*\  *..* *.*... *.* ..\* * \ ..... .*\.   .*.* . . *\* \ **..   .*\* * *.....\ *  .\ \*#                   #
# \**.\.*\.\*\... .*. .... *** .*\...\**... .. .\   ..* .** *\ **. .\....  *\\. .*.   .*.  \.**\. \*.*..  .**.* . .. . \.*  *  *.\* . ** .\**.. * .*  .*...\* ..*\..\.*##.####                    #
# \...*\..*.*** *..\  .*.\ *.. .. **.*\*.  *.\... . * **\ \....***.  .... .. *.. ...\*.*...*.*. * ..  \*\ *\*\.  ...\.. *. .*\.* ..  ..* .*.*. . \ * ...\ .*  .\** .#..  #                        #
#\.  *.*...*.*.*.\... ......* *. .\.*.**.*\... *.   *. ..*. .\ ...\ \* *  * ...\\...  .*.*.  .  . . .\...\.**\. .***\  ..*.\.    .\ ...\. * *\. ..   *  .  * * ...*.\*. \ #                       #
#.. . ..\  ... .  \*..   * \.\*\* . ... . *.. **  \.*  \..*   \ .  ..***.*. .\  *\**. *\.. .*  .    *..* ... . \*..** . .*\. .*.*... \ .* *\. *\ * \ * .*\*....  .  ..*### ##                     #
#.\** * ..*  .  . ..*\.\ \ .... * *.*.  .... *.   .\.*..\.\.      ..*.*...*... \. .......  * *. . *.  \*   \\ \..    . . * \\*. \ .* .\** .*\*.* .*. *\.*\*  .* ...* .. .*#. ###                  #
#\ ..  \.\. .   .*. .. .  . .**.. .*\.\*...  . * . .  *\.  ....*****.*. \*\ *\.. *.  . \*  .**.   .*.\.   .\.. .   .   * . . \* . *\ \ **.\*\     .*  *\..* .... .\\ **. .*.\   #                 #
#*.**... *  \**.\. .\  \ . .\... *\*\  *\ * * \.*\. ....*.*...\...* *.  ...  \.**\. \*. .\.*. ***.*.* ....*.* . *\...... .** *.\*.....* *.\.   .. ... . . .. ....*.  .*\  *.* * .#                #
#. ... *.*.  ...*..\...*  ..*.*\.  *. ** * . \.\..\*.***.. ... *  * ** .* . \.  .*  ..  .  ...\\.\.*....  *.* . **.  * .. ..... **\  ..\  *..**.*\  .. .*  * .*. *..  .****\.  *#                 #
#\... \*.*. .*.\... *\..  * . * ..*\.*.\.. .\.  \..* ..\ *.\   \  . .*.*......\   ....* ... * *.\. .. *\****.\  ..* ...\.\..*. . . \\\. *.. ....\. .\*  . .* * ..* \ .*...   ###                  #
#\ \*\..\.* .  .. . * \.  .    .* .\.... .. .*\. * . . ...* .  ..**  ...* .\  ..* . *...** .* \.. .**\.\*.*\ .\\.\..*\.\    *..  .. \** .\ ..\...  *... \  *. . *.*.\*.**\...#                    #
#  .. .  \.*   \... \ .*.*...*. ..\*..*.**.  .* **\ ..\   **.  .  .\\*\..\  \****.  **....  . .**.\..*.*..*... .. . ..*... \* \.\.\..\. ..*.*.  *.  *.. .  .*...... .*\ \*..**#                   #
#* . .  *..\  ..\.\*..*..**\ .* * ... *****..*. \.*..\     .   *\ ..\.*\*.**.\*\.. *.. .**  . \*.  ..**....** *. *.**\..\*. \..\.*** .. *\*..   \.**  **. * ....*. *.**.# # **#                   #
#. *  \   * .*. .\ ..*.* .**..* \*... *..*..\.\ .*  . . .. .  .\.*.     *.*.  ..  .  *.\*\ . . .. . ..*.\..\*\.  .\ \ \\.  ..\\.. .. .**..... *\.**.\..\. . \....* **..\*\.*#*#                   #
#... . . .. *.*..\ \ ....  .\. *..*\  \\**. \ \ ... .....** \.\..*. * ..\*.**\  . .*.  *.**\.\.. .*\.\* .*.** *    *....**. *. ... . .\.\.   *..\.* .** .* .\.\\ .....\#..*#.*#                   #
#..\ *.. ..*..\..\. ......**.*\  ....*. ..\*\*...*..*\ *\*.*.. * .. **   ....*.\\  \*.*\*.\** *\..* .*.* ....*.  **.\.*..... *  * * *. **. . .......*.*.*.. .*...\ *   \\.*\#*#                   #
# * \*\*** . .*.* ..\*\.\. .\....  . .* ..****.*\* ..\\* ***.*.. .* .* .\.*.*....\ ..*. .** \. ***\  *....\ \*..*\.. .*  .  *.. ..\.* \\.\.*.*.*\....\...... \*\..** *.#. . \#                    #
#.. .*. ..  *.*.* *\ .   ..**\.\ \.*.*  ** \.. .*\  **.. *.**\****.  .. ***... **  * *.*...*.\ *..  \.\ ...\.\.*....**\.\   *. .\   \* . . .*.\* . \*  \* . ..**  *##.*.#*  #                     #
# *\*..  .*\. . . . *.*..  .\  \..\...  ....\.  *   ..*. **.\.*.   *   .** ..* .. \.**. \...*.\  \*\. .  *.**. \.*. *.*...... * .  . .*.  . ....  ..*\  . .. *.*.. \#\.\*#\#                      #
# . .*  . *.\.\*** ..*. .\ *.\ .  **\  * ** ..\\* ..\ *..**\.*.*. *. * . .\**..* .. .*.  *.  **..\. . ..* \* \*\\....    *   *.. . .*\\ .**** *\.*. \  .  *    *\\.. ..## #                       #
# * *\  *.. \. *..*  .* * ..*\ .**. .. \..* ***..* ....*\  *\**.*...*.\. *..**.   *\ *  ..*.. \\ . . ..\.. .*.**.. *.  **.  *  \. \...\**.*. ....\.\ .* **\.   ** .\*\ #                          #
#**\. .\ *.  \ .**.. *. .  * . ..\\ * \..*. \.*.*. *\ \* .*. .* ..\ .  .  *... . ...*.. ..*\.\.**.* * ..\ .*.*.*\    *\.*\. .\ \. .* . .\*..\ .*  .*.*.* ...*.\ ***### #                          #
#*.* .* \* \*   *. *.. .****.  ..*\  \.. \**. . . . .\..  .\.*.* . * .. . .  .. .\ .\**. *. ..\ .   . .\  .**... ** .*..*.* *... \** .. .*... \*  .*.\  .*.. #.\..* \#\#                          #
#*\.. .\ . .\ .*. ..\.\. ...* *\*\ *... \. .\...    . **. * .*\ ..\.... \.*\   .  . *. * *...\. * \*.   ..\.\ .  .\ *. *\.  . .*..\.. \*.** *.*. *\...\. .. * *.\#\ # #                           #
#..*.*.*  \.*\**.  **  *\.  *..  ..*\  ...*\  * * ..   *. . ....* .*  .\.*  * *..\.\.**.  . .** ..\.. .* .. \.  *.*.* .\*\*\    \..\\\......  .**. \  * *\ .** ##*# \#                            #
#**. * *. . *..*.*... **\* \*  .*. .* *\ .\*.\* *\ \* *.*.* . ..*  \....*..*.\. *. .\*. \.* *.**  ...  .***\*** ** .. \ ...***\ *..*\.** *.* **..* .... ..\ .*\**\.##                             #
###################################################################################################################################################################################################