##########################################################################################################################################################################
#..\**. .\.\ ...*...  *.\ *. \....\  ..\  .. *  .* * *. ** ..\.\.*.*\..\.*   .*..* *.\  . *\. \.*\*** .** . . .*\ .\ .**  .   **\. . \. *.*....\*. *..  .  .  ...##      #
#* *..\  .\.* . .. * .. .*.* ..  *. .*\*\. . *. *..* .\\*.. .. *\.*  ...*...*..* ... . * *** * .. ..*.* .**  . * . .\ *. **  ..* . \*.**\.*.... .\  *..*...*\*.\ *\#     #
#* .*. \.\.\*  * .\*. .*...*.*..**\ .** ..*  .  . \\.\*.  * .. *  *. .\ .***  .*   \. \**...* ...\\ ****.*\ *. *    **.\.*. * . *.*..*.* *.*...  *\ \* *.**.***. \#      #
#\.*. *.**. . .\ . \.\*.\ .\ * .*..  ..*\.\.  .**.   . *  ..   . \* * ..\*\*\ *\. *.   \..\ **\ ..\  \**\.*\.\ ...\ **.  *. .\*.\ .\..\* . .*\. .* . .*.\. .#  *.. #     #
#.** *...** \* \. *.. *\* ..... *..**.\.... \.  *\*... *.\*\* .*\.\ *  *..\.*\.....*.* . \*......\*  ... *. .\.* *. . .\. *\*.* .* . ... .* .    .\*....*\.**  .*..#     #
#....*. ..\...* .**    .*. .* *.\ ... ...*.\... \.*.  \..*.*.  .* **.   *\ \*...*..* .\*. ..*. .\.*** * ..   *.. . .\. .  **..* \.. ..\\\..\ . * . \ *.*. . *.*.###      #
#. ...    ... .\\.. **... * ...\  *...*..*..* ...*\.\ . \.**.\. * ....**.....*\.. \*.\ ... .*  **.*.* \  *. ..*.\... .. . \**......*..**\  ** .* .     ...  ...*##       #
#\.** .\ *   *\ *  ..*.   *\ .*.\ . ..\*... .* \\. .*\.. **..  ...\*.*.. .   . \  ...\.\.\\ \ *\.\\.**  \.**.\ ** .*. . *\ .. *\*.*\. .*.*...  * \*\.*\.**. * \#\\# #    #
#..*.  . .**\*.*.\. .. * *    .\**   . .\. \..\... ...  .\ \*.     .  ..\ . *... \*. . ... .* .\* \\..*   .* * **.*.** * .  **..* . *  .*. .. * \* ...*\..*  \# *..#.#   #
# ..\ \. \.  * \* *..... .* .\*.\** **** .* .\* .\...  .* .*. \  ****\.\..\ \ .\ ..\*  * ..*. . .*...\  .***.\  * . *\.**\. *. .\ .*.***. *\***\.*\.*** * .\**\.**\  #   #
#.\\*    * .\* .*..*... * *....\ *\ ..\\.\*....\...*\. \*\**....\  *. *.  ** * *.* \*. ..*.\  .  .  ***..\\**  *.  *..** *  ...**\*..*..*\. .*.** .***.*\.* ...\.*#.*.#  #
#*  .**. .\\..\ *.*....***\*.   ..*\* *.*..\* .*.. .........**  ..*.\ . .**.\. **.. .**..... . \.*. \ *.   .* .*..*.\**\ ** *\ .***. ....    . . . *\*\.*   \*...\#*..#  #
#.  \..  \**.\ *.*   .*.. .\..\. .*  ..*.  *.  *.\   \.**..*.**. \ **......\..*.. * *\**..** * ..... \ . **  .\.\*. ..\*..**.* *...* .\..\ **\  \. .*. .\ . .*.*.*   *#  #
#.. .* **  .\**\ ..\ .* . *  ... *.\  **\.\.*\...*\* ...... *... \ *.**\ *   .*.  * ..*.  .* \...\ \.\ *. .\*.*\.**.\ \.*.*\. \\. \   . *. *.**\    *.\  ..*\\** . .*##  #
#.   . .\*\ * .\\ . \..\ ...*. .  .* **.* . *...*....   . **\* *. .\ .\*.*\.* ** *.* *. . \*.**\..*\.*.\.. .**.* *.*.\. ..* .\ . *. ..\ . .**.....\ .\**\.#.*\....#*#..# #
#\.**.   ..*.\** . . *.\. .* . *\ *\*..\. ..\..\.**..*. .*....\** *\  .\.* *.. . ... *..\ ..\**.   .\*\ . ..** . *\. * . .. ...*.\.....\   . \* . *.\. .* ..* \..* ..*#  #
#. **  * .*. . . *.**\**\. *.  .. **.*\.*  ..*.*\...*. .\.\** .**........*.. \*.  . *.\..*\* *. .\***. .*  ...\..*  .* .  *. \.. .\ *  *\. * \   *\ ...**.***\#\.###\.#  #
#..*\**.*.\  ..* **\.\.* *..   \** \*. *..   ..*..* . ... \.*...***. \ *     \  . *\*\*.  ..  *  .\ ..    \\..\ \.\\*..\*..\ .  \.  .  *.*.\*. **..   .\#*\*..**#.##*\#  #
#\\. .\..    .*. ....*..        .\...*\  . *\..*..\ ** **.. . . ... * \.\** \..*.\** .* . . \ .*.***. .**...\\..\.* \* ...* *\ ..*.**.\... *. \*.....\. **..*... *.\##   #
# .*  ..\.*. .\\* .*\.** . ..\.. .*.*.. *  \*  ... ..\ ... **\ .... \ . .\.* *..\. .\*  \  ..*.\ .**  \ .   .\.. ..*\.\. \...*\. .*  .*.  ..* ...*\ .   \*\.... *.# L##  #
#\ *.*.  .. .** \.\.**.\ .\  . .**\**.\  .*.*   .*...   **\.\. * ***.*.*\*.*.* * . .....\* . *.* ...\*. \ *\ * .   .  *.... \. \\ .*. \* * .*\.\...* .*\ ..  .\.. * #..# #
#  . .* ...* .* *. ..** .*.*\ \\*.*...... . ..     ..*\...\. **. . \.. *.\ ... ..\.*.. ...*..\ .. **...\*..\ *\*. *  .. .*    ....\**..*\* .\* *\. . *.*.**   *.*.  # ..##
# .** .  *** \ *.  . *   ...\ .\  . \. ..  . .. * \ .*....  **.\* ..* *.*. .  .* .\.     *. . **\* .R* ***.***.*..  *  . .*  ... **.*.*\.* *.\  . * ....*...**\.**..*\#*.#
#.  .\.\ ..\...\  \*  ...  . *\ **....   * \  * . .*..*..    . *.  .. ..\\ .\\.\.*    *.**.*\*...\ .***. .*... . \**.*..... . ...  ..\ . *.\*. .\*..\*... *.    \\ ### ###
#.\.*. ..  ..*..    \   . ...**  . ..\\  ..*  . \ .\.*    * .* ** .   * . .\\**.*.\*\ * *.\*\.  *. ..\. .\** *  \..*..  * \ .. . \.\**.**. * .*\ .** . *\...\***#####    #
#. ..*..\ .*.** .**...****\..    * . . \\. .*. .*\ *\. *. ** * ... \.*\* .  .* .\\.\    * ..*.\... *.. *  **\.....\. ***\..*** . *. ....*\. .\.***..\ .\..\\. #*#..*\#   #
#  .. *\ .\.\. ... *..  \\***.\.** ..\ . .\ \ *..\ .*  *.*.**.  \ *\ * .\* *.*. **. .\** .*.**.. ..\. * .\**..\*. .  *\*..  ..   .\   ...  *  *.*. ..  **..*\.* *..##    #
#..  *\ . \*.  . ...\.. *.\\* .**. \  . *..*...\  ...* ... \.*\ **. . \ .\. .** .*..* .** . ...  *\*  *\ .*..**\....*. *.*.. .  . *. *\.. ***.*..**.*.*** . . ***\#      #
#\*.* . . .\*\*.*. \ * .\ .\....\..*.** . \ *.**\..*\.\ * ........* *...* *\****.. ..* *    ..*. .** *\ . **\.*.. . .\ * .\... .* *\*  .*.* *.. .*.\ ..\....\ . .* #     #
# * .  * \*..**..\ . . *...* . *   ***\*.  *.*** .\*  . .  .***.. *  *  *... ..***.. .*.*. ..\..*\.. ..  .*..  ..* ... \ *\..  ** .. . **...  **.*. .. .*\.. \   .#      #
# \. ... * .*.\.* * . \..\***  ..****.* ..  .... ..*\ \   ***\.  *.*\.\*\ *.* \*.. *\. \.*. **\*.\\*\.*\  .*.* ..* *. . ..*.  *. ***\ ..\ .** \  .*.*\  *...*.*# #       #
# .*  ..* .*  .*\.\ . ... *\..**.*\.. ... . . *\   *.\*\* .\....*\...\**. \..  .  .*.. ..**.\ ..* ***    *  .\. ..*.  \. ..* . .\.\ .  \.  .. .\.\.*.*  *.\* ...###      #
#.\*.*\\.* * **.  *\* *...\  .\\*..   *  .  ... *.\. ..*. ..  *....\\ *\  *..* * .* **\ \\. * **..   .**\.* * ..\.\**\..\.\*\.. ..   . . .. *..*   * .  .  *.**..*\##    #
#  **. ... *\.*.**. *.... *.\.  ..*\ ..\..*. .*.*   \.\. .\. \.\..\.*.. *\....   *. .   ..*...\.\ *..**.*** \.*.  *. *\.  *.   .  .\   . . .*. . \..\\. \..  \. #* \ #   #
# \..  .\. .* ... .... \  \   *\ . .**  ..*..*...\**..* .\ *\. .  . ..*..\ \ .*.*\. *\*.. . .  \ ...\.*.**.  \.* .*.\*.**..* ** **.** *\.*  .*   ..\.\  . . *#.. . ##    #
#* \*.... ..\ \ \  *..  . ..\ .* **  .* *\ * * * **. \*..  ** * \.. .**\.. *   \*   ..\*..\...* .    .*\  . *.*\  \ ...\. .\ .\ .\*. \*. .\. . . .\.*.. ..**.#\\.\..#    #
#. .*..\  *\.. .. *....*..*.. .  .*\*.* ** .  .. *. * ..*.\...\ ..*. ..  .** . .  .* ..**.. . ..\ * \ .*\ *   .*\* . \ .. *.**..\...* *... .*. *. * .. *.\  .\*.\***.#   #
#\. \.\.* \ . .*\*. \  * *. *   .**\  .*\. *.\.*..\ \. *.*** . . .. ....***.. *.** \ .\ .\   . \...\. *.*.\ * * * \*...*. ***..\* \ ..* .  .. .*..  .  ...*. *\. *##. #  #
# .\  ... . ..*.. .*.. . **\. \.... *\  *.. ..\  *.    .*.*\*  *......  *.. * \...  . *.**\ .  . .\ * .\ .* .*.\. *.. \    . .\..  . .*.. *.**....   .  *..*.\*.\*#*##   #
#  . .  .\* . ..*.\.* .*\**.     \**\ . ... **.*.\. ..* ... * ..*  \ \. . .*\**  ..  *. .\*\.  . \ *..    * \..*   * ...*..  \**   ...* .\.\*\.\ *\.. . **\. .*.....*#   #
# ..*.\*\*. .. .. .\* .**..\** .... *  .*...\.** .\ **. ..\  . . ..\\.  ****..*\\*...*\  *..*.. *.\.. .\ .*.. *..\.* **\. .\*. ..* *\ *  \ .   .. .*.  ..**   .* *.*.#   #
#.\ ..*\  .. ***\* . . ....\*\\  \*\.\ ..* ..\.*. . ..\.\ .**. . ...*.....   * ... *..*.***.*\..\\*....\ *.* .. . .. *.  \* *\*\\*..*.\.*. *\  *.  .*\**.*\* ..  .. .##  #
#  * . *.   \*.. .**\ *.* \.. ..  .\  .  . . * .*\ .  *...*.*.*.* *****.. .*..*\..\*\** *...\..\ *.\\.  ***.\ .*\ *.\*\*..  \.\...*\.\. \*\. .*.*. \.**\\.\.  . \\\  \ # #
#\. .*.**..*... ...*. **..*.\ *. ...*..**    *. .. * * *..*..*.. .***. * *.. *.. *..* ..\  *..\. . .. . \ ... *..*.. . *.* .\\...*.\*   ..\ .*. .\\ \.\  .  . .\..*\*.#  #
#* .   *.* .  *.  *.* ..*.** *.  . \. .\..*..* .   .**\. ** \.*.*.*.. ** .**.  *.. \.*\*.\..* *\*  ..*. . . . .. .* \.*.\ .**\\ ** ..  .\.. *.**  . ..  \\ .   #.. .##   #
#. *\.*... *.\**.\. ..  .  .*.* .*..*\ **..*.*.. ...*.. * . .*\\**..\. . \.*** ...*.* .\ .*..*.... .\. *.*   . *.\. .\....\\.*. .*.* .. *.  *\***.   * *.. . .*##  \#    #
#\ *.\.\\. *..\.\..\*.*\*.\*\ .\ *\.* *.\* \*..*.*.\ .  . \*\**.*.\*.\. .  **.. .  .*\\.*.\\*. ..\ ..\.*\.**\* ....** **.** *.* .*.*\** **..\ ...*.\ *  \*\.*\*#*  #     #
##########################################################################################################################################################################