#####
#\# #
# L##
#**.#
#.*.#
#.*R#
#\.*#
# .\#
#.. #
#* *#
#**.#
#####