########################################################################################################################################################################################
#*..*\.\ ..* ..  .. \.*  .\....* *.*.  * ** * . ....... *.*  \. ..*....*. . * \. ..\ .*..**.*.. .. \.*. .* ..*** .. *.  * .***.*..\... \.   *.. * ..  . \*.*...*\.*\.\*.. *...* #      #
#\*.*\ .. ..  \ . \...\   .  ...*... . . .*\**\*.\ . \  .*. *.. ...**. *.* \*.\ \. . \ \. ...*.  **..*. \.* **.*\  **\ . ...***..** ..... ...*  ..*  . .. .*  **.*..*..*\  \..*.*#     #
#*.  ..  .* **. ....  .  ..** \ . \\*..*. .. \ * .. ...*. .\..   *.\.*  *\..  \..\ \.* * * .. .... ***. .\*. \ **.\ . .\ \  \..\*.. *. .*\. .*\ .*\ . .\. .  \**.*..\. . .  .####      #
#.   ..*\..*.*\   . . .\ ****\.*  .*   . \....*\* **.. ..*  *.***\\ ..  .  \.. . .\..* *\ . ..\ . ..*.\***\ \.**. . * .*..*\.* **\. .*. .... *   *. *\*. .\.**.. \ ... ..\ ... \#      #
# .\ * ... .*.*  .   .. ...*..**\*... *   .\ *. *.*\ .* *. ***..\*....\ * *. .  ...* .\..*.\....\.*..  *** .. ** .*\.*.*.*.. .\*.* . ** \. . .  **. **.. \* \.\  .*.\.\*  ** . #       #
#*..**.\.\.\. * **.*. .\* .. \**.. .\..     *. . *.*\*. *** .*....  . . * *..* ..... *  .* .*\  *\**. *.*.*** *\ \ ** **.\ . * .*\.\.\.   .\*  . ....... . ..\.. .. \*  \*.\ *# #      #
#. ....   .**.... \.*.\**.*.\..  . .**.. .**.** .. . *. .... \*.  **  * ..**\*...  .**. *.... *   *.... .**.\ \  . \.  *\   *.  ..*. ** \ . .     *.. .. * *\..  . ..  \.\  R..#.#     #
#*** ... *\*.*\. .  .*  *** * *\*. .*.* . .*\...  \ **.*  . ...*...* *.\..*  . \  *     *. *. .*  ..*\  ...*.   .  .. **. .\  .\ *\ **.   *.\ .  *.\.* .  \.* \   . * ..**..\ \*\\##   #
#*\*.*. *\.. **\... \\* *.*   **\. \. \ **..*  . *\.** . .\* *  * \. .** . .. \   * *\*.** . ..* ***.. ** *\* . .\*\ *....\..**.*...*.*.**. *.* .. .\*..  .. \ .*. *.\.. \.* .  *. \#  #
#*..*** *.\ \.. . **  . .**...\.  \.* *\*.. \ \  . \*.\ . .. . ***** \.* ..*.. .. \ . .*...\..*. .*\**. * \..* ... **.. . . *   .. *\..*.. \. \*\**.* **....\.. *.** * .*. *. .\*.. \L #
#.*. *.*...\...\ **. .*.*.* ...*.*  *\. ...*.  *.   .. .*.** *.**..*...*\*\** ..*...\...* .. \* * **\..** ..\*  *   * ..... *.\*\\...\*.\ .     ...\  \.  *\. *\.\ *... * .. ........# #
#.* *.*..**. \.**.\.\  .. ** .  \...* ... ... \  \.\*  \*..*.\\.*\\.*  . *\.\ \ *..\***..  \......*\   *\ **.. \.. .\ *.*** *.***\.   .. .*.**\*.. .*     \*  ..* .**\\.\ ..* ...*###  #
#*...  .* ...\*.*   .. .**....*..*.\.* \ . *.. .*\.*.... \*.  *\... . \  .  . \** **. . .\ . * *\\. .*...*\.*... .  . . *.*.*.. \ .. ..*\*. . .* . .. *\.. ..**.*  .*.  . .*.*. ..*\*# #
#  \\. ..\ * *...\.* *  .*.*.\* \*\***.. .. *.* ..*.....*.\.*...\***. \ *\..  ..*..\.*..* * .*..*\  ..\* * **\*. *.* \ .* .\* .*.. *\ *. \  .  .*  *. .***. *..*.   ****..*\\.   ....# #
#\  **\ *..* \****\.*.*.*.. \ **.. ..* .\.  .** \ \ . \.*  *.*.\....* .*.    . * ... . . .. *.*.*. . ...\*.* .*.*...\ *.. ..  \* \. .\.**\\.*. \ .\**.*...*\. **   .\..\ ..*.\  . \ .*##
#..** . .*\. . *\  ...\*\. .* *.  .\.. ..  \ *\ .*.   .***\***.* \.  .*..\.\ .\*\  .*....*. .\. *.** \ .* *. *.\..*\ *... **\*.... .\ *..  *.\... ..\ * . \. \* *.*\    *....  *\ ..## #
#. *. . .* *  ... . .*. ..  ***..*..* .\* . \*.  \*\   .\* . .  ..\\*.*** **. .. .*..  **.*.. \.**\..\ .  *\ .... \ *.\.\... . \ .  ..*.. ..   .. *  .* *\ \ .. *.\*.** **\ \. ..##.#  #
#* \* *\.*\.*. .*    \ .*\.\..   .*\.  .\  *.*. *. .\.*....  *.  ...*...**. \   ..*.\ *\.. **\.*.*..\.***    .\*\ \.\..** ...*. \  *. ...*.. .. ....*..\.....*\.\*** ..*.*.. *\. ..\#  #
#   ....\. *. *\.*\..* .\..** *\ . . .*  *\ .\* *. *.*\     .\..  \..* .*.. ..*\ *  * .*\..*.\...*\ * ..****   *...   .** ..**\**  *.* \**\.  *...* .* .\.\*..* *..*\. .  ** .  * #*#  #
#* ** *.***\ *....\ **.   \.  .*.  *..*. .***...*  ...*. \.\....\ .. .. *\..* .\   ..* .. ... \*  ** *. .\*.  \..*.***\*.. *.\. .. .   ..**. .\. \ . . *  . * ***...*\.. ..  .*.*  #   #
#***.*.**. . . *.**.....\.\*   ..\ .\..*  \..** .    ** \ \* . ..*  ..*...\.  . \ .. *.  .  . . .... **   . .* .* \. .*.*. * ..**\ \ \ ... ... ..  .* \.. .  ..\.\* ***.. .\. * **..#  #
#*.* * **...* ..\*.*...\* .***.*... . ..*. \..... .....\...  ... *\  \*  *..*..  *.*.*\ .. **.    * \.*  . .*.*.\*  .*.  . . ...\  *... . ..\\ .* *..*  ..    \  * *..\. .*... #**.#   #
#.*. \ *.\  ..\ ..\.*.\...\* *.**\ **  \.. .*.\ *\ **..  .\.   *\.\...  \  .*\ ..\\. ..***\ *\.  . *. **\. *.** .\   *\  .. \**     .\. . * .*. .\*  ..\........*. . \**. *.\\*\.\#.#  #
# ... *...... *  . *.\** ..... **. .. \.\*.***..*.\.*\. . .. \*\** *.*. ..\ .*\ \. * \* * *.**.  *.*  **  .*\.\\\.\**. . * *.**.\.. \.\ *..  ..\  .\   *  . \...\.. ...  \\ . .* ..\## #
# * . . \. .\  . .*.\..*\ . *. *..*..*.\ *\.*\ ..* .\ *  . . .* *.\. . .*\ \ \\ .. *. . *\. *..  ....  .   ..\\.\.*.\.* ..\. ..\.  ..*  \\   *  ..*.**.. .\..*.*  \.  \. .* *. ..#.##.##
# .\* \*.\ .*  .  ..  .. \**.  *\  ...*. \. * \*....**..   *  * *.\. .**\**\... **...\...*\*...   ..   . \... * * \.**.* \.**\*.*\ . . .\**   \  *.*..* . **.. \\* .\  .  . **.* \ ...##
#*.. ...\*.*\ \.   * .\ \.**...\.\   .  .*.**   .\ *. **..*.*\.*** \  \ .\..   \.*.*\ . .*. *.. \. ... *....* .*.. .\* ...**. .    *. *.**\\* . *....\. . .** . .  ...  .   *\#* ... # #
#.**  . \.\*.*.*.. \.**.  **  **.* **. ..  *   ....\.\*.*.\**.  .*\..  * ..   \.*\*  \. .\ .... . *.. *.. .**.  *.  **.  *\ .* *** \  . .* ..  **.. * \\*. ..  **\.\ *   .  \.*\ \ ##  #
# .*   ... .*\..*.\.*.**..* **.. . ..   *\ .\  * . * *.\. .   .**.\. .*. *     *..\  .*  .   * \.**** .**.*..*\***. \\.... \.* .. .**...* \  \ *. *.*.. *\ .*. .*.\*  \ * . *...*# #   #
#* \\**.\ .* . ..  \*. .*..\.* \*  \.\* *** *.*. ..\\.**\ ..*...*\***\. .* . *.\*...*\.\ \ \ *\  \ *.*. . .*\.....\  ..  * .\. .*..*.  * ..**.\. \... **.*. ..\.. .**\. *\ **\*\.##    #
#.  *\.* . *\ * . *.\ . . \ . . *.*.  \\...** * .* .  **\*.*.   ***.**  \. .  ***   . ..\ .. *.*.** .\   *. \* . ..**  *****\ ..*  . **.  .*\***.* *.\....\\..*. *\.\**. .\\*.  .*.#   #
# .* .*..* *. *   *. * *\ .   ..  \ \ ..* *..*.  .. **...*... * .*. . *....*  .\..    *...* **\* *.\   \**. .. *.\**..\.*\*..* \\ .\.* ..*.* ....  ... \    \***.**.*.. .*..\ ** . #   #
# *..***\. . ..*. *..*...  \.  \    . * * **..\**..*\.  *. .\. **.. *\  .  ....*.\ ...\*\.*\*. **..*. .. .*..\...... \....\* .  .*\. ....  .. . .\*\.*. *\...\*\.**.. \  .  . ** ..##  #
#\.\.* \\ .\  * ** * .\.\ *..... *\ .**\\ .*\  .*  \* \ \..*  ***.  .**\ .     ... . . .**..\ ..*.*.\\ *  .. . \ \*\.. ..  . .  ..*.\* \.\ *\ ** .\  .**.* .\.*  ....*****  . .. ..\ # #
#.. .* .** *. ..**\  \ .  *. . * \ .. ** . * * .....*\..\.\*  \.\. .\. *   *  ..\...\ .***\ .. .*.*\. \ .*..* .. ** \ .*\ ** ** . * .    *. * ...\.. *\..  ..\.*. .  *.*\..*.*.  *..*# #
# \ .** .\....\\..   . *... \ *.\ ..**..*\.* ...\\.\... .  \...**. .*..  .. .* *\.*.**\**\ . \.*..\ \* .* .\** ...* . ..* *....*\**\*.\*.*...* \. ..*.*.  ..\..**  ***.. *\ ...**** #  #
#*.*..\ * .**....\.\  \.  \..* \.  *..  \.\*\   . \  *.**. . .  . .*..*\  \* \  ..*.*  ...*. *.*\**  .* . . ..  .\.\ \ \*\*\.\*. *. \.    .* . . ..*.**..  .*  **  ... .*\*..   ....\# #
#.*.\**.\ .* * \.**\.*.\  . \** *... \*. .. ..\..... . \.  \.. * *...*. \  .....*.. . *. * .. *. *.\  .* *.. . ** \     .* **..\.\.*.*\\* ..\. *\ .*...  .**. *.*.*.*. \*.** . * *.##  #
# .. *** **... .\**.* .*   \ *.*.*\*.... *. *\.. .\. * ... . \* .* *.  *..* *. ...*. *. * .\ *..\. ***.* \** **.*..\ *. \. .\ ...... .. *.*\..\* . \*\... \..  .. .*.**..\.*..*\.\.#   #
#..\ ..\ ..*.. \ .... *...*. .*... \  \  ** .*.\.\. ... *.\** . *. .*  .  ***..*.*..\*\*..*\.* ..  \.*.. ... .\.* ..***..\ \.*\..\   .. \** * * .\* ...\. .**.\.**..*..*...*\ . *.###  #
#.   \.  \.* .\.*\.\ \\* ..\  ..\.   *.  ..*.**\ .*\.***. ...\*. . .. *.\ .\...\.\.\..*....  * \   *\..*    * . ..*.**.\.. . ..\ *..***\ \.*\..\..*\ ..* .\.*\. .    ****. . *.**..*.# #
#*..*.*. . \ **\*    ...   *\. . \*\..\*  *...\.\** \ ..  **   *** ...*. \    .*\.* ** .*  \ * ..\*...\. .\ \.\.. \.** ..      ...\..\. . ... ..*.** . ***. *  .*.*  *.*.... \ ..\ *..##
# .*. *.** . .*.. . *\. .. *. * . \ ***.. *\* .*.*.\...*\*....* **. *\. .. .\. .* *.\. *...*...*...*\ .  .*.. ..\   *...  . \ . .. ..* \ ..*\*.\.*\. *  ***. .\ .\...\...*\. *...#\#\*\#
# **. . *.*. *  \**...*\.* . .. . ..***** .\* * . . *... .\ \.  \.. .**\.\.*.** \.. .\.\. *.* ** * **\. \. *. . .    **.* .*. *\**.*\*   ..\*  * *.  .\ ...      ..\ * ..**   .. *.. ###
#* .\.* **.*..*. *.\ \ * .**..   .** .*\.   . ... \*..  \  .\..\.    \.  *. **.* *.   *  *.\.\...\ ..*  .\.*. .*  \* \.\*...\..* \*.*..*.\*..\**. . \.   ..*\   \*. **   .*\  #* * **# #
#\  .\ . * **... .    *.\* . *\**... *.*.* ...    *\.. *. * ..\. .** *. *.* .... .\ \..... *.   * .  . * *\\ *.. *.*..\ \..   .. .**.\ ..\.. ...* \ .  .\ .\ \. *.*\.. \.**  .....\..# #
#. * *  .\ \ **\ \ \. \*....****  *.*..\ * ..\* \.\ .** *.. \\ . .*.\*. * ..\   ...   . * .* \ ..*\.\.\.\ .*\.***.\.....*  .\.\\. .***.*.*\ .*.*\ ***.\...\  \  \*\*\  *\.* *.*\ *.* .##
########################################################################################################################################################################################