##########################################################################################################################################################################################################################################################################################
#..  . ****..\**.. .*.* \.\** *.*\.*. . . .* ...\ ....*\ **...*...  .   .. .* .  \.**.*.* . .\ * \ \ **\. . ... ...*\.  *.\ ***. .\*.\ *  .\.*\ \.\. . *. *\.*.**\  **\..** .*...*..**.. *\.*...  ... . . .*. ** .\. ..\** **.*...\ ...**.**\*\*  \ ..\* *.*..\.*. \  \*..**\\. *.*..*.*.#
#      .......*.\.*\* \ . .*\.*.  .*.. *..*  *. *.*.\ *  .* \** . ...  * .**. \... .*\  \ \.* .*..*. \.****.*..*\ \\* .. ..*..\.*\.*.*..   *  ..   \.. .. . *..*\* \.. . ..*\** *.***.*        *. \  .*.\.\.* *.\   *\ .*.\**..*\.. **... .\ *.\ ..\*..... **. ......*..\...*.*..**. #.###
#..* *.. .* *\* ..  . .**\.*** \.\ ... ...*  .*........  \. ...  ...\*\.\....   .* .\ * .*\\.\ .*\.  * . ...**. ...     ..*. .  ..*  ** ***.\. \... .\ *\. ..*\* .\ *\ \ * .*  .. *.. .**....\*\.\   \.. ..\* .  .  .**.. .*. **\\\*.*.** *....*.** *. . .***\.\** .*..\**. \*\. .# \##  #
#\.\ ..**..\***..\. \. .....\ .*  \ \ ... .. **\...**.....\. .*... \..*. \ * .*.\.\*.*. *\  . ..*.  *.\*\.  \. ** ....*  .\.*.*.\  .*.   ..** .  *..\ * *\* ...** . .. .*.  *. \  .\..\...*.. .*.**.*. *  *.** . * **.\.*. .. **.*\.  \ *..  * **..*\  *\ .* .....*..\*.  .. . ..*    #  #
#*. **  . **..\ \ .\..\** .\   * *. *  .  ..  .  ....** *...    \. ..\. * ... .. ..*\*..\\.... *. .*.. ..**.. *..*\ ..* .   ..\  .  *\*. ..\... *.\. \ ...*.. .*.***\*.** *.*... *.. . .  .\.*. ..\.\ .**.*\...\..\ .\ **\   . ...  **.\*.   . ..  ...\.....** *.... *..\\\.*...*\* ##   #
#* *..  * .*** .* *. ..*   .\. .. . *.*. .  \ *\.*\*..  ..\ .. . *\. *...\.. \. .*..*\** . \ *\  *\.  ....\.\**\ ..*.***..*..\.. .  *. ..\..*.*\ ...*..   .**** \.\*.. .. \.\.*\.\  . .\....\.*\ * .* \.* *  **..  .  **.*\ **\*......*. ...\.*.* *** * *\**.\. * ..\ \  *.\*.\...#\#    #
#.\ \.  *\ *.* *. .\ \*.***.. .** . \ \.* \*... *..  \*    *.\ *\..  ..*\.   *.. .*.*.*    ....\ \ .\*  *. . ... .\\  ...*. . . .**\.** ...\.  ..*.*.* \ . *..... .**  .... .*..* *  ....\* . .  ...*.\ . \.*.. *. . \..\*..**.. .**\.. *.*. *.. ....*\ ..\.*. ..*  .*  ...\**   \##     #
#*\..* **.\..\ . .\.\* .*..\. *.. .*.*.*....    \*. .*  .*..**..  .*.\** . .*\ . .... *.  * ....*.*. ...*.  .** ** \* \.**\* *. ...* **.\.**. . **\. . *   ***\  \*.\ . \. **.... \..  *.* . ...\*...*.*\ ...*\ *..* ..\.*  **....**  ***....*.*  .\ .\.*\...\   ...\* . ...*..* *.*#    #
#\*.\* . .*. ..* .* **. ..\. ..*. \*..\ \.*  . ..*\. .*. . .*.  . ** ..... *.*.\. .. \*\..\ *. *****.**.*. * .* .\. *..*. .  ..  .  .\\****.**  .\.\. .. . *..\ \..*.* *.*..\*  .*\ ...\.. . .*.......*..* .. **.\ ..   .*\\.\.....*  .. .  .* .  .*.** *..*.** . ....\ *.\...*\.*.*#    #
# ..\. .*.* . ...\..\*.*\ .... .* *\*\*\..*.*.\ .*...\\ * .....*\..* \.\.\ .* *..\.* .*...   \ *\...\.* .***.. .*. \ ** \ .* .\*.*. . *.. .*\\. .  .*  .. *.\**\. .... *.***.. .   .*  * . \ ..*\.  .. . . ..   ... R\*\.\....\. **. *  .\. .\*. ..\*.* *  .* .*. *     ** *..**\.\#     #
# ..  *..*.\.\..\. ..\.  . ..  *. . ..\***\ \* \  ..  **.\ .. \....*.  ... \*\  \*\.*  ***  *. *..****.\  . \.. \ *.*....  ..... .   *.  ..*. .*.     ..  .\ ..    .. \ .\***\ *.****  .  .*.\ .\..   .\   * .. *.*.***\\ \\* . * * .. . . *.*.*\  ..\.*. .***... . * \ ...* \.\*.# #    #
# .*. *  ....... * .*.\\   .\...  . .. **   *   .. .. .**..*. . \...**  \. .*. *...\.\*\.\ *..\.*.. .. ..* *.*.\. ..*. .*\ *. . *    . .   \*.*\  .****. *..* **.  . \..  ... *.*.**  .. . \.** . *. . ....  ** . * *\..\..\.   **.   .\ .* *.\**.. . *.....*.   .. . **\.. \.L ** \#    #
#*\...**  . . ...\.** .\  * * . .*.\*\ ...\ . *.  .  . .\.*..  *.\. .  ..*\ \  **.** * .. .***.*\.      .. **  . **\. ..***.. \ *.. .*     *.**   ...\.....*. \**.\. \*\ ..\***..*.* * **.  \.\     **.   .  ..\  * . ** . *\ .*\*.* \. ***\ . ..  \.  \. . . **\.\  *\.*\. . .\*.* #    #
#. \ **\\  .   \ .  .  ** \*.\.\ .***..  \ *\**. .\   .  ... *.*.* . .\.. . . ... .  *.. ........*  .\\ \....\.*  * .\..** .*. . . \ .. ..*... ... \. *\. *.*\..... *...\..\ .. *.*.  \.\ .\.   \. *.*... ..     \*   .\  . .*....\.  .  ****.*  . .*** *.  ..\\*    .* \**.. ..\..\*#   #
#  . *. ..*..   .\.* * ...\*.\. *\.*\.\ .. * .\   .  \ \..* *. \.\... . *\ *\ *.\ ..*\ ..*.\.*.**..  *. .\ *.*. .... . . . **.*.*. ..\* . .\* *\ .   *. **.* . *.\ *..* \  .   *.*  **.\. \.\.* *.*.**.  .\\ .\. .***  *  *.\.. ...* *. \\..\. *.   ..* *.*. ....\... .* ..\*..** .##    #
#.\ . \  ... ..* ...\..\.. *   *. ..... . *.\*  **.. * \  . * *. *... \... .  *  ** *.. .*.* .\..\***.* . ..... \.\.. .  **...  .* .* ..\  .*\*.* **.*. *  . . .* *. .. . \ . ..\.*\**.. *.*.*....*...*. \ \   *.  .\. .\* .*\.   *.\.**. . *. . \. . \ . .. ..* *\ ..*****\.* .*#\ #    #
#*.****   *\** .....*.. ..**  ..*.\...**.*\.*.*\\*.*.. .. * *\*.*.  *... \*  \.  *.\...... ..  . .**\.* ...\*\ . \.. \*  ..*  * *\**.*.*.. ***. *\..\... .  .*\..***  **\.* *.   \\... ... ...  .\..* *.*... *.*\ ..**\.*.*\.\ ..\. ..**..  .\.. ....   .\.   .* ... *. ... \ \  *.#     #
#. \\.**.\ ..\\*\*.**.  .*..  .\*. *  *.\.. ...*....* ..* \.. . . *  *   \.* .   \   \\.** .\   \.. .*.\ *.*   **   .. * * . . *.*\* .\. . **\**  .***  *\.  .. **..   *. *.* *. .*\ *  .*. *.* .\. * .*\  *.*.*.\.*. . *.\  . *\.  .  \* .    .  \*\**..*.*\* *\.*.    *\.    * *#      #
#  .*   .. *. ....*.**. . * .  *. **\****  ..\.**. *. ..  ..* *.\.* .*\*.. .*. .  *. . **.*. * *.\* .** .. *.\ .. \ .. .\ ..\. .*\ .* *  ..*..... \.\. ...*....\.\*\*. .*. .* .. ..\.**.\. *..\.**. .\.**..\..*..*...\* \**  ...  \. .. . \  * *\ .\. . *.   . ...\. \*.* *.\#.###       #
#\* .. . .*. ..  *. \.* *.. . ...**.* **.. * .. \\.  .*. * *.* .**..*.***.**.* *\\.\.\ .. ...*\... .  .. .....* * .\.\ . *\.*  ..*  \.   . .   .**\....   . .     *     .. *\   \..*   .  .. . ...*\   *.. . .* **      *..  ** *.  ...*  .**\*.*. *\*\ . . .  ** *.\.*.*\.*\.. ..#      #
# .. *.*  .*..*.\.. * ..*.*.\...*\*.\.\***. *\..\   * \*.\. \*. ... \.. ..*. .*\.. ...*\.\.******.  *..\.** * ...\\ ..*. ***..\.\  ...   ...*.* .*.\. \.*.  ..\*\* .\ *  ..\. .\.\.* \.. *\ .  *..   ..*  ..\ \. \*...*..\. ..\ .  *\\ .\  .***.  ..*.*. .*\..*.*.\*. \** ..***. #       #
#\.. . . . .. \ ..**.\.\. *  .***. * * *.\. ..\..*... *. **. .. ..*    . *.*. .  *   \*** .*** .   **  ..\*....\..\ **.. \..\... ***.\* .\*..\..***. . .\ \  \ ...\ *\* .\  \*\*..\*  .. \  .*\..\.**.*.\.*\. .. *. **..** . .  \.***..** *....**.*. ..\* .*\   .  .* . . .*.  **\#      #
#. *\ * . .\\  \.\.. * \ ***.*..*.\..*.*..* \...\**.*  ...  . .  *.   .  . .. .  ***\. *.. .... *. ** .** ..   *. . ..*.. \ *\ .*\..\..\\.\\ .  . .*.**..*.    ..\. **.. .  ...\\ ..   *.. **.. .  \ *.....* *.*\.\*...**....\* . \.\  ..  *.**.*  ... *. *\..\ *...*.\..* .\. ..#       #
#... ...* ***.*.**\ * .  .*\ .\ * ** *...\. \ \ *.* .. \.\..*  .**\   . .*\*. * .**\.\ .  .**\  * \...  .. .\.\.. *\\ * .\ \. .*. .* . *. .. .. *  ..**.\*  . ..... ..**.   . \* **\.* ..\*.. . * .\..* ...**\ *. .. *\.\...*..** ... *.***\*.\* \**. .*\ .**..  *   \*.\. \  ###        #
#  *. .\ *\.\.\.* *.\. .***..***.  .\*. *.*.\..*..*..\ . .*\ *\. * . *.  \*. \.*.. *   *. *..***  ...*\ ..*.*\ .*\*.  ... *..*.  .\.  ***... *  .\.  . ****\ *.* .. .* ..*.*\ * **   .\\.*. .** .* ** *..* .*..  .. .\.  .*..\ .\ ..*\\.... .... .**.\*. *.. \ .*..\ *.*. .#\. . #       #
#**..*..  .\...*... **.* \* ..*.*  . ** * \. *\** ..\ ..  . .*.. .... \ ..*  .*\**** **\ *..*.\*..  \ ..* ..*.\.*. * \. * . \.** *. .\....\ .* ..\..**\\*..*.*.* * **.  *..\*. *.*  * . \ \.\ * .. * \. . . ...  .\ \.  ...*.. . . *. \\*\*.  \\  .. * * .***.   ..\.#*#. .#  .\..#      #
#.*..\**.  *\*...\\ \.***.. .**.*.. .\. *. *. .. \.*. .\ ****.*\*\ *..   *    \.\.\* .* \.\*.  .. \  ** *. *.*.....*..* . ...\..... *.  ...  * .* **.\.*.  * .. *\ ..*\..   . **..\..\.\*   . . .*.  *.*\\.\ *\\*. \.*.\   **\  *  .. * ** .\..*. ...\   ** *\. \\ .\.*\..## ** #*#      #
# * * *..*. ** . . . **.*.\* * .**..  .*\.*\* .  .*...* *\... *..  .\ . *   ***....*. \..*.\  .. \.. .**.. .*.   ..*.*..\. \ . *.* *\*.**.*\*..\..*.* . . .*\*.*** \ ..\* . . .... *\.**.\*.  ..*\.  . .\ . * *.*\* *.\.   *..  *.*  \.*...\.*\. * .  . ... ... .\.** * ..# ##*.##       #
#*...\.**...\. .\.\. *..* \*.\  \.\ .\.** *.\.. . . \ *.***\*    * \  \*\ ***.\* .*\*.. *.*..*    *\ \* ***.*... ..**.**  *..\ *\...... .  ***.*\ \..\. . *. \ **.*. \. .* \* *\   .*\*.* ..  \\* \.\\ ** . . .*  .\... \. *   *\ *\. .*.\ . *.*\.\*.\\\* \****. . .* #. #   #*#         #
##########################################################################################################################################################################################################################################################################################