################################################
#.** \  .** .\ ..\.**\ \.. ..\*.\ .*\.. .   *  #
# ....\* *.\ *\...*..\* .**. **..  * .** ..**..#
#\. *  .\.***\**.... ..\ .\....*\.*.* *. .* *.\#
#*. .  .**.*.\*.***\ \.*..*\   . . .*. *.*... .#
#.  .*. *.*.... \.*** ... **\* \.*\*.*.. \ .  .#
#.\  .. \ .* * .. *.. ** . .  .. \.\\.\.\.... *#
#.  *.* .  ... .*.. .\...*.\*\ .\***. ...*.**\\#
#***. **\.\  *  *\\.  \ *\* ..** ..*.\ \...... #
#.\.* ..*. \*.  . **\.*\.*\.. \. \  . *.*..  **#
#\ **   .\...*   **. . *.*. *  **.. \\ .  ***.\#
# *\** *.   .\* .***. ***.*. .*... .**... *.*\.#
#.* ..\ ..\.....  ..**......*\. .\.\\.* * * . *#
# *\ ..*   .*\* **.***.\ \*\.*\*.*\*..\.* *.. .#
#\...*\.. ..\....\* **. *.** ......** * . ..**\#
# ......  .* .  .  *...\. .  *.\  ***.\...* .. #
#*.  **...\ ..\ * ... .*. .\.\..*** ..*  \.\  .#
#**  ..*\\* . . ..    .\* *.   *\.*...\*  \*.**#
#*. * .. .. *\.. .\*.\.*.. **.\.  .* \   *.*.**#
#. .\.   *..\.\**  *.\.*. * .\ *\  .    \*.\ ..#
#  .  ..*\*. ......* *..*\*.\ *\ **..* *.*.*.  #
#. *\ *  .* . \*.\ * \.***. * *  .. .. . *. .*.#
#..\*.  * .\.. .. ..* ..*. \ .\ . .\**\  .. ..*#
#  .. ...\* .*... \..* ...\.*.  *.*.*. .\\ *...#
#*. . .\ ...*..  \.  ..**.. .   ..\*. . ....*..#
#\  . .*...**.  * .\\ ...    *.* \*. ...*\ .\ .#
# .\ .*\.  ..* * . . *\. ..**.*.\ .. .  .*  .* #
#\*\* \** .* .\.\ \  . *. .\*...* *.*  *.. *.. #
#.\.. . .  .**    . .*   *  *..* *...  . *.. . #
#\.\ ...\  \ . .\.. \. **.*  .\. . . .\ *. \.\ #
#\*.\. **...   . .* *.. .\*.  .. \  ....*   \ *#
#.*... *\   *.**\...\*\ . ..*.*\ \  . ..*  ... #
#...\\..*\ .*\**.\.\*\ ..**.\.* .*.  *. .   *. #
# . *\.\.* \.   **.*\. .. * *\..  ...\..\  . * #
#   ..  \...  ......*.  **.   ***. **  .*\.    #
# . * . . . \.*. .\.\  \.. .\**\.  .*   *    *.#
#* . \ .\  \. . \   * .. . * *.*\ .. \ *   *\*.#
#\..  ..  *. . ..\.. .  **\... ** . *\ . ..\ . #
#.**.   *\ .\    *  .    ..\ * \. * .  \.  ....#
# *\ . *. **\.**.**.*  .  . .... .\ ..\...  .\*#
#.** *.* *.\.*. ...\..*\\*  ...**..* ***\\   *.#
#**..\  .*  .\ \ . ..*.*.. R* .\..\.*.*.****\. #
#..\\  . .*. .* .  * .*.\ ...  \  .\. \**.*. . #
#.. *\   ..   ...\.. *.*** .*  .. *. ... **\  .#
# *.. . .  . .\..  *..\..*\*.**   *..*.  *... .#
#.. .* .   .**..*...*.*\.* . .*. .* . \ *. .  .#
# *   \.*\ .**  *..\* *.   **\. *.*.. ..**. *\ #
#  .....\ .*.\*\. *   .**\..  . . .*.\  ..* .. #
#** .  .**.*****. *   .*\. *\  .**..* \* *. . .#
#*\*.\ ** . *. ....\  . ..\\* * **.\*.. \*.*\ .#
#*.... \\ *.*. \.\ \ .  ... *.**** .\.* .\.* \ #
#. *\.\.  * .\ * ......**. *\\*...* .*\.*\. *.*#
#  .* . .\. \. ... \\* ... * **.\.. ..* *.** .*#
# . . ...   *\ .*   **  ..*.\..*...   .*.\**.\.#
#\* *. *.*.\... .  **. *..  \*   .. ..*  .*.*..#
#..\.*\ .\.. ...*\\* . ..     .....*.  *.. *...#
#*..*  . .\ ****\   **.... ..* \ \.* . .**... *#
#.  .\... ..**..   ..* . \ *\*\.*. .\.*. .    *#
#* ...\\ \ .\**\*..  .*\*. . .\...  .* \ *\.  .#
#* ..    . .*\. . \ \ .***. *....** .*.*.\ \\  #
#.* *.*..\. *..\   \  ....\ *   . \  ..   . .. #
# .*\.*...*.*\***..*. ..*\  . *. .\ .\ *.*\.*.\#
#**..*..*   ..* \**.\. \. *.\ \..* *\.*..  ....#
#* .\.**..\  .\ \ .\**... **....\.\...*.* ..   #
#.  .*.\.  .\  ....* .  * \..*\..** \ . . . .*\#
#* ..\...\.*. *  *.**.. ..* ***  ....*.. ...*..#
#*  . .\ .. *.. . \..**.* .  .\*.**.*. ... \.\.#
#. ****.  \. . *   *..***\  . .**. *\.**\...*.*#
#..*....**.*\ . .  **. *\  . **... .......  . .#
#.\..\..\* .*.  * *........ ..*  ... *..****.* #
# .\.** .. **.\.*\.. *.\. ... * \ ...\.....\.*.#
#  . **\ * ..  *... . .*\.  **.... *.* **.   . #
#\. .*\.* .  ..\. .*...\.*\ .* .  .*.  .\. *.\.#
#.* .**..\* .   .  ..*. *... .\ \ * \**\**.\*..#
#\*\ .. . .  \.. ..\ \ *\\  *. \..*. *..\* \.* #
#.   \.   *** . .* .  ..* . . .* *.. .\*.* .** #
#  .*.  ....*.**\\\ ..  \.*...\. .\ .*..*.\....#
# \.* *.* . . .* .* \*.**..* \ .*.. ..*. .* \ \#
#.... \..* . * .* \ ..  .       .*. .*\.  . . .#
# ***.. \.\.\.  \... **   .*\  *\.**.**  .\..* #
#\\*.** . .. .. ..  *.* *** *. \*.\ ...\..   *.#
#*\.*.*.  \**   .* \.\. .\. . ..\. \.*\.*.* .. #
#**. * \ **..**\\. .*..\ ..\.*.**\*.  . .**\ ..#
#\.* .*... \..*...**.* . \.*. **... \. .... \ *#
#.\.. ** . . *\.\... ..\\*.\  ** \ * *.    ..\ #
#\*\..*\  *. .\...  ..*** \  . . ... .*.\\  \*.#
#..*\. * \  .\  .*\ ** .. .*.\*\* .*. *\ .   .\#
#. .*  ...\. .  ****.*.\ \* .* *.. .* *.*.  .. #
#***..  * .** \. .*..* .**. *\..*.  * * **. *.\#
# .. .. .  \. .* *.\** ... . *****.*...\ .**.. #
# .*.*\.. \. **  .* *. *** *.\ \* *\..\*..\..\ #
#\\. . . .**.**  . . ..*. *\ ** *\. * *.  .\   #
# * ..\.*\. .*\....** *.\..*.*. ..  \*.*  *.\ .#
#\*.*.. .*. * .*.*\.*.*\.*.... ..*\.  *..    . #
# * *\.*\**...\.*\..... *.\    \\*. . *..  \** #
#*..\..*.\ .*.\.**\. ...**.. *\ .*\. ... .*..\.#
#**..*\. *. . .\*... .\ . \. \*. ..*..\ . .\ * #
#\.* .*\ .\  *\*\.  .*.\ .. * .* *** \.\ . *..\#
#*..  \.\* *\*.** \.\. .   \.\.  . . .  ...\   #
#  * \. ..*. *..**.\  ..\ . * ..\.  .. **.. *.*#
#. \.*. *\..\* ..*\..* . .\  \    .. **.**. . .#
#...*. ..\...  \...*..\ *\.** . *....***.*\*\.\#
#.*   \\*..\. *....*..*..  ...\.. ..* ***..* . #
#\\ \..*.\ *\ .. .*.*\*.  *...****.***.*\. . *.#
# ......** .** . \***.*\*..* \ *...*..... .... #
#\  \..**..  .*  .... .**.** . .  ..\  ..* ..*\#
#  *.*.\*\*.\.. .   * ...\..**. .*. .\...* .** #
#... .... \.*.* * . * .    \.*\* ..\ ***.  *.. #
#. ** .\ *. .*..  . **  \....\**\. .\..* .\**.\#
#**..**.\*..*  \  .\ * *. .   ..*... *\***..\ .#
#.*..*..*...   *\   .. ***.. .    .* .** *.*.**#
# \   *.*\. \. .\.  *  ****.*. \  **..\*\..* ..#
#   \.. . ..* *** .\\.**\*. \**  *\ .... . \.*.#
#  \... *.*\*  . .   ....\. .* *.**.**.\ ..\*\*#
# *.\..*...\.***   .*.* * .\ .***\.**..* *. . *#
# *.*\ ...*. .\..* .. .**  **...**\***...\\\.* #
#..*.  *\...**. *.*  . ...\ ** ..\*..*  *   .*.#
#.*...*\ .\**.. *.. .   .**.\\..*....\  *  .*. #
#  . \\.*.. *\..*.\  \.  ... . *. \*.. *\.  .*.#
# . *\ .*.*.*..\  ..\ .  . **.*\ . . * ...**\.\#
#   ...**.....\.*.. * \.**...   .* **.. *...** #
#*   *\ .*...  *. ...\.\.\ *.\  *   . **. *... #
#.*.*... ..  .\*... ..**. *. *..* *\ .*** ...\\#
# . .*\ \* * .. * \**.  .\...\ ..\.. .. *\  . *#
#  *......\ .. \.\..\ .  . .  *\... ..  * *...\#
# **..*.\.*.*\  . \** *.**. \*** *.\*. *. . *\\#
#*..  *\.....**  \. * * ..*...*. . .. .. .* ..*#
#..  * .  \  .\.*. \*.\\* *\*. .  . ..* ....   #
#.\.\**\ * \ . .*\ . .  .\*...  \.  . .. \*.. .#
#  *..** . .\.\ *.*   ** ..  \*\...**  . .\.\*.#
#*.. ...\ \. . ..\ *  \* *\.\.*. ..\****.\   * #
#.*   \.. *\  ***... *...*** ....\..* .*\ .  *.#
#..  .... ...\. **.\...\ **. . .*.. .*..  ... *#
#*\ * \**.\. .* ..*.\ .. .. \. \ \ *****\...  *#
#\**.. . *.....\* \....  \*  ..\**...*.  **. * #
#.*.  ..*..* \  \*..\ \\.\.  .   *\ .* * * . . #
#   \..**..* ..*  .  \.\ .  . .. \*\.. .**\ *..#
#  \..\ * ..* *   **.  **.*\*   *.\.\  .*..  .*#
#\*. ..*\..\.\.**.*...*....**.*\...*  .  \...*.#
#... \ \.. ..  *. **.\ .* *....*\  * \..\....  #
#.*\ .  \* * *. .\**.   ....* .  .\ \ . . *  .\#
#*.\ .\* \  . \ ..**\  *\*  * *.   *..* \. **  #
#....\ *   * *. * *. . *.. *..  .*\..\. .*.*\* #
#*  \.. ...*\ ** \...  .\ **  *..** .*\. .  .. #
#*      * .... . ...*.*... .**\*...\...\  .\. .#
#. .*.  .  *\ .. *\ *\.*.\* *. * * . \. *.*. \.#
#*\ .*.. .*...*.\..\. .\** *.  . ** *.  .* ....#
#... .  \*..*\. *.   *\*..***. .\*. .  *.* * ..#
#*.\ \ * .. ...\.\** .* . \...\**.*.. *.*. .*  #
#.\ ..\..**.....***.  .  ..*. *.. .\ ..\*..  \\#
# *\* . .*.\ **...... *.  ...\*.   . *.. **. .*#
#\...  *..    \ . **..*.\ . *.*.. *. .....\.. *#
#**.\ .\.* .. . .*\.. . . .. .. *.  ...**\**** #
#..\.    ** .. \*. . *\*....\..\*..*.. **. ...\#
#*  ..   .*   *.\  .\..*.**..\*..*.* ..*. \. *.#
#.   \. \.* ..*. * \.. *\** **.\ . . *\.*\.* .*#
#*.*...   . *    \ ** . . ...*. \.  *.*  **. ..#
# ***.\ .*. . *. .. ..    \\\*.\*  \... ... **\#
# *..\.*  ...\.*** .\.*  *.**.... *..\. \*. ..*#
#\\ \* .*\. .* ** \.   * * *.*.\*..\ ** . ** ..#
#.. *. **.* .\.. .. .**... ...  \*  \*.  **.\ *#
#\.**\ .. ..*. \*.* ...\. ....*. \.\.  .*\.\..\#
#  **.\*\**..  .  .  .   .*  * \  . ..\..* **\ #
#...\.\.  .*    *.. .**.* *...  *****   **\....#
#. *.   *  ... .*.*  .* \****.*.\.\\.  \..  *..#
#..\.. .*  .*.*.*.* \   ....*.*\.**  .\. .. \* #
#  .*\\ .*.*. *  .**. *\ ..  **.. ..*\*..  ... #
#..*. \ \.*. .*    .*\*.  \.\ .  * *..\* \* \  #
#*..\.*\ .. \*\ * * . \ **     . * .\. . ..... #
#*\ . \ \**.... * .  . *. .  **  .\\.*\ ... ..\#
#**.**    *  **  ...\...* *.**.\*. .  *. * * .*#
#\....... ..*\.**.  .. .. * .*. ..\...\.*.\..*.#
#..\* \ *** \. ......* **.. . \ \* .. ..... * *#
#\ *\ ...*... *.  *.**. **.\. .. ..*   . ...* .#
# *..* \ ..\.......*.*  .*..*.*** *. *\.\  \.\\#
#\*\.\. \  .\.*.. *...  *** .*... ... ..\ *.* \#
#*\. . *\\   . *. *.. ..**\  .\. .. \. ..*. *..#
#..  *   \ .  * * .\. ..\*. .**\\...  . ...\*  #
#.  *..* .\.\......  ..**.. .*.**  .   . .* ...#
# **  ...*....*.\ \ \. ..*.  ..*. . .\ *.*\ *  #
#\.*. .   ..      .. ***\ ** .\.*..*\* .\*  *\*#
#**.* * ..*...*\.\** .*. *.. \  .\..* *  .*..*.#
#.. ..\ **.\. *  . .\  *  . . .  * . *\ *...\*.#
#.\ . ..\*\ * *\.  .*\..\.**. *. .\ \.**.**.*..#
#** \*   .\   . *.  ... **   .  **..*.....  ** #
#.* .*  *.....  * .\ *. \.\.*...*.. . \*\*..*\ #
#. .\. ** *   . ** ..*..\..\\.\.* ** . *. **   #
#..* *..  *\*. ....*\*.  *.*  ... .   .***..**.#
# \... .. . . .*.. ..  *\.*\  * .*.\ .*.\.\..**#
#   * ...  \  *.  ... **. *.. \.*....\. .. *..*#
#.  ***...*.  \. .  . .*.\   . \*.  ...\.* ...\#
#*\. *.***\.  ..*. * .**.\ \ ...*\\. *    . **.#
#*** .*..\**** . ...* * ** .\***** *.. .*\. .**#
#.*.*\... ..*. * \. ..\...  *.*...... . \.* *..#
#*\...*.*** .  \**\ .*..\.*.. ..*..   . * . **.#
# .  *.*\*..   **..\..\\...* \. ..  ** \...*.* #
#.... *...*.\\  .\ .* * .* .**... .\....\****.*#
# . . .*. \ ....\.*...* .. \ .*.\ .*  * *.* * .#
#*\ *\.*\  * ** ..\. **\.**. \... .   \..\. .. #
#\ .\**..* *..*  ...\*\. *...***. \.**..\.\ *.*#
#  **\..\*. ...*. \..\\ ** * **.. .. .\. .\.*  #
#  .*.\**\ .*\ .\\ \....   ..*.\  \  ...*. . .*#
#.. .  .****\ .\*...\.  .*  \ .*\ .*\  *\ \.  .#
#\\* \*.*\.  .\..\ \* .* .\*.. .*  *.\ . *.   .#
#.*.* .*.  ** . \.*.** *. *..* \  .*.*..\*. .*.#
#*\ * .*\.*..* *  .*..*. .*  .\.\* \ ..\\..  . #
#\*\..**.\*\ .*.*.*.\ .. .\..*.. . . ....*. . .#
#*.. ..\**.. .*\..*..*   ..*\. \...\ ..\.\  *. #
#.*.\..*...\  *** ..* .*\*..* * *..\.. . .   ..#
# *\ ..\... \\\.\ .  .\.. *.*.* *. .  .... .\*.#
#... \.\ . *.. \. ***.\ .  .\.... \\**.\..*\*. #
#\...  ....* .*. ...\ *..   *...*.  *.. *.. *\ #
#**\*  .   . *. . * * * *\ ..*.*.*  \.    . .\*#
#..\.. .* **\.    . \.. \. *\....* .*. .\.* \ *#
# * .*  . ..*.*. .*\* .... \.***. .. .**.*.\.*.#
#**.\ \* ** *\ . *.** *. .\. **\ *.\.*.* .*  . #
# .    .\.. .    *\.* ***.*..* *..   .\..\  *\.#
#*\ \ *  .* * *  .*.. .. .***. **..\*\ .\ \ .*.#
#..\.\. \..*\.. * ..* .*\*.....*.\*..\  \** *.\#
#  . . *.* **.\    \ **..**   **..   .*. *. .  #
#..** . \  . \.\  *\ *\  *  .**.. .* \ .*\  ...#
# *\.        *.. .. .\.. ..*..**. *.  . #  #\  #
#. *...\.   *.. .* \\*\ *.\..** .\.* **.  . .\ #
#  . \...*.  \*.*\\.   . *   ....  .\. .. * \  #
#.*\  \\.\.\ \*\....  .* .\.* \.. * *..**#..  .#
#**.*. . \.  .*.*\.. \***  **... ** .. *.\ ..###
#..... . .\ *... \  \..*.  \. #\*....  \##\*## #
##  ##..  *...*.\** ..#. .*.. *.... .\ *\L#.*\##
# ##..*##\..  .**#\ # ## \.\.\*\.    ####\.. # #
#  #\# # * #\..\.##\.\\# \ #*..# *.* #   # ##  #
#   # ##.#\ *  *# #**###\##***\.  \\ #    #    #
#       # #*.# # # .#  #*# ..*.. *    #        #
#         #.\ \ ##\.\## ..\*.##.##\*##         #
#          ###* ## **# ## #*.# #  ##           #
#             # #*.##    ##* #                 #
#              ##\*#     #...#                 #
#                ##       ##*#                 #
################################################