####################
#\  *.\.\* *\.  *..#
#*...*..\* .  ....*#
#.\  \.*.\.\ ... .*#
#\*.. ..**. .\*\ ..#
#...*   **\ ****.  #
#..*. .  .**\..*\* #
#* .**\ * .. ***** #
#..*.*\  .. * .... #
#. .**\*.\. * ..  .#
# \  \ ***\..\\*..*#
#.   ...\.* *.\.. .#
# \ \  \. .*\*..*  #
# .\.. .*    \. ..\#
#...*.*..\ \*..  \ #
#.\*..*.  ...  .\. #
#...* *.. *.   .*. #
# **.\*.\.. * . **\#
# *\  **.\* ..\ .**#
# .. .**..* *.*  ..#
#..  \.*   .\..\...#
#.*. .\.\  \..*. .\#
#\.  .**.\* *.*.. .#
#..*\\.. .. *....* #
#**......** *  . .*#
#.\.  .. \ *.     \#
#.\ *\.. .\.  *.*..#
#..\** \ *\ .\\ *\.#
#\. .. .  ..  .\...#
#* . \ .. ..*.   .\#
#..\*.. * \ .*. *  #
# . *.*\  .  *     #
#.*.\ *.**  **. ...#
#*.*...\*. \. .   *#
#.* *  .*....  .***#
# * .* *.*\\..*.*.\#
#** \   \.* .* .  *#
#.\ . . \\*.\.   ..#
#**\.* . .* \   \. #
#*\* * .**..* . .\ #
#*..\. *..\..\     #
#. *....* *    .\.*#
#*..**\ ...*.  *.*\#
#*\**..*.\*. .\... #
#***. \..*.....  . #
#..\   ..**.* *. \.#
#.    * *.. \ .... #
#**  \.* * . \.. ..#
#.    *.*.\*   \*.\#
#\\.. ..  .. ...*. #
#*.   \*  .* .. *.*#
#*** . ..**. .\.. *#
#.*.\. \.**\.* * *.#
#.. .   ..... ..*..#
#.*.*. ** . * *\.* #
#\.\* *..\. ......\#
#*. *   *. *.* \ ..#
#.**. \*\  *.\.. * #
#..  .\. . *.**\...#
#.**\ .  . .\..* \.#
# .. . . ..**.... *#
# . *. *   \**..*\.#
#*\ ..\*.\\*..\.* .#
#\ .....*\.\... \ *#
#*.*  .*..*. **.*.*#
#.*\*.*** .\...  ..#
#.\.*\.* . ** \. \.#
#*\.. ..  .*.....**#
#..* \*   *.\. **.*#
# .* .. * .*...\...#
# . .*. .  ..\.  **#
#\ . *.  .*   .\ ..#
# \***\ **.. . **.*#
#......\ ......\.  #
#* *.**.. . * \.  \#
# **.*.  ...**.  \.#
#\**\*..\ \ *.... .#
# .. . \. . *  .\  #
#\**..*.   *...  *.#
#***  .    . *..\. #
#.*... \ .. ..**...#
#.*  ..  \*... . .*#
#* * *.\* .... \  .#
#*\. .\.\**.*. *...#
#*..  ...***.*.  * #
#\*. .    \.* ..*. #
#.*...** ...\ .*\.\#
# . ..*\...    .. *#
#\ .. .**.  .*.. .\#
#. *\ *\.\. **..*. #
#.*. *\  .\..*  *..#
#**.** *.\ **\*\.. #
#. *.\ * .... *.\.*#
#......* \ ** .... #
#.*** .* .*\\ \\ * #
#\\*\  .\.*.. .* *.#
#.*. ... ..\ ..\.*\#
#\***\.\ \.\.\..*\.#
# ..\...*.*   .. . #
# *\. .**  ***.*.**#
#\ \* ..* .... *.*.#
# *...*.. \...\. ..#
# .  .. ... ****  .#
#. .\  .  .. ......#
#\.  \  * ..\ *....#
#** .\ .* . ***.\*\#
#..  ...*. .*.* ***#
#.\..*....\   .*.* #
#*** .**. .*\. \*..#
#.*.***\\   ..*.**.#
#\.\*. .*. . ....*\#
#**.\.\..*\ .*...* #
#*  ..   .* . ...\*#
#**. \ *...     ** #
#*....**\. .. ...* #
#.\.. . *  ** *. ..#
#.. . **\ \.*\**  \#
#..*\*\ ..... .*.\ #
#\.\....**. *\ * .\#
#.... **.*. . .....#
#.. *.\.\.... *..*.#
# . .*. .  .\  . *.#
# .  * \*   .*\**. #
# *   . .   *..*.*\#
#*\\*  \**.*\ .*.* #
#\.* .*.\*..**.\ *.#
# ... .\. .... .** #
#\ *.   \. .*.\ *. #
#..**.*.*\..\.. .  #
#. ..*\* .  *. .* \#
#.     .**..  \*.  #
#*..\. . .\ \..... #
#.\..  .  ...*.**. #
#\**  ..\ *.*..... #
#.*. \  * .**.\.* \#
# .\\ ***.\* .**\*.#
#**.   ..*.  **..*.#
#\\ .. . .*..*.. *\#
#*\..\.*\\.... .\*.#
#.**..**  \\  . \..#
#.. .*\.. .  *.   .#
# . .*\ . * ...  . #
#   \***.\ \  .\*\.#
#.\ .... .*.  . ..\#
#... * . .**...   *#
#\** .  \ *\.\  \*.#
#....* ...\*..** . #
#*.. .\ .*   .*. \.#
#\**\**  ..*\.\.. *#
# ....*  .  ** . . #
#..\\..\ * .\.  . *#
#* .  \...\. \ .**.#
#*.\ *.    *...*.\.#
#\   *. .*\*\*\**  #
# .\...* . .* . .\.#
# .* .*.\. .\ .\...#
#*\\ ....  . ....\*#
#. *. .** \ .. \.*.#
# \.*  *.  ..\ . ..#
#*. \*..*.. *.* .. #
#.*.*..\\.*.. \ .  #
#\   * .....\*.. *.#
#  **.  .*.*.... .*#
#..*.\  .* *   \ \.#
#* . .\  .**. R.. \#
#   . . * **  *   *#
#*\   . \ ..\**\\ *#
#*. *.\\ *..\***...#
#..\.. ..*. .*.\  .#
#. ..\. * \*..*.**.#
#\* *. .\ ...*. .  #
#*\ \.... .  *\ .. #
#.* . *\ \....\. **#
#*...\... *.... ..*#
#. . .**\..*.\ *.\.#
#*.*.\ ...\* .\.\  #
#*.  *\ \. .#\.*.. #
#.*\ ..# .*.**** \ #
# .....  \. \.*. ..#
#*..  *....\.\..*\\#
#*** .\.*. . #*\.\.#
#* .\ . *.**. * \ ##
#...*#.***#. . .\\*#
### *. .###.* *  ..#
#  #\L.*\*..* *#. *#
#  #.##*##.#####.###
# ##.\## #\#    #  #
##\.*.#   #        #
# #*##             #
####################