#################################
# # #*# #                       #
## #\* #\#         ##           #
#.\ *.##**#   #####..#          #
##*.#.. \..###.\\ \ .#          #
#*.# \ ..  #.#*# ..####         #
#.  ..##\**# \*#\  .# *##       #
#  . .\**.** *\*.*.*##** #      #
# ** #..*\..*... * .*#..#       #
# \. . #*  ..*.* .* .* \.#      #
# .\ *. .\** *..*..\ *L.\.#     #
#**   .. ....* \* . \*.*.\##    #
#* .   .\..  .. . .**.*# * .#   #
#****.\** *\* *.\ ..\\.\#.* ### #
#.\..* *.\..*.*   \.* .#.*.. *.##
# .*..\. \.*.*.* ... .\... .\##.#
#*.*.\.\..*.*. . \ \   .\ *#  #*#
#*\.* . ...*.\ . . . **\  . .\*.#
#\ *. **......*..  . ***.. .\* *#
# **. .. . *\*..***\ ..     *.  #
# *..\ **  \*.. \. .*  .*** .. .#
#\. .. ** *\* ...*. . *.... ... #
#* * \..  .**. .*.  ..\* \ ... .#
# \* .*.*  ** . .  . \ . .\.** ##
#\..\ *.*. .*  \ **\* *\*****.*##
# *  .* *.\ ..*. .*.\ \..**....##
# * .. *...  ..* * *. . \.. #\ .#
#. . \. .\. *\*\ \..**..   ..  \#
#.  ..\..*\ ..\  .\. \*..   ....#
#\..    ..    * .\ .\.\**.. .\ *#
#... *.   .*\*. ..*\ \*..\  *.. #
# * *.\** ..\ \.* *..\ **   \. .#
#*.*\. .\. \  .\\ \ . .\ \.\ .  #
#*...\.*. * \.. \* .  .. \. .*..#
#*..*  ...\.* * .... ..  .\ ***.#
#. \.\ *  . .**  *  ..**.. ...*.#
#.. ...  . . *.. *..*  . ...  \ #
#\ **.* ..\.... \.* .* *  .\.*..#
#..**\***.  .** *.. .* \  * .* .#
#*\.\ ..**.  *. ...  *\.  ..*. \#
#.\* .*.*.\. \* .\ . . . . ** . #
# .\. **..* *.* *  \ *. .*\ * \.#
#\.   *\ .. ..*. \ *\..  .**.\  #
#.*....*.    ..\ .... *  \.. *\.#
# **..\. ....*...\. ...  .\. \  #
#\...     *.*..\.  \.*.\*  ....*#
# **.\ \*. ....*.**.  \*.**. .*.#
#**  *.. \** *\\ R\   .* .. \*.\#
# .. \  . . ..\....  ..* .\. .\*#
#.  .*..\...* .. \ \...*...  ..*#
#\* .**  \.\..**. *..*.. .*. ..*#
#*. \.*...\   **. .*\.  ... *. .#
#* * **  ...  .* \ \..  * *.\*\*#
#################################