##########################################################################
#\\*\ \ *.  * .   * \.\    \ .   .**. .\....  * **.\.\  * ..***\. .**.*. #
#.***. \\ *.. *..*. .* . .*. .   .\*.**...  .\*\ *.  .**.  . *  \.....*..#
# .**...\ .**..*.. . .* ...\.\* *...*\.  .\ .*\.. *   ..*.  ..... *  .. *#
#..... ..*.*.  .*\.   ..\\\.. ..... .***  *... .* **\ ...*.**  \  ...\  .#
#.*.* \*.\ ..*...*\..*. .\*\ .\*\ ....\.* *.**.*.**\  *. *...  . \ .\**  #
#\.*  . ....\.\  ..  **.  *.*... **\.***.. ..** ..  .* .  . *...* . *\.* #
#*.  *.. **  ...* \*. .  . . *.\.. \.*\.*\.*  .. *   ...\* .** .\..\. .\.#
#**.**.*. . *.   *.\ \. *\.. .*. .\*\*.\.**.\.\...*   * . ...\  *  .***.*#
# .*.**  **.* *..*\...  .     *...*.*... .* .. \.***....\ \.** .*  *... .#
#\.***.  .. . . ** .*** .\ .\..  \.  . **\\* *  ....   *  .***.\. **  **\#
# *. .*\. *. *\*.. *\ .\ *. .\.* ...* *..**..\* *. *. .    *.\** ....**. #
#*.   .** .* \\ .\ **.  ** .\.\. .\ .*\. .  \.**..\**.\ \ *\..\.  ..\..  #
#..  \ .* *.   .. ***.\.\\    **..*. ...   \  .......*.*..\..\.*    ... .#
# .\* .\. .  \.*. . ** \ ..** ..* * **** ..**\.*\  \..... ...*..*\* ..\*\#
#\.*   .  .\.. . **** .. .\.**\*. **.**.** . .*. * *\*\ ..*  . \.* .*. . #
# **    ...*  **....\  \.*..*...**\*.*.  .*\....\.*\....\ *...\\. .*\.. *#
#*..*****\ .  .*\.. **** * **.* .....  *  *** \.. \.\.   . .**.* *.. .\**#
#\ *.\..\  ..*\  *  ..**.  *. .   * .. ...... .* . . ***.** *.*\*   . * .#
#.\...\.*   ...* *. *.**  *.   . ..\*..\ . \.*\  \*..**.*.     .. ..* .\.#
#.\ . *..\ .  .\.... \ *\...  .  * .\ ..\.*.* **.. . .    .. .*.**..\.\ *#
#. . .. \. . .*...*...**...\....\*   .  . .\*\ *\.* ...  .* . *\.. .. **.#
#\ * .* .. **.\* *...*.*..  \*\ **.  \  **...*...*. .. .*..\ ** *..*. *. #
# *.. .**. *  ** ...\**.*.*  * * *\.*.... *..*.*    .**.*.. *..\. \.* *..#
#.* ..\..  .   *  .\.**..... .*..\**.  ....\*. * * . ... *\****   \*..\* #
#***  . *.     * .* ...\..\ *...  \ *** ..  *. *  .*\. ..*..\..\\* \ .*.\#
#..**.\.* .*   .\     .\***\*  \*\*.. ...  \* ** *.**..\\* \..* *.  **.* #
#**\...**   *\\  . *\ *.*...  .....\*   * *.* *. . .. *... \*** .* *.. **#
#   .* .\..*. .  \ *.\.*.*    .. ** .. .. \.*\*.*....... \*.****\.*.   ..#
#.*.*** *.   ..  . .\*\ *. *  \.\.. \. \ ...... .* ..* \... .\.*  .\ .* *#
#.. *. \*.\. ..   \..* *... \*.*.\   ...*..*\ . \  ..*.\.  .*..\ ** .** .#
#\. .**.  \*  \ \.*. \. .**. .*.  .\.\.**..* *. . . ...** *...***..*.. \ #
#* \  .*. ...   *.. .. \..* .*\*\* . *.*.  *...*\.\  *.*.*.\*. .\..**\. .#
#\ .   .* \.*.\.*   **...\\ \* . . . *.\ *.***. .\ *\. .\. \.*.   **..  .#
#***   ** . ..  .** ..\.**\ *.  *. * . ....\ .*.** **  **...** .**\...*\ #
#*.*   \ * *.\.* .\  .   *...* \*. ....**..\ *\*.. *..\*  ...*   **. \..*#
#\.. *\.*...*  * ***.  *.**......**\.  **\**...*.*.. \..*\ . **  ..*\  ..#
# **\.. .*.*\ **..*. .**\.*   .\\*\ **.. *....**\. .*.*..* **.*.*. ..*\  #
#*\. . **\*. **. \*. ..\  . . \. * ..  ....* \.  *.*.\.  . .. ..  ...\*\.#
#\ *  .... ..\.*\.**   *...\. \. .*\*.. *.. ...\\**.* . \. .....\.\. ..\.#
#*..* *\ .\ .*.*..\.    .\. **.\.*\..* .*.\ \ **\.****  .\ *\ *\   \. \.\#
#.... \ . * * \. **  .\*\*...\ . . ..* \\.\*\ .*  ..\. .\*... . \ *.. .*\#
#* \\ ...*... .* *.*.** .  \. ......\...\..\.*\ \. ......\*     .\. *.*. #
#*   *  . .. . .*\...*.   .   ....  . * * *. *.\ ** ..*...*.\*** *...  *.#
#..* ** ..  \*.**\. \.. . \. *\.. . ..... *  **\.\. ..* ...*.*.*\ .*** * #
#.**.*......  \ .*\ ..  . .  *   \***. .\***  \. .\.\..   \. \*\.**\.  *\#
#*\*..* * *..*...**.* .   \**.**.. .\. .*..... .***..  ....* *.*..\..  *.#
#.  ..**.**. .*..*..*. * *. .  .*\  .*\*  .\.  .*.*.\***. \.   ..  *. \. #
#. . *\.\\.*\**   . \...*.\    ...\. *.\ **    .. .***\  * **. .    .\.\ #
#.\*..***\\.**... ** ** . ..**.\*. ...*. ....  * .\.***\\. **\.. ..*\*...#
# ** *...*.*. .\   ..\.   *..*.**... .  *...* .*.. \*\**\...* **\ .\ .. .#
# .**. \ * . .  **  ... .*.\ ......***.*\..\..  .  .\.....*.*\\.*.\. ** *#
# *\....** ..*\** .\     *.*...   .*..*.*\* . * *.  \ ..\.....  *\ ...*.*#
# . .*....\..**.*  ..\...*  .* .*  . \ .. *  .**. \ \ **\\... . ...  *.. #
#\***..  .. .*.**. * . . **....\. .***    \. ...  .\.......   .\ \\. ... #
#.\*.*\\  ...* \***\.** \.\ .*\ ..** *. \*.**.*   \*   .* \** *. .*.**. .#
#. * * *    *\. *...*.\ .\*...**\*\.\.  . .. \. .. . *.*\*... .. ..*.   .#
#*.*\.  ** .***.*\  ...\..** \.. *. *  ..*\   \...\...  *  .* *\ . ..\.  #
#. .\...\.*.**.*\* *\ . *..* ..\*\*\ .*.  .  *.*.*. .*\ ....*  * ... .\..#
#..\ \. . ......  **.   .*..*.  . \.. * . *\\ \ *.\ *.*\.. . .*..\  *\...#
# . ..\. *\*.  *  .. *   . *. \ ....  .\. ** .  ..  ... ...** .. .  . .. #
#\  \..\.. .    .. . .... .*...  .\* .  *.\*. . ...* \ . ..* \*. *.**\*. #
#. \. \.*  * ...\*..    \  ...  *. ...\. .*. *\  .....  ...**.**.\... * .#
#.*.   .* * .*** .*\*\** \. *.. .*.   .\**.\ . \.\  ..\* * .*\.\*\ *\.   #
#.*     . .\.**\ \.** *\..*.   *.*. * *...** *.  ..  \.\ *..*\. *\ ... .*#
# \*. .\ ..*\..*  \*....  . *  * .  \... \   *   *  **..*.  **. *.*.\ \ .#
#..\ *\....  .*.\**\   *.. *. . *. **\.*   . .*.**. \.* **\*.. *.*. .    #
#**.** \ .*\ . . ..  * .\. \ *  *....... .  . .*... **.... .*... *.*..\..#
#.. *.  *.. .\ . .. ..  *...\.  **. *. .* .......**... . *\*\** . ***\.\.#
# .*.*. ..\**    \..*.. **\..*. ... * \ *.*. \* .*.** ** . .  \ . \. *.* #
#  .**.*\* .\*. *.\*..... .\ . . .* ..\ * \  .\ * ...**.   ..R. .*. .**..#
#   .* .    **.*..*..* *..*   . *  *...*.*..\* ....*  .**\. ..\. .   ***\#
#.\* * ***\.*. ..*.\*\.. .*  * .* *.*\.   \**  *  .. . *.*  *.  *.*\**.  #
#... . *.*. .* ...* \.  \  .*.. **\.*... ......\.\*.\\\..\* ****\ *.\.   #
#*.\ *.* \*.* \.  . .\...\.\..\ .\* . .\ ***. .  .*\. .\* ***\*.  *..\ * #
#\...\\. .* *\      . .***\* ... ..** .. *. .. \* . .   ...*\  * \ .\.*..#
#. ..\\ *\\\.\.\* \ \ **. *. *\*.\\.\*** .    .....*  .  *.. \.\. ** \.  #
#\ . \. \  * **..*.* ...**.*.. **... ..\   . *. *  .     .\* ..\. \  .\. #
# .... *.*\*\\*. \.\. ..\. ...... ** \. *.\**. .* *  *\\.  .\.*. . *\ .  #
#\. ***.\*..* . ..*. . . \... ..* *.*.***\..\.* * \  . ...*...\   .\   *.#
#.* ...\ ..***  . ..  *. ..... . ....*.** .**\  . .\.   ..*.\ *\.  ... .\#
# **.. . ...**\** **..*..* .**.*. * *.*..\*.\.\*\. ..\** *.***.*\* \.\ **#
#.*. .**\*....... ..\ .\.. \.\ ..  **.... * ..  .**. .***.\*.\ *.. .*....#
# .** *. \ ... * . * *\.***.  * \*.. .\ \ .  .\**\. * .*  **.*\.\ \*. * *#
#\.*\ \*\. ..*.. \* ..\*.**\  . . .\*.* *..\*..\*   .... \*\*..*.  *.**..#
#****\.*  .*..*. ..\...\***..*.\ **. .. ..\\*.....**. ..*.*... \. ....   #
# *.\  . **\* . .  .... ***.* .. .*     \\ *.\...****\** ** . *. ***... .#
#\*\. .... **..* . .\*..*.. * .  .\...  ....**..\.\ **..\* .. ..*.*\.. .*#
#*.\*\ ..  *.  *  . **. .** \  .*  . * *. \ .*\ ....\***..\.\ \. *  .\*\*#
#..**.  \ ..*\ *. \\*. .*..   **.\*  **\  . *.   .*.....   *.  **.*.\.*\*#
# *..  * .. . .. .* .\  *.*  .\.*..  *.  . **. \. .*  *\.*\.\  **.* .*\ .#
#*.*\.\.*.\*  . . .\  *... .. .\******.\.*.\**\ \.*.  \*.. ..\...\. ..\ .#
#.*.* . .... \    \.   \ \.\.*.  *\....*\.\ \..*. .\.*.\. *\  **    ..** #
#   . . *\ ..\\ *\* **.. . .*. **...***\... .*....\ *. * ...* .  *.\..*. #
#\..  \**.. .. .. . . *\   * . ..*... \.*.. \ ..**\ ** .  ..*.   .*. \.* #
#... **\* \. ***\ .** * .* .*\ \\.*.*\ \.*  .   \... .  ****  ..\.*  . .\#
#. ...*... ..*..*.\.*..\** ...**. \ . .\.\ .*   . * .. .\ *  .  *.* .\*.*#
#***  . *\....* *.* .. .. *.* . *...  ..*. \\.\  **  ..**\.\. \ ... \*.. #
#.**.*.** *.\ *.*\.     \*. .   .*\\ * ...\  \   **..* *.  ....  \    * \#
# .\*. .. . .   ... \   .* . \.**.. *  .. ... . \*. \.*.\. *.  \.*..\ .*.#
#  .. *  * .*...*.  ..\. **. \...\. \  .***\\.\*.* \. .** ***...\..*   .\#
#\* \**\.    ..*** * **   * \*.  *\*..  .**. *  .\..\* *...\*\*. *\* . *.#
#* ***.** .* *..*\ ....\.\\ .*\.\. *.*..*.*.\*.\ ****. .  **  *\....*\ \.#
#\  ... ..\. * *...  \..... . *\**.* ..  \.\.\***.\.* *.  ... \.*.*...\*\#
#.*  .\  *  \ ....  *. . ..   .****.  . *...  . . ..*.**. * * ... \. **..#
#*\*. ** ..**.. .\. .***. .   ..\*.\**.*.. .\. .  \ ..*.\ ... \ .  *\.* *#
#.  . ..  .. . ...\ .. .\*   \. *. .*\ ***.. ***.\ .  . . ..\ .**\***.*..#
#... * . . * \ .* *.*....*   \  *   .\*\..*.. *..  .  ..   \ . .**...\***#
#*   .*...\...*..*.\* .**. *  * \ ..\..   *. .. ....**.*\*\. .**....\*.**#
#..*.\*\..*\.\*\*....**.** * *. .. \ .** \\** *. \..*..*\..*  ...    . ..#
#**. *.  ..*...\..\  .*  .*. .** . ..* .*  *...  .\..\..  ** *. ** ***  .#
#**......  .\ \**. .* *   .\ \ .**.*** .\*.*  .*\.**... . .*....\.*.*.*.\#
#..*.*  *.**.*..* . .**.*.  .. **.*....  .  \*... **   . \ .*.\ *.*..\\. #
#\**\* ..\.\\.   ..\*.*\. \*   \.\.*\ ***.  .  .*.*.* **\*  * . ...*.....#
#*.\.\   .\ . **    .\.\ .\.  * \*.\.\*.\.\  . ..****.\....*..\ * \. *\ \#
#*\** *  ***.*. .  * . * \  \.*..*..**.  * .  ..*.\*.****\.*\.* *.\.\..\.#
#.* .*. *.**\**. .*.*. \. ... *.**. \. .**   . *.\*... *\..** .*.**..  *.#
#\* ...*\. ........    ..\*.\. * ..* .*\.. .\... ..\ .*... ..\ **..\ *.\*#
#\..  *..**\\**   \ \.*. ....* *  *. **. * \ ..\\.*.*.\*.*..**  \**... ..#
#  .  .\ .* \**.*. ...*.*\* .*..**..   ... .\.\   .\.***\  *\.** *.  *.*.#
#\. **\\* .\.*. .*.\*\ *\.*\..... \.**..*.  *  . .\  .... \.. .\ \.\\**\ #
# ..*..\.. .\.* ..*  *...*.*.  .. .**.  .\ .*.\    * \.*.\ \*. .*\.\. ...#
#* \*\.  \.. ..\   *. \ ..... .   \ .**.*. *\   *. . * * . .\. *\*...  *.#
# . .. .\.\...\* *.*  ... *. .*.\ .* \..*  \.*\*\..  **.\ . .**. . .  ..\#
#\ *.*\ . ..\..\.\.*\** ..\.\* \. \.\.*\....\..*.*.*..*.\.\. .*\   . ** *#
# \.\*  .  **\**.  .*..   *...\ .     .. . \.\.. .** * *  .\* .** .  .. .#
#. **.\*.\. \ ***..  . ..*. *\.   ...\.\* \ ...\ *\...*.\*  .. *.*.\  *\*#
#..*.. * *.*..*\ \ \\..*.* *\ \.*. .\.\ .\ . .**\.\ ***. *..     .**.*...#
#*..   .\.#. **.  ...*\.   .**.\..* . * * .\  ..* *\...  .\. .\.*.*..  .*#
#..*..   * . **.\\ *\**...*..*.* .\ ....*\.  .*\.\  \ ..*... . .*...* .\\#
#.*..\ \ # .*..\ . * .*\. .*\.*.  . *  * *...*.... \* \ *.*\.. *.*\ .... #
##.\.*#.L#....\ .**\ .**  .\  . .** .   *.*...\*   . . .**\. *\...  **\..#
##.  *..#*. .*. .*   *. .**.* \ * ... *..\.*.*.\.\  \.**...  ** .*. **** #
# #\.#\ .*. #  .**\  \*...*\. .\.    ..*.*...** . .\. .**** *\*..*. .. *.#
#  # \*.\.\ .  ..*...   \ \. ..*\ * .**.\ *. .\ \.* * *\*...\.\. .*\.  .*#
#   #.*\\.*... .*. *\*\..*** \ ..\*\...*  *. .  . \..**  *.*. **.\**   .##
#   #.#\\* #. .*. .#*.  \.\*.*.*. . * \\*.*  . .\.....*  . . ...*...**\.##
#    # ###.\*.*.*.*\*\.*.. . .*\.  \...\**. \..  .*..\*  \\ .*. .\*#.*#\.#
#         #*#\*#. **.##*.*#\.\  .   ...**.**.\  \ .**...*.\  .\....   *.##
#          # ##   #*# #*.. ****. * * .*....\ \. .* *.* \*. . \* . *.*##.##
#              #...# # .\ ** .\.. *.* . *\\.\..*...*..* ...   \ ..\.#  # #
#              #\. # #\*\ .* ... **\...*....\. \\   . .  . \..#***\#     #
#               # #   #### # **\ \*  .\*  ..*  ..#.*.\*.*..# ##....#     #
#               #.#     #*..#.. ...* \ .. * .. \*# .  #*. *\ * .* \.#    #
#                #      #\. *..**.*** * \ ..* # # # *..* .*.# ###.#* #   #
#                        #  .. .\.\**\    *\ ##.#  #**... *\ # #.. \#    #
#                       #.\*#**#.# *\. . *\.# ##    #. *. .##  #..*#     #
#                        #.. *\ .\ .*\.... .*. #    #\*. .#     #.* #    #
#                        #*.\ # ..*\..** *. .\ #     ##.**#      ##\#    #
#                        # **.\. \ ####**. *#.\ #      ##\#        #     #
#                         ##*.* \ #   #..*. *#*#         #               #
#                          #\ \*. .#  #\ \  .##                          #
#                          #. ## *#  #\.   .#                            #
#                          #\#  ##    ##*## \#                           #
#                          #.#         #.## #                            #
#                           #           # #*#                            #
##########################################################################