#############################################################################################################################################################
#  #**#***\*.* ***\  \\ .  ..**..\ *.*..\* .***\.*\ .\..    . **....\*\ ...\.  .   \.   \ *\. ..* .\. .    . .*\. *.* ..**\ *    *.*... \* \..\.* \\...*.* .#
# #. .. \ *\**.\*.. ..... .\*. *.   \*. **\.\.*..  ..* \*..\**..* .*..  *\ *. .\ * . .. *\.*.\  ...*   \ * . *.*..**\.\*.. **\*  *\.  .\   .\..**.*.*. \.  *#
#  ##\#   . ..*.. ..*\ \  ** *  **  ... ***  *.* *. * ...  ..* .. ...\  \.\.*.**    \*\..*\.. **..\.* ..\* .**.  .\...*. ....  \ .. * . .\* \..\  .\.\*..\ .#
#  #. .\ . .  \.*  ...  **\\ .\... *.  . .\ \** *.  \ . \.*.   . * .* *\  .\\ ...\ * .  \*. **\*\.*..    \ . ..  \. *..\. *   ** *.*.*\*.*. .\.... .*  .\...#
#  #.\ ...  .......\*..*.. .\.  ..*..  .\.***.*. *. ..\****...   .  ** ...   *\ .* .\  *\*..***. ...  .  \. * ****  *.  *\\.    \...   \*\.  ..\ *\..\*.*. *#
# #* *.**\. \* .  .*.\ *\.    **.*** . .  . . . ** .\\..*...**.    *..***... **. *  *.\ ***\.*. ..\  .  ..\..*.\.. *.\   . * *\.** \**\     \ .....* **.*. .#
#  #\*....\.*.\\.  .*. ...    . ....  .. .\ .  . . *.\ * .* **   .\.\ . .\   .\.*.\ ** ****..\. *\ \ \...**. .\ . **.  \** *... .*..  *\****.**..  .\ .\.\**#
# #. *.*\*.\*.. **. .**.\* \..*.* .**.. .   \**.. ***..\.**\. *\ .  *\ * *. .*. \.. ....\.... **..  .  *\.\*\  \\.. .*\ .* *\* *.\.\. * \*\. .\ \*..\..  .*.#
# #..\*. \.*.. .\.* .*.. \  .... . *.**..*\ .\ **.\*.  .\.**\ ..   ...*.  \.  *\  *... \.****..* .. . **  .\*. ..\. ..* *.*\ ...... *.. * *. ..... .* ... ..#
# #.\.*#\..* . * .*.\.  ..  *   .\.**\.*.. ..  .\ *... *...\**.\.. .\ ..  .  ..*.* .*  .  ...  . .  ..** *.*\..  ..\ ..  **  *.* \. .*   *..**  .**  ... . .#
# #\***... *#..\ .\.* ....  ** *. . *.\*\ *.*. . .\*..\*** ..***  \*  . * *\*.. .* * .*\ . .\ . . **\ *\ .*.  **..\* .. .... .\**.\\*.* *..*. . \*.\.*\*  *\#
# # \..* . .\ ...**\..*.. .\*\*..\. .***. ... . *...* . ** . * ....*.*.*. \.*\ ... \.  *. ..* . ** ..*. *..  \.*  *\ .\  . ..  .. * . * * *\ .*...\ * ..\*..#
#  ####.*#*. \.\ .\. * \*.  .*..*. \. .**\..* \. .\.* \.*\ *.\  \  . \..*.  .***  . \ .. . .\ *   ** .\ **\.*. *.*\*.   . ..\ . . .\ ..**.\ ...\  ... . *\.\#
#  #\ #*\    #.*  .*\*.*. ****    ..**.\.**...**   \. .... * \.  *..  . \. .\.*. .\ .* ..\  . ..\ .. .*.*.*..\. . *... \. **. . *.\.\ \.. *\.\ .** \.*.\....#
#  #. .. **# ...**\. *..* .. . . ***..\... . **. *\.  * .*..   ..**.* .  *. .\.   .. *** . **. \* *\.\.*.*.. . .  .. \.*.\.*.   .\ *. *.. \***  *. . * . .. #
#  #..# *\.   .\*.   . ** .\ ..\\..\. *.. ..**  .*. .*.. **   **.** *  \ .... ..**...** *. . . ..**...*.\..**. \ *  ** \..\*  *.\ .*\..  . ..\. ..*...**..*\#
#   #*..*#* \\. ..\. *    ..* ** \..\... \*** ..***. .  *..  .** .. \ ..  .\ \*..*    . .... . . ...*.\...\.*** ***\....*.*.\** .* *.*.. .\. *.*. .   .*\ .*#
#    #*###*#.  ***.\ . \.\**.\ **.\. .\ .**.\.*....  .\ .....**..\.  *  ..  ..  \... *  *..* *  *.**\. \ .\\*\* *** .  .. *...*.* .* \.**   *. ... \*  \ .\*#
#     #  \.  \ ...  *. .\.***\.\....  ..\\. .* . \*.***  ..\.*  .. .*. * *... **  ***. .   ..*\..\*.. .*.*. . \  . ...  . .* * \.. .*...*..* \ \** ..\.\ \.\#
#      #\** \.*.**   .... ... * **  \\  ..\.\.*\ *...** \  *.*  * .\..\\**\*   . *.** *.\.** *  . * \. ..*. *  *\*  \..   .*\.R**..* *. ..*...*.*\ *..*. \. #
#     #* .  ..  *.* .* **\ \*.\ ...**. .  .**. *\*.***.  . *\.\ .. .*.  .* *\. ... **.*.. *\*.*. \..\ * \..*\ *  .*.. * ** ...*...\. .. * .\  . \ .**\.\*..*#
#     #**.\ ..**.. ...\.\ *. \ .  .* *** .\.\ *\*.*. .\ .*\. . . * .\.\ ..* . * .\ .\...* ..\*\ \.*.. *\. \  *.\* ** \..\\.\.*. ...**\*   *  .*.. .....*.*. #
#     #.* .\. ... .  .*  .. .. . ... . *..* ..* *\.\   . .*. \* . \ .\.*.  * . .\.  *\..  \  .*.  *  ..    ** ...\....\* .*..   \ *..\. .\.**... *\.**.* .. #
#     #  *.**.\\.* .* . *... *.. . *.. . \.. .*...**  \*.\.**.\ * . .  . .\.  * *   .. .* * ...  . . *.. . **. .\...\. *..\.. \  \. ..*  ...*  \.. .**.* \. #
#     #..\..\*\*.*.*  .\*  \ .. .*\.* * . ...*.* .. *..*...\..*...\  .**\.*...  .\*.\  \*.* \ .**..* .. *...... * ......\**   .*  \.**..* \ . \.*..  *\. .  #
#    #\. ..\***  .*\ .*...\  ** .. *...\ *  \. .  \ .\*. *.. .*.. .**\..*.* .  ....* \ .\..\.. \.*.*..  *.\ * * *..*\.\ ...\*. *  . ..  .*. \....\.\.*  .*.*#
#    #.\.. #\.\.\**....\*\\*..*.\...*.\.    .. ....**.\ .. *  .*\*.. * \.\. *\.\**.** *.*  ..\. \.\....* . ***. .. . \. ..* . .. .*. .   *\ ..   . .*  . *\*#
#   # .. ** *  ....*\*\\.* . .*..\* .**\. *. \. . *\....**\ \. ...\.**\   \.  *. * *. . \. .* *** * ..*...*... .*.. \. . *.  .\*\. . \  *.  * *\ \* * . ***.#
#   #* ...\*. . . .  ****.  .***\.**.*\.  ..\.*.* *.....*\.*. \.*\**.*. \*.  .. .* **\*  .*** .\.*\ ...\ ..\  **\* .  **\...*  .   *  .*.* ...*. ....  *....#
#   #..* \*..\    \ . \.*    .*...\\ .*.   ..*. * . ..*\.. ***  *..*.*.. .. . \  *...\*\\*.. * ...* *\ *.**.. *\*\   **. .\.. *\ . **...\ . ...*.\ *.\ \ *. #
#  #* .\.*.\ ..**...... ***..\*. .** .  .*\ .*..*\.\ ..*\\*..\**.*..****..*.   **.*** . .*. **..*.*..*.\ ..**.\ ***\ .\.*  ...\..\ .*.. .** * **.* *.   ...*#
#   #\ * .   \  .*..  .  \.\.* .....  * ...\.. *  ... ... *\ ..*  . * ***.*   .\* ..\..**. ..* .. ..\.... . .***.*..*.  * . ..****\.. .  .*\*..\\ .. \ * ..\#
#   #...** . . *.    * *....*\ .\..\\*.* \...\...**** **. * ***..  *. *\.*....**.\     . \..\.*  .\ \ . *  .* \ *\.\**   *.  .*  \ . *.*.* \** .\ ....*..\..#
#    #.**. . .....\ .* \* ...  * . * .\.\..* * * .. ...*.\.*\..   \.  .* ** *\..\* ... ... . .\..*\....*\ . .\. \.* .  ..\.\.\.  \. .* .*.  .*\* .\. .*  **.#
##### #\. .    ... *\*\.\.    ** .\ \*. .    .*\*\. \....  \*..\\*. ..*. \*.**...**...\ ..\  .   .    \. *..*..*.\ *.*   **  .\. .\**.* .*.* . .\\....* .**.#
#  *.#... ...  *\.*.  .   *.\ \..* ...*\....... . .*  *.\ \...*\.\   .**. *\*.\\   .\.   \*.\ **\ .*    .  * .. * .\..\ \..\. . ** ..  \.*..\*.  \  \*   ...#
####. * *\    *....  \ * ...   .*.* .... ** .*   \ .  \*....* ... \*\. * *\** *. . .   \  **. . *\ \ .\ *. \ *\* . . \*\* \.\...\.\.  *. ..*... ...   ... ..#
#   #\.  .\. .**.* .\. .\. * .  . \ \\.* .* *..\*   *...\  * . \. ...  . . *...  .*. * .**.\ .. ........*\ *.\ .\\ .*.. .* .*\ ..** .*..   *. \.*    ..\  .\#
# ##. .*\ .   .. .*.. \ **..*. .*. ..... . *.**..* \*\  .. . **. .  \ *. . ...\  * . *.\. *.. *..*.  ..\* \.\ *.*.  \.\..\.*.......* .**.\ .*..*.\ ..      .#
##\..#.\#*\* **\ .*.\ \..\ *...\** .  .* *\\.. \  **\* *.  \ *..\....*... .*.*.*   . . *.... *. \...*  *. . .\.\.\ .    ... .*.. *...\. . . ...*** .  *  *  #
##*##*..\*.. \ .* * . * \..*\.*.*.. . .*...** ..*.*. \ ...* .*.  .*  .. .\*. .\..\*. *...\.\ *   * .* .. * *  *.\\ ** ** .*\*..\*..\\ . ..*. *..*. *... *. *#
# #.... ..\ ...\. .*\.* .\.*  * ... *. \ . **.. \ *  .* . ..***.. ..*.\. ...***\  .* *  .**  \. ..\  \ . \   .. .. .\.*.\ .... * ..    **   ...\.. .* .**\ .#
#  #\.\    . .* .*.\**** *\*.* \   **. *.. . . \..* *\*.  . .*. .  . \.  .\..** .*. ..   ..**    \*. . .   \. ..\*. .\*\  .\.*\.  ..  .*\. \ \**\  **  **\.*#
# # . ..\  **.\ .. *.*\ \* \ *.  .*.***..\ \***.* .. *.\ *. .  .*.*. \*\. * \.*  ** ..  \*. .  ...*\*   \ *  .*\ ....*.*\.\. .*..\ .*..\*** \ ..*.\ .**\*.**#
# #\#.#*.. **.  *\*.\.. .*\..*..* .* *.\ ... ..\.   .\.  *.*\ * \.  . ..* * .*. ..  .\.* .  \ * . ***.*.. ..  .. .*.  .* \. .* .*...*..*\ . .**\. .*.** ..\\#
#  # # #.\*... .. \. *\   ** ..... . . .. .* ..    . ..\ . .* .  . ..\\.   \*.*.*.*..  * * . .. ...****.*\ * * \ .\...\\.  \. * .. *.*..   . ...   **.\.\ . #
#     #*    *.\ * .**.*  *.\..**.. * \   . .*\ **\  . . .** ...*\ ..*\.*   *\ \\  .* . *.\** *.\*   ...\*. . . .   .*\.*.*\. .* \ *...* ..\*  *.  *..* \ ...#
#     # .#. ..\ ..   .*.**..  ..\ .\. . *...* .*  \* .*.\.\* * ..  .*. .. \**..*  \*. **.*..\.*.*.    . ..*..*\   **   *  ... ..*\...*..*...*.\...*..* .*..\#
#     # #*..\*#.*\**...  *. .\.\.\  .. *. \... ..**  ... .\.*..*\ ...\**   *\ \ *\..\*.*.\. .*. . ***.. *\* .. * . .** . . * .  \\** *  .\  *.*\... *.**.   #
#     # .*#*.*..   ..*\.* *.  *.* ***.**\ *\.  .\*..*\. .* .**..\ .*\..*\.. ...\  .**.\**.*.** ..\.*  . ***  ..   **. . ....  . .  \ ..*   .. .*\\.*  *... .#
#     #.\ .. \.*. *\.** .  * .* ***\* ...... *..  *.\*..\* \.  .*  *.*.  * .   *..  .. ..*.. .*...\.\... .\..*..\..\ .****.   .   ** . *.. \  .. .. *\.*...*#
#     #*#\ # ..   *. *..\\ .. .. *..*.* *\*\.**..** .  *.*.** *..* \ .  *..*\ ..*.\. .*\..  .  . . ..*\ .*. *..  *. *.*.. *. ..*  .   *\*\.*.*\*. ..*.*\.\*.#
#      # #.\   *  \. ...*\.  *.\.. ...**....\\*..\..\  . ....*\.\..   ..*  .*.**  ..\.*.\.* ..*....  *.... **  ..*\ .... \.*\ ...* \ ..*.. ...*  *\ ..\ * .*#
#       ## . .*..\.***.**.. *  .. * .\*.\ .  **.*.  .* *. .* .  .. *  *\ ..\*...\.   ..*.\. . ..\ **.*.\.  *\.\  .  .*.    *. *.\\ .  .. . * ..*.*   *..  ..#
#      #.**.\ ..\ .*.\*.. * *.. * ..  .\*** .. \.*\. ...\.*  .   .... \ ** .* **... .  ...\\\.* .*\ \... .\..\.  *\.*.\. \  \*\... .\  . \\*..* ...  .\*. .\#
#       #*.# .. .  *. ..\.*.....\* *.**..\. .*.\..* ..* .*..\ ... \** .*.. \.\..**.*  . ....... .\  . .\\.*..  \.*...   .. * . *\..\.\.*\. .  * .*\ .  . ** #
#      # ..*\ \ *\..**\* ..\. .\*..*\*\... * *\ ...  ..   . *\..\..*. \.  **. .. . \\. .. .\ . * ..*\  *  .. .. *.*\*.\ \* .*  ** \ \  *  \ .  . . . . .*.\*#
#      ##.. .    **  * . .   *  .  . * . *\.*\..  \  .  ..\...\*. \. \.*. ...   \*..\*.*.*. .*.. *.**.  .. .    \\*.. .... **\ *.  \*.\*\***.  *\ . *.  \. .#
#     #. . * ....... .. **  .. .\\.* .  ***\.*. * ...  .**.   **.*.  ..* ** *.\...* *. .\*.. *..  **\. .*..\ \ .*.** . **. ..*. .*. .* .\\. *  .    .  ..  *#
#      #*. ..\.\..*\.. *.  . *   ... .. * *.\   .  \. . ..*. ..\ .. *\ .\*. .\. *..**.\*  * ***. . .*.. **.* . \. ..   .\.   * *. . \* .*  * *.\*  .* .  ** #
#       ##\ \  *\...\  *\*  .*  .*. . .\ .*.... .* *.. * ..* *.*. **.**...* .\..***\ ..\...\*.. \*   .  *...  *  ....*\..\ ... .* \ .. .\*\\ * ..   .. . ..*#
#      #.. ..\. ..*. .\.. \. *.. .*\***  ... ** .... \ *. *  .\. *. \*.* \. . *.... ..** .  .* ..*..***..   \*..  .*\*** . \.   .*..*..... . *   .* *  * * *#
#       ##\   * \ .\ .   . . .\. . *\.. \.\. .*.*    . .. *.*\.. ..*..*\ . *\... * .. .* .  .. ..*  *\ *  \*.  * *  ..\.*.*. \ \..\ .***\**\...****  .*\ . .#
#     ###* ** ....*   ..\   *.*...\..   .  ..**.... * \.* . * .  ..*.*..* ....   . *\*. .*  **  .\* . *..*.. .*..\.*\\.*..*. .\..    **. .. .\ .\.\ *   **  #
#    #.. *  \.. * . \.*\* ..*.*\ ... . *. \*\..* .  \\. *   . *\ \ *\*..\ .*.* ..*.. *..**  .\.  ..\. ...*..\ . .  .\.   .*..  ..  \..\.\*.*. **.\*  . *.. .#
#   #*.. .. ..\ . ...\..\.*..*\\. *.  .*.. .. \ ..\\ .\ \ \. \*  . .*.*    \... .. ***. ..***.. ...  * \ *  .*.*.  .***. ** . *\* \.. *  \...... *. . \ .** #
#  #...\**....  ...\ .***...*\..\*. ** .. .\ *.** **.. * *. .\ ..  ..*....\.* \ ..**\*.* ....*.. * . *\  **\.. .*  .. ...*\. ..*. ..\..*. *  . \***.\ .. ...#
#   #\#\..*\   . . *\*.   ****  *** .\*\. *.\  .. .. ..\ .**. .*\ .\\. **.*... *\.\.. ..\..**..*\ . *.. \.* .\\.\ * . *.\....*  . ....\ *..* *. ..*\* ..\ . #
#    # ##..  \**. .\.   . .... .\.* ....* \. \ \ *   .\   .** *. .*.. .. .\***.*.\ .. *. \**.    \ .  .  . ..  * *.  *.\*. \ . \ *. .*. \.**.\*\.*....\..\ *#
#       #* ..\\***. \.*..\.. * \   ..* .. .* **. .\*. ...\ .   **. *  *.\  ...*. . .. ..  \ . .\...* \  \* *  ..  \ * ..** .    *\.. .* . *. ..**. .* *... .#
#      #.#..*. ****.....  * *.  .  *..  *  **** \**..  .**....\.\.*  .\ .* **\*  .*  .*   *** . **...*\. ..* .*\.  *.  . \ .* .\.. \ *\*.*.... .. * *.*  \  #
#      #\*. .\.**#  *.  .*. .**   *.\*.\.* .***.. *   . \. .. **.* . \  *.*\.\*\.. .\ \..  . \. *. *.. ..\.\.*.* **\*..*\.  \ * ** . * .... ..*  ...*\\*\ *\#
#       #*\..**.\#.\..*. **\..*\ \. ..* .*. .....*.   ...      .*..\.  ..* .  .* * .*\...\\***  ..*..*.... *...\ ...**\..\*\..\***   . \ .\*.\..... ..*. .**#
#        ##*# . \# * *..*\.** .   *.** .*. \    *.*\. ...*\*...\*.. * . . ..*...*\.*. * * *...*.. **\.**.....\.. *...\ .\ ...**...   ***\  ...  .** *.   \ .#
#          # ##. . ... \*. .*.* \.  .. *\\ ..* *.* . ..\*.. .  *\..**..*..\* *  * .*... **..*.***.*...*.. . *. .*** . .*..*. .\\  **\****.\  .   .\ .. .... #
#             #..\..\.....\** .  *.***.*.*\. .....\ \  ..  *\  *  \..\..\ .. *.\. .. ** *** *.*.\** ..\ ..  .   *****. \*..* ** .\...\\**..*.*..  *\** \...*#
#              ##  . .  ** *. \.\.*.*. . *..\ ... *\* *. ....****. . .\..  *  .*\  .*.. . . .*\ *..   .   .*. ..\*..    ..*....**  *.*\*.. . ..... .\\......#
#              #* *.\   .***\.. ***.....*.\*** ..\..\\\. *\\ .\... *... *.*. \... \ .. \.. \...\. ...*\..**.*\   * *\*.*  ** \ .  \. *.. .\ *  .**. .*... .*#
#              #.## *..  .....  . .*...... .\\ **.\... ....*.*\ *..* ...* .... .* \.\.. .\. . .*\* .** .*.\.* .*. .\**** .*\  ..*\.  \*..\..\    **  .  *.  #
#               # #\#. \.\ \*. .**\\.\. .*\ * ...*.\  .*.. .*.  *...*....    .* .** *  * * **....\\.*..*.\ .\  *\  ..* .* ..... ...***.\  ***.. ...* ** .\**#
#                  # #* *\*..\.*.\. \..  \ *    **...\*. \. .\.  ..**** *. ..*.*\.*\..*.\.* \. \..\**  * . *  \*.\.\ .\ . \*.. . .*\.*** \ *\ *\  ..\*.*.**.#
#                  ####.. .  ..\  ..... .. *.    *. **..  * *\ *. ..*\\ .  \ *. .....*...*.\. *.****.  .\...\.** .*.... ..*. ..\ ...\.\. . ** .*  *.*\ ***\.#
#              # ## ..* *.  **.** *. *. ** ..* . .*...* . **.*\..\*. *  \.\..\ \ **   \* . \ \. \*.    .    *\.  .**   . \....\.***\ . **.*\.\.  .\.  *.\*.\#
#             #*#*##.   .*\ ..*\  ..\.\*.**  \.. .\ \*.  ... * **..***  ***. * . .\ . ..**\ *... * **.*\..*****.\*.. \.. ... . .. .. .*\*.***      .  *. ..*#
#            #\.*.  .  .**. .*..*** **.... * .\..   \.*.*\.\*.* .\*....**\.  *.\ .. \\..*.*.**\ *...**\ . .. .*. .*\  \** ..\  .* * .\*..*\*\  *.*  . .  *..#
#            #.\.*.  .. .... .\ .** \..\\   .**.  * ... .* \. .   . *.....*.\*..  . .\*\*.* **..*****\.. * .*..\*..* .... \.  .   . .*.\**.. ...*.\.\.*.\. *#
#             ##\. *\ *** .\* .* *.* . .*\*\   .\ .   . .. . ***** .*.\*..\.**    .. ...\* \.*..*.\... .   * . ..  .. ..** *  .*.\ *. . ..* .\ .... * \ .* *#
#               ##\..*  . **..\..\*...**.... *   .  .\*...   .\. .\     * * .\ .\.  * .. ...\* *\...** **\*  *.*** *.\*..*\..\*\\* \.  ** ..... .. *..  *\\.#
#                # #\.  . .**.....*.*.**\..*.. \. \  ..\* ...  .**.. *...\*. **.*.... . . * . .. . .. *\....*\\.*. . .. .** .\*... .* **\. \. .. .\.  .*..  #
#                #........*.. . **.\. *.*  ..   * .    * \ .*.   ***.* .  .*\...**\ . ... \ \\*.\.**... *\**. ...    \  *.* *. . \...*.**    ...     * .. *\#
#                ##. . **..  ..\.\ .. ..\*..* \ * .  * *\ * . ..*.*.*  **...*\* ..  ....*  .... * \ ..*.. \.*. \ * **..**.... * . \  .  *.\ . ...** \. .\**.#
#               # . #.. .\  .\*  .\...*.**.*. .*    \* .. *. .. .\. . . \.. \....**\. ..* \ .*\*..... ..\ . *\ . .* ..**\*.** . . .*.\  .. .  *. \ .. *..\..#
#               #\*. .. *.\* .. .*..*.**.. .. **.*.\. . .*\*.  * **. * .  \ \* * .. . *.\** ** .*.\*.\   \ . . ****\* *. .*...*\\* .* .* .***. ..* .\ \.\  .#
#                ##* \ *.**.  * ..*\* ..\*.....**\  ..*..  **...**\ **.\.*. ...*  **  **..\.*.**...*. .\ ..\  ..*...*..*. .. *. .. ** \ .\***\..**\* ..**. .#
#                  # * .*.\.. ..\***.. ** ..  .  .*\.\* . ****..*** **\  . .. * \ * *\\.*\ ...*..* \..** *.  * \\. ..... \  .\ \*  \.\* .\.***\.* .*\\*.. *.#
#                   #.\..\  ...*.*...\ *...  .  . ..* .\. ...*....*... .*.\*. *.. .**   .\ ..*.  .\ .\...*\ \ ..*.***. **. .\\  . *.  . ** *.. .*.   **\ . .#
#                  #.**.\. . . \\***.. \  \* *.\**   *.** .* .* .\..\.... .. **.*... .   *. *.   . .*.\**.\ .    .*...*\ .\ . .  ...*  .*..*\...\*  . \  *..#
#                 #* .\ ..  \ ....*..\. .*** \.*.\ .*.* ** .*.\....**.. .  * .\** ..* \ *.**.*.*.  *.\.*... *.\   .*  .*\  .  ... \*.\*\ . .*  .\..*    \ ..#
#               #### .*. .\. ...*#  *\ *\.. \  *.**.. \  . . ..\ . \ ..  .\*** *..* .....\\... .\. .\ .\ \\ **  .*.*\.\*.\** ....* * .* .   *.. *\.* ..\* * #
#              #. .   \ \.*\.**\..  \ .. *\ ...\**.*  ...... *. * *..*.\.   .. *  *  ..*. . *  .*....\....*\*  . .\.\\*.* .**.\  * .\...*. .** \\...* ... * #
#               #.. .     *\....    ..* *.. .   ..    *  **\***..\.* .*..\.*\  .*.* . \.  *\.. *. *\.  * .\. . *.\.\**..*\...\ ..* .* . ...**. .**  ..  . *.#
#               #*#\ . .*\*.   \.** *\.   *.  . .. *\*\.*** .\. .\ *\** ***.*\*.  \\ * * . ... *\  .\ * .\*..*. ...*.*.* * .*. .*..*\. ** *.**.*.*\ \*..\ . #
#                #  ... *.*\.  . *  **\..\*  \  *\.*.**.*\*    .*.\. *\..*..   *  ....*..\   *\..\*\..\ ..\ *\ .**.... .*** .\*.. .. . ..\**.*\....*..* ** *#
#                #*#*\ ..*.\  . ...  *. *.. ....\  ...\.*... *\.* .\.*.*\..\...  *.\..*..*\***. *. * \.   . . . **.*  * .\. ..**..\...\*\ ....*  .*. .\.*. ##
#                #\\. \* .. .\*.. *\**. *.*. .*..**.* * .* . ** .** ... .*.. \ ......\.. ... .....\. .*   * .. .\*   ..\ .\*. ..*  .* .*. *.\*.\.\..*  **. .#
#                 # .*#*.... *# . \.\... .*\* * *.\ . ..\..* *.\.\. * *\ \   ..*..\.   \ *.*.. .*\..  \....\\*\.*** .*. * .  .***\ ..**.\ * ..*  .  .* .*\* #
#                 #.#.# ###\#*..*..L\  .\*..* ..  .**.**.. . ***\* *  \...\*. *.\  *\\* .* \*\\ .. *.*.  *.***  ..*  *..   .*.*****.*\. * .*. ..*   *.    . #
#                  # ## #  #.  .\ * *\ \.*..*  \ \ .* .*.\.... \..**.*   \ . .  *. . *\ *.\**\. .  \*\\ *\\.*\*\ ..  \ .\* .. .. ..\...... .\..\*.  .*   \  #
#                      #  #\\**\ * ##...*.* *.  ..*\  ... *. *\ * *  ...* ..*  *. . \ ....*.**   ... .\...\.*    . ...*...* *.\*.*\** \..*** \..\.*..\*.. .\#
#                          ###*###.# #**.\ *..* .. .#* .    *.... ...\.*.***\  .*\*. ... *....\ \  .*. ***  *   ** ** *... ..* . ****.. *.....  .*.** .     #
#                             #   # #**..#  *..#.. #...\.\. \*...  **..*.*.*. \ . .  .\...*\ ..  .* **.*. \. \*\...*. ****.......\.\.*  ..\...* **.*\  .\\* #
#                                  #\.#*\. ..  **  * *\.*\*... \  *.* *.  *....\** .\  *   *..*.\***..*\  .** .*. \\ ..*.. *  * \....*  .  *.\...\.*..* *. \#
#                                   #*## \ *.\*.. *... **....*\ *.*   .*\ .\.* .*       .. .*..*..\***. .\........  ..\ * *. .** *.\****. .*** .** .*\.**..*#
#                                    # #..\#\..\  . .\**..  ***.* .\\ *..  . \ ** .* * .*\..\. **\..*\  * . .\ * ...\\.\..** .   ..*.\\ .... .    \\. .*  \\#
#                                     #..# ..   *\#\#...*  ... *\  ..    .\  .*..*..\..   ... ... . .*......*. . *.   . \* *   .  .*.*\* .* . \.* ..* . .\\##
#                                     # .  *\..#..*##. *. *\.\....**.\* *. *. **..\..  * **. **\. \ *\.  *.\**  ..*\.***   . **\*\ . ..\   \** *.*. .\  #.# #
#                                     #.\######\...#. .\. . .*. .. ... \   ..... ..**.*.*..\\.. . .\ . .*\..** . .* ** . . * ..   .. *.*..* ..\...*...### # #
#                                      ##     #\# .#\.\**. *\.. *. \ *   *  . *  . *......**\*\   \.  *.\* **. *.*.*..\* ..*\*.\**.  .* * *\ *.**\.\  #  #  #
#                                              ##*.\#\*...*.... . .   \\ .. . . *. . .* \.*...\.*..\.**...\.**  .*\*...*  *.*.\**.\.. . ..* \...* ...#      #
#                                                #\# ### **..\.    ..* .  \  \**\.\   ......*   *...*.*  .*.... \*.\\**.. .........\*.*\ .  .#.\**#*#       #
#                                                 # #*.*   \ *..  * ..    .  ... \*  ...\.\ **. *  *. *.*  .   .** *.*\..\  *.. *.  .*.. ***##  ###*#       #
#                                                    #\#\\ .*\  \...\ ..  *..\\*.* .. \... .*.*... .\.\*. .   . *..* . *..\\..\.\*... \..\. .* .#  #        #
#                                                    #.### .## *# .* .*....****...... \ \.*..*.*  *** #\  * . ...\**\..*  * . \ .\  \....    ..###          #
#                                                     #   #\ #\#.#\ . . .\\ ... * *\\.. .\..   * ....\ ...\ \. .. .......... .  \...  .\ \.\.*.\**#         #
#                                                         #\#.*\*.*.#*\.*\.  .   *. \  ..   \.*.\.   * #*  .. . .. .\..*\* *.  .. \ \.*  ..**.*.##          #
#                                                          # #**\*. ** \..\ *   * . . ..*. *  .  ** \*#.*##*# #\..*.*..   .\.**..*..  .\*#. #*##            #
#                                                            #*#\.*.. * *\. .  * * ..   .* ..  **..\## ## #.\*\  ******.\ # *..*  \..*...\#. \*#            #
#                                                            ##\ .. . . ..**.. .  \  .   \ .... **\#     #\ ....*. ***.# *\##* .  . \..#.\#\.#\#            #
#                                                           # .. . **\* **.\ \ .\... .\* .* . #.**.#      ##**. \#\ ..*#\.*# #.*   \..\ *.#.# #             #
#                                                           #.. . #*.*#..\.* #*.\ *\ *..\.#\ *..*# *#       ###  .*  \.#  .## \.\ . ... . # #               #
#                                                            ## *\..\..* .\.# \ # ..#.* *.##\# *.##*#         #.####\.* #.## # #.\*\ ...* ##                #
#                                                             #*. \ # \* *. ## *#\.\##*. .##.# #..#*#          #    #.\#  .\##*##.**\..\.*\#                #
#                                                            #.# ....*.*\#*\ .## ***\###\*##\.##\# #                 ## ##\#  #  ## ...**.*#                #
#                                                            #..# ...*###.**\ \*#..##   ##  ## #\#                        #       #\..\####                 #
#                                                            #**.\*  *#  ##.* ### *#           # #                                #\###                     #
#                                                             #\ .#*\*.##   \ #  ##             #                                  #                        #
#                                                             #*#..###*# # *.#                                                                              #
#                                                              ## *#  #   ##.#                                                                              #
#                                                                #.#        #                                                                               #
#############################################################################################################################################################