###############################################################################################################################################################################################################################################################################
#.. ...   **.\.\.\  . \.*.. ****\..  .\**.****.*... *   ..*  *   ..\ .***. *.** .   .\*..  \* * * **. . ..\.**.   . \\\*... *   *\.\. \. *  .. . \ *.*.. .*.. .   . .\*.  * *.\.*.*.* ....*  . \. **.**.\. \ .*\  .\. \   .\.\ *\..*...\.*\\.*   * .*.*\... . \*#             #
#\..  . \ .**.. *.*     .*\..** .\ * . ... **.**...\.\.* ****. ... .. *\.*..*.  . \.*.*.    . .   .*. . *\. ..   .  . *...\ ..*.  . \   .. **.. .......\  \  **\..* * .**\..*.*.*** .\..* ..* .* ..*. ....*.* * .  *\.    **   *.. .. ** ...**..* . *\ . * .**##              #
#*..\.** **** .*...   **.. . ..\ *.*   \ . \*.* .... . . ....* *  ... ....   .\ ** *...*. *. .*. *..\.\**....... \ . \\ . .  .*..\\..\*\. ...\. **\. **.\.. \ *....** .*\.  .*.\*..\ . \... **.   *. *\. *. *...*.*.   . . *..* .\**. ...*. *.**\* .**.* .. ##.#              #
#..**\ . ***.***.\ \*...*   .* .\\.* . .. .\. . **\. .* \ *.**  .** *   \..  \...*\*..**. .\. .* .    .\. *\..*  . *.... *. \**\*...\.\*.*  ..**** *.. *.     ...  \*.\...*. ....\   .    **.*   \.\\. ***.\. *\. * ....  \.* .*\.* **\  .. *....* \*...\#  .#.#              #
#  . *.  .***...  . .*  .    ..*. \*\  . \.. . \...*  *. .***.*\ .. ..\.. .**.** **. ..*.  *  **  .\.*   \.. .* **.. ...** .....* .* * **..\. ** ..\. \.. *  ..  *  **...**.\ *.\.. .\ ....** *\* \\.* \.. .\ \  .\**\. *. *\     *\....\.\.....*\. \ . ..\.**.#              #
# * *.  . *.*.**.\. ****..\..*\*\  . .* .. .   .\ ..\.* . .*..* \*  \.    *.* \ \*.*.....***..** **.*.  .. \*  .....  ...\ ...* **.*.. *.* .\.\.\ \.*..**..*.\. \\ \...  .\...\......* *.\*.****.  .  *.  .     .*.*..  .*.* *\ .\\.\.*.  .   . ..\...\*....\.#               #
#.\ * .*. * \..* *.\.*** * *.* . .\** . .       ... ..\**. . .  .....  .\... ..*.*.*.\* .*......  . .   *..*. *\\  . .*....**\. *.  .  . * \ \* ......\..* .   \.\  ...* .**\* .  \. *\.* .**.\..  .\*\.\ .*..  \.  \..**. **.*.  *   .** *.....   .\. ..**..*#               #
# .\.\  *.\...\. .\. .*.*.*...*.. ..*  .\  . .   \*\\  *. ..** \*   \  .*..  \*.\.\.\*.\.  *. .    .\...*. .*.*..\\ . *** **.. .. .. *.. .*. *\  .   *..*\  .\   *.  . * *.. *\.\*.  ***  \.\.. *\\* ..*..** .  .   .*.*\ ..*.  *.. *  .. * *.*.  ***   \*.*#.#               #
#..  *.. *.....*.*\..\....\*  .* .\* * *** .*. .***  *...\..\* .. .* .\ *. . ...*...*.*.*.**  *.   .......  .. .*..   ... * .\    *. ** .\ *\.*\..\.*.. . .\*   *\. .. *\.. ... ..\***.*   **  * ..\ *..** * *. *.** . ...*\*.... . *  ** \ .*   .. ..   ....*###             #
#.\\\\..... \ * .. ..**. *.\ \** *.\*. \.. ..   .*\ *..** ..*..*. *\*.. ..\...*..\**..  . ... * . .*.  \. **\*.** .  *\...\*\ \ .\**\... *...\..\. *.*** .*.* .\.****.*\. ** .**  .*.* .*  . **.*.\** \    .*.\*   *.\  *.*...\ *  .  ..*...\.\. \ ..\   \ \    \#            #
#  .. \.*\. .\. * .  . **... ... . .......*\.***.* \.. \. .*    \.\.*. \ *.  .**.... * **...... .**.**.***.* .*...*\.. * *.. ..   \. ...  *.**\.   ..*.*.*...*   ..\.*..\ *\ ...\*\ *.\  \ ...**..*..   * . ..\.\ \..\.\.** ..... .\** ...  .     **.*.  .#.. .##             #
#*\. .*.*.\     .. .\ *..*...* \*\*. \*.. .. ...\*  *.*.*\ ..* ..   *  . *. .. . .*\** .. \**.\...\.****.. *  \. ...\ \. * *\*..* .  .\  \...*...*\.****\.\.  * . *  ..\. *\. *\** *.*. . .* .\* .**   .\.\  .*....* \. .*..   \. *...\   *.  * *\.* .. .** .  \#             #
#.   . ...*..*   *. \  . .*. **.\*.\.. *.*.   \*.*\.. .. .   *\*. .*.* .\  .. .. .* .\.*\ .\ * *.\.****\*\..*...*.\\.*..  \  ..**.  . * .... .*.\ *  \*\.. *...\  *.\ ..**.*  .* ...*.* *. \** . . \.*.*. .*...\*\..  * \..  **. .. **\.*.**. *. \#.\*  . ....\#              #
#...*  *.. .... .*. ..\  ....*.\ .   \ .... .\..*.*.*..   .  .\. *.  .  *.*.\    *.* ... . *.  *\*..\.\..*\..   .    \** .  *. .. *\..  .*\.\**.  .. \.. . \ \**. .  *. . \*.  \  . * . *..**.** ..** .*.*..  **.*\.*\** ***. ...\.*.***. .* *\* **.. \ . .*#*#               #
#* *.  . .....\* . *  \.*.. \..*.**....  . **\\\...*\  * *  \*.* .*\\.. .** . . * \ *  . *\.   *.\ . **\.. . .\..  * ....*. .\.\. ..\*. .** ..*.* . ..* . *.\.*..  **\ \ *.*. . * * \.\  .* ***.... . .*\* .\  * *. **\ ....\..*... \..\*  . ..* .\.*..*.\ .*.#               #
#**\**\ \. \  \.* * . . \*  .... \..\.* . .\.* .*.*  .. ...*.. .  .** .  ..\.  .\...\*\**\  * .  . ..\***.\ ...  . .  ...*\.\*.*\* ..**\  .* .\. .  .*. . * * .\\* .\ ..\. .\ . * . .   * *..*.\**\   .\...* .*.....*\.*...*..*.. \..*. . * ...*  *...  \.*.# #               #
#*. .* \ *  *.. ..\...*. *.  .\**..*\*** \ * \.**...\ *.*  . .  . \ ...  \   .  . .***..  *...\\*.*..*\*..*.\.   *.. . **..\. .  \**... .  \\.*     \. .\ .*\ **..\ *** *.* ...       .  *..\ .\.* . \.\ **\.\...  *..*. *..\.\.*\   . .**.. . .  . .*... .\*. #              #
#*.. .*..... ..*.  .  *\ . ..  ... ..  . . . .*\*.*.   \. ****. .\.*.   .* .*. .*. *.\*... *.\..\*\ .. .... *.**\\ ** ..* \* ..\ ... .*.. .  *\ *. .*. \ *  . **   \\.\ \ **\   *. .*  ***\**. *... *..* ..\ .. *. \.\.\ . .. . . .   **.\..\  *. *. * ..  ...\#              #
#\ *.*.\   ..  .  *.  * .. .  ..\. ..  \.  * .\.*\ ..\ ..\ *... *.  . .\.\.*.*.***\*. .\ *\*     *.\ \. .* \. ...  *   *.... . *. \********\.\ .  * \\. .. .\*.\. *\. .*\* .*  .\ . .   \. *.. \ \  ......\.  . *.*... *.*..\..\* *... \ *...*\..\..\. ...*\.\.\#             #
# \. .  . *.    . *\.*.\.   . ... .. .  ...\   .... .\.**... \* .* \ ...**... \*..... .. ..*.*\.*.*.\...** ..**.. * .*.\. ...  .*    .. .. .\.*  .*... *. . **\*.*..* \ \.**..**.*. ... .. ... . . * .  ..*.   *. .  . ...*\ ***...*..* .\...* *... ** * *. ..#*.#            #
#. .\. . *.*  .* . .. . *.\.* *\ .  *   *   *.*. ..    *..   .\ .\*. ***..\*\.\. . \*.. ..\..**   ..   . .   .\.**.  \   .  ..**.. ..*...\ . .  .*.\ **.   *..* .*\.\. .  ..  .**** .\*. *.\..  .\..\ ...*..\* ... \.  . .\**...  .   . *.. .*  **. .  .\ * . .**#            #
# * .*.**. . . . \.* .* .\**.*\ *....  \** .*.. . \.  ** ..   . ..*..*.. * . *** * .. ..    ...\*\\*    \..  *.\...  .  ..* *. . .\..**  * *  .\.**  .*** *  \*\.  ..\ \*..  *..**.. ..*.\ ..\ .\..  . *..** .* . * ..* .\ ...*..*.... \**\ ** *.\.\  * .*.. \*** #           #
#\.**.\..*.\.*\..\.* .\*  *.. *\.\     .*.*.*..*\*  *.\*. *..  \... ..* ...  .*\.\  . .*....*.\*.  .\*\ ..  ....\  **\ \... . ...  **.\. *.*\ \ .*.  \**.* * .  *\* .     .\*.  ***\*. .  ****...*.\  *.. ..  **.\.  .. \*. ...*\.. *. .*. ..*...\.*. ... .\  .*\.#           #
#.* ..   **  *.*. \*\.*..\.*.   .. *.\*.\.*.   .. **.  *\  *.\*.\ .  .   .  **\.*. *. \*.  \... ..*.*. *. .   .  \\**.. .\ .*.*  . **  *. **.  \... ****\. . .  \..**. **.. *.\*. * *.\...\*.\*\*** *\ \.. .\ *.  .  . . *  ***.*.*...**. \ .. \  ..****  \*......\#          #
#**\  .*\*.. .\.*.\....*..\*\..\.* .* \*  .\   .\...* ..\ ..\.\* .\. ...* .\**  .. .*.**.. ..  *  \. .*.   *...*..\..\ .  \.**..*  **  *  ..*  .. \..*.....*\ ..*\ ... ... *. ..... ... *... *.**.\*.*..*   ....\  .*.* ....**. . . *..\  ... *  \  .. **. \ . \*###          #
#\*.* .* ..\ \...*. *\*. * .....\*.**  .  .... .. .....\.*   \.. .*\. .\..*.. \.   .\..\.  * ..*\*. * ...\ *...\. .   .. ..  .\*.**...* * .\*   **  ....*.. * \.\****..**..**\   . ..*..*\* *..*.  *..  \. . *. .\.*..\  \.\*. .\ .\*.*\  .  .\*...\ .\ ... ..\L### #         #
#..*\.**\  .*..* .  *..* \.*\ *  ...\ \* \ ** \    * .* \.\  .\\.**   . .*.  \. *.. .\\.* . .*\*..  * .. . \ .*   *..* . .* ..*.\..** .\.***.\.* \.. * *. ...    .*...\*.* .**.*    ....*.. * .\  ..\..\* .  ** \*..* ..  \*\ \.*.. * . *..** *.\*   . .*\* \. *.. .#         #
# *...*.*\* .***   *  .**. \\**...*...\.** *\...*  . .  . *. **...... ***.*\.  *\.....\ .*  .. \ . \. ..   ..\... .\ . .\*.\* ... *.*. * .** **. .*..*..... \ . ..**.*....* \  . ..*   ** . .\\* ..* \.*..   .*\\....     ..  . .*\ *  .\\\\*.*\.* * ..*\*.\#.*.*#*.##        #
#..\. *\*  . .*.\*** . .. \..*...*.. \\...\ . **.*... \.. \.*...*\ *\\*.* .. \...***...***.  .   .   . *. . \. *. * . *\. ...  * *.* **.. .. ..*\.... ... ***.*   ...****.. ...*.* . *..\ .**.\* **.. .*** *.*..\.\...*.\. *.  .\**.. *  \  . ...*.*.*\.. ....#**.\. *#       #
#*  **\*.* . *. .\*..\. *   \.**\. . .\.  ..* . .* .. .\*... ...*  .\.\ ...*..*.\.*...  ..\  \* .\ \.   * . .*... .* *\. .*......*.*\*.\.     .. \..  \\*  .**...* *...\.*. ....*.* .*.**  .* **\....  .*..\.*.**.**  \\.*..* \* ...**.\ ...\   ..\. .  ..\ * *.*.#* #        #
#..  ..\..*  ..\**\ *\  .*.\* **. .*.. . \*..\\*. *\*.*..  \ *  * . .\..\ \. \.*..**. . \*.\ ... *  .\..\***.\ *\ . *..\.*\.\.*\ ..\**...  .  . .**\.*\*. . * ..**\... ..\..*. \.*.***\*\** *....*.*.**\* .. \ .*\  \   ..*.. *..**\. **  . \*.*    * ** \    *..\ ##         #
#*  ...\ .. . * .*... *..  *. ...* *.\ **.....\* *\  *.*\*   *\..  .* *..\*.*. *\ . ..*..* .\* \. *. . *.\..\.  .. * *. *.*\. *. \ *.*.. .* ..*.*.\. ...*.*  \. .. *\ *... . . * . \** . ...*..**. \..**. \\.. ..   .* *...  *\.*...***..*\.\.*. *.. ..*\..\.\*\ *.##         #
#..*. * .*.\.*..\\ . ..\**.. \ *\ ***. .*..*.***** * ... **.**\ \\ .* .\ * **...**  \  \ .  .*. .\\.\. * * * **\ *\* * * *...\..\  . .  .... ..\.\*\.*** \.\.. *     ..*  . \  .* *.\***  \ .*\. *...\..... \.\.*\ \.\*\..  **. ...\...*\.*  .*.*  *.  . \  *\.. . #.#        #
#***.*. .* . . .*.\*\ **..**  ....*\***** *. ..**.**\ .  .* . ... \ .* **.\*.*\.\. ..\**.. . . \ * *.\ *.. . *.\.***\.*. ...  ***.  . *** \*. ** \ .*.... .*.**.*...*\ ..**.. **.\.\* *.  . ..*. .\*.  *. ...  ***. ..\. *..... *...** .. .. *.** \ **. .\ ..  ....**#        #
#\.** * .   .  . * .*\*.*\* *.*....*. .*  *\ . .* ...\..... .  *  . \.\.*..* \.\.   * .*.  .\   *. . * . *. *...*  *. .**.\* *..  .  *.. .*****\*.\ .*.\****..*..* . \.\..***\..\.*. *.*\   .\\.\ **.***. ** .\**. * \.\\.\  ..\*\.*... .\*\ .\\*\  ..  ....\ * **\.#         #
#.... ** .. * .   *  *.*.. \*..  . .*. .. *.. **.  ....*. *.**  .*  * *\.\.*   .*\. . .*\*. .**. . . *. *...*.. \. \*...\..*.. .\.   .\   ... . * .......... \. \ . *.*.\  *.  ..\\.\...  .*  *\  *.....*..*.\.*.*  \*  * \.\. ...*\..\   .  *. ...  *  .  \  . *   ##        #
#..*.. * *......*..* . .*..  .\** *.* .\.\*.\. *.\ **\\*.*...* *   *. .\*.*..\. ..*  .*. . *\*.. . *\*.\* . ..*.* *..\*..**.. .*..\****.\. ..*  . *\ \* \.*. .....*..\..*.\.* .\.   .*  * *\  .* *. . .\.*\.\ ..* *\.\ ..* .\ .*.\..** ..*.*  *..*\ ..\*....* *.*. \ *#       #
#...\*\. ..* **..    .* .*..*.*.. *.\. *\.* *\ .*\.*.. .\\*. .\  **\.\  .* * *    . .*.*\... **.    \.*. .\    .. .   \ ** .* . ** \.\\ .*\  *....* \ .*.*****... \    \..* ...* ..* . ** **\ *.*.\.   ... * \.\.\.  .  **.. .**. ***..\*\*..\**.* . ..\*.\.\ .\.....###      #
#\. ** *\ ..*\ *\ \*\..\**\.* **  \ ....* . * ..*.* ...\..* *\...\.\*  . .    **\ *  . .**\  \..\\ . *. .  .** *...\*. . .  \.\.\\ .... .*\.\.  \.. .. . .    \*\*.\*..\ *   \*..  \   .* *\ .... *\ * **..* ..  *.** *\.**.\.*. ***.* .\ *\\ . .. ** .*.\.**\* .**.  .\#     #
#**..*  . \ .     ...  *\**.. .\ .. . .*.\  ***\*.*  . .* .*\..*  **. \.\...  \* ....\ *....\*\ * .  ...* *****.*. *.    *.\. ... .  * . ... .. .. . .  \* .. *. .**. .*.. . .. \*. \**.* *. *.*.*.  \... .. . . . **.*. .\* . . ..\...* **. . \*..*.  .*.**.*. .\.\.\.#      #
# *  \.*   .*  *. *.*\..  *    .*..  \.   *....*\*. .. *** *.. *\.*. .  ..\** .* * \\ ..*.\  ....   . . . .**\**..\...* .\*  **.. *  **\...*\..\\.\  * ..\.* *\* \.\. .* .  *.*\ .. .\* * \ ..*..*  \...* \* .\ .  \****.\     .\.\..\.\.*\**.* * * .*..* . .** .\..#*\#      #
#**\\**\. ...  **..*.... .\ *. *.       *..*. .\*. *.. **... .\..*** ...*\ ..  ..\ . \*..\* \.*..  \ .*  . ..\* . .\  * \ . .*..\ .\*...*.\*. *\ *  \*\ * *. * ....**. \  .\* .. . .... .  ***.\* ...*   * ..\ **.\.*.. ...*..... .. *..* \.**...\ . .*.. ..* .\.* **\*#      #
# .. .\. * ... ** .*....\ *. . .   *...**. *\*.*.*\\.\. *.. *   .\..  . .*.*.*.  * *.. .  ...\.\*****.... **..** *\... \ .* ..* .\ .. \.*\   ...\**.\ ..*.  \..*   .\..\\*\  ..   .\\.\   *\ ....*.\...   ..   ..**\..  .**\  \ .   .. *.\...*  .*  ***\ .*.*..  . .\#.#      #
#\..* *  .   . .*...*...* .  *  \*.* .**\*.\* ..*.*.\.  *.. \...*.    ....\. ..*.* .\*\    . . \*...*.\ . .   ..\ . . . .*.\..*.  \...\\*  * *\ .*.\.* ..*.\*..... \  ...*.* .\\ * . . .\..**\  . ..*. . \.*. \  .*   ** \. .*.* . * **.\..*... .* . .... ..**\*. . .#\#      #
#*\..*...**. .*.*.*\ \. *  \..**.\*..... . *. . .*....*.\. *\  *. *. \ **  *.***\*   .**.** ..* *.\ * ***\**  * *\   *.\*. . *\.***  \ .*\   . ...  . . .*  . . ... .*. .... .*.*\.. . *. ..\  \*\.*** *.* .\  .\. .. .. ....*\ .*....****\..* \....  . ..*..\ .*\*. *##      #
#\*.*.  . .**\*.\ .* .  ..*\... .*\ ..\ .**.*\ .... ....*.  .  \ *\* . .*  **.. *.   *.***.*.***.\.*\\** . ** . .*  *....** .....\*  \*..  .* \  *.**.   \ .\ .  .\ ..\\  . \ \  . ..\.* . \ * ..**..*.. **... *. .\ .  . *\..  ..* .\*. ..   \ \.. \ ..\ *. \ ...  #. .#     #
#*. \.\.*\ .\.. *\*. .* *.*.*.. .**.*. .. ..\.  ..*...\..\..\ \. ...*\ \ \.\*.  . *.. * ..*. ...\.\*.*.**.*.\\.\ ...** \..   .\*.** \.*  \.**...** .***.*. .*.\  ..\ **\*  ...*\.\ . * *\.*..\   ..   *\* . *. ..* .**.......* .  ..*...* \\   **\*.  *\ *. ....  \.#. *#     #
#..\ *  . **...*. . . . *.. ..   *...*. . ...... **.*.  * * * .*  .\... *..*\  .* . .   .. . .\* .  .* .*..*.\...*.**.  ..*. *..*....... \ ... **.. .*.\\*\ .. .\.\.**. *. *.*\. . .\  ** \ .**. .*  *..\. .... *.*\*.. .\.  \  .  *..*.\*. **....*. *** ****\***\.***#.##    #
#* . *.\**. .\*..... . \ **. * **\ ...  .* * *..\.. . * *   ..****.   \ *  *. .\.     .*. *. ... .   ...   .. \* .**.*\. ..*\.\...\..\ \ ... \.*.\*.\.*****\* \..*.*.*. . * .*. * * . . ..*.*...\ * *.\*.  \.\*.*\*..\...\* .  \*\.\*.\ ..* \.*\**.   ..\. .*....  *..\  *#   #
#..   ....* . .*.   .... *.**..**   ** \.. *\ .** . ... ...*   . \*.* .** .. \* \ *.\*..... * .\*\* \ .. .\ * ..  ..*.*.**\\* .  ** .*\ ..\\ ..*\.\.....*.  .  .***. * \ \*... *. . .    .....  .*...  .\. .*...* *.**. ..\*.  .  \.*.... .\ **...**\. . \* ..*\ *.*\..*.#    #
#\*... .  .. . *.\.. . .\..\*\*. *..*\ .*. .. *** .  ....*\ \*\ *....\   . .*  .. ..*  .\ \\  * .*\   .. *.\ * ..   .***\*.\.\**\. *.*\*  .\ . . \... * .***  *.*..*\* .  ..\*\\ .*\  *.\....\. .*.   \ . . ...* .\*.*.  ...* *.\ **... * *  ..* . .* ... ****. \...*\. ###   #
# .\ \.\ .    \.  ..   *\*\ ......\ ..\*.. *. ..\... .  *..*..*\.*.***.*\   .* .**  * **    .*\..* ...*. *. .*\* *. *... *..*..\.... \.\.\ ** .*** ...* \...* ...*** *. \.**\.   . .\ .   .\*.*.\.**** ... .*\**\ ...  * \*\* **..*\.. \ ..   ...*. * ....\.\. *...**.. *..#  #
#  . *... .** .  .. .*. ** *  . *.  *.*.\*   . .\..\.*..*..\.*.\.. \. .\. \ *.***   \..*\ * . *\ *    .*.\.*** .  .. \*.**.*.... .**. . .. ....\.**.\*.\. ..**.*..**\.  .\ * *.. *\     *** ...** .. .*. ..** ...... \..  .*. .\* .\ . \.. **  . . ..\.  *.  \*\*\ ... *..* # #
#..\\.\*\\..\. . . . *.** \*.* \   \.*\*.. \    .. . \.....*\.\ . * *\..\   \ **. **. \\. ..\**...\.\. ..*.*..* \ \ *.. ..*..*...\...\.. .* . * *\.. .\* .  .*\.\.\. *.*\*..\* \\.  .\.....**\.\* \  ***....\   ..**\ .*.  .. . ** *. .**. .* \\ * *  * *.  . ..  **\.*..###  #
#\..**...** .\ \ .* .* .\..*\.  . \.*. . \ .*.  \.*   .. .\..\**  ..\*..  \ . ...\. *... *\.*.. \\ * ..\\.*.. \*  .. \ ...*. .   \*. ..*  .\ \ . . .\**\ ..  . *  .*...\ \ **\* \ \..*.* . .\. ..**. **..*.. \. .*  * ..\ **. .  *.*. *.*   .*. *  . . .\..\ .\.*.\***..*.##  #
# **.. * ..* * \ .   .\ .*.*. *.*\..* . .*.   .*. ..** **\*\**.\*.\..*****.\.  ...*.*\*\.**\.**.\**..  .* ..\. *  *\...**\.**.**. * .*\*..\ *\.\.\. .\.. \ *.*..**..\* *... *..\*.   *. .***.\* *.**. * *.. \.\...**.*.\ * ...\.**.\*..*.*... ..\. . .     ..\.*..***.*..#..# #
#\ .\\.\ .*\.\. **.\...\*.  .. ...*.** *.........*. \*\.**.. *\.\.  **...*.*\.*...\.. *. \****. . .  \.\.\***  ..\* .*..* * . .*  ...*. ..*.** .*.* .   ..****. *.   . . \...*\ *.\ .\ . **. *.*...** **..*.\*.  ...* *.**\  .*... .*. *    *  \. .* .*.*  .\* \* * .*..**\#  #
#..\. .* ..*   \***.\*\.*... *\ \ *.. .\*..    *..\. . ...**...*...  \..\...  * .   \ .*  \\ ....\ .  .. **\..*\    .** .**.  \\  \ \.\ *.** *\*...\ .**\ \... .\. *.\. ..\.\.* .....\   **.\.*** *.*.\*.*** *  . \ \ . *.  \** \ \.*.\*  *.\* \ .*.**.. .\. . *... ... #*#   #
#.\*.*\  . *.*..\.**.*\\.  **..*....  *  \.. . *.\.. \...\...\.. .*  ..  .*.   .      **.*. ..* . ..\.\*...**** ... .*\* *.  \. \*. *.*.....**..**\. \.. *. *. .*  .\ ..  **.*. .  \ ....... ***....\*.*.* .*. ..\. ..\\*  *..* ...*.\..\*.*.\*....*...\.*.. **.* \.   *.\#   #
#.*\ **..\...*\*. *..*..*.*.*. **.\*..* ..**.\.*.*.....\*.*. *. .**.  *.\.\.\ \*.\...**. \. ** ..\..\. ..*.*.**.*.\. . *.*   . *. \.*.**.*\*.**  .* .. .*\. ... *.   *  ..\\**..  *. *  \.* \.\. ..   **\ ***. * ..  **.*\\.*\.. . *\ ..*. .\..* *.. .  .\ * ..\**..**  **.## #
#*** **.\.\. .  \..* *.*.*\. *..  .\** \ . *. *.*.*.*\* ... *.. .\* *\..* . ** .  *\ ..*.. \..\*  \. *** . .*.* ..  . .. . \**.\* . \.... \...**.*\*. .*.*.  ..*. .. \ .     *\.* *. \.....  . *.\.*.\..*..\.* ..*..**\*\.*\\. .*  .*  ..  \.\...*.\*\  *.\* ***.* *.*. \#*# ##
#.\*\  *. .*\ \... ... ***.*..***...*\ . *..* . *. .. *  * *.. \ * *.  *\\* ..*.. .*.    \ ..\. \  .*\*...  .\** .*...*.  **..**.   \..*.\ \* . .* .**.*  ..  .**.  . *  ..  . *. .\ .\\ \*\** .\. *\***.\ ..  *\.*.*..\ \.* ** *.* . \* \   ..  *.*\* \.\.. .***\.. . *  .. ##
#*.\ * .*\ .* .\.  \****..** ..*.. ..  *.\.\...\. *.\ . *\ .\ * .* ... .  * .\.*.\ ** **.\  . . .* ..  \ ***\  *  **\..\.****. . \. * * .. .. \  .*.*\ . *\* *.. * .  *\.   *. . .*.*\  ..**.*  ..**..*.. . *\ **..*.   .. . .* *\ .** *.....* **. .* *  . ...*\ .**  . \*..# #
#... .  . ...  * . .*\.**\*. .*\. *..\  * ***.  *..* . .*.*\*.  .* . . *\ \ \  ....\*..*\.  .  *...**.*. *... *\*.**.\. ***...***. **\. *. .*. \ *.**... * *.*.\.*   * .*\* .    .*..*.. \.. . ..*\.  ..\* *..*.*.\.** * **.**  *.\  . ..  . .  ... \**... . .* ...**.*  .*.###
#...**.\.*.* \* * . *\** *.* .\.*.  **.\***.***\..*.\...\..... .*.. . * .\. ..\.*\  \  .  . .\ ...**.*.*\.*  ..*\ ..*. ..** .  .**.*.*.  * \..\ ** .* *..*.\....** ** \\*.\*.  *.\\.*..   *..* * * .  ..* \. \...  \.\ *..* ... .\*   *... *** .*\* ..\* ..*** *\.*...#.  .  .#
#  *** .*\*..  ...*\*..  ..*..*\..*\ \ ..\ ** ..*.\..\* ..\  .**.    .. \. ...* \   **.\ . . . .....** .......  .  ..*  .\* *.  ... ..*. . ..*  . .\.\.......\ ...*.. ..*....\.\*..  . \  .*.*....\**..\*..  \*.\*.\.\.** \ . * .\. \  .*. ....\..\ .  . \.\\. * .\.  .. . ####
#.*..*.***. *   *..* \.\.\*.\\**  \..   .*..*..  . .*.* .*.* .. **...\ .. .*...\ . \*.**  \. *..\\ ...*\*\.* ..\ *.\.  .. . .*\  * ** *....  * \ *\  .. *...\ \...***\ ..*  \  .\*  .**..* * *.  \.**.* *. ..\.  .   .\. \ .\.*\ .* .*\.. *** ......* .\**\**.* *..   \..*#   #
#*\.\. ....  .. ***.   . *\.. \**\ .\ *\.*.\ \     *. .*..*...\\ . \... ..*...***\* . \..*.* .\.... .*  **\*\* .\. .* *. * .*\...*  * .*.\  *    . ... \.*** ..  *... \..*\. ..*.**.\..... . **\.  .  .\*\......*. ..  \.*. .  .\.\* ***.*..*...\. . \\...... . *.\ . #\#.\#  #
#. * ..*\ ** ** . *   . .. \ *.*. *\.**.\  ..*  .*..  *.*\\  . .\*. **\...\ **  .. .\    ..*\*  *   \\\..... .  \**  .\*\ ..  .. ..\. *. *.*\***.***.* .. **  *.**  ..*..* \.*\*.\.\  . .\ * .. ..\**.*** \.**\.\.  \...      .* * . . .   ....\. .. \** \**\.*\ *.    ...#   #
#...   . \ .*\. *..\ .   \\ ..\*  ..*..\..* .....*. \ \..  .\    *\*.\. .**.. *.\  ..* *\ \...\*   .. .   *.*.. .*\   ..*.  . . .\.  *\ \.\.*..\**\..*..\ .. \... .. ** *. . \.. ...*. . ...**. .\ .. **... *.*. . .... *. \\.*.  *\ ** \ * *\.*\  \\..*.... . .\ . .*.* \#   #
#   ...  .   .\.**. .\ \ ... ...**.\.\ * *.**     ..      *\.  .*\.*.*   .*.*.... .*\. ... .\\.     . .*.***\.  .\..*\.*.. .*. \   . .  . *\....*..\  .. \.* .. *  . ..*.  \ \. \.*....*  \..*.\ .. \ ..*\ *..... **.\.\  *   \.**.  .. **..*. .*\ .*. .\*..  .*...... * #    #
#\..* . ***.\ . .\ . * ..\*\..* **\  .. .* .*.  . *.*R .**\.. *..  .* *.\ .* .\*\.*. \** .\  ..** \..\ *.*... .    ...\\  * \.*.*\... \.*.***. *.. .** \.  .**  *.*.\ .. \**\.**  .*.\ ***.*\.*.**  \.\.\.* .*\\.*..\. **.*   . ..  ... *.  .*  *..*.  . \.*.**.* ....\#\*### #
# ....\.*...**  * ..*...\*. \.*\.* . **.  . .. *.\*   . ... * \*  .\* . . ..\  *.\.. ..\.... *.***.. . *\.\..* .\ \  . * *..   ...\ .\... *\.  .... .. .  .*. * \*\  *.. .*. .*. *\   ....** .\ . *.. *.. *.....    .**..\.. \ \* \..\. ..\ ...*.**\*\ **.. **... . . .*..\  ##
#\ ..* \....\.\.\.* .. \*.* **\.*\  .*.* .\  *\**  ...\ * .\* \*.......*   .** *..\ \*.*  .\ . \ .*\.. ..\.\...\ *\* .**\ * **.*\.*\*..\ .\.*\*\.\  .\* \. ..*\*.*  \ * ***\.*\* .*.     \*.*. *. * ....\\.*..**\**.\\ ****\... .\..  ..* *.\***..**.**.\ ** *.*\.\  \***## # #
###############################################################################################################################################################################################################################################################################