################################################################################
#.***.* .  .*\..**  *\.\*..*. * .*\.   *..*  .***  * *** ...*  \\ .  ....\ .\*.#
#.*.  . . ..*.* \. *.*\*\\* ..  *..\ \**\.**..\. ** .*.*\  .*.\.. . *.. ... .\*#
#**.\.\ .\**.  *. . . ..**.\.. \*\\. .*.. ... .. .. .\ ..    ..*  * * . *  ***.#
#\. .. .* ..   *..\** ***.*  .\.*.*.. ..*\.* .\ *. .*.\  *\ * *  *.\. .\* *\.*\#
#.\** .\   *\.**.*..*  *..\*\. ..\*. \***  .\ ..*\.*  .. \... .**..  .. .*..*.*#
# \.*.\. *\.**\  \*.. .\....  *  .*  .  \.. .\*.*. ..\* * .\***** \*..\    \*.\#
#.\.*\. \ ..*   ... \ ..*\.   ...\.\*... *\*\*.\\* .. .  . \*.\... .** *\.   \.#
# ...       \ *..\* .*.\*  .*\ .***.\*\  \ *.*\\*.. .****.* \* * \   **. ....  #
#  *\.\****.*.**..**.*..*. *.** *...  ...**\ \..*   *..*\*.*.*.**.. *.     *\. #
# * \**..\...\.*. .....\*.\*\.\* \.. ..*..* **.*... \* ....\*. ... *.. **..* ..#
#*..\*.*** .** . ...\    * *.* ...*. * *\ * ...\ .  ..   \ *..     ....\* *. *.#
#\.*....*.   ..\.*  *.**    ..    . * \***..*\\ ..*  *   .*\*.*  .\......... . #
#.* .*\.\.\. * *\. ...     . *.**.. .\.. **\* . **.\*\** .**....\.*.. \.*\**.\ #
#.\  *.**\.. ..*..\. .** . * .\.\ . ..*\.....    *   *.*\**.*\\ \  . *. *..\.* #
#.*. .\..    ...* *. \***\.* .*\..\.  .. .   *.\..*. *\...** *** . *..* \ ....*#
#*.. ** * .**   * * ... ..** *.*    ..*.\    *..  \ ..*. \.\ \.* **...*..  *.*.#
#\....  \.*.. .* .\ *.*** .\*.\*.  .*. .*.** .\...\.*..*.  .*.\. ...\\*.   .**\#
#.**..\. \* *\ .*   *.. * *...*\  * . *.**.* ..\* ***.   . \..   .*..**...  .. #
#.\. . *  .*.   \..    *.\.*.**.. .. .*. . . . .\ *** \*\ \ .* \\.. **... ..   #
#. **  *  *.. .\ .* .* . *.* *.*.\  * * *\ .\*. ***\.  .** . . .. ..** .\\  ***#
# *... *. *. .* ... .*  * *\. ****  .\\ \*\ ..* ** ....***. ****.. . . .. ..\  #
#\*\.  *   ..*. . * ..  ..**  .*.\*.. * \... **\ .   .**** . . *.\ *. *.*  \*..#
# .*.\ . .. ... . . .*.* *.*\  ...*.\..\..*\ ..*  ...*  *\*\.  ... .\.*..\ .\* #
#.*\*.  * *. *. . .. * **\.*..\   ** ** ...*.. .* *.\.\.. **.. \   ***\**... \.#
#.\*\..*...* \ \\ *.....**\.\  *.* .\.\*.\ .**\ * \ .*..*.* **  *.* ..... . .. #
# ..  \*.... \.. ... .. ...\.****..\* *. .* .. *. \.\     .. . ..\. \.  .* \.* #
#\    *.. ***..*  \* .\**\*\ ...*.\ . . . .*  .**   ...*..  *   ***  *.*\..  ..#
# . .*.. .*..* *.* .\* .. \.*\. **  ** * .*..* \. *...**.*... * ..*.*.*\. . ***#
#\ **\  *.\. ....\ ..  *   ..*  .\  .... \*  . ..*.  ..\ .** .* ..****.  \ .. .#
# *.\. *.. . ....*. \*...*.. ..*  .***. \.*** .*.\*..\ ..  *    * *..*... \..\ #
# *. .\. . *.. * . . * **..*.**\ . .***  .*.*\ **.... .\*.*\*.*\.*.*\* \......\#
# \    . * .\*..   * \..... .**.*. .*.*\ ...*... . *\*\*  **.\   .. ..*\. *.\..#
# .    *\. *.*  *.*  \..*\*.* *.  . .\*.*\.* ..\. *\.. .. . . .. \. * \ **.. . #
#   **.. \ . ..*..*.*.*.**.\. \. .\.\..* .*. .. **..*.\.*. *  .* .. \*   \..   #
#   *.*...*** \.. *.*\.\**.*\. .     *\ . ... \ .. . \ ..\*\.*..*** .\.\* * .. #
#*.* ..   \*... ...** .*.. \.*\ \.\... .. **. .\...\ .\.*.. .* .. \  .***  *\. #
#  .. \\.\.  * * **\*. \**.. .  . *..\ ..\ . .** **.*. .. \.\*\   .....*...**.*#
#  \. *  \. \ .\ ....  .   .\. .  *  * . .   . *....\. . ..*. . **.* * .* \. *.#
#.\ *.. *. .\*.  *\\..** ....*.   .\.  .\  *\.\.* **... * .*\  . .*\ \  ..\  . #
#*\ .\*.\**\..\ .. .... . \* .      .  \..*\   .*.*** .\. *.*... \..*.*..\ .. .#
#* .  .\ .\**\..**\* .   . .....  .  .\ *.\ .  *....\.... *\\*. \.*.  .* . *.  #
#*\ . *..\*..... *.*\*   .. ***\ .... ..*.  . * ** ...\. .*..*.*.*\.\**..*..   #
#. . .*. *.*\*. ..\.... ...*  *\   * \. **.* ...\.*.*.\ \ . .. * * \*.**\*\ \  #
#.* . . \ \.*.\*.*.\  .\ *.. *\.\. ...*  ..\** \.**\ .... .**  .\*\. ... . . . #
#.. . .\ .* .*... ** *. ..  *. . ** \ * ***. \* .**..*... \..\ *** .* ..** .*.\#
#*.*  .  ... ..\ \.  *.\  \.*.   *..\. \...\ .. \... *..**.*. \  .  *. **..  ..#
#...**  *.  .. .. . ..*  . ..\*  .* . \ *.*..  *. .. *.*\... .*.. *... .*   .  #
# \ ..* * * *   \... *. . \.\** .. . ..  *. *\...*. * \* . \ ..*...  *\*.\.\*..#
#..*  . *\ *. . . **.** **.*...\ . \....\\.*\*.  .  *...\ .*.*\.. .\.**. *.*\..#
# *.. *  *.  \ \ ...\** ** .* * .. . *\.  .\. *   \*. *...  ..***. . ..  .\. .\#
#\. .**\..* ..  *  .*.....* . *  ***.\.\  ..  ..\. * .\.. *\ **.*\*  .*.... .*.#
# .   *.\*\.*\. ..   **. ...\.** \..\  ..  . * ...** .\.*.*.*.\ \*. .\**\   ...#
# \ **.*\*. ..* .    ..   ......  .\  .*\.\ \.\  ..\**** ***** \.* .\\..***  ..#
#. ..*\*..*.* . ** ..\\.*\.   * . .*. *. *  . \    ..*\  .  .. . . *.  \*..*...#
# **\ . .*.... *...*.\.*  *  . .. **.*..\\... . .*.... .* . *. ***     *.....*.#
#\.. *..*.*\.\ ..* *..*. \. .  .\* **\  ...**.\* . .*\*..  .. . *..\* ..*.\..\*#
#...** **\ * .\ .. .*...**.  **\ *  . .\.* . *.* .  *.*.*.*. * \...**.* .** . .#
#*... \.\.   *  \* \*.....  *..*.\ \*.  .*.**\. *....\ .. ...  .*   .\ .\.\....#
#**\    .*.  *.... ..*   * *.\ * . .. .**\ . ***.\*** . .  .**.\.\\ .    .*. *\#
#\...** ...  *\  . . .  . *  . ..*. .. .\..... * *.*.   * *.*.*\\.... .*.*\ *..#
# *\*..  * .*.*. . ..**.*..*.  *\ *  * .\\.. *. \.\* ..*..*\ \. \*   * ...   ..#
#...\  \..*  *. .* *.**.**  *..** *  .   .. .** .\.. ... *.* .....****\..  .  *#
#\ \.*.***. *  *\\. .*..*\ ** ... *.*  \.*... . \.  . *\ ...* .*.  .*...* .\  .#
# . *. *.. .*. . *\\.* *. *\*** **\ * .\. .. * \ .\ .   .. .* **. .\ .\. * *\*.#
#   .*... . ..\\*..\ *.**..... *.* \*...\.  **...*\. .\. \.....** *..\  *...* *#
# *.**\ \. . . *.\.\..\..\*  . **.* *..*.*..***.\* .\  \.. *  *..** *. ..  *. .#
#..*. *\ \  *  *. .. \ .. * \..\*.*.*****..*\*\ **   .\.  *\. .*.****\**\ *.. .#
#  \ ..* .  .* .  \ ...\ ....\  * . ... ...\. * .** . ...*.*  ......  ..  .\.**#
#.. . . *\..***  ..\  . \...* ..\* *.*\**  ..\...*...\  *.  .*\* \. .. ..\.\*..#
#.  .   . *\ *. .*\..****.\*  \\.\ ..\.\ \.*.     . \\ ...* \.*..*\.  **.*  *. #
#.   .*..\*..\*.\.. **..*....* .* ..\.\ *     .\ \*.\*   *.**..\ .  .  ..* \**\#
#.  \.*.\.. **\   ....  ..  ..*..\ ** *....*..*.*....**. .**.*** *... ..*.*..**#
#.. \...  *... .. ***. .\. \ .*.***\.**. \  \*  \..*...* \.. \*\*..\  *.. .  .*#
#.  .***.*\ .    .**.   .*\..*...\. *. **.\*\..*.* .\*.\*....*. . *..*\*..\ *.*#
# ..\*.\..*.. .  *.\ *\ *...*.**. \*.\.   .* *.***  .. *. *. ..\ ...\...\ *.  \#
#..\ . .\ *\ .\..\*. ..\...\...\ ...*.  . .* .. \\  .\..  .. . *  .. *.\**** * #
#\ .\ . \..*.\.. ..****. . .  ..\*...  .   \  \*..   ...\. *\  *. *\ * ....\ *\#
# **. *.   * * .. . *.***.  ..* .*.*  . \.* .\**.***.   . \ ..*.*.*.**.  *\.*..#
#***\*...*. \\  . \ . . . .* *.* .\...   *. *. . .\**\**.\ ..\..* . *.. .\.*. .#
# ....\.**\* .. **...*.. ...... *\.*\ . *\ .\ \ .*.....* * \. \ \*\....****....#
#.*. .*  . . ..\\* * .   ..*.*\. \..  *\**. .. ...** . *..* ..\*.  \.\.\\..\ \*#
#*** \.*. ...  ..  .* . .\******.   ..\ *\* .* *. .* . *...**\..*\*. \.... *\ .#
# .*.*..*  . .*.  *\ .* \.\....*. .\  *\.*..  ...\ ..  . .. .*.*...  .. .\  . \#
#.**\ ..\  ****\*..*.**\ .  *.\....  .\\ .*..... ..  .* . . *.\.*.*\\*....*\*..#
#**.*   ..\  *.*.**.\*..*\*..    .\....   *.   ..\**  * .. ** . .*..  \   *.\..#
#.* *   \ .*.*\..*\..  *.... *. * .*...*... ....\*..*** ....* ..  .*\...***. *.#
#..**. *\  . .  *...\...*\** *.*. *.\ .... . .*\.* ..** . ..*\.. *. *.* .*\\.. #
#*.**.\\ *   ..**.*   \ . .*\...   ... \ *..***\.. .... * \  *..*  .**.*\. \*\.#
#.\.*.* \** . .\*.** *. .*\.  *\.*.. **. .\  .* .. \\.. .\ \* * .* *...*  ..* .#
#\ ..* \....\.\.\*\* . .  * * \... *.\.\ *.\ *..  .. ** ....* .  . .  *.. ..\ .#
#*   .*. .     \ ... * ..\**...**. \ *\.. *.*\*.  **.**..*\*. **..**.*. *. . .*#
# ..  \ . *\.\.. *   * .\..\*. .* ...** \ .\.\. \.*. ...\...  *\  **\*.\.* *. .#
#* \  ... ...* . ** *. * .*. \.\.**.*\..  .  .   **.*. *.*. .\***\.. *\.... .. #
#.\. .*..\\\ .*  ..**\..  ....*.\.....\ .*.* .*..*.*..*.*.* *.. ..... .*.. * * #
#  . .****...*. *\  .. .    .....\ *.   *.**  .  .*..* .  ...\**\* *\.\. .*. . #
#...\..\.. .\. . *.** ** *   *. ...* . . \...*. .\*. .....   *..**...  .**\*\. #
# .\*.. *.. . *. .\\\ . .\   *\.\\ * \** .** .\ ***.. *  \.**. ..*.*  .\** .  *#
#\ .   *.   *. *.  .\.  *..*. *  .\..*.\ \..*.***.\* ** \. .\. * *..\*  ......*#
# *\.. .*\ \.\.**\..   .  .\ ** \. ..  . *   *.*\.\*..*\. \ .*.** .\**\.* *.\  #
# .* . ... * * .\ .**.\\ *  *.. .*\**.\* *.\..*. .*  ...  \ .*  .\. .*.. ..\.*.#
#  .. ** . .. \   *.\  \\* *.. ***\..*.* ... **\\*..*     \*\***  . *.\  .\**\.#
#.. ..  *\    * \ .\..\. ...*..\ .* .*. \  .\..     .  .. .. *. .. .\. .**.* ..#
#**.\. ..  *\*.\  *.... . ** *\ **.*  \..* *   ..  \.*  *  *\*. .\*.. ..* .  \ #
#\.****.**\.**\.\ .\ \*.*\**   ** .*.*.........* \..**. *..*.* .  .*\  .. .\  *#
#  ..\...**\.* .. .. .*.**... *..  . *  \. *.... .**.*  ... .\*\.\*.  .  ...\ \#
#\**   \...* .   ..\. * . . *\.**\.* .*..\*\ *\.* *.. . *..*..*..\. .\... .\  .#
#..   .. .\* .  \....\*..** .. *.**. *\.  \  ***\.*...* **..  .\** \.. .   .  .#
#\ ..*\*. \...*  **   **\ .   .....**.. . ....**  . \ .\.*  **...\* .\*\.\  * .#
#. . .\  .   ** .**...\.*  \.* . . .. ... \*.\\\   *.\.*** **..\.*.\..* * .*\..#
# ...  . *\**.* \*\   * .  .*\.  .*..*.\ \ *\...  .. ..*.* \* *....*.\*\*  . \ #
#*\...  ....... .. ..\.\   .. .. ..     ......*\ . \*** .**.....*.*  *. .. **  #
#*..****. \..**       . .\. . ..   . \.*.*.* ..* . *.\\**. .****...  ..\.. ..  #
#*.. ..*. .***  \   . ..  * ..\ .\**.  **..    . .. *..**\\ **\.\ .. .. ..\* * #
#*. .  \. ****..\..  .  \ .. *** * . . \. * . .    *.......   .*.\.... * \..   #
#* * .*..\.* *.\.  \*   .  *..\.\. \.. *... . . .....*\ *.*..* ..*.*  .....***\#
#  .*.**.*.....* .\.. ... .. * *   .*\ .  .*.  **   . . ..   . .*...\. .\...\.*#
#..** *.* .*\  *\*.\.. \.\ .\.\.... ..* * ***.*  *\\ *.* .*\. .\. *....* \..** #
#\*.\.**. ...*.*.\*.*...  . *..*   \ .. ***\\**   **. *\\*.\.....\*..*\...* \. #
#...   ..   *. .... *...\*.\.**. ...\ ..  ** .*.\..**.\**  *\  .\ ..\. * *.\ *.#
# \\ ...  \**.\ ..\.*\..*..* *\ \.  .** . ** ...... \ . .\*.. ...  \ . *.\ *\.*#
#  .**.\ ...\..  .  *...* . **....   *.   *..*   *\....  .. \ **..*.*. .*.*..\.#
#\ ..*. .* ... ..  .\. * \ ..**.***\  .**.\ .  .*.\.\.*. *    .. . ...  .\..\.*#
# \ ....... \   . .*\*.*. .**.. **...*...\.. .** ...  ..*.  .\*. *  \ * *.\ *\.#
# \\*.\. \.. ...*. **.*.\***. *.*.**   \ .  ...** * \..***.*.*. *.. ...R.**. .*#
# .*\    .\.*  ... ... ..*.*   *\..* * .*..\.* \*..  . *.\*\. *. .\*\.*. \..\..#
#*.. .** **... .*\  .\ .\*.** *\..  **....* *.\..*.  .\\. *.\..*. .** .*  *\. \#
#\**... .\ \.\*....\ *\... ..*.  . \..  *..*...\ * *  *.. ..*\**.*....\...... .#
#*.*\  ..**. *. *.*.*. .   .\**.  * \.* . .  \*.*\..*.*.  ....** .. .\* .**..  #
#\.. ......**.. . * ..\*. .* \.. * ...* .**  .* * *.. .\.*\**.*.. . * * ******.#
#.* ..*..\ \* . . **\ ....***.*. . \.*.*\\ .* .\. **.*..\..*\.*. *... ... .**. #
#** .\*..\ .. .  **. *  ** \*..\*... . *.***\*\.\  \.  ....\*.\ \.*. . \ .\ *\.#
#.. . *.\.   .  .*\*..\ .\**.... .    . *..  .* *.. .   *     .\.*.... *..  \* #
#\. . .\.\*.  *....* ... \*. .**\..  .* .\ * ** *\.\*. \. \...**\.. .\*.*.*\ . #
# ..    \. \**\.   *..* *. ...\.  *.\ *\.*..  .\. ..\.* \\.  ...  .. ** \\...  #
#\.\. ***  ...*...*.*\*  .*. . *\.... .  * .***. *** *. .  *  *. *  .\.*.. .** #
# ......*\    ...\.*..... * \. \ \**..**.. * ..  .\.**  \... ...  .\. .*.  ....#
#\. *\*.*.\*..* *...  .*\. \..\. .**\*.\. ** .  .. *.. * ..  *.. *.\..\.\ *  \ #
#*.* ..**.* ...   *\. *. \ ..**\ ...  \*\..*.\*  \**.  . ** \*....\* .*. ****.*#
#.*.* ..\...\ \\.*   .\**\ \.\\     *....**.  .  . * .*\\.\*.. .\... ..* * .**.#
# **\.* . * .\   *\ * . ...   *\...*.. * .. \  *.... .*....**\. .     \.*.\*\.*#
#*** .\.**..  .***  *.\ *\ *. .. . .\.*\ . ... \*\   ***   .* *.  **\.\*\...*.*#
#*.\.\....\ * *..*\  *.   .** \.. .  .  *\..*.. . **.**.\ *.. .  *.. . .   **\*#
#. *.* **  *.*...*. \.. * ..\..... * \.*\.....***  * \. ** ..  ...\\.\. .** ...#
#\.* *\\.\. \. \ .\ .**\..*.. * .. *.....   .*...   * \....\*  *. .... **. *\  #
#*..\. ..   .\..\  \...*.\. \..\ \*.  \  \  *.. .\.. \.\.*..*.*.     \. . .*.  #
#** . \ ** . . ** .*..*...**. *.* \*\\   *.   .* ** \... ** *..*\. \*.......*..#
# . *  ***  *.***\\\ \.\.*. * *.* .*. * .. .. .* . ..\. \.\ ..\. *. ...\.. * *.#
#****.*.*.*... **..* *.*... **. **.*  .*..  .\..  .**.  ..*\  . *\* *.\*..*\. *#
#.*..\**...*\  .*\......\.*\.*\.\. . .*.     . * ...\.* * .*.\ ..**\... * * . *#
#*  * \. . ... \..    .* . .  . .*** *.\.    .*. ..   ... .** .* .. * \ *\. * .#
#..*  .\...      . *.***..* *.\.. .. ...*. .\.* * . . \\.\ .*.**.. \*   . *.. .#
#. ** ..*** *......***\.*...\  \.***\.* *\ .. ... * \* .  .*. \* . ..\  ...**..#
# *\.  ..*. ** .\....  \.   .. ..\ *..\  * ..** *. \.\..   *  *. *. . \* .*.*\ #
#.   *  *.  .**.*.\  *.. *. * .\** ....  . . .**.* .*. .. ..\. .. **   .*.***..#
#\.. *\ . *. \*\* .* .. *.. ..  ..\     \... .\* . .\*   .*\  \  .*.. .\. .*  \#
#.*\*. *\ *.....*\***  *.**.\.*\  .  .\ ..\. * . . *.*.*\ . \ .\..   . .*..*. *#
# **.**..*. .* .*.. \**. \... \.. ..  . *  ...\**\.  ..*..**. ...\. ** *\* \ *.#
#\..\ .* ....\ * * \ \*.*.*\...\*.\*\* *.*. *.*\.*\.. ..*.* .*. \*\\**\*    ...#
#.** .* ** \..*\ ...... **.* . .    \.*  \.*.\\  . .\* ..*....*\* . \.** .**. \#
#***. . *\.   \*\  *. . \.*.   \ \..*.*.*...  .*.**\   .. .** . . *  \. .\..  .#
#.\.\ *    .* .*.**\*\* *.  .\ .... *\.*. .    \.*\.**..\ *\.  *  .. \.. *\....#
#*    *.. *..*  \ *.. .\*  *   \ \ .* ..   \***.** .*.\.. .  \.....  .   .*.\\*#
#.\  *\.* \  . *.. * .\ .. \   .\.  .  \.    *\*...\.*. *.* .*\. ** .\...\.*. .#
#*. ...\    *  ..\ *. ... *.\ *\. *  .\.\*\*\**. .  .\ **..\ .\* ..... .* *..  #
#.. *    .\.\**..*.\* *\..\  .*.... * \.  .*..* . . \.... * .   .* * .**... *. #
# * .. *\** ... .*  *..*.\ .* . *\*..  .   *...*   .. .*\**  *. .. \.\.\ \  .. #
#\.  ..\ \* .*.*..  .***.*\ \ * * \ ... .**\.  **\. .**. .\ \ *.** ...*.*. * . #
#**\** .\ .\.*.* ..  \ *\  *... . .....***\ .. . ... .*  ..\ ..\**.**\**.. . ..#
#.*...\ *.*.*. *.*.*..* .\ *\  \ **..*..\. .*\*... ***. **\* .* *.......\.*.\  #
#\\* *.*. . \* \...*  . . *.* *\  *....  .\. ...  *. ..\.  .* *.. \. \ .  *....#
# .**.*  * . . . . ..   . . . \   .\\. .  . . \  .* .    .\ .\. .\.  ..\... *.\#
#* ...\*\* .* .   *\..*\ *  *  . \**\*.\**.\ . . .* ..*****.**\...*....\.*. **.#
#. *.*  *.  .  *.\*. * . .**\***   ..*\....*.\.\ \.\.**..**\.\.  *   ...\*  ...#
#  . \. . *.  ..... .*..**... *.*.. .**...\ \ . . ....*  . ** .\*. *\*     ..*\#
# \** \*... *\...  * \.\*. .. .\... *. . \   * * .\...*\.\.** . .  **. ..\\\ . #
#*..*. *.*\ *..  . . .* .. .\.\. .*.. .* *.. .**   *.. * **.*. ...\.*\  *... *.#
#\.\. \. ....    .\. \.\.*\ *\.* .* \ *. \**. .. ..***. .*. **    . ...*. ** *.#
#... ..* *...*.\.*.\*.\ **    *   .  *...*.. .*\.**.\* *.. **\  *\  .\ . *. .\*#
#*  \ * ..\ *..  . *\.*.*..* \. **. .**. .*. **  ..*....\    ***..  ..\  .\.\*.#
#. *. ..\...*.. * *** * .*\  . *.  .*  \....\..\ ...*.*   \.\ .. *. . ...*\  *.#
#**\.. \*. \....*..\..\ .\.. .**. **\ . *.*\\. .  **.*\ . .\.\.*... .  .*\   ..#
#.*. \.*..*.\..*. .*\ *. * .\. ** .\ *\*\**.   . **. \ * . * . .. \  **\.\ *.\*#
#*. *. \*..  . *\*.\.**.**. . .... *....*\. \..*..\*\...\   \ . .  \..****  \..#
#* .\  .. .\  *. .\.. ... *.\  .*  .\ *.** .. *..*  ..* .*\   . *\.***\\*\.. *\#
#\ *....\*\*..* .   \.* .\*****\.. *. ..**..* .\\.** *.\. \*.. .. \*\... *..***#
#.. *\ . .... \  *\.\ ....\..*..*\ ..\* .*\ ...****\*.*. ...\. *  *\   . \. .\.#
# .*..  .* ...*.** * .\.. ..**...  **  .. .\ . \ ..* ..\.***.. *.*\. ..*\.\ ** #
# *.   . .* .  * ..   .\ . ..**.*.*.* . .\*.. .. * ....  .*. *  *\. *. .** ...*#
#*.*. ..\..*..*.\. \. . .   .*..  *..* .  . \ *\  . *.*  *.* .. .*. \   .*.\*. #
#.*.\ . .. .* . .    . \\ .*..\\  *\.. ..  * *...  . *.* *. . *. .. .***\.*.\ .#
#..\ ***  *\.   \ \* .\.  .* * *\ .*  * * *\..**.\.  *.... ** . *\.. . .\..*\\\#
#*  .\.. ..  *  *...  .*** *.\.*.** * * ..\ *. ..**.*     \. .***\  *  *\\.....#
#. \..  \.....*..  .  .*.* ..* **..  \...   . *.*\.*..*. \. .\\*. . .\ *.\\ ..\#
#*.... .* \.*..*.*.   *.*\ * ... \.*. .   * * ..*  . \*.* * ... *****. *\*..* .#
#***    .\. *... \  \..... .* .*..**. * **. .\. ..*..   ..* ... .\..*... ..\..\#
#.\.\**. * *\.**\.** ..\   .     \**..  ..***. *...* .*\. *..*. .. .\ * * . ...#
#\..*.**.**.*. *  ...  .. . ** .*.*..  *. .\. . .\ .**.  .**..  \ **    *.  ..\#
#\*. .\. .*.**....\   \.. .**..\.*.   .** .*\**  ..*...\**.*. ....*  .  **   \.#
# .*..* **..*\   \  \*  ..*.. ...   \.*..*.....\. .* *\**. . .  ..*  *\*\*. .* #
#.. .** ..*\..*.**\... . *. \. .\\ .\   . * *\*** *. *  * **\.  \ *...*..  **\.#
#   * *\* *  \..* * * \\  \ . .**....  *...\**..** .\*\*...*.\ * *..\.    .\. \#
#..\***.. *\ * \. . * ..\.....*.*\..*\ ****...\  * ..*  *** \ *. *...*\ ...   .#
#\..\..*\..\ .  .\\ *\* .. *   .\.\  *..\.\....*.\. \\  *..* ....* .\. ..  ....#
# .**\ \. \*  .\ ..\ **.   . ..** . \.*.\.\.  \ .. ..\..\\\.\*** \\*.\ *\ ..   #
#. ..\.\.*.. \ . ..  \* * ** **.. \ * ....\\** \.. ... * *...**...**\*.*   ....#
#.* ..  .**.  *.* \ ...*...* ..*... \. .. *\..  ..* ..** *.. \. .*.*..**   *   #
#.* ** .*.\**.\*. . *..*.\ ** .. . .. ..*.* .. \.*.  \..*.   .   .. *\..*\..\ .#
#.   * . . ..\..\** \*.***...  ..**  .. .*......*. .*.* \ .*.\. * ****. *.* *. #
#\ **\ ****\ .....\ .. *.*\.\. ..\. *. . .*.**\   * *\...*.. ..\....\ .  .*... #
#.\..\*..*..   . ***..\.*  ..*\*   . *. . *.*\**......**\\ .    \.\ *..*..\** .#
#..*  . .\. .. .* \\*  .* * \\. *..\. .\. ...*. .  ***.*.. **.\.* *.** *.   . .#
#  .* * *\**.* .......*.. .*..  \ .*\.\  * . .\.\.*..* . *..\.*\..\**\...\* **.#
# .*. .\\ .\*** . \*... *. .. ....*. .*. . *. *  *.  *.* .\.\. *\* *.. .* * ...#
# ****.  . ..*. *..*....*.** *..\.* **....\.\ \ **\  *\\**.\   \**..  * ....*  #
#\....  *  .*..*. * ..**.  . **\.** .*. .*   * .**.* . **. * *\...\ . . .\.\. .#
#*.*.*\.\.. .\.*. ** **\. ...* *.** *. .**.\** \..\*...*.*\.*.** ...\ . \.. .*.#
#\.. * . .** **  *....*.\.*\.\ *.... *  \* *\.*. ...\...* *\.*.\ ... .*. \*. ..#
#.*.\..\ **...\ .\\ \ *** *  *\.....**.\ ...**. . ...\   ..*.. .\*\*\ . \.\...*#
#\\  ...*.*.**.. *\ .. .\ ..*  * *...*. .*....  .*\.  \..\.*...\ \ .\.. .\*   *#
#*.\ .  .\...*.\ .****\.. . *  ...*   \. . .**.\ *...\. \  .*.*. .\ .\ .* *.*..#
#** .\* \.** .\.*\...***..*.  .*... **..   .\ * \.*..**\.\. .\ .\. . *. \ * \**#
#.\*. .\. ** ..\*..  .\ \\.\.*... \.\.\ .\*** . \.. *\*.\..    \.*.*. .  *...**#
#\*.. *\.*.****  \.  .*\.*.**\.* \.  *.  .*.*\**.   ...\ * .\.  .*.. . \.. *.*.#
#.*** . .*..\.*   ..*\*..* .*..\..*.. *.*.* ......*. **.**.* *....\* ...*. . .\#
#. .. \\.\. *...* **\.*.\...*.. *\    ***\* \ ... .... *.. \\\*\   .  .\. .\  .#
#***.  .* *.. . ..* .** . *..*.\. *\  *\..*\...  *   *  \ *...***\ * . .  *  ..#
#\*.*..*. \\  *\ ....*. \*\  ...\..  ..* *.**. ..* *** ** . \*. .. ..   . . . *#
# * .\*\**.*.\.*.. **.**. ..* .\***\\ *.\  .**.*..\\ ..*\. .*. .**. *.**.. * ..#
# *.\.*.* *. *...\*.*..\..* *..... *..\..\.   \**\     . .  . * .*...*.  * .  .#
# . .* ...*. \*.*..*  . ..*\.*. .  \. ...    **.** .\ ...*...*..*. ...*\.\ ..*.#
#\  *\ \.  *.** .*..    .... .  \....\\.** * .* .. .**.*\* .*.**.. * \    .. ..#
# .***. .  ..\  ...* \.*\* ... * *  . \*..*...\ \ \*.. *\*  . \.  * . .* ...\ .#
# .. \*.\.*\. .*  \. . .  . .  .  . .*.. \*  \.. *  .   ..*. ..  * . ..  * .   #
#  \*.. **\*   . .   .\ .    .. \.*\.\**. . \ * . .*\**.\..\.*. *.  .\ . .\*\.*#
#* .*\.\.. . . \\ .  ..... ** \**...\ *\...*.....\.*..\  .....*** \.\.*   *.**.#
#*\ .\\ *..**   *.\ ***. *...*\... .\...   \\.\ \. .\. * *\*..* *..\. .*\.  **\#
#*. .\* ..*.. .\. .  \*\ .  ....*  **  .. *.*\.\..**.  . \*. * ..  .   * . ... #
#.\*. \ .*\.   .*  .. ... *\... ****   * .*.. .*\ ..\ *.\ *.  ...\ . . .*..... #
#\  \****\ . . .*\* *.** .*.** ..*..\  . ...  ..\*.. .  * ..\. ..*. .\ .\ . \ .#
#\.* *.\ .*  \* * ...... ....  .*  \  *..\. \ ....  .* *.****....**\ *.** .. \ #
#...*\..* ..  * .\... *\.*  \.\ *. ..* .**\..* *. ....\*.\.**   ..*\\.\ ..* .. #
#    *.\...*  .\* *.*  * * \. **.* * . **\ \ .\. .. .* \   .\.* . ..* .....   *#
# .* *\ . .. ..** **\*..*.   ... .**    **\.. .\*\\.\*\ *.* *\. ... .*   .*.**.#
# ..*. ..\ *. ..*..**.\ *.     .\ *.*.* ...\*..... . \*.... .*\ ..* \....**\.\*#
#***.*.*..*\ . \. \\*..\*..*\.\* .  . .   \***.* \. \.. *.\ .*....*  *. \..\*.*#
#*. .\ *** *\ .*  .\.*\* . *.  .\  \.. .*. . \...  ..\**...* **\. \\*.\ . ..*..#
#\*.*  *..*.*  . * . . * \ .\* \*. .*\. \. . . *\ .*..\\* .. .*.\*.\. ..  .*\ *#
#... ** *  ...*..\ .\* * ..*\..  .* ..\..* \  .. .. * . *.**\... . . . *.. .**.#
#*\\ ..*\..\. *. .\*.*....*\ ****..\  *\*.*..*. ...\. *..\.*.. \.\.**.*\  . *. #
#*.****   *\ ..*.**.. .\ *. \ ....  **..* \.***.*.\.. .. **. . \.. .\..\ **\.. #
#*. .**..*....*. ....*..*** ..  \ *.\.\\***.**\..* ...*\ **  .\... * .*  .\*\  #
#. * . \*.*\...  *\ .* . . \   *. **.*  .  ..*.* .**.  .*\\*  .\  ...**\ . ..\.#
#* .\\... \*. ..*\. *. ...*.*.\ \*....\** .*.*** ....\. ..** *   * ....*.   .* #
#\.**..* *.. *  .**..*....... .\***..*\.*..\.*...*  . **.  . .* ** .\ **.\*. . #
#* . \.. . . **\ ...\.*\*.*    ..*..\...**.. .  .\  ...*. .*\...*  \*  ***.*   #
#\  *.*.*  .*..* .*.. **.\*\ ..   . .  *.* ..**\**. *\ ..  \ .  . .*. ....*.. *#
# \ .\* **.\*\...\\.\.. ... \*.** .*.... *\  .\**   ....   \  . * ** .. .\* \ .#
#*..*...\**.. .**     *\* *.** .. ......* * ..**.  *\.... . * **\.**\\* *.* ...#
# .*. . ...\\ ..\.   . .*.\*..  . .* .*..** .\ .*. . \  .. \*\*...**  \*.*.  \*#
#\..**  * .***.*.  .*\ ....\ ..    **\*. .* **  . .*...*.* .***   *\*\..\***...#
#. * .\..* ...* \... ...* .*..  .* ..* .*..*.*\. *.. . *.*. ... \ *..*\* **.\..#
#\.. ..  .. ... . * *\ .. .***   * . ..\.*..*.\*.* ... .   . .. .\.. .*....  **#
#\ . .*. . ...\*  *\\.\*.  **..\.. **....*. .\ .. .** \..\  ..\ *.* .\.\. *. *.#
#\ *. \.*\ .   *\**..\*\\ .* ... . .*   *. \ *.\****\  \.* \...*.*\***.*\ . .* #
#*** .  *..  . . .. \ \... *.\. * .*  .*.. . \\ . \...  ...    ...  .*...\ \..\#
#.\.*. *...\ .\*..* .. * *  *..**.\* .*. . * .\*.... \\ ..\.*.. \\** * ... . **#
#** . ..  **  ** ** *.\.*. *\.*\**    \*..****\.** . .....*. *  .  .*. \*..***.#
#\* \\*  *.\....\**  **   *.\*. **.. ..   .... \ . . ****  *.* .*   \. .  *.\.*#
#.. *...\. .\\\. .*\. \   .*.* *.\  *\  *. .* ..  . \.  ..*.**.. \ *.   *..**..#
#.\.* \ .\. ..   .\  .  .  *... .. .**.\.. *\* .\.* \ ..... .** .. ..**.*\*..*.#
#\\   . *. .. *. *. .*.   ...  .*\ .*. * \. ..* ... ..*.\*  *...* * .*\\* ..*. #
# .. *.\* .**.*\.*.\...*\*\ ..  ** \. *. .*\*... .**\.*.*. .*#.\\.\*.\**\* \...#
#*. #. * \....* *.    .. **\. * .... #. *  *\  *.\..  ... * **. ..*. ..\.......#
#\..  .#\.*.. .   .*.  . \ . . .*\.   * .*.. .*.  *. *. \ * \* *.*\**  ..*.*. .#
# #..\ .*\ .*. ***. * * .....  .*.   *.** .* ..    ..\. .*. \ .. \ *..\. ... .*#
#\ ..* ....*.*\* . *. ..\.. .\. ..\\ *... . *.**. \***. **. . .*\  .       * .\#
###*  \ ..\.\...   .\ *\ .*\**.\\ *\. ..\..**.***.\..\*.\\*. **..#***. .\\.. .##
##...#. .*. .\\.. .**..* *..*... *\    ..#\.\#..**.\.*#* ..*.#. .**..  \. #*\* #
#.\ \.# .....* \ \**\****..*.\  ###.#..\.\*.* ..*** *.\.* .##*.. .......#...*\ #
##*.##***. . .*.*.\ *.*\.*.*** .* #.\  . ..   #\.*. **. * *...#..*..**\#\  \*###
##* #*.\.. .\ *.. ..\ .**. .#* .*.#...*.  #\ \*   *#..*.*\.#*#**###* . *#*\..# #
##..\.* .*  *.\ . \*...\   **.  ###.*.\. .#.#.\#* # #.\ # \ # #...#..*.## # #  #
# #\. *. .\*..  * .\\.\  \*...  *# *## .  #*#\..## #*\#*####   ##\#... # #. #  #
# #*\....\# **...    .#\**\.*..\## #  #.## # ##\#   ## #         # #### #. \*# #
# ###*  \* *. .\..\ *.# .*# ####  #    #       #                        #  ##  #
##**. \*#..\  .  ** .* #\# #                                             ##    #
##.*##\  .##  * . \..  *.#                                                     #
# ##  ##.  .  .#\ \.*  * #                                                     #
#     #*. #  ..#***.\ #.L                                                      #
#      ####\ .\. .#\ . #                                                       #
#          #**\ * \###  #                                                      #
#          #.# ####  #\#                                                       #
#          #\* #     # #                                                       #
#           ##.#      #                                                        #
################################################################################