#########################################################################
#. **.. .\.*  \ ..*.*....** .\ *.. **\ *\.*  *...**.. ..\.\* \... . .* \#
# \* .. \   *.. * *.*.\***\ \* . *\..*.*. .\..*.* \.*\    ..\     ..*.*.#
#...\.\.....\*. * ..\  \.*. .... .*\  .*. \.\  **   \* . . *. \.* .*....#
#   \ .  .*..   * \ .* .*.*  *\ .  *.* . \    ..* .. . . .*\ *. .\**  \ #
#\ . . \.\.\ .*..\...\ ..*..*.. * \..\. ..*\*.*.*.* * *\. ....* .. \. . #
#  .. *  .**  .*..***..  .* .  .*\**\...*.* *\.\*\\\\ * * \ \..*  \..   #
#* . \ **  \..*.*... **  *.. .....*. ...  ...* . * . *.*. ...*.\ .  .\\.#
#* \....*.\ *.. .** .\***..*...* ...\   ..**..  **  *...       .\ ..*   #
# **..\ . *\* . \.  ...** \*\..... *.\ *  .. \. \* \ . .***. .\ . ... ..#
#\..\ *...***\ .* ...* \.  *.* \.* .**\ .*.\  .. .. ** .*..* *..* \**. *#
#.*.. *.* .....*.. * .   * .\.\. .*....*\.* *.\ \..\.*\   \.\\   . *.\..#
#\. . \*  *. *\**\***\.\*\.*.\ . .* ..*.* **. .*.\...\  \...  .. . \ .. #
#..  .... .\*...*\*..*.**. \ .. . *.  \.. .\* *..* *. . *..  ..**...* \*#
#\..\*\  ****  *.*** .*\..  .*. \*.*.\.\.*  . \. *.*\.\...*   ... . ...*#
# .\ .*\.\\ *.  **\ * \. \\ .*. **.**.*.*\.   .* .*.. **.*\..*..\. \  .*#
#  ..*.*   .** .\ . .  *.** *.    **  .*. .... .**.*  \\\.*\ ..*  *..* .#
# *\ ...  . *. ***   \*.. . ... * *\ ...*. . * *.\**..\. *..\ \..\\ ..\*#
#.*   *   \.\*.*.*   ..*  .*...\  ..\ *. * \*. * . \ ...*. \.   . .. * .#
# . . * ... *\.**.   *\\  .\* ....\\...*.\ .. ..   ..*  ..  **.* \. .  .#
#\**  \...... .\..**..\ ..... .\*..\\ \*. .  \.. \* \.*\ *  .* ... . \.*#
#.\...  . * *.\. *.*.. \\\ .... *.* . ..*. \.*.\. \.  **.  \.**.*. *.. \#
#   ..  \.  ..*.*.\** \. ..**\...*. \ * * *.. *. . ...**..*.... *   \...#
#\*...\* \. \ \.\...\ ..  \.**\. *.\... . ..\ ..  ..   .**\ .  \. * .\  #
#.**\..\ .**\**\ *** \   . .*\ .*\*\  *\* ..  ...\ *   .*...*\...*.  . .#
# ***.    *\  *..*..\\.**..* ****.*..\..\.****\. *.* .. *\\ ....\**\.* *#
#\..*. *..\ *..  *...  .\  . .*.* .*  .\**.**..  ..\    .** *\ \**. *. .#
#     *\. . .. \.\. .*.*.* ..**. . ..****..\..* * \ .***.*. .* .\. *. **#
#**** ** .. .*..* *. . ...  *.*.\ *. *.*\*\.\ * . . .....*.**.  ........#
# .**..**\\ \.  . ....* *. *\..**. ..... .      \...\.     *... \.*.. *.#
#...* * *  .  .. ....** .  *.*..**\ ...\*. . .\ . *. * *** *   *\..\  .\#
#\...*.\ *\ \* *\.***..\ . \ ..*..   .\  ...  .\ .*.. **** .   .  ....*.#
#*..\* ... .*. .*..*...*..*..  .  * \.\..*** ..*  *\ **.**\...\* \* * \ #
#....* .* ..  . \ . .*\* \.\\ **.. * **.\.\.  .. *\...\...  *\*   ...\\.#
#\..** *\..*. . . *\* .. .... ...*\.\.. *  \\ **..   ..  ** .*.  .  ..\ #
#  .** *. ..* . *..\*\     **    \ * .\.. \*.\\....\\.*\ \.\ ....***  \*#
#\.* .\ **.\\\***\\\* .. *...  *  \.* *\. ..* ..**.\. .   \.. * \..\ ...#
#*\.  .. ...\..\*\ .  ** \.\.  *.\ .* . \. ... .\..  \.***. .** ... . \\#
#.*.\* *. .\*.***.\ \*\. .. *\ .*. \..**. . *.\..\.\*\. ...   \.**\*\\. #
# *. *.\\  .\ .*.. ..** \\... .\** . *.  *\ .   \ .  .. *.... ....*.\ . #
#.*.*\*    ** ...*.....  .\.\ ***.. ...... \    .  *** **\ .. **.\. ..  #
#  *\..*.\.*\. ...\ .... . \  .\\.*  .. .. .   \ . .\ ..***  *.*\*....\.#
#.*.*\..* \*.\   .   *. . ...\**. . *.* \..  *    \.....\*.*..*...\ *\* #
#\. \   .. . **.*\\.\.*.\ .*. ..\.\.. .*.\.  *\*\\.   \  .\* *..  ..\\* #
#*.  \ .\ . ******\.  .\ . . **. ..\ \*.  *..... **** ...  .*.     \ \.\#
#.\.\ .  .*...     .* .\*... .* .. **. .\*. .\...**..\..   .*\ .* ..**\ #
#.. ..\\   .\  ** \*.\**.*\ ..*.   * .*\ *.  .\. ..*..  ..\..   *\  . . #
# .. \. ...\ ..**...\.*\ .... . **  . ...  \. *  . *.....\. \**.\ .*. \.#
#...  \. *..*.*.\ *\ \.  .\  .  .\. ....\ .\*  *.\....\ * * .*\.  *.* . #
# ...*   . \....*.\ *.\ \ **  *  *..*\.*..* . ..*. * ..\...*.. .. . .\.*#
#... . *.*\   * .. *    ...\\.  .*\ .. *. ..* *..\.\\.\... .**\*\ ..\.*\#
# * .*\ .\..**\ .*..\.*.\. *.\   .  *.  *.*\...  . .\* .\   .\.....*..*.#
# .**.  ..*\.\ . .* . *   *. .***\*\ .  .\.*\*.  *** .  ..\...  \  \. ..#
# ..\**. \..  .*..*  *\.* *.  *\* .. *.. . ... *.\..\.  .  .   \. . \.* #
#. .*\**.  .\ .\.\.  .  . .\..*.** * ...*\ .\*\.*.\..\...*\.    .\.   .\#
#\*   *.\*  *.\* *\\*  .*\ * *\ .\*\* \*.   **\*\ * \.\ *. .* *\ *\ .* .#
# .. \. ....  \.** ....*\  .\*\*  . .. .\.. .** *.\. . *.. *\ .. ** \ . #
#..\ .* ..** \  .**.*\.*... .... * .\ . *..\ *\ . .*  .... .. *\\..\.* *#
#* **...*\.\\.\. \. . \.*.* . . .. *.*.. . ....\. *. *.  * \*.\ .. . ***#
# \. .\..*..****.. **.. .**  *.   ..\.*** .   **.  \ *.\   . ..*.*  ....#
#.*\.** \*. .* .\\ .. \.*.*. . .** *..*\ *.* **.***...*.. \*\ *\.*... . #
# .. **\. ..*\. .\.\*....\  . \**...* \*    .*..... \\.. *..*** ..  \.\.#
#\   .*.* . .**.**  *\.\*.\*.\.* ** .....*   .....   *.  . . ** * ... *.#
#.* ..*.\. \.*.  *  .. .. * **. .........**.\  \*\ **.* *\ . .. *   \.\*#
#..** *..* ... .**. \....* . .*.. .*.\.. .*\* *.   ..\.  *.*.. **   \. *#
#\. *\.*..  .  ..*   . . .  *\*  *\* .*   ***..* *.  .\.\* .*..... * . .#
# * .. . .*\\.\  .    . .*\ *..* \ .. .  ....\ * *.\***\ * .*** .*..**. #
#\\*.\ *.*... ...  . . *   ** *. . . .*.  *.*. * *. . .\\ ****\ * *  .\.#
# *\*.*.** .  * ..* \  .\ *** .** . \\..* .\.*  .*.* .. .* *...*\ .\  *.#
# ..*** . ...*\  \*   \* **.*\ .* ...\*....  . ..* ..\. \*** \.***.**.\*#
#  ...   \ ..*.. .\.. .*.*.*..  ....**. \**.\   \ .    .*...*.\  . .* .\#
#\.\ .*..\..*. . ..*   .\. \.\.\*\ ** * ...   *. .\..*\*.....* \..\*..\.#
#. *  \..* *...*  ...* \*.\\\ .**.*..\*..\* \ .. *** *\*. \... .* .* \* #
#. *.*.\.**. *  .\.\ .\ . * ..\..*.. . * .. .\ .\*.  ...* .\\*. \  .  .*#
#*..\ .**.. \ .** ..  * *.\ .      \\* *. *. * . ****.\..\ \.. ..  \  *.#
#\  .....\   . .. \** . *  . *.\** .*\ . \.\ \*  ...*.    *..* *.**. \.*#
#.*\ *. *.**.   .\*.\.* .\ *.\ \.* \. \ . .\*.  *.\**. .* .\.. .*...*.  #
#\.  .*.*.*.*\.\ .\. .**   .   *.\ \ ...*  \. **. **\*.\ * *.**....*.. *#
#. .  * . .**  .\..\.\.**.\*. ....... .*... \.\\...**.   .\  * ..    *\*#
#.... * .\... \ . . *   *\.. * *.*..  .*.. *.\. *. . \.**.\  *     * .*.#
#.\.\.\ *. *  . . .**   \*\ .**.\. .  \*. . \* ..*.**. .*. ... .. .\  . #
#..  *.\.*....  .\*. .  .*.* *\*.* .  . \*.\..* \  .*..*\.*.  .  * . . \#
# *.** * *\. **.. \  *** ... .*. .*.   * .***\. ... * .** .  **.**\***. #
#\.\...* ..\.*.\ \. \*\.  *.. *\ *..*  .*... *\*\  ..*.. \..**.\* \** \ #
# ****..  **..\ ..\* ..  *. \.  .. *   .. ..\.... .. .\. ..* . ..\..\\. #
#.. .*\..*...\..** .\ \*...*.*... *.. .  * \.*.****  * *.. .  *.*  ....\#
# *.**.   . .\   \.    . \ .\.\ *..\ .\*\*\.*\ .***.*... .\.\.\  .    *.#
#.*..*.. . *  .. .*.. . \.    . ..* . *..\. ...**...  .\  ..*.. *.*.**. #
#\*\*\ .. *.*.\.. . ** \ .*. **.......\ . . .*\*\  .** .*\ *..\.* *.\.**#
#. *. ..   .\ .. *.\* .  \*.. \  *   .\*.. .*  .\ ....**\.\.. *** ..*.*.#
# **\ \.  *.   .    * .. .  . * *\.\\... *.*. ..  \ .*.\..*..  .\\ *....#
# ... * . ** . . * ..   *.  . **. \... \*  *..**. .. ...\.. . *\.. *\. .#
# \.  *.\\... . ..\ ..\ *     .***..\* .. *..\.. * *\ * * \.\. .. .** . #
#..*\ . .*  .* * .. .\*.*..\ ..\.. *  *.\ . . \  *  *.\ \ ... .. \......#
#.\** .* *.*. ...  \  .\..\* * .\ .* \.*.* *. .  *.  ..*.\*\*.\  .\*..  #
#\.*. \. ** \*..  . *\*.*..*..  *. . .\ *. ..\* .... .*. *. **.... \. . #
#.*   .* *\ .. \*. \\....*..*. .\..*  . \. *  \. .*.  *\.\ * \**\. .*** #
# \.****.\  .*..*.   \\.**  .\ . . .   ..** ..   \.*..*\..*. .*..  **\. #
#\. .*...***.\.*.\...*..\. .  \ .*.  *\*\.** ..*...\ **   .\ *.**\.* *. #
#  \*.  *..*.*\.\*.  *  * * \..* \\.*\ \.*.*\.\.* .  ..... . ..* * * *..#
#\*..\\..*. .  *.... \. **...*.\.** *.\.  .....**\.\ .   ....*\... .....#
# ..*.   .\ *   \.\.    * * \...\ * .* *   \*  .\*. **\ * \ * *.** * ...#
#\  . \  \* *\  .\   *  \ *  .  .\. ..**. * **  .\. ***** *..  .. .\. . #
#.\..\    * .. . * \..\* *\.   .\.*.\ *.*\.*.. \..\..*\** \** *\*** ... #
# * .*\.**. \.. .\...*.*\ .   .*. ..*.. .\ \*\*\.  .**... ...\..\*.*  *.#
# \ \.*.*....*  *.  *\***.\. **** * ...  *  *** .  \.\..  **.  ....*\. *#
# .\.*.\  *. ...**   *......  ..*\.  *   ...\. .  .....  *\\.*.* .\.* * #
#\ * .  *..** *  . \.**... *...\..* .  *\ ..*  ..** .*  *....*..\ .  ...#
#... \. . ... .*.\*.\..*\. \...*. *.* *..  . \.**....*\.\ \ *.\* * .\* .#
#* * .*  ..\ .* ..  .  *. \.\. * \*.. \..   \ *..\.\\* .* \*.... .*  \ *#
#...  *..\...... *..  \.  .   *.  .**..*\.. .. .\**.\\**.  .. *** .  ...#
# .  .* **.. .*\*.\.\.   ..* ..\ ... . ***.. ...\.\\..**... \ .*.. ** ..#
#    .. *.... * . ..\ ... \* .. *\*\  ...  .  *.*   \\\ * \ ..*..\*.\ **#
# .*  .\.* ...... ...  \ *\*.* *.\..\  \  \. \.\*\  *. \.*    .  **. *.*#
#  *..\.*.\ \*. * .*  .... . * . .* *  ..* .   .**. . * ... ..\ *.. ..*.#
#.  **  ..*\..   .*\ *   **.* *  ..\. ....\. .. ***  .\ .\. **....  \.**#
#**** *\.\.   *\ .*  *\ \ ... .  *\* .  .*..\.  *.. . .\  * *..\  *\ . \#
#\..\ .. * .* .**..\ * . ..*.\.. * *\..*.\.*....\***. . ... ..\. .*  .* #
#..\... \* *..\*.*  .**. ..*\*.  .      .** * \ ***..*\. *..\**\.  \   .#
#.*\.*. *\ .*\.*\..**.*.\  *.. .. * *.*  *\. . *.*.* *. *. \..\. *.*.. \#
#*....\  *. .\* *.**.\.\.\*.*.. .*. * .** .*.. * .  .* ** \. ..\\.*. .**#
#...\  **. *..* *.  \  .*.. *.\ ........\ .***  .   \* .  .*\.**.*.\. ..#
#\* .\  *  \* ...*  .***.\ *.*.**.\..*\*..*.\* .*. \  .*. . . . ..\. .. #
# . * . .** ..  \ .*\.   *.  .*.** ..\ **\.**  . .\*.\*. \ *\ \*\    * .#
# .** .  ..*.....\\.  . .\*. .*\..  .* .\.. .. ... ..*.\ ..*..\\..\.\*. #
# *.* * .*.*\..  .  .*  .\.* . .* .* .. ..  \\ .**.  . **. \.** * .\.* *#
# ..\ . . *. *. ..*\ * ..*\.\.*....  * \*.\.*\ *.\...\.\. ..\.*    .\.\*#
#\ \.*.\\*.*.\*.*.  .\  . *...* .*\.**\ \.\.  \.\.  *  ..   .**\..***.*.#
#** *** . *...  .*  \* **  . .\...   \...\ .\ .* *.*.\. \    .*. ..  ..\#
#..\*..**.. *  .*.** . \**.......\\  ..\..*. * *.* . .  .**. .\.*. .*.*.#
#.****\. .\ \ .*..*..\*\*.*\\  *\. .\*.*  .. .***\. .\*\. \   . *.  * ..#
#  .* .\  .\.*.\.\ *\*..*   ..*. ** .. \. \   *.*.   .\*.\..\. \\.\\.  *#
#  \.*\.. .*.\*. . ...... ... *. .\...**\  . . .\ .* . .. . . ... . .. .#
#*.  *.\ ...\****  . \*...*..*.*\ \.  .. ..*.*. ..*.\.*\**\. \...\.*\ *\#
#* .\.\ .*  ..\* .* . *.* .\ \  . . ....\...\*.*..... \ **.....    . .*.#
#\* \\ .*  *....*..... *.\.*   *.***    \ .* . .\*\\* . \.**\ \.. . ..  #
#..\ ..*.  .*.. .... \*..** \*..*\*.  .. \ .  .* \.\.\**\\... .. \* .   #
#\ ..*..... . .   *   ..\..    \. *..\.. .     *.  ** .*\ *\ . .\ .*\ ..#
#..  .*.. . *.* .\. * .\ .\..*\.... . *\ ..*...\   . ... .  *. *.  * *\.#
#.....*\ .* .....***. \..\. .        .....*  .  ....\  \* * \\ . . .\ .*#
# ...*..* .\. *   .... .   . ..***.  ****..       . .* ..* * ... . . .. #
#.\*\ \.. ***.. .. * .*.*.\. \.*.* .*....   \*.*\. * \.\ . \ *.*\*... .\#
#. *.\..* .**\* *\ *\ . .\.  . ... \.\.*\*.. .*... .  \   ..*.. ** *  ..#
#\..*   .. *.*.  *.. \  \* *\ \..\ . *.*..* ..  \ \ .\*  ...** ... *.\  #
# *    .*.*\.. . .*. ..  \ .**.. * ..*\*.\...\ *   .*.\\ .* .*  . .\.*.*#
#*.**\ **..  ..*.*.*\  *.. ***.\*\ .\ *.\ *.\ \**.\*. .\.  .*.***  * *..#
#**.....\..*.*....\*.** .. . *... . *..\ * *.***.. *\.\***\* **.   \*. *#
#...\.. .  ..*..... *..  *  *.\****. .*... **\.* ..\*  ... . \* \*.*.**.#
#*\*   .\.  ..* ..\*\ **.*.*.  .\.*\  .  *....**\ **.  \..   . ...*.*..*#
#\*\  \.*   .  * *.** ...\..  .*.*.. ... .  \**.\.\*.   \.\\* .\ .. ** \#
# .**..\. ..* \.\ .*.**.\*.*.\ * ...* .. . *..*.* *.*..*\ * \ .. .. *.  #
#* *\ **    * . **\  \  .\.. .\..** \  .   . *.\. .\...*  . *.* .   .*  #
#\ . *..\...*  .\.  \. .\ \.. . . .   .\ ..... ..\ . . ..*..* . ...* *\*#
#*  \.*  *  ...\   . .\    *.* \..*.*.\.\*  *  \ ***.. .*.*.*.   * . . .#
#. * .  *.. *. *\  .. .*****.\... *...* .. *.\.. \*\.** *..\\*. . **\  .#
# \* \.  .\  *..  .* .. .. *.  .  **.**. * **.\*..**\.. .   \.  . .\..  #
#*.*\\.\*  .*.\**  .**\  \**\.. ..*\.. *...* *.. \.*.\.\.*.\. *.* .* **\#
#.* ...*.\ \****...*.*\. ..*..\.*\...\ . . . **... ...** ..*.* ... \**\*#
#  \. \ ** .\\.. *. ..*\.\*** * *. \** *. .\.\ *.*\..... *... ****\..\* #
#.  ..\\*  **.\..\. \........\ \. \\..\... *...\ ***. ..\.  .\.** .  *..#
#..*\.* .*.*..  . ....*\. *.. ... .\**..**.\.**... \***\ \. *... \  ..*.#
#.**.*...  *** . * * ... **\.*. .\ .... ...*\.  . .. *\ . ..*.  *\.  ...#
# .\ ...  \ ..*. * \ . *...* ...      .*.**..*.   . ..  .   \  .***\ ** #
#. .. \*   . \   . .\.* .*..   . \ . * .*.  ...*\..*.*. *\***  .*..  *\ #
#\*  \..*.\ \ ..*\ \ \\*** . *.\\... *\ *\\* . *.*  ..\  ...\.*\.*.. .*\#
# ..*.* * ..\ ......  .. .*. .**  \.\.\.*.\ . .*.** \..  ..  \  ....* *.#
#*. .\**\*\ **\   ** *..   * .*.*.. ..\.*.. . **.*...  **  .. .  ***..  #
#* .\. .    .\ .\ \. . \.\. .\. .\* .  ..* \ ..***.   .*..   .\* .*. ...#
#.\  * .*\..  *    ** *..*. **......* .*.**.***. .* * *\\ .**..* *.\ ..\#
#*.*\.  ...\.*. *. ** .*   . .. .\\  . . .\.*.*.\*\.*   ... ..\. .*\. . #
#. *. .* .*.\.* * \   *.\*.*\ *\.*.. \**.  ..  \**  **..*\*..  . \.. .\ #
#\**  ..\*  ******..*.\. . ...\**.*\ .*. * . *\.. ...** .  *..***.\*  **#
#**\.\   ..*.**\*\* *\*. *.*...\ .\.  **.\ . .. * . *** ..*.*\*.\*..  ..#
#*.. .  ..  ..... ...*\..........\*.  ***. \    . ***.* \*. .   ....  .\#
#* ..* **\.*..**.*\\*.. .\.*\..*  .\  .\*.\. *\*. . *.. ..  \\* ..*\*.*.#
#. .. *.* *.   *.\ ..\** ...  ..   *...*. *  ...***\ ...  *......\\ .** #
#\..**\..*.\.  ..*  .*..\\.*.*.\ . * **.. ..\..\.*\*.*  \*...*       .  #
# *.*.. .*...\.*. *.... *....  ..\.*..\  .  \ *...*...**... \. . ... ...#
#.. .. .. \  . *..\.\.***   * * *.\.. ..\..* .*.*.* *.*.  ** .\**.\.  . #
#.* .\  ... .  .*.*.   ***. \ * .**\.\ \..*. .... .\..... .\  *** ... .\#
# . \.*\   *.*\ .\.\ ****..*.*. ***. .....* * ..\ *.*.*\\ *\..**.  .. .*#
#.* .\*....\ *. .** ..\ . ..*.. .*\*..*\ ****\.* .\**.*.. *\.\. . . ..*.#
#\  ...\**.  .\ \*.. * .. *.*   \.***. .*\...\* ..**. .***.  . ... \*..\#
#*.  *.* .* .... .. ..*. .  .. \... . . \ . * \.  *\. .\ . .*\\. * .\.  #
#*\  \*.*..\ .\. *..*\\\ \ . .\.*  ..\  . . . .\ *. .  * *..*.. \. . .  #
#*. \ *.\*   .*** * .    .\* *. ..   ***. . *.**.*. . \. .\..\.\ \  \\..#
#.*..*.*.**\\ ..\.* \ .*...*** *. * \* .  ..\\.**.   *.. *. .*.. .\*..*\#
#    ...** ..**  ..  *.\..*...*. .\\ . *. \*.*\.. \. ..*...\*\ *.*... . #
# *   . ...* *. .\. .**.. **... .   .*\ . .*  **  .* \..*. .  \*. ** \* #
# *..  . ** **\ *..  **.  \.*\\\ *.\ .*    *\...  .\  ..\ ..\*\.**\.***\#
#*.*.*.*...*** .*.*.*.......**.*....\. *\ ...    .. *.. *\ ....*\..\....#
#* . . . ..\.  *..*\\*..*\* *\*..**.\ \*.....\.**..*. \\\ ** .. *  .*   #
#*\. * \ .\   . **.* *. .*.\.**.\*.\. * . ..\.*.** *\*..* \...*.*.* *  *#
#**\..\ . ..\.  .\.. **. *.*... ..\ ..\ \.\. .. ..*.**  .. .. . ..  ****#
#\..  *  .    *.. .\ *\*..\*.*.*** *.\**...*   ....*.\...*   \ ..\ *...*#
#  *.*  ....* *\***\.* *.. \*. \.*\.  .. .\.  . .*.*. .*\**..\.. \.\  \\#
# .. . .*\. * ...*...  ..** ..* \*..**.\.*.  .*..\..  *.....  .*.**....*#
#*.\ ..*.. . \  *. .  \.\.**\ ..* \**.**.**  ...*.*  **.* .* **. \..  *\#
#**.  \..  *\  *.\. . .*.*.*  . \ ..\\...*  *. *....* . . *  . ....\**\ #
#.*.    . \**.***.  ** .. .... \ *... . .*  .* . . **.. .*.*\ . .*... . #
#\....   . .. *.\ .*\. * **.*\\.** \*\ .\...*. .  * ..\* *..* .  .\.   *#
# . **\. .** \*\ .     ..\. . .*.*\.\. .**\.\...* .\** *\.  .\  ..  .\  #
#.\*.* *. . \\.*..*. **..**  * .**\ .. *.\* . \\.  . . . *\ . ... .  .  #
#\...* *\.\  .** \.. .\ *.* ..\..   . .  **.  ..   . .* \..***\*..* . ..#
#*.\.* .  .   **.. .  .. ** ..  .. .*  .     *. \ .  *....\...*.. **.. .#
#***.*.\.*.   .*..*.. . \\*. \\. .  * **..* ..\ . \. *  \.. \ .*.\... .*#
#.*.\.  ..\*\\\.. .*. *\. . .. .*\**...*.*...\.....  ** .  . \..**...*\\#
#\.. . \* *..\ ..\.*..* *.  * .\. .\ * . **\ * \.... .. \* . . ***. \*  #
# *\  * *  * *  ....\ .. ...\  ..*.   .*  .    ..\ .**.*. .* \\ ..\*\.*.#
#** .*...  * *.\ \\.   * \*..*\....\ **.\*\\.  ** * *. *.  .\ .  \*. ...#
#. \   ..\ . \.. .\      .\*\.*  ..**... *... . \\. .\ *.\*.  \ .. *.*.\#
#  ..\* *  ...  .*..... . *. .*.. ...\ .\***.  ...\\.* ***. ..   ***....#
#  *.*. .\ \   .* . .\**\*\*  *.***.*...*\ \ .* *\. .. *.\*\ \ .... **  #
#\*.\...*\.*\.  . \ ** .*  * .. ... .  ..\ .* *.\ . . \.   *\ \  \\\. . #
# \.* ..   *.. .  ...* \.* *    .*..  ....\ . . ***\ .\** *..\.* ..\ \* #
#**... *\..\ *. .. *....\\ *\** .\ *  **. .*.*  .**.*\ ..* ..**.  ** *\ #
#.\.\ ... **.*..  *\.\  .* . .. ....*  *\*.* . .*.....\ . *\**.. * * *. #
# . ..* . .\\.* *..     \.   ... *. . ..*\*. * *\ .  \  \\* ...\\ \. \**#
# *.*.  * ..*.  *.  *\*\ *\  * .  \.*..*\.\ .***. ...   *...\** *.. ..**#
#.\ *.**.***. . ..*..**....  . * *.*. **.\  \.\.**. ..\  ....\.*.   .  .#
#*.**.*...\*.\. .*.\ \ * ..  ..*..*..\.\ * \... .* **\.\  *. ..*  .\.**.#
#. * **  . .\ ....*.. ..**.. .\.* .\.\.. \ .\..*.......\... *...*.\   * #
#  * ..\...*.*  *\*\ .\.* \. *  *   .**\*\ ..  \\ .\.\  . *\... . .**  *#
#..*. *    . *. .*.\    .*.***\..*****.  . *\\*.**. .*  \.\ *. .   *\*. #
#.* .*..* *  \  *.... \ *.\**.\. **.. . .\ * ..\.*. .  .   ...**. .\ . .#
#\*..\.\. .**..**. *.\. . .. . .\**  ... .\*\ .......\..... \..* ...* *\#
# * .*..  *\*  .*. *.** **  . \.  .\.  \.*...... ..     \*.\..\\ .   .. #
#..* *  .*..   ...  * ....  **. \.*. .\. .* .* \\*. * \ \. ..***\*   .\ #
#...\.\  . ...** . *.  . *.  \. *\.*...*.*.\ *...\...*...\ **..\*..*...*#
# \ .. *.*\ *.\\\. * .* .*  .\ ..  ...\*..  \.*\\.\. . * ..**.*.*\ ... \#
#\. \**. .***  *. ...\.* .. *....\*  * *.*. ...*. .*.\.*  **..*..* . \. #
#..*.*..*.. .* *.   .  . *. *.  ... *... \ *\.. *  .*\*.   *. ..   .. * #
# \..\  .*..** *..  . . .**    .*.\  \.  .. .*\ * ..\...*. *  \ . . .**\#
#  * *.**. \....  **  ...\.\......**.....\  *.  .  ..  \\** .\..* *. .. #
#*.  . .*\.   .**\.\.*.  .\* . .*\..\* .* \\*\ . *\*.\***\* \ .\.\*.  * #
#... . \..\ \  ......\*   .\ *.*..*...*.\*..**\ *..\\ \*.  *.* .  *. .\*#
#  * . .  .  .\.. \..****   *.*. .*  ..*... .. .*\ .. ***...*.\\**..*..\#
#  ** *.*  \ *.*\.    *..\ \*. ..\ *\* .   ..*\\* .\ .**.***\*.*..  ..\ #
#\... ..*. . *.*.. .* . \.*...   *. ..    \...* .. ...\.....** .* .  **\#
#  *\*  .\*   **\*.\* *..*. \**. ..*.*.  \. .\. ... .*.*.*\*.* ....* . .#
#. *.*.*... \ \**... .\.\  \ .\* **..** *.  .* .\. ***  *  **.\ * *\\ ..#
#* **.**.  .....   .\ *\.*\.  .* \. .  *.**. . ..   .*...*  .  **..*  ..#
#\ .\\... * .. .*.*  . *.\. **.* .\..\*.\*** .*\.**\.. **.. ....\* .** \#
#...  \\  . .. . .*.***.*.. *..  \*.    ..**. ..**........*.  * . \ .  \#
#..   . .* \.   \.\.*. *.\ ..   ..**. *......* .\. *\   \..   .  *.  .**#
#\ ..\..  .\*  *.*. ...\*   *    .\.\.  .\ \.. ..  .** * \  .. \ .\.* ..#
#* .\ \ ..* .\ ... .*\ .  *.. *  ....\.*. **  . \**.\*.....*  * .*** \. #
#....\..* .   . \* *. * *\*. .. **.  .\.\\ \ ..  *** . . \*  \.*\. ...  #
# . . .**. *\..*. . * ...*\* .\ .* ...   .*...\  *.. \ .\*.\ . ...   .\ #
#\.\ ..*\ \..***. \ .*... . . *...\..  \...*.  *. \. .. .**. .    .  . \#
#* .. **. . \... . ..*.\  .\  .*... . .\*.\..   .*..* \* .\  * .  *** . #
#*.*...\ *.  *  \  . ..*\.** \*\..\* *.. *.. *\.*\**R.*\..* .*.* ....*.*#
#*\... * .*\* *..*\ \ .* .*\  \ **...  .*...*\*.  . *..  ..  .. .  .*.\*#
#* * ..\  .*. .. ..\   .* . \.....\\ .\  .  * .**. *.  *..\.  .*.\.\*.*.#
#. . ...\ .*. *..*.* .* .  . **.  ..\*\** \ .\* . ..*.\  \ .\.  *.. .*.*#
#.. . .  **.**\* *. *\ ... * \.*\ .\ \ .**.**   .. .  ..* \.*\****.*.* .#
#\\***\ .*.**. ...\ * . *\.\ *..* *. ..*.*. . *  . .. **. \\..*.\\ .  \ #
#.\.*..  *.\.  *....* .*.  ..\*.. ****.* . *\...\*..\ .** .. *.\  \ . .*#
# ...\..*\.  \ .\..**  ..***.*   .\.\. .\  .*\ . \. ...*  *. .\ .. ..  .#
#*  \* \*.*  ....   * \*.\..*.**  .\. ..*.. *    .*\ ..\*.\.* ..\...  *.#
#.  \ *. *..\. .** *.  ****\. .* . .\  *\...* \\.\**.\*.*. .  .  *   *. #
#. ** .. .*\.\\ .\  \* .* \ *.*. .  \\.  *  \*\.\ ....\\**..\ **. .*\\ .#
#**.\    *.*\ *..*...\  \*.\*\***..*... ..  .   *\*.*\ *.* . .  *.*\*\ .#
#\*   .  *. .   .\ . . ..*.  * *. *.*\ *.   *.  .* .  .*... .\ ......***#
#  \.**..***.* *..\   *. * **..\ .*.\..... ..\*\ ..*.  \.* **. \...\*..*#
# \ \... .*..\***.* . .. * ...*  .    \*\ *  .*.\ .*  .**\...    .** . .#
#\  . \*  *\ **...*..\\****..\ .....*  *. . .*. .. . .\... .* \   ..    #
#\ .* ..\ *\.*.*.*.*  *.....*. .. . *. . .**..\   ..*. .\*\ *.  *..***\ #
# ..* \   \.....*..\ ..*. . \*.*.  .* .*\ *\     ..\..*.*\  .** .*..*.  #
# ..\...\* . *..*\.**\*.... .\... **.  \...\...\..* \ ..** . .*.\*.. .*.#
#\.\. *.   ..***.* .... ...     .*. *\.. .\*. ..\ .*\*\... . \.*.\.\. . #
#**.\ .\* \. **\  *  *..*.*..  .\.*..*.\.. *.\ *   .   *** **. .\*. \ ..#
#..\   .* ..*.   *.\*\  *.\*\.*.. *  * .* . ...*.\.*  .. *\* \ .   .   *#
# *.\. ...  ..**.... ..*.*.\.*..* .... ..** .* .*...*..  .......\..  \ .#
#\*   *  *\  *\.. \.\  . * **...*..* **. * .... .*\ \ ..*\.*.*\..*..* .*#
#*.   *.*. \*\* \ ..* \* *\.. . *\.*...*..**    .*\.   . *.*.....\ \*. .#
#* \***..\..*.*  . \..**.. .\..*  ..  ** *.**.\. *** .   ..\**\  . ..*\.#
#\# . ..*.\.  ..* . \ .   .*.\ .* *..*** \....\ \.\ *\. .....\*...*   . #
## *.*. ** *   \ \....*.. ..*.. .\.*\.** ..* ....*. .. *** *   ..*. . . #
#\*\ \**.**...\. ..   .. .  *\*. ...   \ ...  ..... .*.. * *\ .**  ..\  #
#  **..\\#. *.. .    .  ** .. . *\  \**   .  . .\.  *. .  *\ **\**.****.#
#.\ .* **# #.\   * .   \*.... *\ ..  \ ..*\ *.*..*...*.. . . \..  .*****#
#*.#.#\#* \*\  ....  .. .\* *   *.  . **...   . .*.\*\.. *.*  ..\* ....*#
## \# ##\\.. \ ....*..\\ . .. **\.\.*..#.*\. ..*..* .**  .\  ... .   \ .#
#.\ # #*. ..*..#  ** . \* #...\\    \ *..#**  ..* . .**.\. .* \..* .*.. #
##**#  #*\  * \.. ...*. ..#.#**.  .#  \. ... ..\\  .**...\  *\.***\.**  #
# #*# # \. \.. #.  .\.\#*** *.. \ #*.### #..**# * \ .\ ..    #**.* *.*  #
#  #  #\. . .# ..  .##*##.###***.*.##  # #*### . *.  . . \#*.*.\.. *# \.#
#      #L.*.*.\ *. \.##  # # \.*.** .# #.## #   #.*.*#* *.****...\.***. #
#        ###\* \.*.*.\#    #\.#.#.###   #   #*.. *\***.. *\**. .\ *.....#
#          #*.##\*##*#      # ## #          #. # .\ ** \ ..#  .*.*\ ..#\#
#           #. #  .##        #              # #\  .   .  ## #  ..* \.\ .#
#            #\  #. #                        # #\.#*.#\#  #\.*.\* * *.  #
#           #*.\.##*.#                          ###.##.\###**..##\*.\#\.#
#           #.###  ##                             #.# ##   ## *.....**.##
#            #                                     #         ###. . #*.##
#                                                              #*  # ## #
#                                                               ##.#    #
#########################################################################