################################################################################################################################################################
#                  ## #                                                                                                                                        #
#                 #*# ##                                                                                                                                       #
#    ##         ###*#.#.#                                                                                                                                      #
#   #. #   #   # **.# . ##                                                                                                                                     #
#  # \ #  #.# #####\.\ \. ###                                                                                                                                  #
# #* . ## #\##.. #..# ..###\.#                                                                                                                                 #
## #  \.*##*#\.# . *\ * ## * #                                                                                                                                 #
# # . .  . .*.*  *.. \*.###*#    #                                                                                                                             #
#. #..   *.** . *..\  *.*.  .#  #.#                       ##                                                                                                   #
#\ \ * * ... *\  .\ .*\..*. *#  #  #     #               #.*#                                                                                                  #
#..* \ .   **\.. *\.  **....## ##.*## ###.#  ##         #*\##    ##                                                                                            #
# .#\.  \*.... \ ..  \..***\..# ..##.# *#..##\ #      ###*  *####. #                                                                                           #
#*** * .. ....\.* . .. *.\. ...* .#  **#. .\ *. # ## #\* .\ .#\ .#\ # ##                                                                                       #
##\.\.. .  ...  . . . *..*****\.***\. ..*. .   . #* #**. .\.\\ .. .  L *#                                                                                      #
# .*.  . . .  ***.. .****.* \. .\#*\.  \.  **.  .*.. *\.**\. **. *\.*\ # ######                                                                                #
#. ..**\  ..*....* .\..*.  .* .*.\ . .*.\##.# ** *  *.* .. **.. *.*\.*.##..\*\ #                                                                               #
#\  .. #..  *.*.. \**. . .* ..*..*.  ....* .*...** * *.##  ...* \.##.* .\** #.###                                                                              #
#.. .  \ *.  \. .. *.\  .*.. \* ***\.. **.***. **\ \..\.*\. *\. \#  .. .*#\# ##.*#                                                                             #
## **.*. . \ ...   *. .*..* . *\*..*\\*\.* ** ..\*\. \**.# ..*..#*   *\ *.  # ##.#   #                                                                         #
#...*..\*  *.\ * .*\ *\.*..*R  ...\.*.*\*. ...\ .\ *  .**\. \**   \ \.  .**\##.#.\# # #                                                                        #
# .*..    .*..\. *.  \ ... .. ** .* . .\.*..*. .***.*. \.\. ....*\. *\. .#..#.....# # #                                                                        #
# ***\ .\*    * ** \\. \  *...*.  *  . . ...*.*.*.*..... .....* . ..*..\  .\..# ##.##\#                                                                        #
#.\*.*.\..\..\.**.*.. \  *.*....   .*\ *. *\ ....*.*\.# \. *\ .   . * * .\*... .\#..*  #                                                                       #
#.*\* *. \ ..* .*.\ .\.*.\....\\.**..* . * .*. *....  .\. \ .\ .\ * ...  .*...# ..**# \#                                                                       #
#\*... .\ ***.***. . ..* ..\....*\.. ..  . \.... . * *\. . *\  .** \ .\ .*\ *.\ . **  *#                                                                       #
# *. . ..\*.. ..*   ***.*     * .* .  *...\. *.*.. .\...\ . .*\\. \ .* *...**..  # * ..*#        #    ##                                                       #
#*..\*\   **.. .  . ... ...*. *  .   * * \*....*\  \* . .\*.... .*  .... ***.*... *.  \.### #   #.#  #\*#                                                      #
#. .*..*.\.. . \ *\. \.\ * .  *  *\. .*. ....**.*  ...*  .*\ ****. * \ * *.*..... .. .*  .\#.# #..#  #.\.#                                                     #
#.    \.*.\.. ..\*  ** ...\.  .\*.*.  .. ... . *  *..*\.*..  \*.*..\\*...**\* \. .\ .*.** * *###.*#  #*..#                                                     #
#\.. \. ..   **.\.. *..**.**\  .\*\.. . .*   ..*\. .***\**  *.........*. . .. . \. . ..*.*\.....*#   #*\#.#                                                    #
#* *....*  * ..\****......*...\. .*...*......*\*.. ...* #\ \.  **\**  .*  *  .*... * .*.*.. . ...# ###..  .#                                                   #
#.  .*\.. .\ *.* ..**. \ **\.\ \  ..\*.*. \ *..\\.... ..*. *\.\\. \**.*.\ * *... ** \..* ** #.**###..  *\ \ #                                                  #
#\.\**.*.*. ....  \\ *.  . . \\ \* .*.  **\ ..*.. ..\ \.*.\..* * * . *... *.*\ *.\*\ \. .**\.#.*..##* ..####                                                   #
#***\ \* ..   * ** *\..  .\...* .* ...*\*. **\.. .*.*\. *\ ..*.  *  \*\* . .\.*.*. .. \  .. .*  \  #.#*.  *##                                                  #
#* . *.  .. .*\ *  ... ..\*\ \*\..  ..* ...**. \*....** .\. . \.*.*... *\*\** ....\ *. *.  *.\**.* *  *.***\ #                                                 #
#\*  . .\ ** ...\*  ...  ...\ ..* ..*\..   *..\ **. *.*..****\\.**   . .... .   \. .** .*.** ..\** .*.#* *#***#                                                #
#.*\ ..  **...**. * *  .\* ...    ...*\. * .*\\ ... .*.\.\..*.\...\.*. . **.   . . .**.\  ..  .   #\.*.**.** ##                                                #
#\*.  .\** * ..\ \..*.  **\.**\..  .*\.* .  ** .  *  ...\ \. .. \. **...  .. *.  \ *\.. ..\*.  \ .*..*. .\ .*# #   #                                           #
#*..  * .*.*. *.*.* .*.\ .  ..* ...\ .... \.\*\.  .*.. .. ..\ *  \ .\* *.\. ..\ ***.**. **... .*.#*. \.  .***\*#  #.## ###                                     #
#* .  * *. .  ..* *. *. \\*. ... *....\*  .*..**\\.. .* \    .  .*.\..*\*.... ..... *.\.**. *...*\*  ..  \.#\** # # ..#. *#                                    #
#\..**.\.. . . *.\. ..  \ \  **.\* .\ ..*\.*.** .* .* .*. . .*.  ** .\. .*...   ..  .\....* .  *\.  ** .. \.*. #   #*. *##                                     #
#*  .. .\  .\....*..\.\. .\.\.** .. .  *. *\... **\ .\ ..\**\.. \*.\. *\ \...*. . .. ..\  \ **..*..\ \*...*\.*. # #\*#.*#                                      #
#. .**\. *.   **.* ***.  \ \*\  .\. *\. .... \. .* \ **.\ .  *.\...  *.* . \  . .* \* .\ *. .\ *\ *.*  *\ .* .*.##.*# #.#                                      #
#.\  ..\.\* **.**.\.\* * \  .  .* . .*\*. .\.\.**   \**.   .**.*\  *.  ..\.\..\... **.\*\.....*\ ..** \.   ...\*.. *   ###                                     #
#** . *. .*\*** ...\ ..\.. * .. ...*\*.*\ .\ * ** .*.**. ..**. \...*   .*\*..\....**. **.\.. ***..*.**  *.* \**.   .\ #* .##                                   #
#.*. .  ** .... . .    \.* ...*.*.*\ * .. .....*.*\..*   \**\*.\. * . *..*. *..**\.. ..*..*  *\****. *    .\** ***.*#* *..\*#                                  #
#\**\ .\.. *... *. *..*.\ \*  . ..*. *...\\*. .....  . .\..*. .* .. \* \ ..... ... .***..\*.\. *\.*.* \**\.....* ..**.   .##  #                                #
#\.*. ..\*\**\ \.* ...***\.*.. ..*.**  ..  .*.    *\ .* .  .*. .\ *  .***** * \*. \**.** *. .**  *.\   ..   * ..     .\.\ *.##\#                               #
#.* .**..**..\   * \  ..   .**.  .... \. .*. . **. ....\.  **.\\ ..  * *\.*.. .. ..*. .   .\*.\.\.\ .*..*. .. ..\   \ *.\.*  .*#                               #
#** .* .**.\ .\ *.*..\ *. .\*.*  .*\  * . . .  .. *\ *.***\*. * .*\.*\   \..* *.* .. *. . .....*  . **\* \ \...\.\.. .*\#\. .  #                               #
#\.  .. ..*   .**....*..*.*.. .  ....* *\ . * .\ *\.. *\\.*\..\.**. \ .*. \ ..*\\ . ***.\.*.*  . *\ *.....\  \\ \ * **..\*. .\\##                              #
#. .\.     * .\ . \ *.\*\ \*\ . . ...*. .   . *..*.** \.\.. * .... .\*  \   ... *** \**..*.\****..*.\.\. \.  .* ***...#\.... . * #                             #
# . . *.*...*..**....**... * ... ... *.*\ .   *\\ .** .*. **  \**\ .* .*.\  \*.*..... . *....\.\...***\. *\.* * *..\...*. . .**## ###                          #
#\.\\.\ ..* .\ .*. *..  *  **.\   **\ * *... .***.**..\ **** ....*\ .\*.* \\ * .....** \..\ \ .*. \*...*... ..**\  \*.*.\*.* \. .#.*.#                         #
# . \ ..  *. *  ..**. *.\* ... .  *\*.** * .\. .*\*.* *.* **....  .  .*     .\.  .\**. .. ..*.\.*  . ...  . * .* **. ...* ** *\.*   ##                         #
#\  .*\ *\*.\*. ..*.*...* .**  ....*.\. *\. .  *...\ *... ..*.. .. .\**. .** \. \..\ . .\*\ .*.*\  .*\*\*\...*.*.\..*\  *\.*.#.**   .\# ## #                   #
#*.***. .*\**.\**.**  .\.  \*\.\*\ \ *. \ .*.  ..*\..* **\ *.. *\.  .*.\*\.. ....*\.. \...\\*... .**  ** **  . ..*  .*. * . ...\\  \ .##..#\#                  #
#.*\.* .\ . .\.*.**.\...\.\ ..* .\.  *. . ..*\.  . *\ \.\\*.. \.*\.. . .. \.\ \*\.\**\. *\..*  .  .*  .* *\ \ *. ..* . ** .. .  \.\#.*###\# #                  #
# ***\ ..  * *\..*\ *.\*.* .  \\\ * *** \. ..  *.  .* .\.**  *.\*.*.**  **. ...*. ..\ * ..\*. \. \..  * .*.* \.... ....\. * .**..** *...\**\#                  #
# *..   .\ * *  *.. .  . *\.\ . .\\* .   *.\*.*. *. .. *..*\..\ . .*.\.. .* .\ .  . ***  \..\*   .\**** **  *.. ...* *. \ *.*\.. *\* ..**###                   #
# *  ** ..  ..  ...**. .* \ *...* *.*\.* . ..*.  .*.*\...*.  \*\.  .  .\  .....  .\ *...*.\ ..\.......\**\.*\.*\.\.. **  ..**** \\**. ###                      #
#\. *... \.*\... ..\ . * *.... .......*.  \  .. . .*.*.\ .   ....**. \\**.   .*\.*.\...\. ..\*  ** \.  *\...     *\..\..  . ...\..\...#                        #
#.\ * .\ ..\ **.\*. ..\...  . .  .\ .\*.... *  .* \* \.*.\ . \  . .\ \****   \..\.\..   .*\ .\  *\*. *.. .*.*...***\ ..*... * . \ .**#                         #
#*.**  *  \ .. .*..  ..*...*\*.* ..\*.. *..* **  * \.  \. *....*.. *...**...*..... \..  \.**..* ..  **.*......**.\**. *.  **.*  * .*.*###                      #
#* .... . ..\.*\.\ \.**\ *.*.* . *\*.** . * \.*  *  *  .*..* \ *\ *... \.**. **  ...\.\..*..\.\.. *..\.. .. *.\*.*\* .\....*.. .. *.\#.**#                     #
#.  \.  .   .  .\.\..*   **.\..\*.*..\..*.*\. ...\* ...\.. .* ..\ ...... ... **.*...*.*.*.* ...*\.\.   \ *    .... . **. *.* **.. *\..\#.##                    #
#  ..  **....*\ .* **.. ... .*.\...\  ... .*\.*\  .*\. .\  ..  ..  .*.\.  .*.\... **.\.   **  .**. *  ..   \*  .\*\  ..... .   #\.**.\ ..#.#                   #
#. .. ....**\*  ..\ * *   .*....*...*    * .  \..*****.*\ *.*. \    .. \ .. \.**...* .****\. **\..\\..*\.  .*. .**. *... ..**. \.**.**** \.## #    ##          #
#  **   . .*   . *.*... \ ..  . *.\*\ . *.\.\ *...* .\*.. . .\. .  *.. .. .\  ... *.*. \...\ ..  . *.... ..*.*..**.*..*.  .*.\ .  *.*#..    \#*## # .##        #
# ...\ *\..\\  . .*\\  \ .    .*..* .*.\*\*   ..  * ... .\ .. *\ .  .*  ..   .* \  * .  . .*..  . .. .**.* . **\.. \* *.\  *.. * *.*\ ..\. .#\*\*#\.  .##      #
#\..\*** . ... . \*\**  .  . .\*.*.*.*  \*\.\\* .\. *.\ ..  \ \**. ..    *****\...\* * *   *.* \ *     ..*** ..*.  ... \**\\ . *.\....* .    .. .#*#*. **#     #
#* \*. *. .*.*** **.\\*. *. .\*... ...*.\. ..\\*\   ..*.****.\.*.  .  .  *. **.  *..  .\.  .\. .... ... \.* \\\. \..* ..*. *.\. *...*  ...#.* . *.... * #      #
#*.\. ....**. .. \.**..\ \.  .* \\.\  ..* ..**.* *.***\*.*\. .*\  ***\*.......*.*\ *   .*...  . . .\ .....*.. .*\.***. \ *\.*. *.   \*\.* . #*\ *.*.# .*#      #
#.\* \.**.\..*\.   ..... \* *. \. . .  \. *\ ..* *.*\.... . . \ ***...*.. .** .*** *\. .. .  ..  . * .  \...\. .  .\. \ *** .* .\  \.*.*\ . .. **.. .*\. #     #
#. .\.... **..*.\*.*..*.*\**  .* .  * \ ... *\ .\. ..*\ *.. . . ...**. . ..\.\ **\\.**. . . * . ..*\.\   .\ .. \ . *.*..**. \.** *.  . \ .**.*. *.*\*...\.###  #
#.**..\***** *. \*\.\*  . .*  *\  *.** *. **.*.*.... .*..*.. . .*\...\ ..\**\.....\..****. .*...\ ..*.**** * . .. .* .   * ..\..*. \*...**\. \*\.\*..*.###...# #
#... * ....\\.* ... * **\*\. **.*.**..*. .**  .\\.\.*\.* .*\\....*. .*.  ..... .*.   ** .. ..   * ...*.*..\* ....\*. **\*.   .\ .... ..\.**  .. *.* * .. *\ #  #
#..  \*   ..*...\. ...*  .\. ..\...*... .*\*  **\.*.. ..  . .**  .\.\.....*  *. * .\ **\\*.\ \*..  \ . ..  * *\   \.*..*.     .\*. *..\**..*. \ ..* .. .\.* ## #
# .   *\. ..**\  * ..  ***.   .*\ *. \...  \ ....*.* *..*   . \ .  *.*\   .. ..** * ... ..\...*\ * ....   .* . ** .*\. .\*. .....  *. *. *.. ..  .. ...  *.# .##
#.*. \* .\  *\   \.**...\*.\.*\.*..* . *  \..\*\ ****. \.  \* .. .  *..   ...*.\. ..*  * \   ..* .\ ..\**..\.*.*. ........ *  . *.\*  \ . \.*  . *  \. *\*...\##
#.. \.. *.. . *\ ..*.\\***. .\.\*.*****..\ *.*  .*.*\**.\.\ ..**  \...... \*.**. * .*.. ....*.*..\.. \*.. ** .\.. .\  .. *.\..*\. ..  .* .#...** ..\.*.#.*. .  #
#  \ *** .*.....\  ....*..\ ..\**\...**\*\.*\  .**.*.\... .*. .. *..** .*...*\.. .* *. .**.*...*. \ \..\*..**\ *\\.\ .... ..  . ..\. .* . ...*..*\ ***\ \ *...*#
#.  .... ... .\.*. *.\... *\*.*...** \ ...*\ ..\.**..* \.*\*\* ...*.\**...\.*  .  * \.*\..* .. ..  .*.*.......\**.. ..\*..*.\* \.. ** .   . *** \.*.*\*\ ...*#.#
#  .** .  .    **. .\* *  \.\*.\...\.  .* .\\* ..\* \.\. \.* .\\  *\* *....  *\\ . . *.. .*.   *  \.\  ... ..* .**.   .*. .\ ...\**.\ * *\. \.*.    . *... .. \#
#....** *. . *\.*.*\\  *.*.\.. . \\ *\\ . .. ...  ....\.\**\  *..**...\.*\   .*\. \ *..* .\*\.\.... . ...\\.\..\... \ ** ... *.\.*** . *\ .*. *.. . \* \ \.. \##
# . .** \.**.** .** *\**...*\ \**.*.**.*.. .* *\..\*. **\\* *...*..\.\...\..****    ....* .*.\ **. \  \ ..\ .*. .*. ..\. *\  ..\ *..\ ..*  * *\    . \\.\ **.**#
#.\ ** * ... .\..*\**..*. . .* .* .\ \**.\.* .. \  .*\.\ ...... .* * * ..\..*.** . .\*\ *** \*\** \. *. \*.*\..   ***..*..\ \**. **\.. . \.. **   **\...****.* #
# *..*..\ .....*. **. .. **\ ** \ *.....  *.\*\ \ . . *.   *  .... *.. \***.. .* .. *.\. .   ..\.\...*...  .  ... .*  ..\..*...\ *  .*\\.  * \\  \...* *.*.\..*#
# *\.. .*. *\  .* **.\ * *.**\.\. * .*  . .***  *.*.* *. .*.    * \. \..... .*.*\. *. * ... \*.    .  .* * *.* \ *\  \ ..... * ..\ ..***.\..** ...* .* . **  *.#
#*...  \.*..*   .\**\ **.\.*..* .*.\ . ..  \.*..*.. \ .   *** . .  . *  ..\\* \. \ . .*\*.. ..*\. . *. . \ *..*. * \**\.*.\*\.. .**.\.  ..*\*\* . ..\... ..*.**#
# .  .  \..\. .. *.\ .\.  . * \ \.\*\ * . *..*.*.\...*\.*.\...* *.\*\..\**\.. *..  .. **\*...* .    . \ *.*\.\. \* *\*.****.*\ . . .  .\. **\**\* \. \* .  .\..#
# ...*.\*\ *\   \\  *  *..  .  *.\ .*\.\ .*.  .. \..  ... *. **\.\..*.***. .  \ .\*  . . \.\*\ ** ..\*.\*****  . .*. . *... * * \*** *.  **\*.. * . *\.**...** #
#*  . **.....*\....**  *.\\**. ... \.. *\ *.*.  .. .... ....*.\.\.*** . . \*..     ..**. .. .* .**.  .  *.****  *...    \.* . . ...\ .   \*.  *.. . ..*.*...*\*#
#. *.* .\.\.**\\ .. *  * ..* \ . . * \*...\. * . *  . *.\*  ... * ...**....\ .\ .*.  *. ..*\ .\  ..  .******.. \* .  **   . *..**\\. *..*. .*..\. .*..\\.**.#.##
#\...**. .\. .\. * **  . *. *..\.* **.*. **.\... *\.*.* \*  \ \ .\  .\*.*\*.. *.\..... ** ... . \....**.\*.\*....\. ... ..\*  *.  .  . * \ *\. .  . * .*\\ .* ##
#\ *\.*.*..\..*\.*\..\* ..\ .\*. **.\..\...\     .*\.**\*..   ..\** . **..*\ \.\.*.\ .....\*\** .   .***.*  .\...*.\ *.*\  * *.  ..  \.. .** **. **\.\ .. .\ ..#
#.*\. \* ** \ \.*\.* *.   *.**.* .*.*.*.  \**.\.. .....     \.**.*.* *.* *.*..*  *..*\ *\. \**\*......**.. .**\ ...* \*. ..*. . .\  *.\*  .* \.\..\. .  * ...\*#
#\.  \....\*.* . . .\* . .\..\.*.*..*\.  * *..     *.*\.\* \.\ \ .*.\** .....** .*\ \* *  * *\ *.. .. *.** ...\. \ . ...   *.\****..\  . . \*. .*.**. .\..# \ ##
#**\**.**...*\ .\.* .. .\  \. .. .  * ..\*..\*  ..  *.. *\.  *\. \.  \.\.. .*.\ ......\. \... .  .   ....* ** *\.. . . *. \..*.\. *  ..*.\*.** .***.  **\\*.####
#\.*...... \\.. ... *.\ . *.*.  .*...  \ ..* ..* **\.*. \....*....\  ..*\  *\.   * **... ..\...*.......  ..   .. \  *\ ..\... \ *..\ . *. .. \..#\**.#\###\ *\ #
#..*** \ *\. **.\\.\*  **.\.. \..\.\... ** *  *\.\...\   ..**\. *\ *.....\  ..\* ***\  ***.... .   ..\ .  .      .*\ ..*  . .*\. * .**..    *.* * .... *.. #.. #
#. ...***..*...... .   .\ .   *  .   * \.. .*\..\  **\  \. *.** ... * * ** * . .. * *   .\.\ .   .\. *   . \   \* .*.. . .  .   \ ..*\ *.\ ..* . * \   .* .   .#
#.*   ...*.*.**   .*\ . ..  *\. ... * ..  .**... **\.*.*.. *\  . *.*  .* ...** *. ...     .**\.*. .. *. .. ..... ..*.\\ .... ..  ...  . . . ..*\.. .*.. *  .*\*#
#*\  * . \ ... \   .*.   ..*. .\ . .\ *.* \.* .  ... **\..\. *  ** .***.*.\*\.***  . .  **  ..*.* .**. * *\* .***  . .\.\..  \* .* \. . *\** .**..*\.\ .*  .***#
#*.\*......\.** .\.\.  **\\* .*  .  * \..\*... * . ..\..*** .. .*. ..\.\..\*. ..\ .*..\.*     .*. .*. ** . .  *\* . * .\    . .\ .. **.....   *.  ..  ... .*..\#
#... . *\.*    \\  ..\ ..** . *.**\ . .\ .*     \. .*.  *\*. .*.**** ..  **\. *.*  .*. .... \ . .. ..* * ... *.*. *.*. .*... .  .  .\. .\. .... *  \   .\..* . #
#\.\. .\ .*\*  .... .*.** *    .. .\ \*.* ....\\ ..**. .  .\ ... *..     ... .. *.* .\..* . .\.* .***** \ \ .  \..**   . * . .\ .*.** .***  **.\. .. .  \* .. *#
#.* ..***..\*\\.\ . .. .. ...   ..\*...  * .. .\.  ..\* *\ . \ .\. ..\ ..*....\.. .  .  .   . .. *\***\...* \ * \\.. **...\.* * *. ..#..*. .*\*** .  .* .*  **.#
#*..* *. ..*.* *... ....**. \\  .. .  .  .\ *\** ... .\\... *... .** .  \ . ***  \  \*\*.* .*  **...\.  \.* *\. . *.\ . \  .. .\.*   .\**. .\.. .* ** *.**\  . #
# .** \. .\.\.....*\**. *** ..*\ *. \\  \* \...\.. * .. .*  .. .  ..*. ... **. * .\... ..**.\. .. \ *\..\..\..\*... .\  ..\ *  .*\.**...* . .... .\.. *.*\**. *#
#\*\**...*..*  .\ .\..\ . *  **  .\*.  \.*. *...** .\**\*\.** . . . \ \.. ...*.. **\**  **. .*. .   * . ....*\...\ ....\ .. * .*.**..*  .. *.\ \...* .**...*...#
#*..\.*  ......  *  . ..*.  *.\*\. * \*. *.\**.\..  *.....*.*   *...*..\.   .\* .\..**\**.*\.*..*   .** \.* \*     ... *.\.*\. . .****\.  .\* * .* *  .*.* *. \#
#*.\ .**\**.*.*\ * *  * \*. .  *  .*... ..\.....  . ..*..  . * *\.\  \.   .\.*.. . ***.\***... ** .  ..\\.*..\    * ** ..*. .* \\....\\ ..   *  \*\  .*....\* .#
# ..* \*\*   ..\ **. ... .*..... .*..**. .. . . *   .*  . .* ...***  . ..\ ....*.. *\... .\  \.\.*. . \ * \*   \. \.*..\*.** .  ...\\.*..\ ... *  .. ..*  \. *\#
#\*.**.. * ..\. .\..  .   \.*   *.\* .** * .*.*.**. .. ** .* . ..\\..       . \. .\.* .\* .\.\ *** \* .\... \*... . .** \...**.*.**** ...\ \\**.  \.\.\.  \.*. #
#    . .      * ...\.*\ *. .* \ . .*. .* **.*\***\*   **...\. .\ . .  .****. .*\**..\.\*.     .*..*. \*.*\ .*.. .\..\*.\ *.*.. ... ..  \   .\. . *.**\. \ * . \#
#\   . .* .. \\. .. ... . ... ....\.*\  \.\ . ..\ .*. \ **. .\ . ..**  \.**...* *.. .  ..**** *.. ..  ....* ..  ..***.\. ... \**.\ \* *.. .    *...*** *\ .\ *\#
#.\*... \.*\ . *\.\   .. *  *\... .* ..  . . .**. *.*\ ..*  .....\.* \\.** . .\ ...** \. * *.**.*.*.  ** .. .. *...\* . .*...*..* \.. ..*.\\\..\ .\*.  \ .* .*.#
#\.*.* \* **..\.* *... . .* ...  .**\*\*\... **\. ..\.   .**. *.\* **.\ ...*\.*\  *.. .  *\* .....  .*..* ... ..\ **... \  \ ..*. . \     . .  * \\..   \ . \.*#
#  \ .\.*.\*..**... .. * .. ***.  * *. .*\ .*.* ...   .  *. *  ... ..* \* . ... \ .* *  ..   * *.*. .\*.**.  \.\ *..* .*.. *  **..\. **. .  .  \** . .*.*  *..*#
# *..   .*.  \ .*\.. \.*. \\ \..  . ..... \..**.* *.*\..*.  .   \..**. ..\* *.\\ . .  ..\.\... **.  *. .* ..\ \   .... .   *. .... . \*..*\ .***..*** *.. * *  #
#\  *.** \ .\  *.  .   . \.*\ *. *\.  \  ..\\..**\. *...*.*...\..  .. .*. * .   **.**.\  .  .\ *\ .\ *\ * \*.  .. ...*.. **..\ \ * \ ...\. .*. .  ... *. *. . \#
#..*\*..\ .**.\  \** \  ..\*. .\ .. . . .. .\ .\.**.*.** ... *    *  . .... * . .* .\. \.\ *   * .**... \...\   . \ .\  \.*..*\. * .. \    ..    *...\.\ ...*..#
# .\**\.. *..\..  *...\*. .*\.\ .**. .. **  . .  .  .*\*\ .  ..\.*\ \.\ *\  \ ..\.\ ..*\ *...*\.* *.\....\\..*..  .**  . *\.\* . .\...  .\.  . \..\ \**.. \ .**#
#.\*.*\ **.\**.  \.* ..*\**.. * .*.. **..\    .*.\ \ *\*..*  ..  .*.*. *\.*.  **\..  *\. .**... \  ...* .*  *. \\  ..  .... ...   .\\  .  \. ...  .\... ...  ..#
#. ... \*   *.* *. \\ *....\. ..* *\ ....*.*. \ **  ....*..      ..*. \*... **.\... *...*.\* *\.. . .\**   .*.  \* .  **\....* *\.*.*\..\..*.. . .  \** \.\**\*#
#\.\ .. .\ .\\*  \\.* .* . *.\..**... \.*\ *.* ...\.\. *. .* ... ....*.. . .\.  .\ ...** ....\**    *.\...*..\.   \  *\*\ * *  \* \.\..* * * \ *\. ..*\ *. ..*##
#. *  .  *\ *\*...  .**   .....*...\ \. .*.... .. .** *\.\  **\ ... *\.*. ..*\\. * \...* ..  .\.  **.\    ....* .*. **..*.*   \.  \* ..... .*. **.*. .*...*  * #
# \.   *..\.\.*  **.. .\ ...\* \.. .   . *.\.. .\  ..  . .*..*.\...*.. .*\.\...\ .\.  *..\  . *. *\.\... \.  ..\ *....  *.\*\ *.**...*.\\.. .. .*\..   .*.  *.*#
#  *.\ * .. . .*..\  .\ * *.  \....  ..**.* .\.*..** *   ...... .\**....*  .   .  *.*.\   **\..* .*.  ** \. .  ....*. .\.*...*.**..  . *  * *.*.\ ...  *** * \.#
# **..\.\  \ .**. ** ***... ...   *  .\ ***\. ***  \ *..   . *.*\*** *\ .\  ..**.*.\. *** .*.* *. *.  .. .. ..** ..\*  .*\.  *. .\ .*\\.**.**.. *. *. \. .**\  #
#\*.*    .*..*. \.\  .\ * **\..\*.\.   ..*\ . \. .*..*. .\ * .*.*... .\.** *\*..*..*.**..**. . \ ... .*..**** .\*.*.*.....*. .\. *.   ..*\ .. ...  *... .\...\##
#\.\**  **..\ .   ..... \\.*.\*.\\ \**\.*\*\..*..*\..\*..* .\*..\*.   ...\.*. \** \ * \.*\\*.* ... \*.**.**..\ .****. *\*. *. *. ..**\**..\\.\*.\.*\.\.\**** .*#
################################################################################################################################################################