##########################################################################################################################################################################################################################################
#*\*.**  ...  .*\ .* .*.*\**. ***....*.\****\ ... .* ..\\*.. .\.   * ..** *.** **  *  .  ..*.. ...    \  \.*\* .*....***  *\.\*\..*.   \       . .* \***.*.* .*\.  .*.. .\.\ *.*\.* ** *.. .. .*\. \ \ .\\ . .  *... \. ..#*#            #
#. . ..\ . . .*. ..*   *...  \ \. .. ..*\.\ ... .\..  \ *..**.*\ *\. . . ..\.\ ..*\**.*.***.  .* .\.* .  ..****\**\ **.\ *.   ....* ...  .  ...*   *. .***.\  * ..\..*...*\.\ \..   *..*\.\.*..\..  . * .*. *\ *.\ .*.. *.. *#           #
# .. .****** *.    .\..*.. ... .\. .... .  . *..* ...   .\.*\.*     .\..*  \*. \.*......*\.... * \..\. . .*...*. .   .\  .*  . ..*.. .*..* * ..*\. . .. ** \* .     \. \  .* . .. .*.. . * ...******..\..*  .***..  **  \.. #            #
#. .\ ** \.. .  .*\\ * ..    *....\*\ \.*.\* .*\.. \  *\\  ..\ .\ . .** . . ...\.**.\. *.\.\ *..**.** .\ *.\ ...*\  * * . ***   \..* * . ..** ** *\* \..\.  \  ...*  *...\ * \ ... .**\*.   . ..*.*.  *\ .  .. \.*   .  ##* \##          #
#* .***\.. .   .* *.\. .*\ \   \ * . .. ..*. ... . . *\..\* *.\  .\..*\*.\*.  . \*.. *.  *. *. .....* *. . *\.. *  .. . *.*\ *..\*\.. ... *.\..\ \**..  .\. .\.\  .*.\*\*  **.**\.. .. **.\.  ...*.   \..*\. .*...*.. .*\#*# #*#         #
#*\*. ...\  . .\.... * *....\. ..* .\...*.**\**...   .* . *..***.  *.\ .**. .*..**.* .*.  \**.. .\ ..*.***. \\ \*\**** *.  . * .* ... .* . \..  ..** .*.    * * \.\.*... *.  **.*...  .\\*  *.\ *.\.  ..  **.. \. * .\*.. ... .*#        #
#**\.\*\  *.\... .  \... *..  \ .\ .    *\.****..**\.\. .****... .*  .*.\. \**..*\.\***. *.. . ...   *.\.\ **  .* . *\ ....*.\ ..\.* *... \...* \.* *...*..*.\ ..  \ \ ...  .\*\. \ .. .** *..** **\. **\..* . .  *   *\. \  ...*##      #
# \**.**... *\*\.* . \*. ..*.  *.*\  .. ..\...   \ \...\  \.. . . .*...    . *...* \...**.  \. ....* *.\ . .\.. .**.   *\  \.. .**..*..*\\.** . *\.\*\.** *.. ..**\.. .\ * . \*. *.\.\  .*\ .\*.. .. .*.  \.*.\ *\ ..*\ .\... .##  #     #
#\ ..*.***..* .**.\ * . *\**.. .*. * .*** *... .. .** .*... .* .\.      **\* .....  **\.\*.\*\  *. . ** .***.*\*.\*.** .*... * .. .*. \  *\*.  *...**. **.. \. ..\.   *.\* .. *\*.\...\* .*. *. ..*.*\.\..  *. \*.*. ..  .  #. *.\*#     #
# . ..\...*.*.\.*** .*.\.* .\ ...  . *\.. *.\.\..* .   .\ . \. ...\*....*....\*\ * ..... .*...\..*\... *. **.**.. *  \ ..*.\*.. *** *. .*.  \ ..  *.* .\.*....  ..***.. .\.\   ***..***. .*.*. .  .\.  \* \**.  .... *..**\.##*  \#      #
#.   * *\...* ... .***.*..  *.*\.*.  \*.  ** ..*. . \**  \. .*\*     \ *..\ \ .  *\ *\ .* \\ .**** *\*.\  *  \ *.*\....  ** . \*..\..\\.** *..*....  .\ ...   . **\**\ ..\... . ...**\\ * **.*.*  *.*. ..\*.*..**\* .** ..** #*.*.#      #
#  . **.*   . ..*. ** *\\  *. \.... .... ...*. .  * .**\** *   .\.......\\ * .\. .**.*\.*. \*\.* .. \. . ***.\ **..  \... .  ..*   *   ..\ .  .*.*   \..* *\*..*..... ... \ **\. \.*\. *. *. ... .***\ .. \..*.*...\**. * *.#.\ \* #     #
#.*  \..\ . .**.*  .. .* ...  ..  ..*.*.. . .\\\ **  ...*...   .... \*. .*\*\  *  *\ . ..\  . \...*\.\.***.*. **.* * .   .\ *\\.\ *\..  *\ . .* *\ .. *\.** ..*.\ \ ***\.*. *. .   ..*.\*..   ..*.\ **\*.\  *\ . \.*\. *. *\\. *.. *#    #
# . ..\ *  ***\..*. *\.. * . \.\*\ \.** ***..*\..*\  ...* .*\ \  .*. . .. ..  .\ ***\...  . . . . * *...* .  ...\* .\ ..*..*\*  . . \.\..*.*. ...*\.*.. .. .\  .*\. ..\...*** . ..* *.**. *.*  .\...*\*. .... \.    *......  \. . ##     #
#*\ ..*.*.* .**  *.. ..*.\*  .\.***. ...\.* *.\ .\..*. ** *..... .** **\* .\*  . .. ..\ .\ ..  .\.* .*..* * *.\*\*.**. \ .*\.. ..   . * ..\...* .\.\. .* \...\*      *. \*..\     .*  \ .*. **\*....*.*.\.*\*\.  *.**\. \ \.##.. #       #
#.*.  * *..*.  \.. ..\**\.*. . .  .\\*.\   * ..*.*\ .* .\* *...   ..* * .\**..*\  .\ \   *\ .\. *.* ..  . . ..   *.*.* .*...*.  ...*\*..*.\..\**. *.**.*..*\ ** \    *. ..\*.* *** \\. \*. **.\.. . * . . .** **\*.  *.\ \. .  *#        #
#...\.\ *.\* .\.*.\.* ..*.***. \ .\*.\ ..\.\  \\.  ....\*. **.     *. *.\ .***\..\ .... .. . .* .*\ * *. . **..\ .  *..\. .*. . .*\  . *...\* .**. *.*\....  .* ..\ \\\*.* *..\.\....*. .**.*  *\...*  *\ ..***\*.   ...\  .. .#         #
#  .\.**.**....*.\ ***.....*\.  *\*.**.   ..   .*  \.  .\.*.  *. .*.\..  .*...*.* .** \  *.\.\ **..\....\  *...... *\  *.\ *.   *..*\\ \\  .\ *. *..\*. . * * ..*..\. .\ .*.**..***.* .* *.*. ..   ...*...\.... .. .* ..*\.*..**###      #
# .. .*.... * ** *...** .\ .. ... ...**\* .  *  *  ... *.*..\.** *..*.*.  *\.\**.  . .. ..\*.... .**..\   *.* *.\. ... ...\..  *..\*\ ... \* .  *  .*  .*\.***\   .*.* .*... .  *\\ . .* \ *..** .  .. .\\*\\* .  . .* \.*.. *....*#     #
#*.*.* .\ ...\.**.* .*  ...*\...\ * .....  *.\  * .\.* \.. \*... * *....*\..  *. \*. . *\\ . . ..\** * ...   .   *\** .\ *. .  .**.. * \*\ ...\ . . \....  *.. .*.\ ..*** .**.\ \* **.*\ \\.  .. .     .*  ..\* .*.  **... *.\.**.#      #
#... .   *  **..* .\*   . \*\  . ..  *.**... *    .. ..  ...\  \ . . \ \.*   ..*  .***..*\**..   ......  \ .. *  . .\ \....**. *..  .  .\ .* *..  *****..*** * ..\....*..  . * * *. *\..*.  * *     . . . .  .    .....* * .\* #*.#      #
# .   .. .. .*.*.*\ ..  \**..\ * . \..*.*..\ ...* .*  *.\. *.  .**....\..\*..* ..   **\*****.\\.\  . . .  .*.*\\.. * ... .***. **\..\* .* \.\..  .\ .*..\*..* .*   *..***. *.*..*.\...*\.\.*\.. .\ *\ .  \ *..*  \* .* * \. *. #**#      #
# ...  * .** .*.*.. .\  ...\.*\*.\. ...\ . \..\**. .**.*. *..   * .* ..*  *\*.   \ *. *\.  .  .*.* \*.**\.. .\.*\. .\ \   ..\* .***\* *.*  \ *\  ... . \ .*\*.   .\..\..\ \\.*\*.   * *...  ..*. . *.\  . ... ..\ .* . .*...\. .. .#     #
#* *. \*. ..**.*. .**.  *** **..\ \. *.. *. . **.\ * ...\..* *.\.\ ..**....  . \. . *..  .** *  *.*...... *\..\.**. *.**\.***. *.*. ***.***.*. .*.  . .**\. . .  ***..  . **.. .. .\....** \.\ \..  *.  \.     .  *. * **\....\ .* .#    #
#..  *  .*.... . ..*\   \.. .... .. .\.**..\ .\. .**  .*** **.....\   *.*.  *.*.. \ *.  *\.. .... ..* *   .**. ..*  \....**\*\*.\ ... .**.\ . . .  \.. \ * .\ .** \. \  \\*. .* * . *. .*\... . ..\*.\*.* *\ . .. * ...*.***** \  ..#    #
#    . ..**..*.. * .*  \ .* ..*\. *.***.\ \..\.****\.* *.\* ***.  .****... \ * *.\.*\.  *.*.\ *.*\.***.. .**...* ..*.    \.*\ ..**... .. .. . *\*.***\ *..**  \.* \.***...\.   .*  *.\ ..*  *. .\..**.. ..* . . \ *  . \***\.*\.\. *.#   #
# . .   ..\.** ..\.*. ... . . ..\\. ...*... *  ..*.. *** .*\\*   \*..*..\** \..**..****\ \* ..*.*.* .\.\*\.* *\****.  ..\...*.\ ..*.     ..   * .\*. *\ ...\. .*. *.\.  .      *\  *.  .**  .. .    .\  .\*   ..... * . ... ..* .* * #   #
#.*.. \.*. **.**. **\. .. ...* *  *\.*.*.  *.   .. *..*\.\.. *.** . ..* *.  .  ....***  ..\  . ..\*\. . . .*\.  .*.  .. .\ ..\.\ .. .  . \ .. ...**. .**. .***... *. ... ** ...*. ... ..*\.. .\ **..*.*. *\**   \.**..*. . \ \.. *.\#    #
#*\*...\ \..*   .    \ *.    . .**\ **..\*.\  **.*****   ..  .*...\*.\.*. ** *...* **. ** .\\. . .. ** .  .\*..\  .. .  .. .\      \*.   **\.. .**.  \*.   .\...  ** **\**.  * *\. . ** **     . .    ***. .... .*.\ \*\  *.*. \#.*\#    #
# .. ..*.. *\*\ *** * *..*... *..*  .*.*..*.* .. *.... * **\. .\**... .\\ .\. .* ..*. *... ....  *..*.*  * ..\.* ...\\*\  .  . *  .\.\   . .**...\.. .*\***   .  \  . ....*. \*\...*\*   .. *\  *   **\..  **..\.*  .... ..\... \ . #    #
#\**  \... \.\*.*.\  \ .*... ...**   .*..*..*. . *.*\  .. .  .\...\.**\.\.*.\  \   *.... .*  * .*\  .*. **.  ..*\..\ *\. .\.  *.*.  \*. ..*...*.*  .\* ....*.\..*.*.* .\ \ .. ....*\.*\..*  .*.*\.  **. \.\.\   \.***.*  .*..\.. . #     #
# .\  ..*. .*** * **\..*. \.\ . .... .*\ .\..\  *.  * *  \\  * * \  .*.\.***** *  *  ... * ...  ..\ \....*.\* **. .. *  .\.*.    **. .    .* *.** . .*  .** * *\.* .. **... ******..*.. ..\ \..*... ***  ..\. * .....*...*.\ .\.\.. ##   #
#..*   ... . .... .*. ..\.  *\..*\   .. *. .. .\.\.*.\** ...* .*\* *. .. ..*. \*..*.\\ . ..  \ .**..\.* **.*..*\. .  . ....\.   ..\**.\**\*.*. . . \*.  ..\ \*..\\ .  *.  *... .\ *.\*.   \\  ... .... *..*\ \*\. .. ..\. . .** .*##  ####
#*\\*. . **. * *....*. .. \ ..*\*.*. .\**  *.**. ...* .. ** **.* .. .*.\ .**. ... ...  *.   . ..**\***.*..*.  . ..\  *...\\*  \** .*.  \.*. *\ * .. .. ** .. .  . *.\ ..\.... \* **\.*..**.  .**.*.*\\ * ** ..*. *.\**\* ..* .*\*.\...*\*#
# \.\   ..***.\.*.* ..*.** . \.* \. **..*\ . *...*.*.   \\  .* *\ .. *...\..*.*... ** .\. ******.. ....\  . *.**.\ \**..  ****.*  **  . ...\*...\.\* . ..*.\   .  *.*... \    ...... ** ....*. . . * .***..... . .. ..... ..\*. *.*.######
# ...*.. ..*... . \.\ \*.*\..  .. . .** .    .\.\* \ ***\.*  \*.  *\.*\* ..... .**\*\...   \* ** * .*.** ... ...*   ....***...\.. .. .*.\ ...* .. .\* ..\. **.    .\.  . .   *.*.* . \.  .*...\*.* *\ . \...*.  * . ..* **  .*. *.*.###  #
#.*.\* .  *. .\.. *.*.... .*..  *  \ .*... ..*. ..   *. *.**\*.*..*.. .\ *\     ...**\..** .. ...\\ .. ..* *    .**.\..*\..*.* .   .    . *....**...\  * * ..   .**  ** ..*\..... . ....*.R*\ *.**..*\ ..\.** .\. \. *...   *. .*\#*.* # #
# *\*. \*.. ..\ **. * . \.*..*...*....** .. \.*.\...*\.\.. * ..** . *\*...*..   ** ***.** ...  .  ** ..  \\.... * .. ..**.*. .. \  * *.\ * ..  ..* **.*.\. *   \*.* \**.  ..*.\. * ..\. . ** .\ ... *.\\.*  \.\.**. ... .  \*.**.##.\##  #
#.*. *\..\.  .. \.* *. .. . .\   *.*.* ..  .. . *   **.**. . \**\. *\.*.\....\***... ..*  . ..*** .***\* .*..  .*. *.  .*\..   *.* ****. **.*..\ .\...* . .** .........\* .\ .*. .*...  . \... ... ** .**. .*.**..** .* \.\.**#.\.. .#   #
# ** ...* .\...**.*.*   .\.\   \.**. *..  ..* *\  . *\*.\  .  .\*. .\  .*..\. . \*\*  *.*...  *.\ *\*\.* . * *  .*...\. \* \**\..* .**.. **..*. .     ..* *... .. *\..*\.\.*. *.. . .**\  .\  *.  *..   .*. .   \*...\* .\ ***..\.\\#    #
#... *\   **   *.*****\ ...**\..\**..*\ *.  *...\ \ . * **.   *.* ..\.  \.\.   \.*.** ...*\. \.\**** *..   \.*. .\.  .\**\.*\***. .\ **\. .\*.*. * *\.*\*. . * .*  *..*   ***\.    .\ **.**.    .\.  .  \ \  .* ..  **\.\***\..**.#.#    #
#\ ...* ..\*   \*\........\.. . .\.  .. . *\.**\ .. * .. .*.*.. \ .  \\....* *..\..\..* \.* ...*...\ . *  . \. .\*\.\..*..  ....*.   *. . . \ \ \.*\***. *. .* **. ..* .\ .\\. *\..\**.*\.. .*.*..\ \ . . *   . ****..  ***..*.#.# ##    #
#.*. \*\.*. \. *. * \*...   * *  *    \ ..*  \..\**\*.*.. *.. .\ .\.*   ..*\.\ . *  . *  *..*.**.\  * *.   *..  .. . ..   ** **\* \*.*.\.. *.*...*...**.\* *  \.* ..\\ .*\  . \.  \..\.  ** *. *.  ..* *.\.\.  . .\ ... ... *.  *.\  #   #
# . \**.**. ... ***\... . .*... ****.\.*..*.\    ..*.*....*  . .. . . ......\*  *\\** .*\..\. .\\* \.\ . *..\.\..*.\.*..**\.*.*... .\ \** .*\..\*.\.**. .... \*.. \. *.*.  ..\*\. .  . * .*\*\ .. \  *..  . .* . .*\*\ .  *.**.. *##.#   #
#. \.*\*.* \  *......\***.\**.**.*.  *..* *...*..\.*..*\*** *...*.. * \.*. ..*\ *.\.... . \ \*  **..  .  . .*. . *   * \*.  .  ..  *.*...\\..\..\ *  . .*\   .**... ..** \ *\*** \ \  \ . .. * ** .. ..*\. \*.*.* .*.*\. .*\..** .*...#  #
#.\... ...\...*\.\...*.. . ...***.\  .\\ .\** . .. .  .***\\.**\ .*.. .* *...*..\   \*  ..  .    ..\    .  .**.. .  *.. * ..\ \  ..*..*.**\..*\. \..\.*.\*. .*.. \   ..\ ..\. . \.*..*\ **. . ..*. .\.\  *.\..\*  *. ..* ..** **..\.*.## #
#*..*.\ . *  .*  *** . \. . ***.\.. ..*.* .. *. . . \ ...* * . \..* . \....\...  * * . . * . *\.. *. \**   *...   ..*.......**.. *..\\.....*..*. *...*  \.\  * ..   *.* .. .. *..**.*\*...\    .\. \. *. .\*.*.****.     \.*\.\.\. ...* ##
#*.*.**.*.. . .**..** . * .* ***\.\ \*\.. **\. ..\  *  .\* *  *.  ... . **\.  ..\*\. . ...*  .   ..\*...*\*.\.***.**\. .     \   .\***.\.*  \ . .\ .**.  ..\ **\*.. **\ **..*\...*.. *.*\***.*\  . . ...* .*..*.... .\.  . .* ...\ .# \# #
#.*\  *\...** *  ...* .\*.\..\.*.\*. *.  \\* \*** *.\.*... **.*\   . **...   . ..\..*.* \. .\** . *.**.. *  .*.*\.* . .  \..   ...*.\***..\ . *.  .\.* \\.   ....  ...\..*. ..*\.*.\.*\*.*.. ... * *.*   . . *. \*\ ****... \..\.**\.. # #
#.. ... **.*.....  .** .\ .**.**\ ..**\...\*\*... .\.* .  *..*..*  ..*  * .. .  ..* \*.....*\*.. \*.* *..*.* .*\  .*.\.*.  \.\**.***... .  .  .. ***.. .*.\\. \ .*\*  . .. .....\. * ..\*. \....\*\. . * ..\..*... .  *. . \  \  .\..#\# #
#* .*.  . *    . ***\.. \ \..\ .\ \ \** \ *\ .\* .  *.\..  . *..... *.  **  ...* ** ... .\.\ .... \....*  .\  ..*\ ..\. .  . *\..\.\*.*\\.\..* *  *\.* *. . * ......  \\*..\  * .  * \.*...  \.\  *     .**  *.  .....* . *. .  .\ . # # #
#...\. *\*..\   * .*... .   .  *\*\.  * . *.  ..**.**..*.\ *.\*\ ..\... *.** \.  .. ** *  *...\ .* .\....*  **  . **\.* .\ *.\.... *. * .**.    *..\.\ \*. .**. . \*. . .**. *..\..*...*. \. . *\ .  \*  . .. \... ..\*\ .. \** .. #..**##
#*.  **...*..* ... ..*. \. *\*..* . .\..**. *.**\* ... *..... .*\*\.**..\  .*  . ..*.**\ \...**\*\.. \..*.. .\ .\ **.\. ***\ .* * .**.*\ .\*. .\ .\. .* . .\...\   . .*.   \*   .*..  *. .\*. .*.**...\..\ .\.. *** .....*\.#*.\*\# ##*# #
#\. .\*  ..*\..*....*. *. \. \ *.\.**.\....\*....*..... .  **  * .  \..*... ...*.\ ..\. ..\.   .. ** .\***.\* .\* *.*.. **. *.*.*  ** .**  . \ ... .. . .*.. \*\*.  *.\  \. ..*\  ..**..\.*.\.*.***   ...   *.  *...\ **#.  #.\#.  ## #  #
#*\*    \ *\*  * \* .\*..\.  ... .\** . \.**.  * *\*\.  *.***\*..*.*\.\. \*.\  *.***\..\...\     .*.**\..*.*.\* *\. *. *.\.  ...** *.....\\ .*\ . . *.\  .**\ . \  *. \*.\   ....**. . *. \.. * ..*. \.\.\***.\ .***\\#\#\#\*L##. .*.#   #
##########################################################################################################################################################################################################################################