#####
#   #
#.* #
#.*\#
# . #
#.\*#
#. \#
#*  #
#  *#
#.* #
#\. #
#*\ #
#.* #
#*. #
# \.#
# . #
#. *#
#\ .#
#.  #
# .*#
#.*.#
#.**#
#*.\#
#.. #
#\.*#
#* .#
#.\ #
#***#
#...#
#.  #
# *\#
#  .#
#\*\#
#**.#
#..*#
# .*#
#...#
#**.#
#.\.#
# *.#
#**\#
#..*#
#  .#
#. .#
#  .#
#  *#
#  .#
#.\ #
# \ #
#*.*#
#*..#
#.\.#
# *.#
#..*#
#*.*#
#.\ #
#** #
# .*#
# *.#
#..*#
#\*.#
#.. #
#. .#
#  *#
# .*#
# *.#
#.. #
#\. #
#*.*#
#.*.#
#*  #
#.\ #
#\  #
#** #
# . #
# *.#
#*.*#
#.**#
#.*.#
#\ .#
#..*#
#  .#
#*\ #
#...#
#.\.#
#..*#
#**.#
#...#
#*.*#
#..*#
#..\#
#\.*#
# **#
#*..#
#** #
#.* #
#...#
#** #
#.  #
#** #
#*. #
#**\#
#*  #
# * #
#.  #
#* .#
#.* #
#\* #
#.. #
#. *#
# *.#
#*..#
#*\ #
#** #
#.* #
#\.*#
#...#
#.. #
# * #
#\..#
# .\#
#*. #
#.  #
#** #
# . #
# .*#
#  .#
#\. #
#  .#
#.\*#
#*.\#
#. *#
#.\ #
#.**#
#...#
#*..#
#.\ #
# .*#
#.\.#
#.  #
#..*#
#* \#
#. .#
#. \#
# * #
# .\#
#**.#
#.\.#
#.* #
#**\#
#.\.#
#\**#
#*.*#
#\ .#
# ..#
#** #
#.* #
# ..#
#.*\#
#*.\#
#  *#
#\ .#
#*. #
#.\ #
# * #
#  .#
#\ *#
# *.#
#**.#
#\. #
#.*.#
#\*.#
#..\#
#.*.#
#**.#
# \.#
#. .#
#.*\#
# ..#
#\. #
#..\#
# * #
#   #
# * #
# . #
#.**#
#.\.#
# ..#
#\*.#
#*\ #
#* \#
#. .#
#\. #
#.*.#
# . #
#\.*#
#.*\#
#\**#
#.*.#
#\.*#
# .*#
#  .#
# ..#
#\. #
#\. #
#***#
#*..#
#*. #
#...#
#*R.#
#.* #
#..\#
#  .#
#\\ #
#.. #
#. .#
#  \#
# \.#
# .*#
# **#
# *.#
# . #
#*. #
#.  #
#.**#
#..\#
#. *#
#.*.#
#\**#
#.. #
# \ #
#  *#
#.*.#
# \.#
#**.#
#.\\#
#  *#
#.\*#
# .\#
#\ .#
#  \#
# ..#
# .*#
#\  #
#.. #
#   #
#\ *#
#. .#
#.*.#
#*. #
# * #
#**\#
#***#
# ..#
# **#
# . #
#  .#
#*  #
#\. #
#..\#
#.*.#
#..\#
# . #
# **#
#\**#
# *\#
# .\#
#\.*#
#..*#
#\ .#
# * #
# ..#
#.*.#
#.\*#
#  .#
#\**#
##.##
## L#
#####