#################################################################################################################################################################################
#                                                 #.* **\.  *...    *\ . .*..*..*  \ .*\*. .\   ... .\. * * .. *...\ .* .*...  *.....\.   .\. *. . \ ..*\.*. *.** ... ..*..**.\ #
#                                                  ###*. *\.\*.  *..*.*.  .. . *. \...*.\. . *...* *.*.*. .\ \.\ *****.\.* \ \...* *.\  *  . * * ...   .\ . *.\.  \   \\*.\ *\..#
#                                                 ## .#.*..  .\.*. .**..\.    .*. .    * \**\* .. * \. .* *... *\.**.\. .\. *. *.**... ..\ *.\  .. \*.. .*..*.*.  ..**.. .. .. .#
#                                                #*\*  #.*. .  \**.*.*.. .**\. .*.    **..* *... \.* *..* \*....*\ .\ .**** \ \ **\  \******* ....*.  *. ** ...** ..*.*.    *.  #
#                                                 ###R\  . .  .*.**.\ *.. . . \\*   *. *...**     *.\* .... *.. .*   *... .*\* \*.*\.*. ..*.*  .... .*.\.*..  * .  .**.. *   .  #
#                                                 #\#. \.** \* .**\...\.\\ .  . ...***.... .* \*  .\ .\  . ..\. .\.\ . *.  ..* .....\ .. **.\. .. \ \*  **\  *. ... .\**  \ .\*.#
#                                             # ## .#*. **. .*.  \..  ** .** .   ... .*\. ...\.* . \... **\ * .. *\.***\\\.**  \*   ..*.....  \ *\.*.* \*. .\ \ *\*   . . .... .#
#                                            #.#\#...*  *.  **\... ..* \*..\. ..*.. .\..* . **\.  ...*.*..\.*  **.*... .\..*..\ .*.**   \  \*.* .. .\.\.. ... *  .\...   ..\  .\#
#                                           #*..  ***\.*.*...  . .. ..  *.*.\ . . * \*..\  .. .\ .   ..*.* \...*. .  *.\.*..*\ ......\.*..*..*.\\.  .*.*.   ..* *..  ..*. .. \**#
#                                            #\.\\*..*..  *\  .*.*.* .*..\*\.\.   .*.... ..\*...  * \. . **.* ..* *...*.*\*\  .. * ... .*   \........ .*\. ....\\**  .**\...\.\.#
#                                             #\ .*.*\  **..  *.*.*.\..*..\*** .. ..****. \..*\*. .\  .* *\.. .\.\ . \.  .. *...\ .* *.*. *...*    *.****.* *.\.  *\  \* .*\ * .#
#                                             #.*\..\   *. .*\\*. \**. ..  ..\***.. .. .. \..* .\*  * *..*..   . .**\*  .*\\ \ .*.\*.. *. ..\ ..** ..  \*.\ .*.  *. . .*\ ***** #
#                                             # .*  \ ... \..  .\..*** ..\.*.. ..*.*\ . ...  ..*..*\..* .....* .  .*. . ..\.\  ..*.*..  .. .**\*.  **\*.. * .** .***.\ \.*\** ..#
#                                       #   # #.\.*\  \.**..**  *.*..* * ** . *\*..* . *..*.\. .*  . *\ ..*. \  *.....**. . .**.\. .\  \ . .\.*\ \*..*...*....\...*.* *    ..*. #
#                                      #.# #*#*.#.. .. \*** *.*..** *.\* .*\. . **..**.*.*. *.*.  . *.. *\.*  . .\* . * .. ...*\ .. *\...**.... \..\.. \..   .....***.* **.\*.*.#
#                                     ##*\#**. *.\ .*#*.*\..\. *.\*\..*.**\.\* .....\.\  ....*. *.\\.\  . *..\.\ ** * .   \. ..*. \.**.\..*.*.* .\ ......\.**..   ..\ \ .*. .\**#
#                                    #. .. #*#*.*.****. ..  .  .\.*  ..  ** .\. .**\  \  * * .*.*.*.*. . .*  ..*\.* **.*... \ ..*\  .*\ .*. *\. \.\..\.**. .   *. \.  ... *\ .**#
#                                    # #...*..#\ ....\.  .**.\.\*..\*..*... *.\  .....*. .*. . .. .  * . ..* *\.. . .**.\ **. \.*    *.***. .  .**.. ..*.**. ****. .\ \** .* .*.#
#                                    ###\##.. .. ..  **..*. *. ... .**\ \ *.*. .*\  \   .*... .\ \   ..* ***...  .. *.\*....\.. \.*.\* *..*\*.   ..   ....*..*\.* ..*\.* *.*.\ .#
#                                   #.\ *# . #.* . ... * .* .. \ . **.. *.***.*.**\.*\. \.\.* .. .  *    .... .**. \.\ .  * * *\. .. .\   * \*\*\   .. ..\.\....**. .*.****....*#
#                                   #  ..* ... ... *....*.  * .*.\ .. .*.***..* \ .*.  ... ...\. .  .*\** *. **.*.*.. . . ..**..*.**.\.*.  ...*.\...  *.. . * *\*.   .*\**..\*.\#
#                                   # .*\. *  \.* .* \\  **.**   *.*  *\  \ ..*.** *.\ * .    .   *  \ .\ .\....** \\.. \*  \.**... \ *.\*.** .* *\*  .. . ..\.  * .* ..**.*.* .#
#                             # # # # #   ..... .  \.....\* \. .\\** ..  ..\* .....\.  .**\.   .\*  .\.* *\ *.*\.  ...  ...\* ** .\.\..*** **\ ..*..     .  ..* .*  *.*  *.. ...#
#                            #.#.# ##..  . .\.\  \ ***.\ ..\*\*. ...   \ ** . **.\\  .   .**  *  *.\  .. .*.\ .* .  * .\*.\.. .\* *..* .***..**.*.*\.*..\.*\*.. .* *.*. .\. .*..#
#                            #* * . * .\*.* .   \ *   * *.  . . * .\ . ....   * *. * *.. *...\* *.\* \ *\ .*  \\. *..*\.**.*\ * **..  .**.\  .\ .*.  .* .*..*..\.. **... ...\.\*#
#                             ##.\  \.\*..\...  . . . ....  \  ..   .\.\*** **... *\ **....\..* *  **.*  .***....  * .* .* ..*\\  ***** \..**  .*... *\\.. ...\* \.*... . .\. ..#
#                  ##       #  #*# *.    .*..* \.. . ... \.* \*.*\*.**. .* .*.. ..*.\..**    \.\. ..\.* ..****.. \.*. .  .. ... .\\*.*...***. .. **. .\ ..\.  ...... .\  *   .*.#
#                 #\.#     #\## # ***  *...*..\ .*. *\\ *. **..**.\..* \..**   ** \. ..*.. * .*..\ *\*\.\.*.*.\.   .*\  .\  ... *...*.*.* \.\*  .*.\ *. .* \*.    .*. \ .. .\..\#
#                  #* # ## #*#\.*. .#... *\*.* \ *  * . . *..   *.\ .\.\ \* .\* . \\..* *.   *. *. . \.  \...... *  .*..\.*.\.  *. **..*.* . ..\.\.*.  . **.* .*.**.*.. . \* \..#
#                  #.  #.\##.*.*.* ..** *..\*\*.\*\.*... .. \.  .. \ *.**... .*. ...**  *  **.. .   ...*.......\ . . \ * *.*. *\.*.\..\. ..  .\.\ ..\..* .* * .\*.. *....\ . .. #
#                   #*.  . ##. *..   ...*.\...   .*.\*  * .* . \.* . .*. \ \.   .   .* \**  ....  .\ **..*..*\**. *..\*.*...*\..\.\.... *  . ..\   \* *\.\ .* *.*\ \.. \\ . .\. #
#                   #**. \. ##*... \ \*.**.. \**. .  ..****\ . .**.\ ..\  *.*. ... \...... ..   *. **.\ * *.* .** . .*  .\ .. **. ....*..* .  **..* . **\ .\* . ***..\...\.*  .\#
#                  #*.*  . ..\.*\.. .\*.** **...*.* ...... . \.\..\.**. . ***   .* .      *.*..*.  \.** .*.*. *\. \  .*** .....*. .*\.*.\.   \.* .\.*.*.*. . * ....... **.\...\ #
#                   #\##*  .\.\*.  \..\**\ . \. .\.\*  .**\*\ .   ..*..\  ... .* .  .*\*.. ** *  .*..\...... *.. .. .\.*.\*  \ .\\ ..\.  .*..**\ ..*\..***.. *     . ****.\...\*#
#                  #*#... ..**..#.# ...\*  .*..* *\*\   .. \*.\.** *.\  * \ \... * *.*... . ..\.\*.\**   *\ . *\. .  .*.    ..\   .*... . .. .\. *\*  *... .   .. .  \ .* .\..*.#
#                  #\ . .* \ * ..**.*#. . . .\ **.*  *.****.*\ ...*.**. .\...   ..\. .* . .\*\*.**...*\*\.  .*\**...*\ ...*. \..**..  . .*.*  .* . * \ * *.**. *  ..\*.*..*. *. #
#                 #\##.*** .\.  * . \.\*. ..  *. ... .*.*..**.. ... .     \   *.. .  \. .. *.*\ .\\ \.\.. . **  ..  .*.  *.. ..* .*  ..  . \*\.. .\.*.\*...... . \.  **\\..  .. #
#                 # * ..*\ .. .\***... ..\.\.....***\ *\.. *\ .\*\ *.*\\. .\ ...  .*...... **..\ .*.*\.* ***.. * .  \*\..***  \* ..***    .\... *.. ..*. . ....  ..* ..*. \ .**.#
#                 #\####. . .. \**  ..*\.*   ... \.* *. .. \    *. .**.* \*\ *. .*\**.\ .. .  . . *.   . \ .\. \.. ***   .\\. ...*. . \..  *...\*    .**. *\ ** ..*. *\.*     *.#
#                  ##**\  \#....*.  \.. .*\* *. . \.** .\*. .*.   . .... \   .. .. .. .     *.*. .\\.*.*\*.* .* *.*.*.. . *.... \. **\.*.   \**.\* *\.\.*.. .\*\. . .***.* ....\#
#                 # \ ##.*.*  ...* .#\\ *. ..\  .  .. .\ . \. ..**  \. . .\. \ .   ** \ *\.*\.*\\.* *..*.\\*  \ *....* ..\..... ..\.**  . . .... ..  .. .\*....  \**\**..  *\\*.#
#                #\*##*\*. .*\* \. \ .. .\.*.. .*.*.*  ..     *.\.... \  ... .*. * ...... *...**.\ .* .*** * . *..    .****  .\\ \..**.\   \.\* .  *. \***  .  \  *. *   **. **\#
#                 #  #\**. ... \.  .\...* **. \   .*\..**..** \ ..** ..\*..\  **\.*.\  .****  .. \.   \.*.*\  .\. *. ...***.. * .. *\.*. \*\. . ..\\ * ...  ..*. *...\* *.\**...#
#                 ## ##.*.. .*\. \**.  .*.*.  ..   . \ *\  \**.  *.*. . *\   *.\. .\   .  **.  \.. .  .** ..  .. **...  .*.   . .  *.\.  \.\*..\ .\..\ *. * *.*  **\  . * .** ..#
#                # \** ....  \.. .\... .*..\.. \.* .*.. ** .. .\ *.\ *\*.*\ *\ *... *\  *..\*\* *   .* *.   .\. *. . **. ... *\..**\ *   .* ....  *...*. \. .*.  ........ *.* . #
#                 ##.* .   **....* \.\ *. *.*\ \..\ ...\.\\ \  ..\...\ *\ *\.*..*. .*..\* \ .   . .* . .\. . *  \.\* \**.\ . . .\...*. *.*. . * *\.*. ....\ \ .*.. *** .   ..* *#
#                   ##\* *.\**\ ..*.*. .*. \**  *...* .. . .*\. . .*...*..* *** .\*..*.*... *.* ***. \*.*.***\.*. ...... .  * ..*.\. . .\* *  . \ *. \..\.\  ....*.\ . ....   **#
#                   #\.** ...... *.*.  .....*\* \\* .   **  *...\ *..\..**.\..... .   **.* .\ .\ .**...  *.\\. * . .  ...\ *\*..\.* \. ...\ . *.. *** *.. .  * ***..\*\. *..*...#
#                    #\** \*  .*..*.*\\* \ .*** . *.\ \...\ *\...  \\  **.*\  *.*** . . ***\*..*.  ***. .\ *.  *  *\  .* ***.* ** .  .\  .  .\.* \.* *.\ .***..\.*\ .. \ ...\ * #
#                    ##\... * . \   ..*.\.. ...   *....\ ...*    *. * \ .\*. ..\..\. . **.... .  .**..*\ * ..\** **..\.. *\. .  . ...*..\ .\.* \.  *. *.\....* .*..\.*. *.\..*. #
#                   #*\*#\. . **..*.\ *..  \ *. .\ *.. .*.* . ** .*.*\.*\ .  ... .. \*\..* *\\..**\*\*.  .  \****\\   ..*... \***  .*.*...*.\.\.* *\* .\.   .*...**  .  .\ .\. .#
#                  ##*##***\ *..  *. \*.   \.\ .*\.**.\ *. \. ..****.**. . ..\.. *.\ .*.\ *\  .\* .. .**.   * \.***..\.* .  \.* \  .\.*.* . .    ** . *..*\   .. *.** .*.. *... #
#                 #. ## ...\.#..  .*. *   .\..\*. *..*..*... .*  .*.... ... *..\*.*\.*. .*...* *.  . **.   ..**\.\...  . .\ . *.**.\ *. ..  .*\*.\.***.  * .* *   \*\..* ... * .#
#                  #.#*#.*..\. *\**\* \   .*\* \*.*    \. .\  \.\ .\*.  .*.**\ *...***.. *\. . .   * .* \.   ..** .\. \\. . ** ...\.**.**  .***\.*..*.. *.*.\..\ * .   *\ *. *\*#
#                 # ....\..\*.*.* *..\**\**. . ..** * . . \ \ .*. \* .. \....\...*  **\  .   *..  .\\ ...   * \.\  . ....**\.*\.... \...\.\*.*.   . .\**. ... .  .*   . *.* \ ..#
#                  ##\ .. .*. . \ . \ . ..\.. *. ..\*\\. . .*. \.\.. **...*.. .. .  ..\.\ ****\.*\ **.**\. *. *.*\. ...\**.....\ .*. * \ *..*.***.*.  .  \ .. ** .\.\ . ..* .  *#
#                 #\.*.*.   . .* \.. **.  \ .\.. . ....\ \. .\\....*\*   *..\. \* . . .\*\.\.\. .*.\ .**.\...**.*.\......*. . *  \. .*   .\*.  .\  .\\  .\  \ ** ...   \ \*   *.#
#                 #....  *.* .\  .\ \* \ .      *  *\  *.* *   *\  ***..*.\*    ..\*\.* .  .**\*... . . \*..*\.*.\.  ..\...*\ * *.*. ... \ *\ .*  .....****.*.\    *.... .*   *.#
#               ####. . .  . \. .\ .....***   .**\...**.*.*...*.*..\*. .*\.  ..  . * .\*. \ *\...* .. .  *....*\..  * *..   . .  ..*.*  *.   \*. ..\*.  ..*  **    \ \ .  .. ** #
#           #  #\ ..  ..\ * ..*  ..*.***....* ***\ ..**..*.\.\.*..\..*. *.\* . .*\ .\ .*.  . . *.*  .\*  **   .* \\*\...*\..*\. ..*. .\  \*.*..\ . ..*.\*   .\*. .\. . ..\ .**\*#
#          #*##\. .*\. *.\*\ *\\* \.. \ .\  ..*.  .*.\   ...*. . ..*.\**.**.**. ..*.****...      .\*\ *.\..  ...*.\.*  ..**.*  .  .... . ..*\  . .\ .*\.*\.*.  . . *.*.  . ....\#
#         #\.. .  .  .*\..\.*\* * .***. .* \.\. ** \   ..\**.... .\***.*\..*..   *.\.\.\. \.*.*.\*.\*..... *. * .*  \..  \.*\*. *\.*.\* \. ** ... * .. **.**  .**.*\*.... .* *. #
#         #**#.. . \*.. .*. ..  \* \... * *...*..\..  \ *.. .* *.* *.   ...*\  ... .\. . ..  \. . *...\.\...*..\ ....*\.\..\*....  *  *  ... **\. ..**.*.*\\* ...*. \. \   . *. #
#        # ..\.*. . * *\...**....\ *..\..\. *. .**.  ..*.* \*.**.* .\ .* ***. **. .*  *... ...**. \.. .  .*.* ..  .**.*..  .\.*  *.  .*..\.\.... **..\*. . \..\.\. . *. * \ **\ #
#       #.\. *..\\ .*...\.* .* .\.  ....  *\.* .* .  **.**  . \ ...  *..*. **\..**.***.\*.\    *\..  \ ... \. .*. * \*...\.   *.\.  . . ..\. *   ..\. .*... .\ *.\ . \.. .. ...*#
#        #  \...  ..\.\*. \\ \.*    .*   *\ ..\.. * .*. .* .\.\  .\...* **\.  *\*..*\*    **.  . * .. ..* ..** . \ \ .\ ..**..\  *.. \.***.. \.. * . *.****\ *... .. . .....****#
#        ##\.\  *..\ ***. *\.\ .. \  .**.. ... .*.*. *\ *. *.\..* .*...** *.\\..\...   ..  .. \ .***..\..  \*.\..*\. *. .**.. ...\.   \..*. *\ * \ .\**... . .*.  .* *  \..*. ..#
#       #* *\.. .*......*.*..\ *. ***..*\*\\   **..\ .*..**  *. ....*.**...  ....* * *. *.  * .*\ *. ..   .*.*.  .... *\\..*\.\*.* ..  .**.  . *. ..  *. .*\*\.    . * *\.\.\   #
#      #** .  *..*.*.  \**.*...* . .*.\  .* ***..\*.  \* .\\..*.\*\. * *  .\\ ...**...  *..*\.\. *.*.*. .. .. ..\   **..**  *  .*..** \\.. .***... . *\ . . .*...* *\  * *. **\ #
#       ##  * .\\..\\. .*\..* .. *.\*** .  \..*..  * .. *\. . ....*  .  *.* .. .. ..  ***...*  .\\ **. *  *. * ..\ ..*..*  ..  . . . \*. \\ .*.\ *.\ *...\..*.... ... .* .*.... #
#        #\#*  .*  *** *...\.  . .***.*\*.*.\. *\\  .  *\* \..*.  *\. * ..\\...*.*.  .** \. ...*\. *\****\.. ..    ... .. \  ** ...\  \ .*.. .. .. . . * .... \.\.*....\. * .\..#
#       #*..*#  .  .\.**.....**.*\.**.****    .**.\ . ....  .**\  .*  . ** .*.  ** *   \ . . ...*\**.*.\...* *\ \ *.*.... . . . **.. ..**..     *\  * .\ \.. ....\..  *\*... ..*#
#   #    ###\*..*    \...\*  \*** .\. *..\. **  ..*.\.\*\.*.*.   .*** ..\  .\\   ...*.\  .... .\**.. *\*.*.....\...   * .\ *\  .\. * *\.. .*\ *..   .\ *. *.***** .\.**. ..**..*#
#  #*## #  . . \. \. ..* .*.**...\.*. .  .\ *\*.\\\ . .. ..\.\ .****  \  *\.**....  . .* .**\. .\..  ..\.. \.\\..\*.\ . \*. ..*\ . ...* .*  **. .  ..**.***.*...*...*. \.\*.. . #
# #\.. #\** *  . . **..\*\*..* .\.*.. ...*. .\...*.\***..*   .    .* .*\*.. *. \ * \*  .. *. .*  *\..  ....  .*. .*.\\ \....\.***** .**. . .*.*.. \ .\.* .\...*.   .\  .* *.  .\#
#  ##.\  .\*. *#.*.\**.* *. .** ....   \..\ ...  *.  ..* .\. * *  \. *. . . . *...  .  .. \*.... .* ....  *.*. .*..  . ...\ . **\..\ \.*. .*\.. *\. .     . . .*.\ .*..** .* ***#
#  # \ *\. .\. * *. \.*\ .*..*.  .\*.* .***  **.****.\  .*.\*\.\ *.*  *** **\.. *\\.* .   ....   *...  * **..  .*..\**..* ***.. .\.*..\..*.\.. .*.**.* ..*\*  ..**\ . .**\.  .. #
# # .#* *  .  .\***... ..**.*. \* \.*\* *..* \*  **...  *. *. ***\..\*.*..... \ ..... * .* . .. .*.\    * \.*\**.*\ *\..\ .** . * \.  .***\ \ .*  .\....\* .\* .  ..*.\.. ****\.#
# # *#* \.   .*..*.**. * ..* .  . .\.*. \*.*. .. *. .\  *\ .\...*.* *..*.. * . ** \.*.\* .\   .  .\..  .\...\.*. .* ..\ .*\.. \ .\.\. *.\*\\...**.*. .\.*..\... .*..* *. ... .  #
#  #*\. . * . * \.\. * ...*\*\*\  \. .\  .... \ .. *    \.\ *  ..\.\.. .. *..\..*..***....*\**\  .*. * . \ \ *\.... \.\..*... *   .\.**  ..***  . .\**. .* * ****. \*..\* .*.. .#
#   # .\##*  . \   ... .  ..\....\.. *.. ..  *..\\.. .*\.\.*\.*.\*.  *\ .*.\    *....\....*.*...\ .*.*  .  ....* .  .. *. .*  ..**..... .  ..\.*  *\..*.\. . .*\.**\.\.*. ..  \ #
#  #.\ .#*##.*\...\.\ * \*.\..*. .\*\* ....\*\.\*. \*\*.*.\*.. *.*. *    ** *\** *.*.*. *.**\.**\ *..  . *.*.\ .  \\ .\ .. \ .**.**.  .*. .*** . ......\...\ ..**.*. . ***..*\ .#
#  #**.* .  * .    ..*  ... .\** ..* .. .\\ .  .\ *  .. .\ *\**.\.\ .*.* ..  * \. **.. *.\.. *.*..   \..\*..*. .\  \**.\   .\ . *...... \.*.** \.*.** .*. ...* \*.*.*. *\  *.. \#
#   ##  #* \. #.. *  .\*..\ *...**.*.\**\*  . * .\  *\*.\* *. \...* *. . . ***.*  ...\ * ***..*.*.**\ .  .*.. ..*\ .   *****\\.\*. **\* *..*.\.  *...*****\*\.\.*... \   *.*.*.*#
#   # ..#*# .     .\. *\.   \.  \.*\**\* . * *\\..\**** .**..\..\ . .\ ****\** .\.. ..*. .\.\  \.\. *   \ *.*\  .  \\*  . .*...**\**\  **  * . ..*.\  *....*  . ...\\.. \.\*.* .#
### #\*.\.*.....* .  *.**. \   *.\ *.\..\.\. .* .*.\ ..  ...\*. .   **....**.***..\.  .. \*** ..**  *\ .* .*...\* *..** . *\... **...\*.\....**. ...\... *.*.\* *\*.. * ..*  . *#
#..#. \#  * . ..*  .\.**....\* . .**.. * ..    *.*\. *.  ** .*  * \.*.*. *.... .  * *\   .\.*\  *..\*.\*...\ *.*\ ***.\.   *.** .. * .* . \.. **...   \.\*   \ ..*..\... .  .* *#
##  .*..*.  *...*\ . . ...*\..  .\***  *\.*\..*\*\  .*\ .....* \ *...\.\ .**.\* \..\. ... .***. .  .\  **  . .... \*. *  .*.*.\\*.\*....*.*..... *.*\..**. \. \ \* \ .\. *  .*\*#
# #\... ....*\.\.\ *..\  \*. ...*..\. ** .\.\.* * .\. .*... \.. .**..  . . .***  \.*. ..* .. ** . .. **\\.. . \.*  *... * . . ...***   \*.. *\... *.*\...\  *  \.... *.  .\*** .#
#  #\ ..*\ .*\ **.*\.......*.* . * . *.\\.*\.*.\.  ..   .**\**\.\*. .. *\  *. .  \ ..  .**..*\*.\* \..*. ..\  ....*\... .***  .  *...\ .*.\..*. .\.* .. .* *\ ..*  . \.\. .\.*  #
# # *.. ... ..****...  *\ *\*..*..\ *.\*..*..\*.\   *\. *...*.....  .    *.*\. . ..\ ** .*.   . *.\  * \*.. .. .   ..\ .*.**.\.... ..*  .**...\ **.. *\*.  .. * . .**\**\... *\ #
#  #.\\ . ..\  *\*\ * . . .*\ .*..*..\ \*\.*  *.* .\ ...*.*.*\. .*\ *.* .* ..** * .  ..  .  *. .*\.** * .\\  *.   *.  . ..**.*..*.\***. \\\ \*  ... .. *** .*\\...... \** \.  * #
#  #*.\* .*. ... .. *.*\*.* .\ *.*\*. . *...*.. \..   .  .*.....  *.* .*  *\ *. ..\.. .. .\ .\ ...\ *** .   .. *\.*.\ .** .  .. *.  .**. ..... \...... ......  \ \ \. . . ..*...#
# #\* .*..\.. .*....\ * *..**.\. *.*. . ....\ **. \. ..***..  . ....   .  . .\*.. *\**...\ *    ..**.*\* . * . .*\\*.\ .*   *........*\.. *\....\  \\.*..\**.*.. . ....\\*. ..*.#
#  ### #\**.\** .\.***. \. **\..\. *  ..*\ *......\* \ **..\* .  .*.*  *\ .   **\  .\ *   .*\ .. \*\ \..  ... ***. *.* *\*\......* . *. *\ .\..**.  .**. . \ \*.  *.\. *.\ .   .#
#  #* ..#.   *.*\.* .*.\ .  . \   ** . \   *. **\* . ...*.* .  .*.. *  ..   *\. \\  .**.. \ .*\.. .*\..  *. .*.\.*.* ...  .\ *\. .   .*..**.* *..* \... .\   *.\ *\.   *.  \. *\#
# #\*\\\...  .* . . .* ..  .*...*.   *\..* \ ... *\.* **  .    *  . *\  .\**.\* ... ....**  *.  . \.. .\  * *.*.*... \ *    .*   . .  *. .. \ ..*  *. ..\..\ \** .\* . .**..\* .#
##*.\*.   . . . \ ** .\.\.\\.  *.\* \..\   . * ..  \.*\.  .** ..*\* *.\.\*\.  .. .*..* ..\ ** **\.*.\*.  *... .\*. * . \ *. \ .\..\..*..* .. *.** ...\.\.*  \**\ . . .\ .. **.  #
# ##*.*#.* **  . **. *\..\.. \.\**.\.*\.. .. *  *.\ ...  ..*..  ..*.. ..  .. **\ *..\ \*.  .. *\  *  **. *  . *.. .*  ....\*..\ * * ..*.  * \\.*   \*..... .**\ \* .**..*.*.*  .#
#   #. #\* . \.  .\....\. . *. .......**\.*\ \\ **  *..\** . **\.\..  *   .* .\.\.\.. .\.*. . .*  * .*.*\\.   ..\*.. \ .\*.*    *.** ..*.\. .*  ....* . .\****.\... * . *.\**\  #
#    #  . **. #.. \*. * * ...  *..   *..     *\*..\.*\ ..* \ \*.***  .*\*..*. *\.  * \*.   .\..*. \.\. .  .*.*\\.\..\.. .\. * . **..* ..*  \ * *    . **. ..*..\  . \   ** .. * #
#  ### * .. ... . * \ \ .**  . *. \. .*.**.  ..*.  .*\.\.* .*..**..  **...\  **.**..\. ***... \ ...  . . . ..**. *    \.*.. .   .. .*.* . ..* ..\* \ *.*\.\ .*   \  **..\.  ..*.#
# #\.. . .  ..  \*. \..*..... .* ..   ..\* *.\*.  *.. .*...*.* *...\.\. .\ ....**. .**.* ..*  .*  ..\*\.*  * ..  * *    .*.\*  .\*. . \*\.\. *. *.*.\.\*  .\ * .\ ..\.*... *\*. #
#  #*\*..\   \ *.\    ..  \   .**...\. *** . *.*.** \.*\ \*  ***..\.  .\* *\**.*..  *.\.  .*.\ .\. \..  \ .* ..\ \*.* .\*.. **.\ .*** . .*.**   ....\.*..  *. ...*\...*.\. \ **.#
#   ###\.  .*.** *.\.* *...   *.**\* * .*. ****..*..*.*. **.*. . * \.\. .*...* .*.*...**\.*..  ** * *. *** .\  ..** * *.**  ***..*.***...* \.*. .. \*\*.**  . .\.** ..**.. .\ *\#
#    #.\ *\ ..*.. . *.. \ .* .*\........ . \..  \\* *\.\..* . \ *...* * *.*..\\\.    * \* \* .. . *..* *.* ...*\.*. *.. \* .*.. **\******. . ..*\*  ..\..* *\ .. *** \. * * .**\#
#   #\. *..*\...\\.\.***... .  * . .\. ..    \   .......* * . ..*  *. \***.*.....*\*.*.  .\.* . .  .\. .\. ..\ .. * *.*\.**.... ..\*.*** *..*\..** .*\*.\ \*.. .\.*... .. .\ \  #
#  #\.. ..**\. .. .. *.\ \  ..\  ..\. ** .... * \ . . ..  *\.  ..   . \*.. **.\. ...* . * * . .  * ..\ *..\ *.  \ .*..*...\*.. * \.*.... **.. *.\*  ....\* *  . .\\** .* ..  \**#
#   ## \ \.*..*. . \  *.. ..  *  *\.  ..\. * ..\. ..*. .\\.. .*\ **..... .. ..\*   .*. .*\  \.\*\  ** .. .\.\     ....\  \**  ..\ *  \.*.. * \.. ...\\ * \.*.. .\.*...  \.\**.  #
#    # #..\**..*..\.\\.. *\.***...   *.\ *  *\.  *. \.\..  \***\\\.* . * ..\** ...\\. * *.. *\...\\*\  .** .  *.\ .. **.\. *  *\*.*\ .\.  **    .*   .\.** .\  \....* \* .*.  **#
#   ##  .  *..*\\  \..\..* \..* .    ..*\.\.\ ..*. *.*.   \. *  ...\.\..*\ .*   ... . .*\.* .****...\.. ..*.\ ..*. \ ... ***  **. ..*..\ ...    .* *. **.....  .. . ** ..\  \.\\#
#  #..*...#..#.*** \*. .\*\.\..*. ...*\... \**\  ** ..\.... ...  .*.. . *.\ * *. .\ .\ \* \  *.\* *...   **.  .....*  . \....\**\*..*** * .\ .   ...  **\ \  **. .. *\*..*.*.*.*#
#   ###..*  .\.*.. .....**\   .. \. **.\.\*..* \.**..\*  \* *. *\ .\... .*..*\    .*.. .* *.**. ..      ..*..**.**** **\..  \ \*.. *.....  .* \*... ....*\. .\..*\.*\.*.\*\\..\.#
#     #.*\  #*..#... . \..*   .. .*  . *...\ .\\..* . \*\.. .**. \. \ **  \.. . .  *\ \\. . ..  *.**\.*.*..* .*..*..***    . . .*.**\.  *.* .*.. *.. \ .\ *. .* **  ...*..*\.\. #
#     #\*#.*\*****..*   ...  \ *. .\. ... \..   .\* *\.*.. ***. .\   ... ...\ ..*\.\.  .\ *  * **\.**  . .\. .\\\.* *. \* \*. .*\* . \*\. .\...  ..\ .*..*.** *.\..*   \. . \**\#
#      ## #.*# **.\.*\ . . .  .*\.**  \\ *.*.* *\ ..\. ** .... .\. .*\.  ..\.* ....*  . .*\. .*.. **. .. . .  .\*\*.  . \**.*\.*\* \*...*  . \\  *.**\.*\\.*\.. .  ..* .*\ *.*..#
#          ###.\**  \..  .   ..... .  .\.....\*\*..   \.\ *\ *. .\  . . *. . .** ..\   ..\* \ ..\..  .*.  .*  \ \.*. *.  \.\*  **. .\* ...... .**. .. .**\* \*.. \. \.  *  .\\. #
#            #.*#.....\ .*\* \.\. \\.**.. ..**..*..**.. .*... \ \.  \.* .   . ***... ..\.*.  .   *..*\  \* . .* .*\*....*.  **  .*   * .**.\*.* *   \.\.\...*.\ .  .. \ *..  \. #
#            # \* . ...  ..*.. .*  .  *  .****  .\ **.** *\ .. ..... ....\ .\ *.*\ ..*   .. ....*.* *    .\*\** **..* .\*..***\*..*. *\... * *\.     \* .  *.\...   ** .* ..**. #
#           #\ .* *\ ..\* ...\  \..*. *** ***\.. *\.* .\ . \.  ..\ \ .\ .* ..\. .*. *.*.   **.\. .\.\  .  ..*...\..\.. *\. .\.*.....\*.\. \***** .\*.*   * .*..* ..\. .\*.\...* #
#          ##.* .*#*   ..   *. .*  .* **\ .* .   .  .  \. \..* .\ ...\. *.\ \*.  * ..\  \ . .. . . .        * . ..*** . .** .* \.*\  \. **.*..* ....*.. .\. *.\. . *\ \..* .  ..#
#         # *\ ##* *  * * .\.. .**  .**.*. *\ .\ .* . * . . .*.*  *.. .*.. ***. *\  \*.*..* ..    *  .. ... *. *. .. \..    \.\..**. .  ..\***   . *.*....*.. . . .\     .  *. .#
#         #\#*# #..  ***.......*..   *. .  \.\\*\...  .\   .\.\\*.*.*  \ . .*. .. ....**... *  .\*. ...    \.. \* *\...\ *.....* .*.\* *\*...**.   ...... .  * \.    *\\*\.\.*.*#
#          # # ### \*. .*  .\* .*\ \ ***  .*** ...* *... .***.. .*.***.*  * ** *.. **\ *.. \  \ *.\ . .\** . . ..\.* *  **.*  *.  ..\***.. *. * .**.\ ..**\ .* .\....\...*.. ...#
#             #. # .\ . .  *.* .*.*\...*..\..*. ..  \.  .  ..\*\* ...*\.  \ *.*. \ .. .***.\.**\*\. .. **.\..* .***..\  .. \. .*..\. \     ** . .\.***\**\ * .. .  .  .** **\**.#
#             #.  \#.   \* *.  .....** *.* *.*. **   ..*.**.* * . .\..* \* .. *..   .  ....**......* . \  * .* **.\ ..\.* ..*.\.*\\ *. ** **. . \.  . .**.* ..*...* \.*.\ . *\. #
#              #\ .*   .*.*. . \\. . ...*.\.*  * . *.* .*.\\.**...  ..*..*  **.*\   . .. .\ \*\ \*.*  **.\****...*..   .*\...\ *...\*..\... . . \. ..**.**..\.**.  .. **.. .***.#
#               ##**\**...*  ... .. .***.*...\ .\...*\\ .\.. . .* .*\*.**\ \.\..  **.*.** *\. .*.\ .  .. ** .... *.. *.    .  ..*...*\.\*.*.\*. ..\\**.  . ***.. *.\ *\*. .*.*..#
#                 #. *\.**..\*  **.\ .... .\  .*  *\... **..*.\..\ . .*\.  ..*\**.\ ..*.* *.  . *\*.*\.  *..  \  .*\.\. . ...\ . \*\...*.*.\.***    .\. .*. ..**..*. .\ *... . *#
#                #\**....*\* \ **.*..\**.  *   . **... .....\.\ \ \*  ..\.  \ .\.  * .* *.\. \ *\.  . \* \.** .** \ \  *\.  **\***.*\.. .*.\ .*....\..\. .\ . *.  .  \ ..\  .\..#
#                #.*\# #**\.\.**....\..\  ..\. *  .. .\** ..*\ *.... .*. ..*.\* .*.*  .*. .  .\. .** ... .*..\. .\ ... .....***. \.\  ..   .\*\ .\**..*\   . ....\  \.\***. * * #
#               #*.#*.***\. ..*.. .. ..*  .**.***.  ..*.* . \...*.\.. . \ *.. .  ..* \ ***. \ . .**.*\  ...*  * .* *  *..\....  * .  \. .*.*. *.\.\. .. .*. \.*.*.* . . .    ** #
#                ###.#..*.  . .\ .. ..*   *.....**.  .**. .  ** \.\  .\ .\*.*.   *\. *. \.*.*.\ *..\.  \\ ..\.. *.    ..**. . \..*.\\*  .. .* .\ *.\. .**\ \. .\*   .\**.  *.\.\#
#               #* #. \  *. . .    * *..\     *\ . .. *.*. .. . ..*.\***\ .. .* ... \.\ ....*. **** *    .\...    ..\*  \ ...\.* . ...* .*.*.*  *.\ *.*.* *\*.  .\**\  .*. . ** #
#               #\.. .\. *    ..\ .\.. *..\*.**...\.\\*.. **\. \. \.\ **. ...* ...*.**..* *\..*.. * .    ...   .\....    .*\ *\\  .   .. .\..*.\**..\...*.....\  ..*  .\.*.\... #
#                #.**#. *.* *  .* *..\.***..* **.*..* .*.*..  \..*..  \***.\.. *\*.*..  . .   *.\*.   \ .*. *..\. *.\.\. .* *... \  *.  *..  *  *\\ . . . *\ \..*\ *  **.\  .*.*#
#                 # #* ##*. *.\ *..\.. \.\.**\***.. .\.. \.\. .  . . ... .  \ *..*.\  \. .... . .**.**.. .  \*.  .*... \ **.*.*  .*.. **. .  .. \ .  .\.**.\..*\..\. **.*....  \#
#                 #\#* .#\.*.\****\**...\   .* ..  \**\  \*.  *. .*.   *\ .   ...\.\*.... \.* .  .. ... .. *..\. *...\... *\..***.*.  .. \..\. . .*   .. *..*.**.\ *... \*  .\  #
#                 # # \.\* **.*\ **..* * .  \.. .  .\..* *..*\ \ .. *..*..** *..  \*..   *... * *   *.*.**.. ..*. .*\.\\. . .\ .. .  * ......*\ . . .  ...*.*..... \. . .*.. \..#
#                  #* *# ..* \\.* .\.. .   .*.     ..  .* *\.** .*. *.*. . **.  . .* \   *.\*\... **  .  .  \ \ \  *  .*..   . .   ..\ ..*  ...*  ** .*\... *.  ..*..* .. ***.\.#
#                   #**\ * .*\ ..  \ * *\..*\ \....*\ *. *\ ..*...*.**.*..*.. \ *..\.  **\  ***\.....\  **.*. .\...*. .* ...*  *.***\ *..* . .*.\ *. *.*    ..\. ***..  **.** *\#
#                  #\.\.#**  * ..\*..*..*  \....**.\**.*  .*...\.\.\    **.\*\  *\ * ..\*  \..\.\* ****\.\*.* \  .\*  \.\* \**\.*. ...\ \.\\. ..\.***.  . .\*.  ... *  \.**.* .*#
#                   #.\...* *. ** **....\ * .*.... .*.***... .\  * ..\...\  ****.... *.*. .. * *.*. .*\. .. . .. . .*.. .*\.\...\.\.\... * *..  ..*.....  **. \ *. *\**. .. . . #
#                   #.#\*L.*# *..**. *\ .*. .*.*. *..*..*..     **\*\  ... *.* ...  .*   .* .. *. .. . . ** * \.* \ * . . *..  \ \ \*. . .\*.  ..*.\ *   * .. .  .\ *\...*.\ .  #
#                   ###.# .\* *\. *.*. \ \   ...**.*  .  **.. *.*.. * .. \*. . ....\*..\. *******\ .  * .*  .  .*   . .. **\*\ .  . ..*\ *.. *. ..\. \.. \* * * .. **...\*\.**\ #
#                  # * .*** .**.*..*......*.. \*. \**\..*.\ \ .\.*.*  ..*.* \*. .\**.*\*  **.*.\  ..  .. *  .  *. *.\\  \.. .**...   .  .... . *  . .. \\.\.  \  \\*.\. .***...*#
#                  #\#\*.\.  \**.*\ ...\.. . .*. ** **.**.* *. *..*.*  *. *\ .*  ..*.\ *\ *. ..***  *.*.*. \.\.. **** \*.*\ \..*\. *\*.\**\.. .*.  ..\ . **\*\.*\*.*.** ***..**.#
#################################################################################################################################################################################