#######################################
#      #*#                     # #    #
# # #### #    # #      ###    # # ##  #
##.#. *#.\#  #.#.#    #.. # ###.# ..# #
#\.#\.** .###\.#  ##   #\*\# *#.# .L.##
##*. ....\*.#  \#   #   #. ..##*\\# .##
#\# *  . #.*##*#  # #### ##\ .#..\..*\#
#.**. \..*.*  *. #.. **.*.#\**#  *.#*##
#*.***.**.*  \#\ *.* ....# .\.\  . **.#
#. *\\.* *\  #...**.   .\...*#*.** #\##
#..**. . ..\*****.  \..\  .#.*.*.. *.##
# .**..   \ . *.\  .  *\... \.\ . .\..#
#\   * \. *.*\. ** \.\... \ .**   *\.*#
#.  ...*. .\ *.*\*\...*  *\  ..\...\ ##
#. *..  ..\*.*\..*  . . ..#.\ ..*...**#
#.*. ... *.*** .. . #*....  .  *#*\ ..#
#.*\ *.\ .  ... **  .*\. *  ...*.*. #.#
#..* **.* \.***\.*. . ..... \.\. \ .\ #
#\\*... .  .*...**  . .  .**   .*.\* .#
#  ..  .*.*   *. * .*.* *.... ... \.* #
#\ .*...**    . \   .**. ..\.\\.* .*. #
# . \\..*.  ..\..* *.. *. .. **.* ..* #
# .\...* **\... *. .....* . ... \*..**#
#*..\.*....***..   ..*.. . ..  ..*.. .#
#\..** ..\ .*.  . .\..   ....  . ** \*#
#\*...**  .*\* \\ ... ..\* .\   .*.*.*#
#*..*\** *   *..*...\  . \.**\*. . .*\#
#. ...*..\ *. .......** *.*\.\* .*  . #
#\  *... * .    *.*..\. . \. *   .\. \#
#*\ \\ \ *  *..*.. ..    *.  \ * .*. .#
#. .. ...*.\..\..\.** .*  .  .*.*****.#
#\*\ .**\..*  *.*.......*\ *.\.\..*...#
#..   .\..**..*\.**\.*.\.. . *  \\. . #
# *.. . *   *..*\*..\.  * ..\. \  \***#
# . ...\.*\ ..\. * **. *. . .* \*.*...#
#*   ..** . . * \.  ....\  **. *\.* . #
#*. .  .. .   .  \*..*.**. \. *...\** #
# .\.*\*\ ...  **..* ***..  ... .  .*.#
# ***  \ . .*...   ..**.* \***\. . ..\#
#\**. ..\  .\  . * *\*\....... .\..*  #
#***\..*. . .  .\**...**  \..*.* * . *#
#\**..**.** ***.. .*...\.*.*. *.** ...#
#  .**.*...* *....\  ** \ ***.. .. . *#
#\\.**.**.* \ .\ .* ..\...* .\\    . \#
#..*..**..*.  \.* *..*.. *** * ... *\ #
#\..\... *.\. * ..\  ..\ ..\  . .. .*.#
# .*.\....*.. . ..*.**.. .. .\.. * .**#
#. .. ..\*. *\.\*.. ....* \\ * \ . \.\#
# .* ..\ .*\  \ ... *.. . . * *.\*....#
#.   * . ..***.* \  .  . .\. \* **.   #
#*.\ . \ * *. .\.\ \ . *. .  .. ..*\  #
#.. .. .\*\.  \*\  .\ *.\. \* \*. .*  #
#\\.  *  .**\ .*... .**.**. * .*.. ...#
#.\  .... ..**\.\  .*. *. \*\    *. .*#
# * *.\..*  .. ...   \*.*\  .\.. .*  *#
#\..*.**...\ ...* ...*\.\ *\ . .\** *.#
#**\  *\*\.*\    \     .**..  .**\* ..#
#\*  . .* **.\.**. *  . *. .*..*. ..**#
#..\  .....\* \** .* \   .  ..\ .  ...#
#.  . \ *  *. .**\*. .  ..** \..  . . #
#.*...\.. .**\ ...*.  **...* .*\*.  ..#
#\.\  . *.* . *\.  . **.**.*. *.. \.\\#
#*..* . . * * * ..*    \.. *..* ..*.**#
#.*.\..  .\ *.   ....... *. * .*. . ..#
#.\  * . \  . .* \*. *\*.*. ***.. \ **#
#  .\\.\.. ..*.\    ..\**.\*\.. **...*#
#\\...** . .*. .   *. ..\.\*. .. ..\*.#
# \* *.... \.* * *..   . \.*.\* * . *\#
#... ..\.* ..**. .*\... ...\. ...** . #
#\ . .* *.*\ ***. \ .**\.   .* .\*.  \#
# \.....\ ..  **     .*  ...  .\ .....#
# ..* *  .. .***. *.  .. \***.. \.\.* #
# \*.*\.*   *.\.**.\\ . ..* * .. . .*.#
# . .  ** ..\\*.*..* *  .*\ \*\  .*.. #
#. .\.. .. \. .*. *  .  .*.... ..\.\ .#
#*\.* ..*... . ..   .\.\   *.* *   .\*#
#\* . * *.*  .\*.\*.   .*.*.*.. .\* **#
# * \*.*..*\** .. *. ***. *\.\  . *.**#
#\..\. *.*..*.. \.* \.. \. . .*\.... .#
#\.\.\.\. **.\* . ....*\* .\*\*.*.  . #
# *..**..*.\ .. \.\  ...*\ .\ ...\.  .#
#.*   \ \. ...\ .** *.   .* .*  ..    #
#..* ... .\..* .\. *\.\*...\..\. * *. #
#* \*.  ....\ . . .\.\*  .   *  . ..* #
#.**..* *..* * . *    ..* . . \ \* . .#
#..** .**..* ...  .  *.**\* ..  ... . #
#.\.*.\..\..** .*.\.\......* .\**   * #
#.*.* * *. .... .* \.   ** ..\\.. *...#
#.\*. \ . .\... .. .*.\ ****\ **\ .. *#
# *.\.. .    ..    *\. ...\.....*  *  #
# *\ ...* .. .\.. *.  .  .\ .  *. ....#
# ..\  .\  .   .. **..\ ..*   *\ *.\* #
#. .. ..  *..*. *  \ *.  *.\ .***\.*. #
#.\*. .*\..*.*  .\...*.  *. . * ..\ \*#
#.. *  .  *\ . *  *\ **...**....  *..*#
#.\*\..*\ \ .  .   \.*.* *\**  ...\.. #
#.*..\ . ..*.*R**.*. \.*.\ .*   .  *.*#
# *  * . ... ..\  .*. *.. * ..\ \ .. .#
#* * . .*  *. .**  *\.. **\.*. *.\  *.#
#*\ ...\.\ .\.*..\... .\*. . ..***   .#
#.\  *..* . ... *. .*.*...* .\.**. .. #
#..  \ *.*.* \ *.*\.* *  ..  *.** * .*#
#* .*. .. *..... .*.*.* .*.. .*.*.. \.#
# ..*  **\*\.*\*\...  ... .. *...   ..#
#...*** * ...*..\ .. ..\ . ** * \.*** #
#\ .*** \. *.. \  ...\.*.. .. \. ..\..#
# . *..** .. . .. *\ *\.. * . . .\   *#
#\....\**.\ .. \*.\* \ ..\ .***   .. .#
#..*.\*.\. . . ...\*   .. * .\.**. *  #
# .*..\\ \ *.*.*\...\ .* ....  ..\ .* #
#..* . . *.\ .*.*.*. . ..* ****.\. *..#
#    *.**.\* .. .\ .*. \ * .**.    .\ #
#\\. ..**. .. .* .\.....\.   *\ **  ..#
#***** *\.  .  * \  *. *.*..*. ...  . #
#.*\. ..  ... .**.. \*.. .. .*\ ...  .#
#*.. \ ..   \. \.\.*.. .* \ ..*.  * ..#
#.* ...*. *.  *. **.*.  ..* \ . ..\ . #
# .*  \*\    .*  ....*.*   \*  .\ ..*\#
#.\***....**... *\* . .\   \. ..*. . .#
#.*. . **\... * \.*** *.\*. ..\ .. \. #
#\.*\ \.. *..  ...*.**.. .*.. .*.*\ *.#
#*..* .*.\...   .*....* . * ..*.** .*.#
#\...*...  \ .\. ..*..\* \. \..\ . \* #
#* . .*\** . .\  \ * ...  *  ..*\ *.. #
# ...* * *\.***\*.\* \  ...  * .***.*.#
#. * ...**..\.. . ** .* .\..* ** \.*.\#
#\.\\ \  .\.* \.\ .\. .\. \*..**\. ...#
#.*..\. . * .  *.\ ....*. .\...*.\*...#
# *.    *..*\.. .\* . *. .   .... *\. #
#\.*  \ \.*.   *   * * \.. * ..   ... #
#*\.\..\. .  .\ * *. . . .\  .* . ... #
#. *.*..\ \.*....\*...*\  * . ..*.*\* #
# \*.. .*.\.**.\*  *\... .*..***.\ *.\#
#....\ *.. .... ***\.  * ...*...*.**. #
#     .*.\. *. .* * *.*.*   *..\** .**#
# .*.**\*.   .  *\. .*.*\ *\.... *\ .\#
#..\ .* *....\  *.*...*. .*..\* *.* **#
# **\ \*.***. .\.*\. *\*. .* .. **\.*\#
#**\  ..**... *.*.     .. ** .**.. .*.#
#.\*\**..\.   *. \.*  * **.****.\\ **.#
#. ..*... *.\ ..* ** ..*...\ .** \... #
# . .  \ ..\.\*..* \.\\\.   **..\. *\ #
# .*...\  . *..   .\*  *.*  ..  . .**.#
#. ..  **. *.\* ..*..* *\. *.** \ \*\*#
# . .  ...\ *.**. .. * .***.*..  *....#
# \ *.*.*  *.**\ . .\..\* ..\. * .  \.#
#   .\. . .... \..** *\*.\. .**\  \..*#
#*... .*\  .  *  ....*.*\ *  .**\.****#
#*..*.....**..* .. *\ .. **.\*.. *****#
#.* ..*  .\**.. .. \*   .*. *   \.. ..#
#\.. \ . ....*.* . **.* \.\   \. * \.*#
#**. *\**.\ \.*..* *  *.*..\.*.\..**\*#
#######################################