######################################################################################################################################################
#                                                                          ## ##. .#..  *.*.**... . . *.  ..  *.*\*\.\.\.. ...  . \*.\.\ *\. .. .\ *\#
#                                                                        ##\ \    \ *.*\ ..  *..*.* ...  *  \.. . . .  ..  .**  . ..*.*..*.\ **.\. *.#
#                                                               #       #* \    *  .. * .* .*.*.* .\ \ \.*\*.\*.    *\ \\.* ... ..*.\...*   .\**..\. #
#                                                              #.#       #..*** *  ***\\ ** .* \**..**. *. .\ ** .....*\. .*. *.*..\ .. *  .* .*.\*. #
#                                                             # *#  ######.##\#\#.\.\*...*.\ ...**  ... *\... ..*  **.\*.\..  *...**. \. .\ .**\  .* #
#                                                            # ..# #\...*#. # *.*\*. \*\.\* * *.*.***\*.*.*  *  .\....*.. \ .\*.* ...*.   .  *\* * . #
#                                                           #*\ . # *#*. .#\ ..***.  ..  .. *\ *. ....\..*.. *  .** * .**.   .\.* .*.. ..***  .*.. . #
#                                                           ## . # #\..#  \*. \. ....\. .. .* *.*.. *..*\ .* * . *\ * *.* .*..*..  ..*.. .. *\ .. .  #
#                                                        # # #\*..  **. *\....  .  .* * .  *. ****....\.*.*.*   .*... . . ... . .*\***\* *.***   .. *#
#                                                       #*#*..\. ** #.. *    \. *\ ..*..\ *. \*.\. *\  ***.\*  * . *.\.\..**\* ..* ..*\* .*. *.  .* .#
#                                                      # .#\#*. ..\*\.***#..*. \.  \...\...* .\. **.*. *.*\.\ ...* * .*. \ .. . ..**\..*  .. *..**\  #
#                                                      #*..*..* .* .  ...*.\.*.  .*.\.. . \.  .. *. **\ ..*. .*..\..\ ..\. * .\ ***.. \.\ \* *.\*\.**#
#                                                       ### *\..*. .\  .* . .*    *....*  \ ****..\ .. .*..*. \*\\* *\   \ \.. ....*.  ....\..\*.  * #
#                                                         #\#**#*\.. .  *. *\.*\ **** \\*.**\.*. \. .\  .  . \*.* * *.*..\ ..   . .... \.  * .\  . \.#
#                                                        #.* \..\*.*..\ .. *  ......   *. . . ... *\  **\*  . ... .**.*\****\ .\ \...****  . . *    .#
#                                                       #.#*\#.# . *.* * *..*\..  .* .**. ***   \..*..\..*\   **\ \.\..*.****.. .   ..\*.* *\* * *. .#
#                                                       #.###  .*..\\... ..*.* *..** ..\ . .. ... . * .*\***\.   *\ .\  \ .**\\.*\   \ . ..*...\.*..\#
#                                                   ####  .#\** *\  ****  *..* \ **.  .\.*   * \.. .\....*.*  * ****    .*..\...*.\  * .. *.**\* .*..#
#                                                  #**\#* #* *.*.*\ \. .*.*.*\*  ..*.\* ..\  .... **.** \.\.\ \*..* ...*\.*\  .*. .. .  .*\ .\ \  *.\#
#                                                   #*...* . .\. .*.*.. . ..*.. . ...*.....\ ** .\...\...    *...*.\  .* ..* * * *.. * . .  * \.**...#
#                                                  #*.#\ ##.\....\.\ *\**  \..\..\   . \*..*.\.\ * *  . *\\   .***\* *... ..\  .\.** ..*. . \   .*..*#
#                                                 # .\*\ .\. ..*.  . . .*.* . .....***  *.*****  .**. .*..*.*..... \.\***.* * . ... \  ... ..   .. *.#
#                                                #.   .\. .**\ **.   ....\*\.**\*\ * ..*.\.*... . \\. ... ...\.\.* **..*\*. *  *.*...*\\   ...*. .\  #
#                                                 #.* ...\\** ..  *\ \\*\*.. \. .  .\  .\.\**\* .\..*\.. ..  ...*. .** .*.*.....*.\*\ .\*\\ . .*. .  #
#                                                 ##.   .*\..  *. . .. *..*.*. . . .. ....*.  .* ..  ... \.**   . ...*\\....*\..\ ..  ...** *\.... *.#
#                                              ###. *  *.. *\*...*.*..*  *.* \* *. *\ \. ...*\.\   *.*\ *.*....*.* *.*\  *\*..\   **.  . ...**.\**\**#
#                                             #.**  .... \ .. *\ *.*.\. ..*.\*.\.. \ .*.*. *** ... \*.\.. .*** **.**...* **.*.***.**..* ..\. .. .* *.#
#                                           ## #.#.. \ .. *** .........* .\* .** *.   * .*. ..  .\\.*.*..* .\. ..*.\**...\.***.*   ..\...\   ..  ..**#
#                                          #  # ##** .**\ .*.*..\ .  *\... .*\*\**.*  .\** .   . .\..\* .. ....* . .\* .\.. .\ .. .*..*\\. .* *. * .*#
#                                           #*###.#.. #. \*. .  .\.. .*. *\.. .   \  .\ .\..\.  . .*.\**..* \ .. \ .**.* . .\    .*\ \ .*.. .*....*\*#
#                                    # #  ### .*..* ..   \..\.* **** ..* ..\  . **.  .... *\ .** . .  *.  . . .... \.....**\  ... ..*.  *  ....*.  *.#
#                                   #\#*##*.#...\** \  \*...* .\.\.    .\* . .\ .* .. \.\ \*...... *.. *...\*   ..*....*\..   \..   ..*.* *.*  * **. #
#                                   #  . ##\* * *. *\* .*** *  * **.\\  ..     * . .  *\*... \ ....**  *\**.**    *.*\ ....*\ ..** *...\. ..  .\ * * #
#                                    #* *. ...\ ..\** * * **.\  *. *\ \.**\. *. .  \*\ .. ** .*.\ ..**.**.* *..   \ ..\. **.. *..* .* *\* * *.  *... #
#                                  ###.**#.   #**\.*.  *. .    ..  \* . \*. .. ...\*...  ..* ...* \ . *.*... .\.* .  .** ..\...\..\ *.. *.*.\..*. . *#
#                                 #.\  .\  .*.*. . *..*. *.\..* .. \.* *.. \.. \.\ *.   . **.* \. ..\.\..\* . . *\\.. *.. .***     .\ .***.* ..\..* .#
#                                 #.*  *. ***.. #  * .*  .*.    .  ..*\* . .\  . . .. *  **...\.  *\.   \ ... \..  .. . \.\....\**\  \*...*   \  .*. #
#                                 ###\.*......\ .\*#...\...  . \ .* .. .\** *    * *\ *...\..*..\..* .*..  **\ * \. \     .****...**. .  .  \. . .\.\#
#                                # ##*\..*  ...   ...**...  .. ...     ...* *\  .\.. ...    *.  .**  *\  *...\.*  * . **.*...\* .\.  *.*.*\.*  .** ..#
#                                # # ##... *.. .***.*.. . **..* .**..\..  ....**. .* .* \ **... ..*. \ *\*. *... ** *.**.\***.*. .   .  ...*.*.**\* .#
#                                #*###*\.*.\.\* *.\\ *.  \..  . .***... .* .\.*\** ..*.  .*.*  * ** \.*\.*   ..* ..*..*\  .. *\.\..*. ** *  ..\ ..\*\#
#                                #.# .**..\*.\..\*..**.\ * .*\*. **.  .*..  .....   .. \ \**.  * *\....  **\   \. ***....   ... ..\.\ .. \.. *.*.**.\#
#                          ##   ##*#*\..  **.*..*.   .. .* .*. * ..   \. .  .*.  * \ \... .*  ..*\   .  * .. .*.**.*..\*\..* ..\*  .\\ .*.\.*. ..*.* #
#                         #* ### ...\*.*.. . ..*\. ..\.*\\  .....  .\\.  .. *** .\ .*\ * \.. *..\\*\   *.* . ** \..\.. . \.. \.* . *.*..   .* *  .*. #
#                         #.## ###  .\ ..\ *.  *     .\*...\ * *.  .**\ .  ....   . . .. ..\.*..*** *.\.*..\...   *.* . *....  ..**. *..  . .    ..* #
#                        #  *. # #.   .*..\.*. .* \*  .  *. *** .*\.. * .. *. *..  . *\.***. .*..*  .***.  . .\..**..  \.*\.  .. .*..* \. .\* .\  \\*#
#                         ##*# ##  * ..*\. \.** . ...  \ . * ..  .... *\  *.\.\.* * ..***..*\  \ ..   .**. .** *.\.*.    *.\ ..** ***.\  ..*.*.  *...#
#                          #* ... * *. \*\ ..*. \ .\.\....***.*\  \.\ .   . .     .. .**  *..    . .   ..  *.**. *\ .**\\\  *..*.*..*\ .* \*\.\  *...#
#                          #.#.#  \.\*. ..* \*..* \ *    .. ..  . .* .   * *\.*.   \.*\..* . .  \   .   . .\**.\. .  . .*. ..\. *. *. . *. ......\...#
#                          # .\#\\  .*....\  **  *.\** *\.* .\* *  * .. ..* \...  .**.*   \.**  R .* ... \**.******.. ..* .\..**.  \*.**\.. ****\*\* #
#                          #. *.*.   .  **. .. . * *** .  .*.**  ..*.*  * . .**\.. *\  \.\ .**.... ...\. .*...*.*.*.*...  \.* .  .. *.\  *. *..... **#
#                          #*#.... .*.. .*\*   .*\.....\ * . *..   .\  ..... ...   * **.*.. *. . \..* .**.\.... . .\..\ .*... \*..* \.*. .. *.\.*   \#
#                           # #\ .. *.\...  .  *... **\*..   .    *. *\\   *. *. .*.\ *..*\ .\.\..\*\*. . ..\ *\.*.** \* **.\..*.*.  .\.   \.   ... .#
#                          #.#  . * .*\*... . \\..*...* ..  **. * .  *.\.\    *   * .\.*\..\. ..*.....  *   .\...   * .* ..*.  ..*.\.*  \*..* *. \*.*#
#                          # ...\*..\.*.\.* \  \..\.....*.. *.\ * . \..  . * .  .\\. * *.. **  \ \ *\ ***.*  .\. * .*.*.* ..*.\. .\. ..\.\ ..\****...#
#                          #*.  . .\*..  ....**..*..\ . . ..\ * ..* .. *. *. .\ *..\*.\.* ..\.*.\.\.*  ....  \.. ..\*\. \ *.*\*\  ...*..  .. ....\ *\#
#                           ##*#\ *\  . \ .\**\ \. \   .\... .\  *.***.. *\.\*..\\ ..  *\**.. *\.*.\.*\ *.*.**\ \*  *  ...\ .*.   *\.*.*..\*  .***\* #
#                             #***..\*.\ **..\* \ \\*   . . . *  .. ..\ *.   . .. *\***.*.  .\....*. . ..\..***  .  . *.\ *    ..*....\.* \... ****. #
#                             #*...... .*..\* *. *... ..... ..* *.\..*. *.   ..  ...*. .*..\\....** ..*.** * .\ . .***.\.   .*.\ .*\.\..* .*\*..*.\. #
#                            #*  #\.  *.*.. . .\ .. \\ .\*  *  *. .* * ..* \.*. . **..\..\ .*.*.\.*  *\.*. \*.\. \ *..*.. \  ..\.*\....\. .*..  .  \\#
#                        # ## .. .  *\ ... ..\. .. *.**.... .* \ *.. ..* ... ..\* *\. .. \.. ...*  . .. .*. . .\.  .* .\*  \ * *\*.* \.. .* .  **..*\#
#                       #.#*\ \  \\ *\ \* . \.*. *..... \\. *... *\.. *..  .  .\.*.. . .* *  \  .   * ..... .  .\ \*\ * . . *\.**. .\ .* *... *\*.**.#
#                       #* \*\ ... .\.\...\  *..... * ...  ..\  *.***  *.\ .\* .* * *.. ****..  *.*.... . . . ..**.. ..\ .* .  ..* *\.*\ .  **...*. .#
#                        #\ .\* .**..   \\.. \*\  .** *.\  . .. *....  *\* .*.\   \\.. *\...* ..\.* \*..*..*  \*.....**. .*.*\* *.*.   **.  *\*... ..#
#                         #\ ..* ...\.* .\.*  .*.*.. \.**\   .*.\.. * .. *.\...\.*.\ * . * ..   *..\ ..**\   \ * . . *.**.. . ..*  .*.\..\**. * *. \*#
#                        ###**\.     *.* .*.* .\... *..\..\***\ . ..\*.* . .** *.  *   . .\.  \**\.***\****... *\.*...**.\  . . *...    \*...\. ..\ \#
#                       # ** . *\.*. .   *.**\  . **.   . .\*. ***  .* ....\ **..*. *..* *.. *.\\.\*.**\.*.  \.* .* ..\.**\  .*...   .\... . .*... *.#
#                    ####\*\ \.*.. .*.*\\. *  *.***.\  . ..* .\*..  ....\.*..\. \ ..* . **\. * ..  * .**\. \*. .  . ..*.\\* .*.**.\***  *. ..**.. .* #
#                   #*.****. .\.  ***.**.*..  . \..\.* *. **... *. . *. ..*.*  \ \  .\  . . .*.\ \*.  .*  .\..  **. \  ..*.  .* .  .  . .   \.. .... #
#                   #\##....   .  ..* ..*** .. ...\..  *   ..*  .   ..  \ . . ...* . * .. .***.*  \*\ ..*\ ....*..  . . ...   . . *** .   .\.*.*.   .#
#             #   #  # # \.* .***. .*\ ...\.   * *.*. *\**   *.*. \**** . .\. .* .\.  ..*.*..  .  ... . .*\ ..*..\.  . .. ** * .   \.\ *.*   ... \*..#
#            #*# # ###    *\...*....\. ...*\ **  . *  * *.....**.  ..*.\.* .*  \.  .\ *.......... . .*.*.*. .*.. *.   *  .... \ .\. *  .*   *  \ ... #
#            #* #. .\#*.**** \* * .\ . .***....*.  ** . . .. \ \ *..*.* *  *. *.* .** * \*..***\   * * .** \ *\.*\..\ .**.\*\ .. .**. *..  \.*\ ...*.#
#            #....*   .*.\** .\\. *\...\**.* **\.\..**..*\.\  ..*.  ... . .* .. * *.   .... .* .\.*. . *\*.\  .\* .....\*\ * ..*.\...  *. .. . .**.*.#
#            #*   .**#\*\ *.    *  . .  .  . ** *.* .*. *.* .  .. ..* *  . ... ...*. \  . \.....\ . .. \.*....*..*.* ** .  \ *.*. ..  *.* \ \..  *.. #
#      #### # ##  **.**\* .....\\. ..\* **\. **\. .  \*** . \. .. .\... .\  **\  *. ..*  *  .. ***.....\ *   ..**.  \. *\.*.  ** .  .\.\.*.\. .***\. #
#     #*\*\##..* .\\ *  ..*.**\*.*\ **.*\. . . *  .\ .**\ *. . ..\**... ..  \\..  \  .    ***..\*.*\\ *.... * *.   * \... ..\.\*** ....\..***\.\...*.#
#     #. ## ###..\.\ .\.. ..*.. * .**.....\.\ ..* *.\****.\ **\.   .**\. \..\\  * .\  \.\.*.*. *\.*\...\\.. **..*\.* ..*...\. **.* \** *.*.*.* \.\**.#
#     #* .\L. .\\ .  *..\.*\* \.*\..    \\*.*\\.*\.  . \. .*.*. ..** .\**. \ .* .  . . .*\... \* ... .\.*.  ..**. *.*.**\  * .** .**.\.. .  . .....**#
#    #.*. #** *.... *\.** .*\ ... .\\* *\\\ **..\*.\. \*  ****.  \ .*\* *\*  ...*...* . .. ..*.\.\..*  .**   ..\ *...*.****.**.. *..  ...  *..*  .. .#
#     #.  .#. ...   .\.*\.\.    **. .. . . ....\  *.  ..* ...*..*. *... \*. . \*...\.     \* .   \..*.    \   .  .**\. .*.. *.   **  .*\* * .*\.* .\*#
#      #**\.*  ..\ *  *..* *.*. .   \ .. *.. ..* * ... \. .**.**..* \  **\.*......*  **\..*. * . . .* ..  . *.* \**..\* *.*** *. ..  \*\....*.. *.. .#
#     # #*.*.*\  ....  \.*\  ...  * .*.  *.***\\ .  .. ...* \. ... .\..\...***. **\\*\*.\*.*. ... ..\..*  ....\. *.\**\... \. **.. *. .  .\ * .**   *#
#    #  .\ .\..* *\*..\.\.*\   *... \*\   .*..**\. ...  \.*\ \ \\* ....     \\ ..**...*. *.*.     *  .*.*.. .. \\.\*.*..  *\*.. \ *\.. *  ..\ **..  .#
#   ##. ..* *. . .*.** . *\*. \. .**......*..\...  .* ...*. .. . * .*. \  .\**  \..\..* \...*...  * * \ *.. .*\ * *....*\*\.*.\ .*.  \ .**** ....\***#
#  #..*. *\.\*   ..*** .** .    *.** .**.*.\ **\ \.*.\*  . \*...*.*\... .   *. *. ....*.... .**\ . \.*  .  . \.\* .\.  .*.*\..*\ *\. ...\.*..  ..*\ .#
# #.####*..**......\..* ** \*.* ** .  . *. ..* .**  * \ \.\ .\\ \ ****.*.**\.* . .  \ *\..\ ..  .**..   .   .. ...   * ..\*  *\  ***\  \.\.   \ ..  *#
# # ##.#*\...  ... *\.. *\..****.* *\*..  \ \*. .*  .* *\   . . ...\..*... *.\**.  ..\*.. ..\   *... *\.*.\*.\*   .. ..\ .\  ..  *.*. *.*.* . .  ** .#
##..*. ..**   .\.. *.\ **. \*... ...*.**\ ..\ .* *..\*\..  .  \\ \ .. .   .*\ \ ...* .**   \*\* ..\.. ...* .\..   \*. \*....*\ . .\** *..\ *\\  ...**#
##\*.... .* * \.\ .... \.*\.*\.  *..**.. .*\.\..*.\.\. \*.... .\.   *\.  . *  .**\ . ***.   .* * . * .. \..  .*  \.   .*\ ..**  ...*...**.\ ** ..\...#
# # # ..#.\*.* * \*.\\   .  .. * . ...\.\ * *. \.. .* **.   ..*...*\.*.\ ** \ \ .. .. .  *.* ..*\\ .* .\.  **.*.  *.. ....*....\  **\*\*  . *..*.\  \#
#  #. \ * . *.** .\\ \.   * \     \.*\ \. \*\.\.\*  \ ..\*\* * *.**.. .\...\.* \.. \..  *..  **.   .** .....\ ** .*\.\  ...  **   .. . \ . ..\...*\..#
#  #\ .#****\..*.\. *.\ .  **.  . . *.*. * ..*  **  \.*\ *....* ***\**..*. .\.\.* *..**..  * *.. \ *.*    *.. *...**.. .* .  \. \.. \ ... .. ..\\*\. #
# #*. \ #*..\. .*.\ *.   ...*.** *****  ..\ .*  ..*  ..\.*. * . .*.**.\.*\  *....\\. *.\..*...*\.. *.\* .\ .* ** . *\*. *\     *. \ .  *  \ * **..*..#
#  ####*\.. * *\...*.\   .\*. .. \.*.*\.*\ *..\ ...*\* *..*.* .\** ..\  \. .\...\  .**\.. \.\ .** *   ..  .*.... .\ .. ...\.\\ ..*. *\..... . *. .* .#
#      ##*.* ..*** *. *  ...\ *.  *.\.**.. ..* \*. *.. *. * *\\ ... .\ . * *****  .*. *. . ...* *...*\\ \.***.\*  *\*.**   ** .*.. .. * \  .*\*.\ ..*#
#     #  * . . ...* * .\ \. . *...*  .*  \. .. . * \ *. ** * ..\**..\. \ . .*...  **.... .*\ .... . . . .** .**..\*** *...**. . .\**\.. ***   \* ..\.#
#      #   **\   ..*. .\  *\.\.\. .  *\**.  *. * ..   .\.  **.. *. \... .. *.. \ .\ *..***\ **.\*    ...*.*.*.\....*. \.\\*.** **..\.  .\* ***..*.*..#
#     ##**  . *\. *. . .\*\* .\*\. ..*.*****.\*..**. *\   \ **...  . .\ .*\..  . ....\ .*  \..\.\ *\. *\\.*.\ \ .*. . .. \....\..*\   .*...\ .* \ \ \#
#    # ..* \.\*.* *\. .\.*. . *.. . \.*.....**.. .\*. \..\   \.. \*... . .* \ .* .*...*.... . *..*.  **   .   .. .* \..*. *  .*.\.     **  .  * .   *#
#     # .*.**  \.\*.*. .**\ .\....*\ ..\.*. .**  ....*..* .\*...*.\  *.   .*..\. * ** ..\ . .*.  .  ... . \. .  .\*\..*.\.*   ... *..  \. \\ ....   .#
#    #...#.**...#*  .*\...*....  ***. ....*.\** .*.* .\ .\ . \ *.*.\**.\*\ . .*...  .   .\.. *.. .       . .   .\ ..*\    .\**. . * * ...  ..*  .  . #
#   ##*\  ..*...\   . .   . .   .*\...\ .\*  *.* .*.*.. .   .. .*\...\*...* .*. \.\  \* .  \.* *    \ .\...**..*..\ **.**\***.. *\. .\. *   *\* * .*.#
#  # .#\*.\...\ .. *...**\ .*. .\* ....*.\*  .*.  *\.\\...* *\* *** *.. * *.*\.*.*.\     .*.  **\ .. **. ...* **.....* .* \...**.. ...\..*\ *. .*....#
# #.*.\#* \ *\*  * * *\ . ....   .. \.*. *. * .  ....*.  ..*\.*\.*.... *.  *.. . .. ..*.**...* \ \.* ...*\\* *. * *...*. \*. *.*\.*   \ \.\ . . * .\ #
# #\*.. \*.. .  **\. \ \ ..   . * \.   .*\  ***     .**..  . ***.\ ..***..*. .*.*.   .**..* \. . ..*. . .. .\*..\..  . .*. \.  .. \...*. ** ..*.  **.#
##\.**.*.*\\*.\*.. ...*   *\ *......\...* . \..\ ... ...*. .*..\.** ..  *\.* .. .*  .  \ **.. .****.. . .  ....* *  **.\...\ .\ . .  \..\.\.*...\... #
# # .\ .\\ . ...\ .. *..  . . .. *\.*  \. *..*.. \*\   **.  ..* \.* \.. . **.. *.* .\... .***...\*.\* .... \ . * .. \.*. .*... .*    *.***\ *.\*.... #
#  #*#***....*.\ ..*.. .  . .  \*..\.. * . .*.*. ...* .  \ .\ . .\.\.   .*\*.\.. *.* \* \.** . . ...* .\ .. .*. ...\.***.   .*. * .  *..*.* \ \.*  . #
### ##\ \ . .**\ *\.*..   .  .\.*    ..... *\ ..* ..* .*    .**. *.  . **\*.. * .* *\.. .\ *.    *.*.****\.* *\.\  \. ..\.*..  .*\ \*.**.\. ....** \.#
#.*#* . .  *.... **\.*. .*\ . * .  *.*\* *  .*\. ..*. .*  . .\.* ....   **.\ .. .*  * . ***.\..  \.*\.* **.. ....**.**.**..  ** ** ...**. . \*. .\. .#
##.* #*. * * .   .....*   * *\. . *.*..****   . ** .. *.\.***...**  .  *  .* .*. . *.*\ ...*.*. \. ..**.*...* . ..*\** *.*\ * \ ..  *.*..\* \.  .. \*#
##*..\...\.*..   *\\ ..\..***.\* \*...\.\*. **\**. . *..*\..\ \. .****\. * \ ...... *\**  \ .*  . \* .\ .*. \*\.* .  * **.\.\ \* \.*..\  ..\   . **. #
##.* *    *\* . .\. .  . .... .\\..\ ...\.**\...  *. .\.** . .\ ..*. .  .. .. *.\ **\.*.\...*... .... .**. ....*..\  **.. * \.....\*......*.*.\.  *. #
##.\.## .**.*.  *  .\..*  .. **.\*\.\   . .\.    .*.  . ...** .  \**...\.\..* *\. **   \. *. .*.....\. .*  \...\..*..**. *\ .\. \ \\...   . *\**.\ .\#
# ###  #.*\..\.*.*..** ..**\ ....*. .. .   \*** . *.  * *  . \* .**. .*. **.\ *  ..**  .*.*. .**.\**.\  *.. **\* * \.* * . . .    .\*.\ **.*\...*. . #
#   #  # * . \ \ . .\..\ **.*\.. .\.\. \\....... *.. .\ . \*..\.*. \* . .. * ..***\.. * .\  * .\\*\.*. .\. *\*.*. *.* .. ***.. . * *.*.**. ..\ *.   .#
#  # ###*.**  .  * .*  *.  .  .*. *   *\*.\... .    \...*. ..** * . *  *  *\  *.*...* \  .\*\ *. .* .\  .* ..*\**\*.\**...*.**.. . .*..*. **\.. \. *.#
#  #**\..\.*#\.... *. * ***\...\  . *\...     *... \.**\*\*\  * .. **. . .**  ..*.\ *... **\* *\ .*.  .*.... ...\*\. .*. .. .**..\ .* ... ..* ..**..*#
#  # ##\** .*\...   *..\..\*. .* ** .* \ ...\  **\.\. ..* .*.\. ***.  . ....\  .*.. *.\...\ \.  ....\\....  .... ..**.. .\*\ ...  \*..** .... .*.. ..#
#   ###. .. .. ..  *..*. *.. .*.\..\.* . .*\. . **\*\.  .\...* .. \   \  . .. \ .  ....*.* * .**\. ..\.* \.\.*.   *... .  .**.  \...\ .* .\*. ..* ...#
#  #** #..**  . . *\* ...*\\ ..    . *   **..*.\.\ ..* . .\ .*.  \. *...****.   .\*.*  ..\\*. .. *..* .\ .** .....\.\..   *.* ....  ..\.   . * \*  . #
#  ##\ .**..\*\ * .*.  .**. .*\      .***..\.  **\  *. ***.\ ...\ *.*\ . .\*.. *\  *. \.\ \\ ..\.\*...*\*...\  *.*..  . .\.*.. .*.. *...   \.*...*.*\#
# #\\ .*..**\. ..**\  *\.**.*** .*.. . *. . *. *** .\** *.  .   .\ .* *\*\.. \ *  ..*  ***...\ ..*.** .*.*\  ***..* ... ....  ...  ..\...\.\.\\  . . #
#  ###**  *\ ...\.*.**\.\.*.*\..*...*\ .* ..* .*..\ ..**.. * .\* .  *. . .**...\ ..\** ...  \.   **** ..\*.. . .**...\* *.. . ....\ *..*   .\. **...*#
#  # #***\*.\***. .\*.*. \.*. * .*. .**.\.  *\.\.\.\ .\*  ..*. *..\... *  .... ...*.\*. **.*.*. **\**.  .* .\***\..  .. \  ***.\.*  .. .\.  ..*..** *#
# # ###. ..\*\.\ ** ..\..**.* *..*. ..\* *****...  .\.\*...*.  \. ..  ...*. ..\*\ .\. *.**.. .\.  * .***.\\.*. ** \ *..... \. .*.. \ .\ .\   \.  \...#
##. .  #.   .  ....\ . \..  . *.*..**..**.* ..*   *  ...* .\ **  .  .\* .\.*..  \ \ **...\\.* ..\.* ..\* *  . ....  .*. *.... .***..  ..*.\\*  ...***#
##* **  * \ .. . * .*\*..* \. ..*.\ \...*  ..**.\.\  \. .   ... *\. *.  * *. * ..*.... \*\......*.\ ****. .    *\ ..*. *\** . *.*.\...  .\.. *.*\**\.#
# # .* **...  .. .  . *  ...\..\. . * *.\..\. *..*. ..**.. .. .\ * \*.\* \**   \ .*.\.. .   .* .**\ *. .  .*.. .*.\*. *\*.  \ *. . * *   . \  \. **  #
# #\*\*.\..  \..\  * .\ ..\. .  \\. ....*  .\.*.\  . .\* . .*.*.*.\*. * .*...*..  .**..\.    ...\ .\.   ****..***\.* \.*. \.\.*\**\....**. ..*.*\ . \#
#  #*.##..*     .\ ..\.\  .*.  *\..   * ...\.. *.  \* .* ..*\\. ....  .* * \ .*** ..  *.* .**...  **   .*...  ... .. .*... *.. ..**.\..\.*  *. ...*. #
#   ##.# ....*.\* .. .. .. **\.* *.*  . \.\*...\....\*..\*\ .*.  .\.. ....    *.*\  .*....\\*   **.*.\.\*  **. .. .**.*..\.. .*\* .\.\   .\.. .   .*\#
#   ##*.. ...*..*\.. . *\. ... .*..... . .*\.* .   *  *. ... . \. *.   \..*.\. .. . .. . . ..*  .. . *\ . .\ .\*\ ..* .* . .**\.*   *. **.*  **\*.\**#
#  #\ .  \. .. *\*..*.  *.. \.  ...\*.* . .**** . *.\  *. .*...  .**\... ..*** ..  ..\*. *..\.  \.*.**\*. .. .*.*..\\.\.*.  \.\..\. .. .  **\. ..\...#
#   ##\  . . #*..\ ..* .\*. ... \*...*. ..  . *.*\ ..*..*..\..\   .  ***. *\..\*.*\ \\. ..*  *\....*.\.\ ..\...\... .*....*\.. * .\.**.\  .*.\  *... #
#    #*.   \ ..  .  ** ..* \..* .*..\ ...  . ** \.   *... .   *\*.    .** . *\.\ .**.. ***. .. *.\**.**\  .  . . ..\*\. *..    .*\.*.\*. * . *  \   .#
#    #.#..*..** ..*.....\*...*...*\*  *..  *. . .**\.\..**\.* **. \.. *\* \ \  . **.. ***.\. *.\   .\.. *... .* * \*  **..*  ** .*...*.\.\*  \  . .* #
#     # #*.  .\   ..\\. .\.  *\ \ ..  .**..*.\   .. *.. ...*. .*  * . .*.\. ..*. .. \*\.*.\.*.\ ** *** .\.  ..*.*\.*\* .* . *.*. *\..\.. ..**.**   . #
#        ##.\ *.*. \*.  * * .....      .. .*\..  ***. .\ ***\* . .*.. \ ***   . \  \.....\*.  \\.\ .\...   *   \   ***.**.....*. .*\  ** \ ..* .*. . #
#         #.. **..   .* .\..\  ..* . . ..*.    ... .\.  .\.\...*..\    .*\. .\  ..* . \.  * **.  *. ..*   .. .* *.*... * *  .* . .\.\    *\ \* .* *.\#
#         #*\*#.\.... *\ ..*..*\ *..**  .*\\.    ..*. . .*..\... .   . *. *..*.. ..  *** .*.*.\*....  . .*  \*.  \**\.\* * **..\ ... *. * *......*...#
#         #.## ####  \. \ *.  * ..\ .. ...***\* .\ \ .... .*.\..*   ..*\  *  *.\   . *\. ..\..*\..*\.\ .\*...... .*.\ *\..\..* ..  ***  *.*\..\  .\*.#
#          #     #*. .  .. . * ...* *  . ***.** .  . .  .\ .**. .  .*\. ..\  \.* *.  ..**. *.*\ **\...   ..\. . *.. . \ * *.*.*    . * \.... .  ..* *#
#                #.. ..*  \...  *.\ . . ...*\..*\*.\**.\* *.**...   *. \ .** *..*.*   . ...*.......*. .\. ..\  \..\*..  . . \*.*.*\*  *. \.....\  ..*#
#                #.*.. .\. ...\*.. . .*  .*..* ...*.*.**.\.**. *\. \\*. ..*\ \   ... * \  *. \ \**.*.. * \.*.*..\**\ .  * ..\.**. .\ \\  ..\**.* *.\ #
#                #\\.  \...  .... .*.    .* ...* \.*.**.* *\.. \\  **.**.\* *  ..   *.. * .  .\*..  . \. .* .*\  ..* .* .  **.*\*.\ * \.  .*.\.. .  .#
#               # .#*. .*\ .  .    ..*.*\ . \ **.. ...* * \. *   ..* .*. **\.\. ...\**\ * ..   .* ..  **\ .**..  . ..**.* \ .*...**..* \ ..*.**..\  .#
#                #**..** *. *  ..\.*\.\. *\ ...  .\. *.*** \ \***  \*\..*.*....  *.*. . . **. **.\   .**.*  .****.*   **.*...*.. .\**\...* *\**. *. *#
#                ##. ..*... . .\ *\**..\ *.*\ ....* ..\.*.  .*.  ..* . ** *..\  ....****.....\*... \  \. .    *.\**.*.\ *..  ... *  . .* .   ..*\.*.*#
#               #\*.* *#*..    ..*  .*.* **  * *\ .    *.. *..  \ .\..\\  *. . .*..*..\.. ..* * *... *.**\ * \* *.\ \ ...\*..*\. . **.. . .\  *..*...#
#                ##..\...*. \.* .. **.\. *.*.*\\*..\\ \ * ..\* .....  **.**\ \*\.*.* * * \ .\.*\    .*.*.  \* *\* .\.\*.\*  ...* *..\**  \..\... .*..#
######################################################################################################################################################