#################################################################
#..\. ... ..   *..  \. .**.\.*..  \*  .***.*. . .*\.*.\..**.\.*\#
#. ......  *.  .* ..*  ...*.\.. * ..   *....\. *... . .*. .. ..\#
#\*  .\ .\*. .\** **\ * *.\*\**.\.  *\*  . .*.\.  * \.*..*\ .*\.#
# \.  .*. ..... ....* . .*.  *****   ..  .\.. *.*.\*. \. *.* . *#
#\ **.\.. * *... .\*\.*.*.\. .\ .\.*. . . ..**\..* **\**\. *..*.#
#  .. .  ..*\...   ..*. * ...** ..*...    * \..  . .\..\**  .\*.#
#*. \*.*.. . * *   . . \  .***\ *.\* \. *\.**   **.. .* .. ....\#
#**...*. .* .. . .  .**.  .  .. . .* . .. .\.** .*.*\ *..  .**  #
#\.. *\   .. . .****....**\*\.\*  .. . .\  .\ \  \ . \. *  .** .#
#*. *\.  .* * . * *\.\  .. **\..\*\ .\  ..\*.\. * .\ .\ \... .\.#
#..\. .. *  .\*...*.\.  * ** *** . . \** *.**..\.**  * \.***  * #
#..* . *.*. \ ...*.\. ..  *....** \. .\ *. .*  \.\* *. *. . \.\ #
#.****     . . ..   ..  * * ** .. .*.** ** .* .* *.. ...\\.\   \#
#*\.\*** .. .\   .\.* *\..\ *. .\  . .. ....**..  .. ..*** * ** #
#..*. \....   *.. .** *\   .  \  .* * * .\** \..*\* . ....* ..\ #
#* ..** *. .  \ .. \..\ .*\ .*.   *\* .*. *. .. .**. **.\ .  . *#
#*\  .  . *\.. **.\  **. .\ ..**\*.*. *     * \. .\.\*..\ .    *#
#*\..   .. \ **..\ * **\  .. .*. \.\ *  ..* *\.*\... .*.\. .\. *#
#. \.\  . ..  *.. * . *..  *. . .   ..\. ** . . *\..* **\* \. ..#
# ..\. . ..*. .\*....\.\.**..*..*. * *.\.. *.*. ..  ...\. ...*. #
# .\ .\* \.** *.\ * .*. *.** * .\ .. ..\  . ** .\ .\ .**\ . *.*\#
#     \.*.*  \..* *\..\ \*.* .. * .\     *. ... *\* \  ..  .\.\ #
#\ * ..**.\ .* .. ..* .*.**.*.  *  ....***. .\  ..\ * *\.. . .\.#
#.*... *. ..     *.\\. ...\* . ..  .\ *.\*    *...**.\**\**\**.\#
#.. *...\  *.. .*   . . .*.\ .*... \ .*..\   .*.. .*  .\*.*..** #
#..\*  . .*. ..*\ . . .  ... *..**.. . * .*..... *..\ ....*. .* #
#..***.\* .. * * \*  *..  *\ . ..\. .* .\ .*\.***..   .*...*. . #
#*...\ . ***.    .. ..*\.***   . .**.* .. \.*.**** . ..** *..   #
#.   .* * ..\ \\\.\*. *\ * \   . ..... *** **...\.   **** .**.\ #
# . *\. \ ...\*..  .  ** ..*.**.*.\  * *..\ *    \* ** ..  .  **#
# *.  **.* .....\.\*\ .\  \....*.*\ ...\.**\.*..\.\ .**... ..*\.#
# * *.\...\ * . . *. \***.. *..\ ..* \.* ... * \. .  *  *\**.*.*#
#*.*..  * **\..  ...**.\..*. .\ \  .*.*. ..*** .\    .*.\**.* ..#
#\ * ** . .\** *.*****  ....* . . *...*.\ .....  * \.*  . .*  *\#
#.*....*.  ...  * ....*. . \\* .*..**.*..\.  .   *   .\** \   **#
# .*\. .***..  .\ .*\.*\ .*. ..\ * .*\..*...* .  \\.\.*.* ..*...#
# *\ .  *.. ... .  .. * .**.\ *.\ ..     \.  .  .*.  *.\.  ..\.\#
# ..* *.*  **  .. * **\. *.. \.**\.**.  *.  *. ... \ * .**. * ..#
#\ ...*\  ..* .  **.. ...**. .\..*. *..\  .\*..* ... *.\.. .. *.#
#.    \ \**.\   ..... *.\.\*. *\ .  .  .*  **.\.* *\ .. .* ...*\#
#.  ... ......  . \** .\ \*. .***\.........     . .*.*. * \*. * #
#\. .  .\ **\  .*\ .* * **.  .. .  ..\\ *.*.** * . * . .  ..\*\.#
#.\. \ \*.* * ..* ..*..\*** *... .\.\.\ . **.*.\..*\ \ *.  \.  .#
#\.** . .......\.  ****.*..\*..* **\ . .*. * .*\.* ...*...  *  \#
#. .. . .\ \ *...  *.\..  ..**.*..\ .\ *. ..\***\ **. . . .**\. #
#.\\***.*.*..   \\*.\   **\*. *. .** * \.\. ......... . \ .*.** #
#... .*..\.. **  ...  ***\ ...\.\ .*..   *\*..*.*.***. . . .  . #
#**.* . ..*  .* ..\ . **\***\\.    .\.  .\.*..*.. .* .\*.* .\*.\#
#*.... ..*..\.\ ..*\.. . . \..*.*.   **\. .*\.* \.*.*. \*.*\.*..#
#.  \. .*. . . . . *\ ..*\\. \*..*.....*\ *. .. . \*..*\  .\**  #
#.*\.\. *   \ *\. ....  .  \. **** .*\. .*\ * . \*.*  .*\*..* *\#
#*. .   .  ** *..\.*. \.. *...*..\. ..*...** \  .* ***..**  * ..#
#.\ ....\*  *..\. ..**... * * . .**....*.\\*..\.  \ \ .*... ..**#
# . .\   .\**\. .   *.  \***\.\. .... \......**.*  *.\\\.*..*..*#
#\ \ .*.\   .*\. *** ..*...**   .\..*....\**  ...**...** .\  * .#
#  .*\ \  .. .\*\\ ** ..*\*.. \     .*. . .\..*.\**. \.\.\..*..*#
#... .  *.\.*\ ** ..\. .*.. \\* * **.  *.\...** .  \*. *.***  *.#
#   **.  \*.\  ..\*\*. .**\  ..\\.\* . .  .**.**  \...*. . .. *\#
#*  .\.  .*..\.*\..\. . \ \.\*.*.*..   .\...**.** .*  *  . ..\. #
#.** \.\...*........ .*. .. *  \ .\..*. * \ .\ *..*. ..      *. #
#**.\  .* \\*. ..\ *\*. .  \*..  .***.   *  ** *\.* . * .\..*   #
#..\  ...\*\.  ***.\ .*\.*...\     ..**.   .*.\ .*.\ \ \* . *\.*#
#.\ \**. ..  * **.\ .\.* *  ..\  * ****..* ....  .\* . ..*.**.\.#
#\. *\*.***\** ..*.*** . \. *\ .*.*.*..*.\ **\. . ...**\** *. * #
# ..\.*.\.\*\*.\**\\.*. ..\.*    ..\*. \.\. \* **. ..*.*.. **..\#
#\.. .\..* ...* ..* \*** . .. . **. * ..  . . \. .*. .\..    \*.#
#.* . * \ . .*.. .\ .....*..   .   *.  \.*.\*...* *.  *. \  . ..#
# ...*. .  \ .** * * *.  .\.\***. .     ..**  *...*.\**..**\ .  #
#* .*\* ....\.*..\.. .\*\\....*.*  .  .\ *.* \. ***\..  ...  .\.#
# * *..\ *  .*..   .* ..  R **..* *   .  .. .  .*.. .\ . \\.   *#
# . .   .*  .. .***.. *. \.**.* ..* *\    ...\....\  **. .**...\#
#.\    .**\  \..** .\... * .  .*  . .. \.*..\  .\...*.*.. ... . #
# \.\* ....\ * *\.   .*. .*.  **   *.....*\  .*..*\*.*\* **.** \#
#.. *.\ ** ...\. . \ *. .*. * ..*.\..  ***\.\ *.*..\..*..*. .  *#
# .\ .. *. * . *\. .*. .\.. *.\ *.  .....\    ...*..**. \. *.  .#
#* \... .\ \ *\.*  ... *. *.** .\   \ \ . .   *\  *  **..\ .\.  #
#*\.\ ** **..*  * .** .. *.**.\. . . ..\ *.  .  *\.. \..  .**. \#
#.*\. \*\*\.  .*** \.  *\   .\ **...  *....* . \. \ \. *.*..*  .#
#*.*.  ..*. ..\.. \.*  .\ . ..\*. *..\**. * **... .* . \ . \. ..#
#... *\* .*\  . **....* * * \   . . . ..*..**.. ***.   .*.    ..#
#... ...\ ** ***\. **.\  \..  .*. * \.. \*\. *.* *...*\ .**** *\#
#.*.\.\.* .*.*. *  .*. \ *.  \ \.\  *. . **. ***\.\*\. ***..*.* #
#*..*\. .. .\.*\. \***.*...*..*.*.*.* \\. ..*.  * *..* .**\ .\..#
#*.\..* .\. *..** .* . .\. *\*\ *\. .**.... ..\\. .**.*  . **.* #
# ..*\..\*..*  .*\..  . ..\. .... ** .\  . .*.   \**.**. \*.\.* #
#*. . * .*\ .  \.*\. . ..\.      .. *\.**\..*..  . **.\.. .\.*..#
#.*   .. *.  ... .*.  .\... . ...  * .* **..*\. .\..*\. \.  *. .#
# *  *.  .\.* ..*.....  ..**\.. \ *.  *..***. ..\ . .*.*..*\*  .#
# ..   ..\* . ..*.*..\... . .\.**.. ....*..**.\. \ *** .\ .. *.*#
#\. \....*  \.\** . **. ..\  ....*   . .. *.* *\..*....**  .... #
#*.  *. ** \ *...\* ..*.****\. .*.*\ * .**..\ **.**. \.\.**\ ***#
#\ \.\.... *\.* ...*.\*..*... . *.... ****.*..**..*   **  **. ..#
#.\. .....\\. .  \** ** *.*\   *\ \.*  . ..***\* .. ..** ..**.**#
#. .  \  ....**\..\* ...**.\.. \.. ...*  *\..\ * *** \ ..***. .\#
#\.\ . .*\* *........*. .\   *    . *\ ...  . .* ...   .*.\.\ *.#
#* ..**. .. .*. \.\.\...* \*. *. *.\..*\. ...  * .  \ \..   ***\#
#\  \.\ **  *.\..*    ..* .*\ \ ...*   *.\*. ..\ \ * .... **.***#
#*\. .. \\ ***** .\  * \.**\ *   *. ...*..*.* \ . \.  ....*.***.#
#***  ..   **. ..* . . .*..**.   **   ...\\*. .*.* ***.....**. *#
#\...  ..*.** . *.\.*.* *..\.*.* ...  **  ... *\**\..*. \. *\*.\#
#. .*.****.. .**.*   *. .... *.. ** .*. \ .* .* *...*.. . .\.\ .#
#.. .*..*..\  .. ..* *\  .\. **  .**  ...  .. *\.\. *.\ .*** .\.#
#\ *\\ .** *   *.*...****** ..*\...... .*** *.. .. \* .... * .\*#
#. **.  *\ .......\...\\\.* .\....\*\. .*.*.**.\*.  .\ \** . ...#
# *..  ***..    \.**  ... . ** . \....* \.*..... .* .*\.\.* .*.\#
#\.***\....*.. * ..*. *...**..  ..\ *.\\.  ** .*..**.\.**\**...*#
#\..\ **\.**...\\\.*\**.\. \*. * ...\ *..*\.\\ .. .*\. .   *\. .#
#.*. *\ .* * \.. **..\**.. .***\ . . .*. .* * * .*.* *.*\ .**.**#
#*..*..  ..*..\.*. . .\.*\.\. . *  .\ .. *\.  .  . * ..* .*.**. #
#*.... . .**.\  **  .. **. *. * * * .*. .. **\.*\**.\.. \...***.#
#..\  \. ....* ..* \. ***....*\ \ *.*\.\ \*. .*\* .  .* . \ ... #
#.\*...\.\* .*.**. ....\  . .*.*. ..*...    .*** \  \.*. ..  * .#
#. .. *.*.* ...*   .*.\**  *.*. \ *** \*.*\. ...  \*.... *.\*\\.#
#\.*.*\....\. ..  .**\ *.\ *.. \  ..*... *... \ . .*   . * **** #
#.....  ** *.. **. .\.***.. .\..   \.\.\.*. . . .  .\*\    \. .\#
#\..**.**.  . *... .* .\*\\   .\.* .*.  .*** *.*\.... *.*. . *\ #
#.*\ ** *\ .... .\  .\  ****...*.\.....  **. .*. **. *. \ *. ...#
#.   *. . .*. \*** ..*  \....  **. **. .. \.\ **\\*\...*.*\* . *#
# .*... ..*.  .*.* ..\ ..  *..\* * .. .* ..*..\*.*\..** *... .\.#
#* ...*\  *\.**. *  ..* .  .\.*. \** * *. \. .*. \ . .* * . . ..#
#. \..   * \........  *  \\....   .*\. .\\......\..* .*\.** * \ #
#* .*  *\. \..\. .. * . \..\..**\. ..    *\  .**.  * *.**.\ . .*#
#.   * .. ....*  .  .. *  *..  .. .\* ..*....*.\   **..... *\ .\#
#  *.  .*.*..*...*\.\*.**.*\ .  ** .*  .. ***.*. .*..\\  * \ .  #
# \..\\ ..\.*...... *.\.*... **.*\  ..  . \..\. ...*  * \...  *.#
#*\   .  \. *. * \\ .\..***\.* ...*.. ** * .  \ . .\ . \ ..\..* #
#.* .\*\.. .\ *. *..\.\ **.....\ *.*.* *..***... *.. .\.*.\* .  #
#***\..\\\* . .\.\ \.*  \.\. ..**. .**\*** ***** .  *\ *\\... \.#
#....\ *\* \.**** .*...* \*. **...*..\ *.*\..\*. \ * .* \  *.\..#
#.*\\...   ....* . ... *\ . .\..   . .\ .       ... .  *.  .\ . #
#..\*. \ \ ** ***..  \   .**  ..**\  \  ..\*  * .*     ....\.*\.#
#.\**.  **\.*...**.**.* * *.     .*\ \*\ . .\.* ..\*.  ..  ..***#
# . .*. *\* \  \. *  ...\ .\..  * ..\ .*****... * ..*   .* .\..*#
#\* ....\....\...\.*\\. *...\.*\..   *\*.*\.  \ .. ...*\*\*. ...#
#.\  *..  .\  \.*.*.*. **.* . ** ...  .**   . .  .\.\**.....\*. #
#.   *...*\.*.. ...*.* *...\ *.\. \\ .**\ .. * \. .* ..*.. . . *#
#\ *.**.\**..\...\ . \*.\* .** *.\.\*\*.  **.\... \.*  * *   * *#
# **. ** *.* . .***\..* \.. \**.*.** ...\... . ....*.. \....*.. #
#*  .**.* \. \  .....*..*. *.*.\ . *.*  **  *.\ . .   ..*\  .* .#
#*.**.\..\*  .** ..* ***.* . .* .\*. .  .. .\*.  \.*.\ .. \*..  #
#*.. **.  .* . \.  . ... *\.\*. . .*\**.\*\.\**    .*..*.*.*. . #
#..* ..\.. .* \.* * .\. *..\ *. \*...\.  . * ..  .**.\*** .*. . #
#\... .**  ..\..\*.\.*..*  ..*\...\...  * \*\  .....\..\.**\ .  #
#**\..\*.\ . *   * *\..**  .*  .***\.*\..... .*. *. . ..\*. *   #
#..*  ........ . **...\ * . ..\ \ \..  **\ *. . .\*. \..*..*.. *#
# *. ...*.. . . **  *.. . *\  .*.* .**.*.*\..   .. . .*. .  .  .#
#.*.\ *\.. \.   . **\*. ... **..\* *.. .\***.*\ *\**\ \ . ..  .*#
#*..*\..** .. * . *\\.\..*  .\...  ..** .\ .\\ .. ..**. \ **  *.#
#\ \ .*\. \  .**. \ . \*\*   .\**. \..\...*.*.** . \. ....*\. ..#
#.\.\ .   .. *.. \  *\.**\  . ...\*. \.**..*.**\..****\. .\.. **#
#..\. * \*..*.  ..\... .**..* *..\.    .*.  *..  ..\*.*. . *  \ #
#.\\ .*...  *.*\ . *.\ **. \.  \ .* ...  * ... .* * ..**. \. * .#
#\ .. . .. . *\    . .* ..       \.\ *. *. *....  .\**..  *.\*. #
# .*..\  ..*\* .**  .*.  .  .... *\ ..\.*\...\ . *. ..\\ .*\.*. #
#* **.  .. .\...*. *.*  .** .\* **.. .   . . ..*.\. .*.*.\.*.*  #
#  .   ..*..*  *\..  ***. . * * ...\.\  ***.*.\* . .. *****  *..#
#\. ***.*.*.***  *. * \. *... .* \.  . \** . * .  * \.*..*.*.\ .#
#..*\.  * . **\ .. .* *. **.. .\.. ..\... .**. \.\ . *\.*\*.. .\#
#. .***..   \..*\  **\..  *.*.*\ **..**.** *.*. .      * ** .*  #
#*  .\. ..*\ \ ..* .. .   *** ** ..*.\.**.*..  ... .*\.. ..\.\**#
#..*.. .\ .*...\*.\ * ....\.* .  \.*. ... *.  .**.  ... ..* ... #
# ...\  .*\*.*\ \  ..  . \     ... * .\   .. **. \.   .  *. \*.*#
# ..*. *.\.**.\*.\*   ...* *.*..\.  \.  *.  . *\.. .*.. .*.*...*#
#\ ** *\*.\..\.*...**....\..*.* ..\ ***..\* .*\  *\ .*\  ....*..#
#**.\..*. .\* . ....\.** .  *\.*..\ \.*\*.****.. . .*.*\. \\..  #
#...   *\. .* .*.. .*. .*  \**\*** .. .**** .*.   *...    **\**.#
#\ \*  ..\.****\  *  *.\*  .\. .\.  **.. .\*..* \.*. *. *\..*. .#
#**.  \*.. *\* *.****. *\*..*\\.* .*\.\.  . \... .\*.. ..**...*.#
#..\. .**\*\*. .  *\..*. .*  . *\* *.\**... .. .\*.  .\ **.*  * #
#\ . \* **.*. .  \. **\    *  *. **. .. .**\**  *.\** ..\*** .\*#
#.\.\ ....*.....\*...\** ..* *..\.\.* \...***. ... .. * .\*..  .#
#\ .*   . \.\* **.**  .  *.  * ***. \.**\*.\. \ .**\. . *\. *...#
# .*****.*......***.** \.\.\**.\.\ .. ....\. .....*** . .   *   #
#  .**.\ ..... *...* * \  \.***  .\.\*** *. \\ \.\..*.. ..  *.  #
# *.\*. .**\. *\**.* **. . ***.\   **.\.\.\ .\ .*.\ . \ .** .*. #
#..*..  *\..   .....**.   *\.* \  ..*\.* \*. **.  *\. .. .*** ..#
# \ . * . ....*\ *\..* . *..*\.*  **.\.  ... . ** .***.   *\.*.\#
#. .*.. .* . .*\ .*.\. * .*..    *..** ..\*\ \.\*  ..*. *  . .*.#
# * ..*.**.  \.\*.* .  .\ *..\*.\....  . **  *.... *\...\ .. \ *#
#\ *  ..*\ \.*.. *. *\ \...\**.**\.*     \. .\*  *.\.*.*..* ...*#
#* . .... *..*.  .* *.****..\*..\....\.. .****.**.*.  .\\.. **  #
#.\.*.. .....*\*\.*.*.\* .\ ...*.\..* .\.*.  * **..*   ..  \..\*#
#*\..*  .  .*...*.. .*. *.*. ...  \* . ... . .\*... .*****.* *.*#
#.. \**\... .\*.....*.\..***  .. .*****...  . *\ * .*..*.*...*  #
# *... . *.   ..  . . . *......\. ..  . ...*\.* \*..\....* *..\.#
#*.. . .\* .\.. *.\ \.*....* \**.  ** ..**... \ . .*.* * ...* *.#
#. \  \..\*...*\*  *.   *\*...**.* *.. ...*\ * .\.. .. ..*  * .*#
#\ .* . \..\\**.* *.\. *.*. *\** .*.*  ..\***..  ..* . ****\.\\ #
#*\*** *. .*..*.. .. *\\*.* \...\..*\*\ ....\\ .\ *. .\......*  #
#** .. \* *. *. \ \\ ... *. *.. ..*.*...\.**   ...*\*    * *.. .#
#.   .* .*\    *.   .**. .* \ ..*** ..*. ..**. .  ..* ..*. .* *\#
#*. *  **. ...  \.*\* . . * **. *.*   \..\ .. .. *\.\ *.* .. \. #
#.*\.....*. *  .**....\\. . ... \.. **.*. .*\..\ \*\.*... .   **#
#\.  *.** \*.*.\..\...  *..*  ..........\. .****..* \... \ .**..#
#.\ .*.\*\.*.* .. ..**.*.    .*..**. . . . * ..*\ ... *. ..\ .\ #
#*..\. *.*.\    ..\ *. \*. .  ....*.. ** \*..\.*..*  ....  *\ .*#
#..\   .* .. . **\.\. .*\ *    . .....\\.. .*  **\ .*\ ... .** .#
#.*. . \\  * .*.... .  *** *\  .*\..\\ \** **   .**\**. * \ ...\#
# .* .   *...*.**\.  ...*...*\....  .  ..**.\.   \. .\.    *  * #
# *.*.  *.** .\.* .*\. .*   .*   *..\ .* *\... . .\. .\  \*..*. #
# .\.*\***.**  ..** . . ..*  .. .\..*... . . * \..   ...*..\**.\#
#\*.  ....  * .. .* .** \... *.\*. \.. .  . .*. \ ... *.\* .\***#
#.*.\ \* * ... ....  ..*  \* \ .*.\.* *  . \\.*     *  * .\**\..#
#\** . . \.  \.   **. .***\* . . \. . *. .. . *. .**\.\* \ ...*.#
#  . **\ .** .  \.\*.*...**.* *...*\. ..\*... *   ...\*\..*.... #
# \.\**.*\** .   ... \ .\.. ...  ..  .\*.\.*.***..\. * *\ .. \\.#
# . \.*\. * ..*..*..   ... *   .\   . .*.\* \. ...   *. .*.. ...#
#.    *.*...  \ . **.. *. ..\  . **.* *\...   . *.. ..*\.. .* * #
#\.. *\.\  \ ...* * \ ..*.\..\  *.... ..    *.. *... ...*. .**..#
#.* . ...  .\  .. \ *. .*.. *..\. **.. *.. *  *.\ ..**\ ......\ #
# . ..\*\. \* .\ * *. . \*....***.*  * \. ...*.**\*.. . .*\.... #
#\.\ . . .*. ..\ * *\.  .*\\* *\*\.**. *\ ***... .\.   .*\..*. *#
#.\.\. ..*.. . . .  * . \. *..... \.*....\..* *. ...\. . \  .* .#
#.  **\.*\ .*\.. .  * **...\  .*.**.*.. \  .*..*. .**.* *\..* ..#
# \\.. *\...\..  ***.\...\ .*.*.*\...** .* *. **\. ..\. .. \.   #
# *.\ . .\*  . .*. .. ...*...* \\.  \.\.*.*.......* *  \***.*.\ #
#\.*.*\.  *  . ..\ \  .\.*   . *    ..*..*. \\. **. .* .* . ..*.#
#. *....**. .*  . *..\* .. *.*\..  *\.\ .*\ ..**...  . ..\ . ...#
#*.* * ... *.**.* .# *..\. ... *\  *.* **\* **.* **  .* . ..\ . #
#* .\. *...***. .  .*.\.*.\.  *. \ *..*. ..  .**\.\.*\..*   *\  #
#.  . \.*\ . * ..\ ** *.\ *\*\*  .*\*.**.*  *\ * * **..\  *.* *.#
# *\.\*....  * .*.. ***   .*.**..... \.. * *.\#. *...\ *\**...**#
# .  .\. .*.\. **.. * ** . \.*\*.*..  . .\ . ..\.    *\ *.\\# .\#
#\\.. .* \..   ..*. *.\..*. \. .*.*\*\. \..  *.* .. ..\**.## .\*#
#**   \ **.*.. ..**#* . \*. *....*...*........#.# ...*#*..# #\#.#
#.*  . ..\. \.\**\.#..  .  .*   .\..*#**#*. #*#\ ##\#.### *# #.*#
#.*..***.*.....*.**..\.. .\.* **... . *\*.  \##.*#..##  # #  #.##
##**\..\*.\**..  #* #*## ..\ *..*\. . \# **\  ####.. #   #  #*  #
##.###*. ...*..   . ##*\. \ .. ** \# .##.#\  #    #.#        #.##
# # .*.   ##.# *. . # #.\.\.*  .* #. \.## ###      #          # #
#  #\*.*..#.\\ *.*\.## *. **.  \  *... #                        #
#   ##.. ## .\#\*\ #  #.*\*\.*.  .... \#                        #
#    #\..\*#..##...L   #### ..\. ...\##                         #
#     #\ ### # #**#      #\ * ## # \#                           #
#     #.#   #   ##        #**# #\ *..#                          #
#      #                  #*#   #\###                           #
#                          #    #\#                             #
#################################################################