################################################################################################################
#.* ..    .. .*.*.*.\ *.\*.   . .*.  ...*... . .**.*..*\* \.   .*  *...\    .\**.\..* ..\.\.\*\\*\.* .##.#     #
#*.\ \...**   *\** ..*..\.\ ***\ * ..*.. .\ . \.**..\ ... ..  .*.* .. * .***. ..  . *** *    ..**. .\.\# #     #
#*..*.\\. ...*.\ .. .\ *. . * **.* . .**\  .\*...*\* \ *.**   ...* . **. .*.*. .\. .*.. **.* *\.* *.\ ** \L    #
#.*.\ ..*. \\ \ .\. ...... \ \*\.*** .* *. .**..*... ...* \ \.* .\ .\. *\*.\*\.   . . *.. .. \ *. . *\## #     #
#.*\ * .*  **... ***..\     ..\  ...\.\..*  * .*. . . .\..\.*..\*. * \.**\ ..*.*   . *\**.** .\\. * *....#     #
#** .\.*.  .*\   .*.  \ * .**.. ..\.* ...  \. *\*\.* .*   ..  . ..**\..*.*\*.* ...*\ .  .*.*\ .* .* .... \#    #
#**  . .\. ..*\  ..\\..* .\ .   ... .* .\.* .*\.\*\. ..\  *. *.*R\\.. \.*.*.\*\* .**  \*\.*#*.. .... \ .\#     #
#*. . *  .* . \    .\ ..  \. *...   *\\.*... * . \. ..*.  *\.*.\.. *. . . .*   . ..* .*.**\. *.*.\ *#. *.##    #
#..\.  \*.*. ...*     ***\ . ...*\.*.\ .. . ..   .**.*. **..\.  *..*\ . \. ....*** .\*. .\  *. ..*....*\. .#   #
#\. . * .. .\ ...   . . . .    ** .*\. *.  .****.*.\.  *.. . . *\  .*.* . .. .\* ***  *.. .*.\ \.  *..*  \.\#  #
#..   . .*** \ *  .*..**..* *. .\* . ..   \ .....\.* *. .*.* .*  . *.   *..* .. \.\....**  .....\  .\*#  ###   #
#.\   .*.*.*\.\. .**.\*.\\*.*.*\...\.*.   .   ***.. \.*. . \. ** *.\  *\...\... .\  * *..\ . **  *. ****.*#    #
#*..\\\..\***.    ..\*... *\.*.    .  *..\   **.*\**...  \*.** *\ .   * * \   .*\. .\.*. \.\.\*\ .*\# \.* #    #
#\....  \*  *. \ *.... ** *. ..*.\ \  \ .** .. .. .* \..  *.*...*.\ *\\..*.. . \.   . .*.\    .. .* *\.# \##   #
# *... .*\* .. .\*.  *.*..*\  .\..*.  .  \. *\.* \.\....\\\... *\** .*.*\.\.. *...** \*. \.   .  ..**.\##*\.#  #
##. ***.* *   \ .**...\. ...**\*   *..\  ....  \ . .  *.\  ** *\.*.. ..*...****.*..*\ *. . .* ..* *..* ##.##   #
#.*.**..  . *.*......*. ..*\*.\. .\**\*......  .. ... *... \\*\. .\...*\   ...*..\.. *\ . **.  \ .. .  *..#    #
#.#*\. . \*\. * *\.*\.\. ....*    ... .* \ *..\ . *..*.*  .. . *\**..       ...\.  .\\.** *... ..*  .* ....#   #
#...*\ *...*. * .*\*  . . *. . . .*...**\*...*.* \*    . ..\.\ . .\*\  . ...*. **...*. ..\\\  .....**.\ \##    #
#. *.\ \ ...\.***.*  . .\.. . .  *.  ..* *.\.. .  *..  **\. **...  *.\   \. ...*.**..\.\ *\...***  ***. . #    #
#*..*. .**. ***\* **  .   \.. .* *\ *.....\.\ *.*. \.*... .*\ \.. .*.   ..\..\\*     *\..*. .\\ ..\..\.   # #  #
#.#. \.***. . .*.\*.\ * .*.\.  .. *.** \..    *. *...*.   \**\ ...  .\**.\.**..  *.*\... *\\* *. *.   *.  .#.###
#\.\*...\\... **\..\ .*. .*. \*.*\..*. .  * . ..*.**.*  . \.\. \...** ..*. \* .\*..*..* *. *...**.\  ...#. . \.#
#**\. * \.\\ ..* ..   .*..*.. *\ .**\..*.*.\*.*\.    .\. *.*****. \...  . *   ..*\**.*.\ \ ** *.  * *\#\#** ####
#.\....\....*\..*..*.*.\ . * *\  .... *\  * \*\* . ..\  ..   * .*\..*.. \..... ...*\ * . ...... \ *.\ #### #   #
# .     *.\*\ . .\\**.*....  .   * ...... *.***..* . *..** *. ... \\*\.   .\*\.  .*  * \..** *.*\.*  ..\*#*#   #
# ..* *.\*. * .* *.\**..**.\ \ * ..  \ *.* * .*  * .  *\*. . *\  .. ..  .. *. \*\ .\ . . \.*.. . *.#*\ ## #    #
# *..**\ *..\ ... .*\*.\.**\. .. * \\*\* **\. *. . *. ..\   .... \   . .*..\*\ ..\ ..*..* ** ..* .    #        #
#.\ \..  . . .  \* ...\. .*..*. \ .***.....   .. \.... \.\ ** \.*\.\ *.  .\ .***. *****.. ..\ *.***. #         #
#**\ **..   \ .. .\ . ..***.\..\*. ...\. .  \.... ..  ..\*..... .\  *\.\* .*...* ...... \\.\**. **.# #         #
##   **  *  . ..\ *\   ....\. * .\.    *.**...\\* ..\. *.. **\..*.. \.... \ ..\. *\.* *  *. .\*. *  .*#        #
#*.*\*.. \*...\ **.\*. *\ . \. \ .\ *\.**\..*\*.*...**** \....\.*\.  .\*\ ..* .**. * **\.\... *.*. .\#         #
################################################################################################################