##################################################################################################################################################################################################################################################################################
#         # .. \##*###\..**. .  * ***.*\*.* ****\ .  ... **. . .. . *...\.\*  *** *\**\  *.\ *...\ \*.  . .*. *.\.*.*\. .*   \*\... .. ..* . .    *...  .\*.\..*.....** *. * \\\ . . .\  * *. *. \.  *  *\. ....*.*.\... .  ..\. \..\*.\ ...\  .\*. *.*. ... *.**.*.**.**  .*\.\\#
#         L *\ .**.     .*\.* . ..... ....*.*..      \  *.**  **\. *.  \.\ .. \.\ \**.* ..*  .\.\** . .\  *  .. . *\*.*.*..*. ..\* ..\.*\ .   . ..* \    \*\*  ..\\ \**** *..* . \ .  .*.. . .\ *..*.   .. ..\ *.***..* *.*\.\*...  **\.  **..*\..*..\**.  .* \\...*. ..\ .*** . #
#         #  \.\.* ...*. \.\. * **** ...* .*  . *. .* .*\**\*...*.*.. ** *.\ .. .  .* ..  ..* .   ..*\*....*  * ...*.*...\ **\.   \.\ \. .*\.. .\..\  *. .... * . \ .\*\* * ..\** * .**. . * .*..\..  .  . \ *.*\*\.** \***  ...  . ...   .\  \....   ..* .***. .*.\.*.\.  *.*..*#
#         #*# *..\.  \ .*. .\ *\\....\\  *\.*.\* .\  .\......\*\...\* \*..* .\  *.* . .*.  \..  .\    . \.*. . .*. *.*  . .....\...\.   . . .\* **\ .*.... ..*...*...   * ** ***. \ .\.   **  .* **  *..   . ... \   \** ..  ..  . .* .\..\....\ * .*.*... .*. .*.* \ . ..\**.*..#
#      #  #\#\...#   .\ ...... ..*.**  . *. *  . * \*     . ...*.  ***.*\.* *. **.**** .*.*..*....**....*.. \*..  \  .   *  .\* *  . . .*.. *.. ..*. ..*  **\  . .\.\*\ . *. *.\ *. \ *.*.\* .** *. *. *...  .*.\..*...*\....\***.\..*  \. * *  .*\\.\*...   .. .*\ .*\* .*.\  * #
#     #.##....     *.*.*.* \... \ **.  *\*.\. \ .. .* * *\.  *.\*...*.*.***. **\  ..*\ \ ... .**..  \  *......  \ . ..\..* .**.**.. ..\ *.\.\.. \*\. . \\..\.\\ \ ..*.* . .**.*.. . ...*.  * \*....  .\. . *\*.**. **. .* . .....*. *\   .*  .*\ .. *    .*. * * **\.**\ \. .  \ #
#     #.* \  . *.# ...\.\\.\*.  ...* *....\*  *\ \ \.** ..\  ....\ .  * .\. ***. .\\...** . ****\***. *.. .\ .*.  . **** \. * \ . .  .. .*.** \ . \* .\ ..*.*. *...\. .\.*.. ***. ..  .**.*.  ***. ** ....*..*....*.*\\ \.  ......* *  **.\.\.. * * ..* *.\  ..*\ .   \* .*.*\...#
#    # . . . **..\  . ..\..*...*.  .*.     .\  .\. **.\ \.\ *\* .* . . \ * .*.*  . .**\ . ..\..*.. *.* ...* *.*  *\.*.* .\... .*\.***  * . .. * . .. **.. ..*\ * ... .*  .*  *..*   .. \**.\**.**** .****\.\  .\  ..\.... * \.\\.... .\.*   .  \**..    .\ \ .\*. . . ..*\.*..   #
#   ##\.**  *.. ****\.*. .. .* . * *. .\. .\ \. . **. .  *.** \ .*  .*\ . **.\.\..** .*   .. * .*.*\ *. .... *. *\*** .\..  . ..*\...   **..* \.\  .**\ . *.. .**\*.**\*\.*  .* *\. \*  .. *.  .   ..... * \ \ .\. \.   *\*\. .. . . .. . .*. \ *.\   .... .. * ..* ..  *. .\ ..*#
#  #  **\.\ # ..*.*\....  * \.. \ ...*  \ \..  \*\...*\**. .. . ...*    .*.. ..  ...*.**\. ..* ...*.**. . ..*\ ** ..*\*.  .*  .*\ . ..* ..*  *..*..*\**. ...\.**..*.**. ...** .\. \*.*\..*.\ \* . *.  .\  \ ..\.   .** ..*.*  .*\*...\\ **\. .  .\ .* *\ .. **..\...\.*.\\. *.  .#
#   #...#   ** .. . .\ *.*.  .*.. .*.**..*. *.\.\* * **\ .\ *   \.*.\ .*  .**.* .*\*\.\*.\ *..  *\*\.\ .\**... .. *\. *****  ..  .. **.\   *  \.. . .*. . .***.**.*.*.\   *\.  .. .. .. ..*\ *...  .  \....* .  .* **\ *. .*  ..*...   ** .\ . .**  \.  ..*..\*\  .\* ***.  . \* #
#####.\.. * **\ \   *. \\\..*\*.\*  . ....*.... *. .  .. *.... ....*.\ . . *\*.. . \.    ..\.*.*... \. .. .*  *\ .\ .\\ .*.    .\* \...*  *. \..\.*...  * . .*. \*. .\ * ..*. .  *\. .* \. .*..\*  . *. ...**..  .  ..**. .*. .*.\* .\.. .*\.\ **\ \. \*.* ....*.. .**..* .  . ..#
#.*..#. * .*\..   **...  ..*..* *\ *. .* \.**.\. *  . ......\    *..*\\. \**. .\.  . ... ..*      .  *\*.**  .. ..\.\. *.   ...\.   .  * \*.    * . ..   **.\*\.*. * .*.\  ..*.....  *.. \....\ **.* ... ...  *.**   ...  *. \ \.*.*    .  . . \\. *.\...* .** .. . * *\*  .**.  #
#### .\.**.\. .. ..\* * *.*\*. ****. . . .\.*  ... \*.  . *****\.\\.\..*\. . \  *\ * .\ . **..**.  .\. *...*\*  .. ... .\.  \*.**.. ...*...  ...*** ... .\*. .\*\  .* \ *. \..*\.\...*.. ..*..  ..   . *...*\.*.***.* *.***  ... \ **\ *.  \*\  .. .*. *.*   *  .. \. . . * .*.. #
#   #\*.*.*   . **..  . *.* \ .. *.\.  *\.   **.\ \*\...*\..\  * \ .* .  .\.* *  * .......*...* ..  .*. .  ...\.\.  * \*. **.     ***\\*\****..**\.**\. *..****...* . . .\. .*.**... .\.    *. *.*\**  .  ...\  *\...***.\   . . . \..*\.   .... . .*\*  *\...\.*.\ .** ..*\.**. #
#  #.***. .**..*...   . *. ...   . ... \. .*\*.\ ** ..**.. .   . * * ...* *** .*.*..\*. .  * *.. \..   . \ ..**  .** \..** *. . * ..***..*.. * *.. *  . ..**\  *..\  . \*   *....     *\*\ *..**\  .....\.\..\ .. \ *.\  .. .*.... .*.\ .\*    .  .**.* .**\.....*  ..\ * *.. .\ #
#  #.# *#  .* *.\*. .*.\.*..*.*.\\*. . .*.*.*.*. ...*.*....\.\\. .... * . *.\  ....**.*\ ....\ . .. \..*  \  ** . .* .*\.   .**\..  \. . . . .\.***. **  ..\ .\. .\*..    .*\** ...**.. ..*..*...** .*\***.\*.. .  *.  * . .* . \**. .*. .  .. .  *.. **.*. . \.**\   **.. .\. ..#
#   #*\...  . *.* . .\...** \.. ... \* * \..**. \.  . .*.    .*  *.\* .  *\. ...*\..*..*.*\*\*\.\* ....\ * . *  **.* .*.*\  *. .. **....\.*    .* *..\.    *.... . . . ** .   ..* .*\**\*...... *.\.**.**.. *...*...\...*. \..   *..\*...***.\..  ..**.*.*.  .  *\*.\** ..  . . \#
#    #...\. *...*...** *\.\*\.\. ..\.. *  * ..*. * ..*\.*  *.\..*...*\   *.*..  .\.....\.**.... *..  . .*.\.. \ \.  **.. . *\. . ..    . *. .  *.   \ \**  *\ . .****.\.*..  \\ .\.*..\ .\.*** *.**..\\.\* .*   * .  \ .*...\. .\.* . .  *..\.  . ..*. . .. *\ .\.. **. *  \...  #
#    #**.#*..\*..\**** **\.** ... . \ ..*.* ..\**.*.\ ..*\*.\   .*.* ** ..** .*      \ .**..* *. ..    . *.\ *. * \.....* .*.**.\*\* \.*.*.. .*\  . .. .* **. ***....  .*** * **.*\...* * ...*\.\\ *. .*.. *.\. ...  *\*..  \ *.**. *.\\ .\ \* .\\. .\  *.* .. *..  \.   ..** . *#
#    #*#  # #*.* . **.  .. ..   .*.*.  .  **....**..  .*.**.  *\.*.*....*.**.*.**  \  .*.\*\\*..\ **.  \.  . . .. ..* .....* .\ .* \***\*.  .\.*.. \**  ..\\\ **.*..* \**  .\ ..  .\  ...**  .    *.**.*.. .\.   *     ... *..\ ..  *.*\ .  ..\.  *\.*. * . \*\... ..*\*\.. .* \\#
#     #. .\.....*   .* . . ..\ * \*. . \ . .\ *.**\. *\..\. ..*. **** .*.. \ ..\... **. *.. ....\  .*..  \ \ .\*\ *..\ *...... *\.  .*. .*. \**.*\* .*. .\   *. ** *. ..* \\   \.. .*\*. \.\.*. *..\*. .**.* *. . .*..*.*\ \   . *. . \. .** .* *\.\ *\.. ...*. ***.*  \. .\...\ #
#     #**## *. .* ...  ...  * .. .\.**..* * . ..**.*.*. . .\.   \..*.\... .\*.* \.\.   .\.*.** .\\ \. ...  *\**.*. *\ *.\\   .*  **.  \  * .  ***  \. ** **... *.*\ \.* .  . *. **.. *..*. .\...\ .*..\ **..... * ..\ .\.\.**.*. ....\.   *.*\\ .*...\  *  * *.*.*. ..*  \\  .  .#
#    #\#*#.... ...\\ *.*..*\*   **  .\ **\.   ...** ...**\**..\*.. .. **\  ..*... .. .*** **. .\*\ ...     ....*...\****\ .*. .***\ * \**  \.\.\*    .*\ .\. \\. . \ .\   *...\..\.* \ *\*.* .*.* ... ** . *.\.. .....* ..\***...\\ *    .....**\  .**...  . *.**.*\***. *\* * .*#
#    # ** .*\ .\   . \ **.\.\.\ \... . \ \ . *    **.. *.* * . ..* \...\\ .* .. * ....... .*....* .*.***\.* .. \. .*..*.   *\  . .\.* *....*...  .* .\.*   *.*    *      .**. .. * ... *.\..\ .\. ..*.\.\* \ .**  \\* *.. \\..*.*.\ \ ** . *.\ .. \... *. ..\*\.*... ....\ *\.*.*#
#     ##\.\.**\ ..*.*\  ... .\...* * *....**..  \ .  .\**. .*\ .*\ * * *.  . *\.*   ..  .*.. **..\**.... .. ...... * ..*\.*...     *. .. **.  **  . .  . .*.\  .. ..**.* \.*  . ....* .. *  .*... .***  ..\. .*..**..**\.*. .\**\\...*\** *..*\*.* \.  .  *..**.**\.*.\.. * .*\..#
#      #*  .\..  *\.\**.** .\*\. * .\ *\.\... * .*    *..   .   ...\ .\  ..\... . .  .\*\  *.**.\ *.*   *.*  \.\*  \ \ .... \*.   .*\*.* \.*  .. *  .**   \.. ... *    . . \ * .\ *\..*\*....\ \.* ....  *.  *.  ** ..*.* .  *\.. ..**\...*. \.*\..\ \*. ..* * . *.*.. \. *..\  *#
#     #.\\.. **. * *.**\     .. ....**..     ** .    .  \ ..*.** \.   ..*.. .\\.**. ..\*\ **  \\  . .  *..*\ . .   ..*..  .  \*  .**..\..  *     *  *..*\ ....  \..\..  \ \.\*.*..*. *.\.*. .* .....\....... . *.*\..*. .. ....*.\ \.\..*\***.*  .\.\....* ..**....    .\* ..*.**#
#    ##*.\. .**  \*\*...  \ ..\ * .\.*\*.\..* . \     .\ .* .\.. ....  *\*..... .. . .*\.*.*   \.\.*..*.\ \ .*. **  *.**.*..*.**. \R**.*\.*\..*.... **  ..  .\.*.\.*\\ *  *\*..*.\..*. .** * \   .\..  * .\ * ....*  **.  ..*. .   . . ..*\.***.*..  *..**\* .. .\  . . .*.\.\.. #
#   #.## * *\*.*  ..**\.  .\\ ..... \.*  *.\.*\* **. . \ ..*\.*.\  ..  .*.. *   \.*\...*..** .\.*.\.  *.* . *.. *  ..***\ ..*....*.\. ..  ...*..   ..*\\  \* **.. \* \*.\  ***\. .\. . * **\.. \ *\    .  . .\.\ **\.\.* *  .**.\  .. .* . ..*\ .. .\ * *. *. ****\*  * * * *. \.#
#   #. .\\. .*\   \..* ..\ .  . . .\\*.****\.\ . .\ *\*.  \. \. ...  *\ * .*. \..\.*.\*.*.*\ ** .\ **** ..*.*..**  \*.*.*..*.. \.**.\\.\. *\*..   ..***.*..\.....\.**.\* *. .*..\ ** .  .\*\ .**\.*.    .  *  **** *\*.*    \.  *  *... .\**.** .. * ..* ... ..\*...\*..*\..\\.* #
#    #.# ## .*\  *  ..  *\* .\ .*\  ......*.  **   *. .   .\..\.\*..*..*.\..*.*\ *\ **.\\**  .  . \\.*.. \.*.*\.... *..*.. ...  *..  *  \ ..*\. \..\\.. .\.*  .** .** *.\\.  \. . *   ..*  *.*.\ **\.\. .  .   .......\.\  *. **. \ .. .\ *. ...*  .  \*\ .*. .*.   ..  .* * . *.#
#     # # #\ .......\.  \..\   *. *.. \ \*.  *\\*\  . .  . .  .... .***. . *. ***.. .\ ..** .  * ** \.*  .  *.    .... ..** .\. .... \.*.. ** * .. .**\..*\ *....\ \. ...*.    \ ** .*\..*.....* ... * .\  * . \ \\ *..*.. \...\.*..\ **  ** .\*. ..*\ . .*. . **\ . .\  *.*\**.\#
#         #\*\. . *.\ *.. * *.*.. ..*...\*.. \ .* \.\ *. ** *.*...\ .\.. **...*.* ..*.**... *. * *.  ** *..*. * .. *\*   .*  ..\.*.  ..\**..\ ** .\.. . \\  .\*** \.* .  ***. .. *.*\\** .\ ...*.*\  \..  *. \ *\.\ *.*..  *  \. *\ . ..\... ..*..\ *.  .\. . *.**. .    *\. *.  #
#        #*..    *\.* * **\   **   ..* ...*  .\ . \. *. ... ... ..\.....*..\ ... .* .. *    \....*  *.. .. \  *.\*.* \ * *. *  *   .\.. \..\..*\ .\*. ...* . . *..*..\ *.*\*\  .  *\.\*.\   .. .*.. ..*\*.**\..*  .*.*.\* .\.* .\. .. .. *. .\ .\ *..  ***.. *..*\ \  \. \.. \..*#
#         # . ...**  .. \.   ..**** **\*.*.*.\   ..\.\ ..... \  .\.\. *.* ....*  \* \...*.\ . ***. *. .\*\. ..*\* \.\ .. . ** *.\ .**...   . ** \ *.\  *... . .*...*.. *\  ....\ .\... *  * * \.....* ....*.\ .. . \ .*..\ *\. .. .  * \    \**\ ..* *\* ...\  *.. ..*  *  .\.. .#
#        #.\ .***.* .*..**\ \.   ..*\.*.**.*   *\ \.\. .  \. ..\.*\  ....*.\ \*... .. \. ...* \.....*. .*..\.     .\\ *   . . \ .\..\ .**.\..\  .\. *...*\     \ .. \. .*.. *  .\ **\ .\*\. *\.   . *  .. . *. *.  .\ .*.*.\.....  ..   * .\.\* \ \. .*** \.. *.. ..\.   \.*** . #
#         #.**.\ *.\.. * . *...\** *. ..\..*  *.*.  *..* .. *...*..   .\    \ .\ .*.\. .. \  ..***. \..*\ *. *\.\ .**\..\  \  *\.**.. *. ****  .  . .\....*...*. *...*  **.*.\ .. \.*\ ...\ ** .\.. *\.. ..  *\.  . **\.*\..  . .*. .      * *..  .*  .* ..\.*   **\ ..\..*.*... #
#         #.##*.**. .\.\.\ . .***. .. \..*.. ..\*.. .  \. *\ *.\**** ***.*...*.*.\*\*    .*  * .\..*\.  \..  ...  .*..\ .*** * . ...\.. ..*     . *. *... *\. **..*.\ *.. .*.* \ \  . ...*. ..\ .*\\.**..\ *. ...\. .\ *.***\ . .*.**\ ..  * .\*.*\.\... \..*..* *...     .    \.#
#         #\.  \*. * *.   .*. *. \.\.\ \ ..*  * * . .\. **\**. .*. .*..* ..******.. * .\.*\  .*.** \.... *****  .*** .*\ *...*..  * .\  * *  \    *. .*  .**...*.  ...**. **** \.*.*.. .**..*\ * **. *.*.. .. \*\.. \*.*  .*..  *..*... .**\.*.  . .\.\.\.\ ..*\ .*\*  ..* * \.. #
#          ### .#*\**. \ \** ..*\...*....   ..  * . . * .**\** *. \ . *.. ... *.. .\*\ . * *.. ..* ..*.\\**\**  **..\...\ \**..\*. *   .. *\  *...*.* . .\.\  \.*.\.*\ .. ..\... .\ *. ..\*.***.\. ..\.\.\.*..*.   . \ *. ..*  \. ..*.\*\..*.* *\    ..*.**.\*. \\...  . . . . ..#
#         # .. *. *..\ .\.. \ *.  ... \* .*   .** .\.  .\. ..*.*\**  ***\   \*\.     *.\...\ .*\ ..\..   .**.. *   \ .**. .\*...\  . ...  ..   .. .*   *..\  ..\*   .\...\  . *  * \.\* \   **..** *\.  \ .. .*  \. *.  .\   .*..\  ....**.\*. .. *   *.**.*... . \ *   ** .\*.\ #
#         #..***\*.\*..* .\. \\**  *.**. **  * .. \ \\.\.  *.. .  * *.. ..\. .*.\   \...*.... ......  *.\  .*.\ \\.  *\.** ..* *** * . **\  *.*\. .. . \\\*.*\  *..* .* . .** . .* ..*..   *. .*.\..\.. .**\*  *   *\ *. . .* *.  ** ....\*..*  . *. *....**.\ ....\*.\. .*\.\*\ #
#        ##* #\*..  ..*.  .*..*..  **.. . . \. ....\  ..\*  .\  \....*.\ * \...\.*\  *..* .**\... .*\.* . * .*....\..... \*.*..*.  *\\*..*. \ ..  \\ *\ * ... * ** . .  *.. .*. *..*..**.* .*  *\.**.\.* ...\ .* .*.. .  *.*  \...\...* *.... **\... .. \*\.*  . **...\**.*   ***#
#       #\ .# .  . ...  . *\ *\.* **.\.\. **..*..\ .   \*.*..*\ .*.\ .\ .\ \.. ..**\ .. . ..*  *. .*. *** * ** *.. *. .  .. **.*.\\.**..\.*..*.***.. .\*...** \ .. .*   .\ ....\. \.  ...**... \.* .** . * .* .*   .. . \* * ..* .*  .\**.  . .****. *.*\.....* . .\. ... * . .*.#
#        #\.**\*.*\.*  \*.**\.\..\* **.* \*.*.*\.. ** .\*\.\.** *\.*.\* .. **\  **\.  \..\.* \.*. *..\\**\ \ ....* ... .\ \.**\.\*..***\* .  ...\\\ .* ..*.**\ ***..\.*.\*\ \* ..*...*\ *\..**\ \*\ ... .\ *. **\ \**..*....   . **\  *\.*. .*.\.*.\ \ . *\****\* .  .\*. .* *..*#
##################################################################################################################################################################################################################################################################################