#########################################################################################
#.#* .  .\  ....* .\\*. .  \  \*\\*   .* ..\.....  *. *.. . ...  \\\  .\..*#\\*.\..#\#  #
#*\.\ *\....\\*.* *  *\  .*.  \.. \ \. .* *** ..\.\  \**.*  .\. * **.  ..**\..\#\ \#*.# #
#.* ..**.  **\.*.\.*  .\* . .   \.\..  \* \. ... **. ..*\ **.. \.*.\..\* .* ** \# ##.#  #
#\**.  ..  ...     .  \ ...  .  ..   \*.* .\** .* .*.. \  .**. .*.*.\ .*\**..*..##.\*.###
#....\\\. .**\.\...  .. .  .  \   .*...  *\*.....  .\*  *. \R. ...**.  * .*.\...  *\*.\*#
#. \*..*. ...  . * \*\  .*   \..** . .  .\*.. . .\\.*. *.  .*.***.*\  .*  * \ .  ** .*.##
#. . ***\  \..\.\.*..\.  *\*.. .\\*  *\.**. .\    *. *  ... *\.***\. * .\.*\ .\ .*\ ### #
#.\. \*..*.. \  \.\*\*\  * *.\*.  .  * *.* *    **.* ..**.\.\  ...***.\* ....... ....## #
#...*.\ ..* \.* .. * *.  .**..*   **..** *....*.\\*.\. .*..*. *\..\ .... .. \*. #. **\*##
#   .*..\ * ...\*. ...    *.    . *. *.. . . *...*.. *  . . . .*\...* . .\* ... *..#\## #
#\.  *\ ..\**. ...  *. \ \.*..** .* * ...   ..\ *.*... ..* * . ..\ **\  * ..  . *.\#..# #
#...... * ....* \. *.*.  . .**\*.\... . *.\\** .. *\ .\  .\ ** .\*.....\*  *.*. ..\###  #
#  ...\..... *...**. \***  .. *. **\.\.... ....*\*\... ....*.* \.\   * *.  \.*.. **#    #
#\.*\ . . \....\*** ..\ .    .. **  *.* .  \\* . .**\.*. .***** * ** *... \.. \. *..#   #
#  ..**..\.**\*.... .*.* .. .*  ..  ..\..*.. .\.**.. *  .*\... .  .*..* *\  \ . ... #   #
#. \\ ..***** *\** *.\**.. *. . *\.\*.* * ... .***\...*  .*\*.. .. ..\. .* .   ####.#   #
#. .\   *.... .. ..* *.*.\...**...*.  . .. .\..**\ .. ..\ *  ... \*\.*.* .\  \.#   #    #
# * .*\*....*.... *. .*..*.  .. \.\*\...*\...\ ***  * ..... .****.*\.#  \#...**#        #
#\.*  .*  **.   ...*. ..*. *.*.*. .. .**....\  ..*.....*.*. ....*\**. *. **#\.*#        #
#  .   .\..\*.*. *..*.  *. ....*. *.*\..   *.. \***. \***.*  * .* ..\ *. \. .##         #
#*\.*.. .\\. *.\..\..*  .\  ..\**.\.\* .. .....*..\*....*\*..*  \ . **..  .  .\#        #
#.. .*... *..*.* *.* *\  * \.* *.**  *.\.  .*...  . *.\ * .*\. ..  .*...\\\#. #         #
#\  *.  *.*. * \.. * .   . * .\***...*.*. . .*..  . ...*...* .\ *. *. #  ##*\.#         #
#\* . .** *\ . .\...***.\. *.  *...**  .  .....    *.*\.\*\......*\.*. ...#\.#          #
#**\  *. \.*.\.  *\*\. \*\ .*. *   ..\\ **.. \. \ .*\*. *\ **.* *\.#..*.#\##L           #
#* *..\.*. . .\\ *\.  ... *. . \ **\*  **\ . .* ..*\ *...  .\ *.***#\### #              #
#.  ..*..**   .\..**. ...\ \.*\* *..* \..\**.*.   ....  \ .....*..   *#                 #
#\.** *.\.*\* *  .\.* *.**.*.*.**.**\  .*..* .*..\.  . .. . *\..*\**.**#                #
#  ... . *.*... *\  * .*...**.\***.\.\  \*.* .  \*  .*\. * * ..  ***\\.#                #
#\ .\*. \...  \ **.*.  * .* ..*  .*. *\*  **  ... ** ...*.*.**. *..  #\##               #
#\*\..\*...   ...*\.\ *. \* . .    **.**...* . \. \.\.  *.**. \.*\..  *\ #              #
#  .*...*\. .*\.\. .\*** ..\*. \ ***    . .* .*....\.. .**.*   *. **..\..#              #
# .....* \***.* ... ...*.*...\\ .*\ * \..\..* . .. **\ *.*\.\.   \..*\  ##              #
# ..\#* ..***.**\ \ *. . ..  .\  \** .   .*\   . ...\..*. .\.***  # *.\*\ ##            #
#\*..\*.* ..*..... .. ... ...   ...*  .. .. * *\. * .\.**. #  *\ .\ .##..\*.#           #
###\.*..****.\**.\ *\ \.. \   ***.\. \  \ *\..\. *..\  .\* \* ** ..  # #\  #            #
#########################################################################################