##################################################################
#    #.#                                                         #
#   ##\.#                                                        #
#  # # ##                                                        #
# #\ .* .#                                                       #
##..#\.#.#                                                       #
#  .  *  ##  #                                                   #
#*..* *# #.## ###                                                #
#. \...\  . #\*.\#                                               #
##*.   .\.*.* \*.##                                              #
##*\.  *\ . #*##\..##                                            #
#\*. \ * *  *.\  #*L.#                                           #
#*\....\ . .\....     #                                          #
#...*\\***\ .\**  \  \###                                        #
#\  .  ....   **. .* .* *#                                       #
# *.. .* .. \*.\.. #... .*#                                      #
# .* . ** *\.*..*  *.. . .##                                     #
#\***. .  \  .\** *.... .. \#                   #                #
# .\.*  .* .\ ..\ .  *. *\.##                 ## #               #
#. .\..* .  * ....*   *****.*#  # #  #       #. *### #           #
#. *. * *.. *.\ **.  **.*.\## ## #\## # #    #. .*. #.#          #
#* . .. ..  .  \*.** ..\#..#\ .. #*** ## ##  #***#  #*.#  ##     #
#**    . *. *. ....*\*..\..**#. \...*\##.# # #\#\\.* *#  #* ##   #
#** ..  ..  *\..*  .*\  \.****...*.\ ** .#*## #* . .\.*##** *.#  #
#. .  .    **    .\. . * * ....    \  * .....##*.*\ ....#.*#.#   #
#.... * *\..\.*.... . .* .....*. * . *\*\ \* . \*.# .   #\* #\#  #
# .*\*\*\.*..*\**... \ ...   *\. ..* \.** #\.# .#\ *.\\ ..*..*# ##
#... \.**\*. **..\.* . . * \\.*  .** . ..\..\\**\ *..* ...** **#.#
# . .*\.\ * *..\ ..**  *..*. \. \  . * *\ . .*.**... . \*** *.*.\#
#\ .\* .**.\ . .\ .*.\ ..** .   ... ...**. .\. ..*\* .\*.\. # ...#
#.. *....  ..  *.\*  *. *. . *.*\*\ ..  * .\. \*#...\..*.* * . * #
# .*.\ .**.*.*.\ .*\**. . *\*.*. **\  \\\.*.*..\\\..  .  ..*. *..#
# **. .*.*\*****.  ..*..**\   **#\ .   .   * \*  *\* *.. *\.* * *#
#\.\. *\*. .\.**.\**\*\..... .\.\\  .*.     *\\\**..*. **.*.. .\.#
#  .  ..*.*.* ..\ .....\. . * ... .  ... .\.\  *\.* ..* . \  #* .#
#.*. .**.*.*.****.*\** .  . .* .. ...  .**\.* \**. ..**\  .*\..  #
#.. * .\.  ..*.. \. . . \     *. .* * **\.*\   .*..\**..*.\.  \**#
#.\..  . .  ... *...\    \.  .\* .**.*.\* .*. * .* ..\.. *\*\* ..#
#\ \*\ *  * \  *. .*. ..\.\ .  ..\***\*.. \ .*.* *.*.   *..* .\ .#
#...\ *   * ..  **. * \   .  ..*\\* ..*.*\ *..\*..*\* * .  *...###
#  *.*.***..*.\*  . .  * \.*. *. . \  .\..*.\..**.  .  . .\*.\  .#
# .\..**** ....  .\  .\.\*\.. * .  . \ ..\.* .***  ..\ . . . *   #
#..  ..*.*. .  .  .*  . .*..\*\ ***. ..\.    .*.\   ** . .*.*\**.#
# .*.*\. . \ .\..\. .* *  *\.\. ..\ *.*.\    *.    **. .* * \ .\.#
#*.*..*\  *..*\ \.\. .... ..*     . .  .  \.*..***\\.  *..**..  .#
#...\ .*.. ... . \*.*  ** \..   .\*.  ..* .*.\ \.\**. .**..  ...\#
#** ..*.\. .*...***.\* **\.\ .*.  *  *..   .*. . * * \..\.\..  . #
#**\.  ****\... . .*\.  .. *\* ....  .*..  *  \ ..*** ....  \.. .#
#*..*. .....\.*. . *..  .. .. .. . *...*.  *.    *... \  ***..*\\#
#\  * . . *\.. ... **\*.* \     . *\.. .  . .\.*.    ..\*.. *\**.#
#   .* *\ * \ . . .. *..*\.. .... .. * **.. .  *.** * *.\.\ ..**.#
#\ *\...\   . .... ..\ ..\**. *  \...* \..\.*.  ..* . *.... * * .#
#*\.\.. . *   ...  .. *... \. . *.  ....\..\.***  ** \ .... ..*..#
#. .*\. ..***. *.*  .  . ...  .\.*.**.\\.*...\.* ..  .  \   .*.  #
#.\*..\  *... *   .  . *..*. *.*\*\ * . .*..*  . **. .**\..  ....#
#. \.\ \** \.** **  . \.. . \* \.  *.**  .  **  **.**\.*  ..*\*..#
#*  \ *\*. . .\***.. * *.**    .   .*.\. . ..** .. .*.. .**\. .\.#
#. . .. . * .*...\*\    *.\ *.  .. ..*  *...*.**. ...\....*.*\  .#
#* ... * ...\..\...   *  .*... .  .\.  . .\.\  \*   ** .**  .*\. #
#*... *.\ .\*. . *. *\. ****.* **  *......  .*. *   *. *. .  ..*.#
#. * *. . .*\ *  . ***\.. .**..*. ...*\ .*. *. \* . ..\...\ . ...#
# *  .\..**.*.**.*\..\  \ *** . .   .. *. \ \...   **   *.   *.  #
# ..\.*  .... .\...\ . ..\......\ *.\ *\*\....*.. \.\ * .. .*. .*#
#* ..... . \\ ...\*.  .. ..*\.***.\*. ... \.  ** *   \.  \  . \ *#
#\\. *\.  .*\...\**.*\.* .*.... .**.*  .*.. *..  .\*  . ..  *.*.*#
# \. *..*.*... \  .**.\.\... .* ..*\ \ ... .. \.\ .* .. \. *...  #
#\ * . . *.\.\*.\* .*\.\*   * * **. **\  *\*..\*.*.*.* *.* .* ***#
#*.\.*.. ... *  . \ . *...  \**.*\. ...   *..   \..*\\***. . \*\.#
#******  . ...*.\  \.**. *. **. .    \* * ***. .. .*...*  \ ... .#
#\ **.. ...*... ** .  .* .. .*.*   * ...*  ..\*.**.. \\.\ ..\  *.#
#... .. *. * \.**.. ..* . .   .\*\.  \*..* \**.\*.. \. *\. \..*\.#
#*..*.\.\  . .*..\  \ .*. .\ \*\..**..**\. ...  \*.\.\.* .* *...*#
#*.\. ... \*. .*\....*.***   .** * \ *... .......* ..  *\*  *\*. #
#. .\*..*.* *.  * *.**.*..  .... .. .\.    \ . ..\ ..**.*\ *. ..*#
#. . *\\....\.  . .\\***..\** \  *.*\.\.*\.. *   . *.\.      . ..#
#\. ***.***.*\  .  . . ..\...  *..*.. \ *  .*..\  ..  .\..*.* \ .#
#. ...* . \... .   .   *. . \ *...  .*\.. .\*.  .\*\.* .*** .    #
#.... ***  \.. .\.**\.*.... . \ .** ..   .  .\. * *.*.  .*.** *..#
# **.....\  .*.. .\ * *\\ \.*  .\*.\*\ .. *.    .   .... \*\ *. *#
# .\ .* *. .*.  *.  ..\  .. .   .. .**  .*..  *.   * * .. .  ....#
#**  ** *.\\..\ \*\**...  ** .\*  ***\*\*..** \*.*\.\...*\ .\* * #
#*\  .\\. .*  ....... \.  .\\..  .*.  .*. ..* .**.*\. ***..\.*.. #
#.  . **\. . .*.*.\ * .  .\ .**. *.*.  *  * .\.**\.*..**.*\\*.***#
#... *... .  ** ..* \\ .***.\..\*. .*  .\.**. ...\...\.*.  ..*\. #
#.* . ..* *\.  .\*\*  . ..*\ .\ *.\*.\.*. *. **.*  * ..  ..  *.  #
# \**. ..\\ \.\*...  .  * .  ..\\..*.. *\*\. *.*\.   *.*.*\.\.\ .#
#. .\ ...*  .\..  * *\  . . * **  ..** \ .*\\.*\* \.\. *\*.\..\.*#
# *  .    * \..* * \*** . .*.  ....*.*.. .\***.*. . *  .... *..\.#
#\*\*.* *   ......\ .. \*  . \.   \.\*.  ..\*. .    ..      \...\#
# .*.\* .\.**\ *. ..\*\...  .  .. .\ *\ .** \\. ... **.** .*..\*.#
#*. ***\* .. ... . .*\. .* .*\  .*\. .. .\  *...  ..*.*.   .  . *#
#. **...  .... *. ...\ ..\ *\. * * .*  .\   .* *... .*   \ **.\..#
#.*. **.  *. . . ..  *\. . . *.**.. *.. **\ \*\..  \ \ . .\*\ ** #
#****\.\.*.. \..* \* ..\  . \ * . ..\ . *..*....  . *. .  *.*... #
#** \* .*... *  .... . *    ...\ \*\*. .* \.*  *\. .\ .. .**   .\#
#......*.*\*...  *..\*...*...****.** **\*..   ...\.\.\ .* *..\* .#
#...\*.*..*\*. . .  ... .*.\....* \. \..* .* *\..  *    \ .   .. #
#\..*. *\ ... ..* *   .*.*   .*.\*\.*  .*  ..*  * ..\..*  *..\...#
#.... ....\.* \ ..* ...*.. * .\**\ .. *\*\*\*.**. **.. ..  .  ..*#
#.* .  \ * ...    .* . .. \*...\.*..   \\  ..\.\.**\.*  \\**  .*.#
# .  ....\  * ..\.... .  ....** *.   . . * ..  .*.*.\*   \.\ .. *#
#..  **\  *\\ \ ..*.* ...   ..* ** . *\ .*....*\. .  \ .* . * *. #
# .*. *  .. .\ \   \     . \ \* .***\.. .. *.*\*..\  .*\.*. * \\ #
#. .\..**.*\ . ..*.\ *... ...**\ \*\. \ *. ..* *. \\\ * *.*...*.\#
#\.\*.* . *.\... *  \*.\. * \*\.\  .. .*..  .*.*\\   .\ .\..**..*#
#.\.* . .*.   ....*.....  .\. ..\ ..**.. *...\*.   \.\ *. \..*   #
#\.\ \ * .* \ ** .\* * . **.  *. .** *. ... ***.\  \ ..*..*. .*  #
# \*..\.* ....**\.**... .*.\ **\  **...\.\* *..* *** ...\...*.\.\#
#* .. .\.\ ** .\.*\  . . *.  .. .*.*..* . ****  . \.*\* *\* \ **.#
#. *\ .. .*.*\  ...**..  .. \**. ..*.\ .*\.**.**..    * \ .. \..\#
#. .*.*.*....*.*..\ .**. .\**\. . *.\.\*\  *. ** **.* . . *    ..#
#\\** ...\  \.*****.*. *...*..\..   .  .* ..*..* ...\*. *.*\ \\ .#
#*.**    .   .\. ..\.... .*.**.  * \ *\..* .. \.   \.\.\..\**. \.#
# .* \  .. *.*...*\  . * \*\ * *..  ..**.*\.  .**\ .  \ .  . . .*#
# \.\   ***.\.. .. ..\ .  \* * ..*\**. \*.* .*.*.  .\.\ * *.***\\#
#...\......*   . ..... *\*....   ... \   *\  . **.*.  **. *.**.*.#
#..   \....*\   **.\ . . .   * .\\  \*. .\ \ *\  .\.. *\. \..  . #
# *. *.*..\. ...\*  \. ..* *..*\ *  .\.. ...*.  *  *\.\ *.*\...**#
#.\  \*  .  \* *.\ . .  ....*** \*. *.  * \.\*. ..\\..  .. . ... #
#. .*.\ \* . * .*..*.\.* . ...\ .\. \.\.*. ... .* . \  *\**    .\#
#.. *  *.*.\ * ***\. . .* \  \ .*.. .* *\ * ..**.  ....\*..* ..* #
#*.\*  **..... \.  .* *\* .*...*\*\ .\\ *.*  . . * .* .*..\.  *. #
#\*.  \.*\.**..**\\ **..* *..  ..*  . *\..  \.. ** *. .**  *..\..#
#\.. ..\.* * ....   ...\ .. *\ * . .. \***.\**  .... .*.\..\**   #
#  .\ \... .*.*  ..\  * ..* .*.\... . ..**. .*.  ***  ...   *. *.#
#\   .*\ *. ...\.*.. \ *.*..*..*  ** .\\*.*\.\*\ . * . *\.  . ...#
# *.* *  ...*\   . *\* .*. *\*...*.**\ .\*. .\**..*\ *..\***\.*. #
#.**.*. * ..\* *\* .*** .  . .  \ *. . . .\* .*..\.*....**\*...\*#
# ..\*..  .*...\** \.\   *.*\ \.. .\ . .*  ..\*...*.*.....**  \* #
#*..   \ ..*...\..\. *\*\..\. .*** . .. .\.* ..  \  *.. *. \...\ #
#*** * .* \ .\    .  .*. *. **\*..\*** ... .. .*\. *. .\\* .*..*\#
#*\. ...\*. ..\ .* *  **.. \. **.... ***.\ \*.\ .. * * . * **\..*#
# .   .\*.**... ..  ...\.* . **. **.****.**..\* . ...\ **.  . **.#
#. \.  ....\.   \ .\.  .. .**... \..**\**.*    \ *  . *....\*..* #
# *.* . \.  * .*.\ .** ... .\* \  .**. .* . . ***   ..\.. *...\* #
# . .*.. \*.*.\...* ..... .* .*.. *** *    . * ...* **.. *.  * *.#
# .. . \  .\*.  *..\*     \. **.  ...\*\ . * .*. \* **.\... \.. \#
#.*\.. * .\. **..\*\.\   \.\ ...   *\...*. ...\ ... ..* \..\ * *.#
#  **. *\ \* .**..**. ..   **. . * *. ...\*..*. .\. *.. .*. ..***#
#* .\. ... . R..  . \. *   .. *.\ ...\* *... * * . ..  \ .. ..\* #
#  .\ \ \***\ \** .\.. * .    .\   \*\.. .\. .\* \*.  *  \  \\..*#
#..  .. \ .. * *\.\  .   ** *. *\ ... ..... . ..\*\\* *. **\.  \.#
#\  * .   .  *  .**. . *.**\.*..\* . .    . .\  *.    .  ..*. *.*#
# .*. . .\.*\...*.     \ *...*\.****  \ . *.   *\.\. **\....**.\.#
#. *..*. .....\.    . **\* ..\  \*..*..  *.    .* ..* .. *.\*. *.#
#*...\... *\  .. **\..\* .*\.*.. .*.**\**. . *. .. ...   *\  *.. #
# .\\ * \\.*   .....\*.*  .  *...**..* *  . ..* * \..*\ * *.\.. \#
#   * .\..*  *..\**.*...\. * ..** .. ..\ . \ \. *.   *......**\\.#
#*\ \  .**. **.*. **\.*..*... * ..\. . *.    . \. .\ ....  ...\.*#
# **.   ..* .*\.*... *.\ ***.** . *.. .. \..   ...\**..*..*.\.*.\#
#. * \ .  \*** **  \ .\.. \..\.\\....\\  .\. \.\.  .\ *......\ .\#
#. *.\  ** *.\.*\  .. *..*.*  \****\ .  \. *\ **.\*.  *.. . ..*. #
#\ .... *.*..*   .\.*..\.**.  ..  *.. *..\*\  *** .    . .  . ..*#
# \  **\*\.. \  *\.\.* ...*\* . \ . .\. . \.\ \. .** .* \.*   .*.#
# .\ .**.  \. ..*.  .. ......\**.*\.* \.* .* . . * . *  \ *..... #
#\ *. *.. \...  .\    .*.  . ..*\. *.  *\  *   \*  . *. . *.\.  .#
#  * \**. .* \*\   * *\... *. .*\  *   . ..\ \    . .\ .* * **  \#
#. .  **..\**. ..\.* . *. .\. *. * .\. .** *.  * \   *   \. ..*..#
#  ..*. .. ****\  *...\* **.. \.\*.\ ...***\ .\. . ....  .*...***#
#.   . . \  \***.\.*.. .* * \.. .*  *\ .\. . .* .. .*. .*..\* .\.#
#.. **.. *** *.*. ..* . .  \.\* . .*. ..\. *..*\\.  \.*  .  ..*. #
#*  ...   *.\* *\...**...*. *.*  \*. .** . ..  ..*   *\   *  .. *#
#\\ \. \  . .    **.*   . *\.** ..\ ....*\  *. **. .*. .* . .  ..#
#*  ..*..\. **.*....  \.* .. ...  .. .. .*  *. .\.\ ..  .    .\ .#
#    .*\....\. .  *\.\ \. \. .\**\ .. .. ..\....*. .  ..\*\*\*. *#
#. .\.* ..\ .*.\.*... .*\*. **... .*\*  **\.\. .. *  **.. . ....*#
#* .*\..*..  . .*.\\ . .*.\... \ *\... ......  .*.. *\. ** **\. *#
#\.*. ..*\ \.. **..... .. *. * * .*\\*\ ****. \\\*. .\** *\*..\. #
#**...** .  *...*  * *. *.**  .  *..*.....*. ....*\\ *\\ . \.*. .#
#...\*\. *.\***.. \...* .\.*\  *.\  ..**\.**.  *\. .  * .\.  *.\*#
#.\*.. ...  .\ ** ..*\.  *. * .. .  ** .. .\.\....**..\.\.\*.  . #
#.... \.\  *\.**\.. .  .  . .\ \ . .. .. . **.*\* ..* . . **..*. #
#\\ . * ....**....\ *.\. . . .\.  ..**** *.\*  *.  *.  .*. .   .*#
#  *.  . **...\ .* .\...  *.. *  *....** .  *  *. .\*   *.*..\...#
#\ . *.\*\..  .. .\*.*\..\..*\* *.  **..... . ..\ .*\**..***    .#
#.. .\ .. . .\     .*.  * \..*  . .\..*\*.\.\ .\ .\...\.*\**.*   #
#*   *\ \...  ***\. ..\... * .\. \.\ .. ** \. ...... .\.. . .. .*#
#\*. *.. \... .\*. .*..  *\. .  ...   \*. *.  \ . .  \*\.\*\.*.\.#
#... ..* .*.\*.*\ . *.  ...  *..*.* .\ **..*  * ***..*. .*\. . .*#
#*  .\  .\*\ *.*..* * .. *. .\..\.\* . *\ *. \.\.**  ..*.\. .  .*#
#\*. .    .*.***  *** .  . . .\ .*  . ..\\ .\..*\  * *\. * .*.. .#
#...\\*\....  \ * .*. * *.* .*  .* * ..* .. .* **. \*..*.*.*.*   #
# .  .**. * \\... \.*\*  *. ..**...*\ .. .. ..*.**\*\  .*.\   *. #
# *.* .**\.  \ *. . . ...\*\* ..   . . .\.. . **.. ...\..* . \**\#
#*. * **.. *...*..*.. ..*.\.**.  . * .* *\.\ ... .**  .. *   \**.#
#*\*..\.*.\ .. ..    *\.*...*\.  ..*  \...\* .\\**.. .\ ..\.**.. #
#. .  . *.. .  .   . .** . .. ***. ..*.   *. ** .\*. ...  ..* ..\#
#\.  .\\.\*. .\ .. *\ .  * .*. ..    *.*. \..\...  .* .\*.*..    #
#  .\ .* *\.   .*\....**. *\*\.  *. * *  *  . **\  **.  .*.**   .#
#*..*\...\*  \.\. *\ .\ * \*\  \.*   \.... \ .**\.*  *\ .. .... .#
#.  \*   .. *.** \ ...... \... .\* \ .\*** *. .\. ***..\  .* *  .#
# * .* .. ....*   **  \ *.  \  .* .**\....*.*\ *\ .\  . *\.  ....#
#*.\.* \.* ....\*.* ..**\ *....***\ .  *. . *.. .. *..**    ...\*#
#*...*\... .  ...\.*.*.. \. . .... .* *.   ..* *. ...  **.*. *\..#
#  \.\*\ \ ** .\ ..*..*   .   .\\  . .\** \. . \. * . . \. *\ .. #
#\. *. . . .. ..*\ .. ..     .... .   .**.. .   . .. * ...\. ....#
#\. .\.  *..*\  ...*\ .*.. ** ** .\*... . \** ...*.*\* \  . ...\ #
#.. \.   .   .\ *\ \.. **. .. .... .\**\  ...*.  *.\..\ . ***.\ .#
#. .   *.*. ** ..  .*. * . ..* . . \ *. *.\. ....\**.\. * ... ...#
#\.*..\.\*. *. .* . .. *  .\..\ ** ...* .\  * .\ \ *\ ..\*.\  .*\#
#\     . .  .  .*.*\* \ \* ...**..*.*\**\.\ \  .*\.\ \.  .\   \..#
#\*** ... ** \   \.** .... \ \..  ... *.   *. . . .*... **  **.\.#
# .**  \ .*\ .   . . .*..\**. *\..* . . ..*\. .  *\ **\...\.*. ..#
#  * .\ ....\*.*  \  .\*\*.*. . . .  **.*\.. .***.*\ ... *.... .*#
# \.\  .. ..*. **  *.**. ..*.   .\   *. * .*..\*...   **\\  *\ .*#
#.\... \** ***\. ...*.. *.\.  *...*.  *    . . .. \  \\... **. .*#
# *.* .*.* ..***\.\.* .*..*....  ... * * \  *** . * *..\..\.*....#
# ...\ *... .\.. .. ..*.*.*.\* ** **..* *\.\.\.  .. \ *.. .\..*\\#
#\*.\*..*\ .* * . \. ....\.\.* ..\*..\*\ .* \.\. *. .*\ .\. ..*\ #
#*.**\ .. \ ...  \\  .. * .. . .. *.. ** ...   *\*.. . . **   * .#
#.*\*\* **..... * *...  .     \** . *\.. *  **.\ .\.*\.. \.  \. \#
# .\. . \.\* .\*.*. \ *.*.  ..\ * \ \\ .*...*.\.. * *..** .*..\. #
#. * .. . \*..*.*.*. .\ .* .. *..\.* ..** . . .\ *. .* .\. . * *.#
#\ .  \ *  .*.... .*  *\.. ...* ..*.***\.**\. **.*.\.\.   \    * #
# **.....\* *.\**\ *  .*.*  * *\.\ * .\ ....\.*.**.* . \. .* *\. #
#....\ *  \\. * .......* \. \ ..\*** **\*\*.  ..\. .  *  * **.*.*#
#.\*   *.*.***\.  *.\ *.  **.\ \  \ .*  ...  \ \.** ... .*.....\*#
# ...**..**..***\***.*** .*.. .* *.... ..**\...  ..\*.\ .*.. \ **#
#. \ *.* * \.*.*... .*.*\ *.\ **\. ..*.\ . .. .*.  *..*...* .*.* #
#\. .**.*\ .\. \.. .....*\.*. *.  .  \.  * *\. .\* .**.\. . .\\*.#
#*   .\..  .  . .  .. .**...*....*.*  .. .. ..  ...\.*. **  .    #
#\** .* . *..   . .   *\. *\..\. . *\  \ \.\ ..\   *\* \\.  .*\**#
#.\.... .. ...*\*.. * \... ** . .  ..\ . * **\  .\..\ ..\*. *.*..#
#..*. \.\**...* .*  . .**.\.** *. *  . *\*\... .. .***. ... . . .#
#\ *  ...*\*\.. *... \...\..*.  . .**.\..  . *.\  ...\.***...\* .#
#. .  **.*.. . ..  *\\ *  \ **\ ** \*  *\.. \   ** * **..* ..**  #
#    \\. **\ ...\... .**.\. .*  .. ..***... .......\ \. .. .*.. *#
# .\  . *..**\.. \*.\.*. *  .\. **   *...\*\..\. * .\..*  . .*.\.#
#\ . .*..\.\.*.*\.* . * . \.\*\.\.***. ***. * ** . ..\** . .**...#
#*.. *\*\.....**.*.. .    .\ ...  ...\  *\.\. *\.\  .    *. \.***#
# * \.*... *\.*\.\*.*. **\.\.\*. .\**  .  \ . *... * ..**. *. *.*#
#*..   .*..*.\... * .. *  \. .. .**..*.*. .. *.*\* \**..  * * * *#
#**.*** *\....\\.*..* *.*\ ..\..  *.\ \.. .* .***.*\*.. * \* \..\#
# * ..* \ *   *.** ..*.\*. .  * .... .. *  .\ \ . .** **\  .*. *.#
#\ \*.*...  . .*\ .\ *  .\*\*...\* * *.\*\ ** ..  \*  *..**  *\*.#
##################################################################