#############
#**.* \ . \*#
##*L.#.* .*\#
# ##.. \. ..#
#  #R.\*...\#
#############