###############################################################################################################################################################################
#                         ####   . *..* ...*.*. .***. *\   . ..*.*.\.  \.*.. *. .... . *.*..\ .\ .\ .  .  \ .. . .  .\.*.  *  *. .\...\.\ .  .\* ....*... \ .\*. **...\*   . *#
#                        #\  .   . \ ... *.\*.*. ..\* \  \** .*. .. .. . ..\ *.... * .\*   .* ...**\*.   *..**..  . **..\..\ \..  .*..* .*.   *.\.  \ \    * ....*..*.\\* ***\#
#                        # ..*#\  . . *\*.* *\...\*.*\.*..*.*\.*.*. .*.*. * *.\    . . .\   * .  .**    ..  *.. .. \.*... \. **** \.. . . .**...  **.. ** *..**.\.*.*. ** .\..#
#                      ##     ..\ \ ..\.\**  .... . .*.. .  \*.*..*..**.\..\*\ ***      ....**  .*** \ .. ... ......* *.\..  ..*.*  \*..   *.  *..\.***  \.. * .**. .* \.. .\.#
#                     #\ ..\.. ***.. . ..*. .\\ ** * \\  *.*.*\\  ... ... \.\ *.*.  . ..*.  *.*.... .. \  *\  \.  \ * .*..\ .   .   ...* \**.\ .* * *\. *..* * *. *\ .   *.*.\#
#                   ##...\ *. \ \* . **. .*\  \*.. *.* \*. \ . * **\**** *\.*.  .\  *.* * ... *  ...**\*  .***.\\\.\.*. .\. *\..   \.\ *  .*. ** ..\..\..\.*  . . ..   . .**..#
#                  #..*. #. .*  .. *.\ *  . .\ *.*\....*. \...*. ..\...\**.**.\.*.\*..*.****..*.** .\\ ..\ .*.  * . .\.. *.\. . *...  . .   .*.*..  .*\*..*.\.   . .\.**  ..  #
#                   ##*. \*\* .\. ** .**   \*... . *.\..*. . *.. ..\ .  \.*..\...*\.* *.*.*..*.\ .. *...  ...... ** * *..*.\*. .* *\\.  *   ..   ...*.*.   \    ..   \.\...\. #
#                     #\  ....*.*  ..\... *. \  **..*   *..* .   \..  ..\ .*. ** \  .\ *. \ ** .* *.  .*.\*\\.*\. ..**. ..\..*. .. *. . ..** \.** *\.*\   .. .\.*\ **.*..**...#
#                    #\.* .*\.  .**...* . .....*\...*. .*..\. .. ..  *\  \ *.\.**.* \. *..\ .. .*..  .\..*..\ \    ..***  . *..*.   .   *\..*.\.  .*.\.\***\.* ... **..\.\\ \*#
#                   #....*...   \.\ *   * \*    .\ .\...  *.* . .. . .    \.....*\....**  .  \* ....** * .\. .*  *.* ..*\*\ . ..*  * ..** \ .* . . ...**... \*.. .*.... *.  *.#
#                # #.****\*  .    ...* *. .. *.\...\. \ ... .  ...* *...*.  \ .\ *  ***...*...*.*..*.* . \. . .  .*\ *.* \   ...\.* .\ *.\.. *....\* *.*...  ....     .\.\ *.*#
#               # #*.#.*\* .*.**** *  .\*   *.  .\  * . * *\*. .\*..**.*\\.\.. .* ** *.. .***  *.**  .\** *\ \     ... .  ** .. ...\  *\.*   \  *\.*\* .   .. *.. *. *\*\ \ \.#
#               #\*.#**..**\* \\.  \ *..*\.***   *...  ..\. . * *.*\..*. *  ..* **.. .. ..\.. .**\.  ...  .   . *  *.*  *. .**\.*. . **. \*\  .\ *....*\. .   * .\..*...\.*\.\#
#                #.. .***.**#*...  . .\*\ .    * * .** *  .* ..*.* .\ *  ..*\.**....**  *\. .*\**.. .***..*..*..\..\.* *** **** .\ .*..   .. *.*.**....*.*. **. \****  *..    #
#               L*.  * ...*.. .\.. * *.\.* .** . .  \ **\ .*\.*\.*.*... .... .\*  * ..**.* \.* *. \ ..*...* ... * *.\.**...\..\ ..* *..... .*.\ \.*****...* *\. . \** **.\ . *#
#                # \.*\ ***.\  .  \...   ..\ . .**\..*...\*.***.. *.. ..*\. . .. . .\... *\.*.* .\*** . \.\.  *.. . .*..*.** **** .\...\*  *. **.*.\... **. .*.\.*.*.... ** ..#
#                 # *.*..*. . \** \.\. **   .*.*.... .. .*.\.*.*  .  .\ **\    \ *...  ** **.\  *.\ .   ..*\*..*   \...*. .*\ ......  ..*..  .*.**** . * **.  .. .***. **.\  .#
#                ###. *.*.  ....*\.*.* *.*..*.\.\ \*..* .  *......\.. ** \ .... .**.\. **\..* * \.  *.... ...*..\*\...**.* *.**.** ..*   .. **. ...  *. .\ .. **\*..*.. ***\.*#
#               # *.\ ##..  \ .\ ......\*..\\ *... *. *\ ...*..   ..*  . *.\ \..*. ... .. * *.*  *.**.* * *. ..  ..  .\.\\\..\.*..    \  . ..* .\. **..* . \\..***.**** .*...*#
#              #.*#*#**.  .\.. *. *...\* .*.*\.. *.\.*.\..  ..\  ..\.\\.*.**....*   . *.  \. .\**.\. *.\*\*.\*\ .*\\..*\.  ..*..\....*.*. \.\***  ... *\ .*.  \... *... *.. .*#
#               #.\\ .\. \**.. .\ . \  *. .*.**  *\  . ..  **.**\*   *\ \..\... .  \ *\ \. *.... . \..* .....  . ..\ .* . ..*****.\*...*.\...*\.** *\*  *\*  .. * \.\.  *..\.*#
#              #*\**.\\... . *.\*.*   * .**.\.* ...*.. *   ..\*..* ...*  . . . **\** . ..*. *.*..... ..\.. *\ ..*\ *\..    *.... \ *. . ... *\. .\\...\..\.***..* .\  ..*.*** #
#               #.\\ \. .**. .  ..**\ *\*.. *.*  *\.\* .\ .....\** ..\.\.. ..**. . *.   \.*.\*.* *\. ..* . * * *. . *. . .*\*.** . *  . \...*. * . **   .  . .*\ .. . .\. .. \#
#                ##..\ . **\*. \.**.*.*... *..* *. ...*..*\....* .  *.. * **  .***...  *.*.***\ . .\. ..*..\   .*.\****.*.*  .*. *.*  .*\.. *\***\.\**\.*. \ *\.* *. .*.\ ... #
#               ##.* ... *.***.. ...* .\. ....*..\ **\.**\...*.\ ...\* .*\ .** ..*.\** *. \..\. .   *\ ** \.**\.. ..*.. *\\  *\  .\*..*.    ..\.\*.**.. \.*..\* .  *\  ...*\ .#
#              #.#\.\. .\. .* .*...\.*\..   .. *\ .\* . ..\.\ .*  *\..**.*.***.*. .  ...**.* *  * ..**..\ .\ *.. .. . ..*.\ ...* *... .*  \*.* *.... . .. *\ *..\* *..* ...**\#
#              #\ * ...**. *.. \*..*\.  \.  .**\..*..*.* ..**.\* . .  *  *.*.*..*.*   .*..\ ...*..*  .\.* .**.*\  .   . .*. * \* .  ..\**\..  \*..\..*..\*. .\  .\.  * \. \. .#
#              #*..* *.\.. .\  \ * ...\ .*. ..\  ** .. .***\*\ .\..\ *\ * .\.\.*.. . \**.*. \*...**\..**.* .  ..\ \.  .. ..**  \ *. .* ** *..  .   *   **.    .* \ *\.*.  ...*#
#               #* . .    .... .*. *  **\*\\  .* .. *.\...* . \ ** .\.. *  .*..  \.*. ...   .* **. ..*..*. .\ *   . ..  **\**. .  .  *\ *.*\. *..  .   .\...  *.  .....*.*.\*.#
#                #\    \.  \* * .\.  ** .***   . *.\.*. * .\. \.**. .. .*..*. ..*. \  . *. .  *.*  *\*...*. * .    ... .  **.  .**\*.. \**\*  . .*  . *\.*\ .... .*\\*. \ ..  #
#                #.\. \***....*  ... .*.*. . .\\ \..*. ...\. ..*.\*.** .. * *.  .*.  .* \*  .*.\.* *.. *\* ..  *  ..*\  \ R.** *.*...\*.. . *..  .*.\ * ..* \.\...\.. .\*.\\**#
#                 # .. .  * . * ***.**. .*.*.\. . **.* .* * .**.  .. .*  .*\.. *.* \.\.* *\. *   * ... . *.\** *.*.  .. .**.. ..*\.\ .* \ ... . . *  * . ** .*.. .*.*. ***. **#
#                #**\***.*\* * *\..* **  \ .*.*.  \..*.  .* .*.*.*.  **.*\.*. ..*.\. . **\*.\**  *..*\ \ *\... .\...     .**\..*   . . \.. . \\.*.\  * *.... .*.*\.  \  .\. ..#
#                 #*.. ***  **\..***...\ .  ..**.* *\*.\ *. ** *   .* *.    * * **.  \ * *. ..\. .  .\..  *\.*.\.***\*\.. \* *\. \ . .. \.. *.*\.*\. ..\ *\* *.\   \* .*  .. *#
#              ## #. *   .  **. .*.. * *. .***.. * ..*.  \  .**\  . . *.   . .**..**\..* . .*.*.*\*\*. * \   .\.*...*. *\ .. .*\ \.. * . . \*..  .   ** * *.**.*\*\ *  .\ .*\.#
#             #\ ##\ ..\.\**\* \ ..\.\..   *\. . * .\... .\ **\  *\  .. .\......\.....**.*    .  *\*.*  *. *. *..\. *\*...\*\*\.\ *\ ... .* \ *\...**\.....  \..  ...***\ .  *#
#              #. ..\ .*.*\.** ..   .\ \*..** * \.   ..*. **..*. *\. *    . *.\.\.\ .. .\.*\ . *. *.*\  \ *. \. *.*.\ . . ***.**..  *\* *\ . .   \..* . ..*  .*\  *...\*.\ .**#
#              #. ##.*.. ..*.*. .  .. ...\* *..     ** \.*\..*. ..*  .\.* .\. . .* ... .\ ..\ .\.*  *.\* .  ..*.. .\.* ... . . .. *.\ * *. *. . ...\.. . *.\.*..\. *.*.*...\\ #
#               #\..***.* .* *   \*\.\.  .. ... *..  *.. .*.*..*\. \. ...  ....**.\  * .* .   ..*. *..*.* .\*..*.. \*.  . *.\  .**.\.**.\*.. \.  ... .  *. **. ..*.  \* ..\ * #
#             ### # . .* .*  * *\ *.   *.\.*.  \.**...\ .\*.. ..*.*.* **   . .\*. .. * *\   *.*..*\.\.*.*...* *.*.\ *..  \...\  .. *....*.*.   ....\*.. ***\*   .*..*..*..* . #
#          # #..#\.\..\*..*... \   . . \...*   .\ . * ..* .*.\.\.*** * .  *\  .\.**\ *\  .**  \ \ . . ..****. . **.. ** .. . * .*.**\.*.*. * * \  . \ **.\..*\.  ..**....*..  #
#         # #* * *. **.*..*.*\.. *\\. .\  ...\.*.\*.\.\ .\.. **...** ..\  * * ** *  .*..*.**   *..  \.    . * *\ .  .\...* . * .. .\.*.. * ..\  .. .....*. \.**\... . .*...* .#
#         # .* *.\... ..\*.*..\  . .* \ .. \*. ..***..     . .*\.  *\*.. . *.*..*.   * .. .* * .* **.\ ..*\\*..* .\**\.  ..      \   *....*  .\* *\. * .*    ....   .. *\  .. #
#         # *# *..**\.*.**\ .* . *.*.*. *\  \... *.* *\.* *. .*.**\..*.\**\***  .*\**..** *.*.*.\***\.*  .. *.* . *.* \..   \ .*. * .  . .\ .\*.\.* .\       *  \**  *..*  **.#
#          #.  ..* *..\.\.*. **  ..  *.*. \ .*\.*.\...  .\ ...**.. \..* *\ ..\   .* ...*.\.\..**..****.*.\  . .\.*\\*. ** . \ ****..   ..   . . ***\**..* .  * ....  *. *.*. *#
#         #\* * *.\ \*#..**  ...\... \ * *.. . *.\*  ..\.  \\ ... \. ..*\... \.  \* .  .\*. .\**. *..\ ....   .  ..*  ..\..*\ .*.\ .*. \  .\\ .*.*. .\..\.*\..  . .*....\\.  \#
#        # *#.. *.#.*  .**..\**.\  . .\ ..*.. *\ *.    *   .*\ .  *   **.\*.   ..\. \*  .. . ..*\ *** *\  *  ** .* .*\..\ \.  *.* .  . ..  .. * ...*.... * .*\\ .   ***\.\  ..#
#         ##* \.. .*\.. ..\**\* * \**.*\\.*\  * .\ ..*..*.*  ...\..*..   ..* * **.**.* * *. .. . .*.\ .* *. .*   *.*\.*..\..\ \ .\ . .\.*\\. *****.* *\\ \ \   \..*..*\ ..* .*#
#           # #*  \.. .  *\.*** .*...*.. \. .*.***\\... .\*\*.  ..\. .*.\* ..**.**\  ..  . .. * \.*    \   . .  .*\..\.    ... \  .* \ **..* *..*.\.\...*.*.  \.* ** . *\..* .#
#          #. .**.\. .   ...*.. *\.*...*... *.*.  . **\ ****  . .  *\ \*..   ....\. . .**\. ..***\\.  .* ..\ **  *..* \*\..  \.  * . . ..\ *\*  \... ..*.... \. \*\.*.*..* \\ #
#         ##\# *.* *.*     .\.# ..** . . \  \..\...**\. \ *\..  .**\. \\.  *. *.     .\.*\*  \. *.\..  ..\..  .*.. \*  \\  ....*.\ *.. ** ..   *.\*.  \.\. *.\..\ ..* ... ....#
#      # #. *#*##.#   .. .\  .  .**..**** ****  . **. .\. .*\* **..*.*...\. \ *.* \**.. **. . **.*..\ .  .*\.**.*..... .*\    .\*....\  . * .. .**.. \. .**... ...... *.\  *. #
#     #*##***... **\..\ \.*\.\ * ..  **.  .\.* .*\\.. *.*\.\. ..\. . ..\ ..    *.*.\.*\... ..  . . \ **..* . ..*.*.\\ * ..*\*.\..\ . . *\.\*.   ....\ .\**\  \**.\\. . .\ ..\.#
#     #\\*.....   . .\..\.      .... .\ ** *..  .  .  *.*  ..\**.\*.   *. \...\*.\.* . \\  *\ \..  .....** .*. *.... \. .   *   . *. *...**\ .\... *   .\\ .....*. .. **. ..\.#
#      #*#\#*..\*.* * * .. . .\ *. \. .**...* .. . .  \*....\ .   *  **... **\... .....*\..*.**.\ .. *. . *.. .\. ** .*. .  *..\..** ..  .. * .\ ..* .\..*.  .* ...***..\.\. \#
#       #. *#...*\*\*.** .**. ..*..* .**.\ ..   *   .* . ..\   ** *.**..** *. .*\ \  .** ..* ..*.\ *..  .*..  *.  ..**.*** .*\**  .*  \\.   * * .\**\  ...\*  *\*..*.*.\. ..  #
#      # * \. .\*. .\ ..\..* . \.  .  \**\.*\ *.. .\ . *\** *... .. * .*\. ..**..**\. ..  .**\ .  *.*.  ..... ..    ..\.. .*   .\. .* . ..  *\* . ..*..*.*.* *  . *  .....\ **#
#      ####.\#.\  .\.**..**... ..* . *.*.**\. * * .*.... .*\** * . ......*\.  .*.\*.\.  .  .** .\.\.. \.\.*\* .\**\\*..  \ . \.. * *\**..  * * .*   *\.* .\..*\.. ....\*\. .*.#
#     #*# ..*\...\..\** .\ **.* .* \.*.* ..\ *\ \ .\.*.. ..***.\*\.*. ......*..\*.. . ...\.. \..   *. .. .. .\  ..*.** \* * ..*. \*......* ..*\   * .*.\ . ... * **.*. *...   #
#    ##..#. *.**  * .*     .. \.......*..\*......  *...*\ .*. *.  *. *\....*\..  **. .\. .\* . *.  .   *.\. ..\.*\* .*.\. *    **...*\.*..* ***\.*..*..  .* . ..\.\ \ .* *  \.#
#   #\ * . \**..    *. *.  . ...  ... ..\..   *  *.\  .*. * \.  .*\*..   \\ .*. *... ..*.\..* *\.\***...  .\\..** .  \ *.*.\.  . *  ..*.  .\ .\*.*\ .... .*..\.\* .* . **. .**#
#    ###  *\.\.. \ .*\ *\\ .* .*. * * \*....* .\**.** .\*.  .*\*.*\.** .*.*\ .\.*\*\.* .**... . \*..  . \*.\**.*. .\. .. ..*** \ *. .\.*  *.\ .\ ..\.*** \.\.**.  .. .. *.*...#
#   #. ## \..  *... \* ..   *.*.\..\...*\ *** \...\.* ***\ **.\ .....** .. .. . * \  **\.* .\.* ...   **.. ..*.*.. .\ .\ ....*\**.*.....*..  ..\**\ \*\  * . *.\. *...\.\**.  #
#  #* *.\.. *.\. ..\\ *\.. **\*...  * .*.*\.. .\*  ..\. \. ..\ ..* ....* \ \..  .. .\ **.**.**. .\*..\.. .......  \ .\*..\. .*....\\. *\.*\.. **..*...  .\. ***\.**. \ \..*\  #
#   #\.##*  *.  *  * .* * .  .*. *\...* .\ *\ *   .  *   \*.\*\ *\. \**\\.. .\*. **   *\.\.*\*\*   .\ \\.*\\ *\..*. .\.\.***.*.  **\  .  .  ***.. * \. . ...\*.*...\....*... .#
#  ##..  *. .\\\.\*.\. . .  \ .. . *.\.\.  .  .\.* ...\...\  . \\. . . *.\ * .. ... .*.*...... ... .. .\.. \.. *.. *  .*..\ \* . \..**\..** .*.   .*.*\.\* \*..      . *...* .#
# #    .* . ..... ...*\.*.. . . .\\.\** *. \    **.*.\ \ \.**  .*.  .* ......... .\*..*\ \   . *.* ..     ..\*.. ****. \*..\.*.  . ....**.  .***\. . * \***..*****  . .  . .\ #
# ##* \. * * *  ..\.* .*.... *.**.*   *.. .. .*.*..  *\. . ..  .. *\*.\  *    *\.  . *. \   .**. .\.*..* .\.**..*\*..*. ...  .*\\ .\..*.\.\\*..*..  *\ \ .*  **.*..*\  . * .. #
##**.... ..*.\ .  .*.\.\...*** \* *. \*\** .\.\ .* *.**.* ****  *.* ..* *.\. .\  * *... .***.\* ..*.. .\   ...*.  .  .     \  ..\**. \.\   *\ .\\..**.\ \ . *.  \....**. .\** #
# ##. *. .#.  .  ..**..   \..\..*  *.\ *.  *    .  .\*.\.* *.*...\..*\*  ..  \. .. * .. *... . \ \    **. .  ..\  .  .* . **.***.*......   .**\**.... *..*. . ...*.\\..*..**. #
# #.*\..**.\..* .. ..*\..\.***  * *\ .... .\. *... * .\**.\*  .\  . .*. . . . *.**.**\..*\ *.*  . *\*. . * ..  .\..*.\*\ . .... *... *\*. . .. *.*.*...* \.*.   .. *   *\...\.#
##..\ **...*.*..   ...  .. ..*.*.\\\   \*  .* .. . ..  ***.\ .***.   .* \*.*\*.\. *.* .\* .*\***    ....\.   .**.* .* . .*\. . \*  *\*..\   *..\... .\  . ..  \..* *.*.. .* .*#
# # * #..   *\.\.** .\ \.** .. ...**.* **.\.. ** ...\ ...**.. .... **..\.. .*\    ... . .. ...\.  *.*\.  \..  ....*.*. ......* . .*\*.  ..\.*\*.  .*\. ** *\** *\\*.\     . **#
# #.#  . . *.\ . ..\ .. *. *....\**. .\*.. ****\.. .*.   .\...*... ...*  * .*.  *.\ *   ** ..*. * ...  .\.\. ... .* ..*.*\*\..  ... *. *.\. **.  .*\*\ ** ** .  .\* .. .\   . #
#  ##\*\ *   .**\ ...  .* **\   .*.....*  ...\*.  ...*\.** *\.\**\.  \.  ..*   *..... .*.*  .\*.\  *. *.....  .   .\ *. \.\.*.....\*.*. ****... *  .. **\*.\**\*...\** *\...  #
#    ##. ..*  .\.\ \..\\. . *. .  *\.***...\ .* *. .* \ \*.*.. ** * . **.\ \  *.*\. *.* \. \ *.. ..\ .\.*\.\.*. . \ *.. **. *.\*.**. ..**\*..\ ..\. ..*\*. .** .. *.\ ..  .\* #
#    ## . *..\.. .*.\*  *.\ .   \ .* ..*  *.. *.*. \* .\.. .* . * *.**.. .*. ..** \...**.\.     .  **..*.. . . . **... .  \   ....*  \..\.*\.** . *\*.. ...*...*. .*.* * \  \\#
#   # #\\ .**  *.*.*.\**.** .*  . .* *\. ..* . \.**.*\  .\  ....\\..**..\* . . ..*..*\.***.  *.\.  * \. .*\**.*  ..**.* ....* ... .  .  * *. . \* ... **  . ..  .   **..*. *\\#
#  ## \* \ .* *\\..**...\ **. .   .\\*.**  .*....*.\.\..   * **.*. ..\ . *\\     .\ \*.*.*..*..*.  .  \ *.\**.* \  * ** .\*\*.. *.\  \*.. .*.. \.\. .*... .. * \. . .\ ..* .*.#
# #*. ## . . . * . ..\ ** \. . \ .\.*.... ....*. .\.****. \.\.\ \. .  *.. .  *.* * ... . \ *.* .*   .*.   ..\ ...  *.**. *.  .***. **...*\.**.*\.*. **\  . . * .**.. * .\   . #
# #..\* .\.  .\* *.\  \.\ .. **..  .... \*.\.**  \.*.. .  .\....*  \\**\ . .\.  .. ..*\.   .*\ ..\   .*  **  \* *\  *...\. ..** *..\*.. .*..\.\..* ..\ * .. .**.*\. .\ ...* **#
# #   #  *\..*.\   * *. .\.....    . * **. * *..\ ..*.** .* \ * .  *.*..**\ *\.\. * *\ .\ .*..* *.* *.*.. * \.. .. ..... *. . ..* . \**.\..*.   .\ .\. .. .. .\.... ** .. . *.#
# #* *..\.*.. *.....*.\.    . .  ** **...*\ ..  *.\.\*\.** \. **\.. .* ..\ .*...\*.\.  \...*. \ . * . ..  *\. .. *\.  .\.\* ..**\ .*..\ * \..  \  .**... ...\. ... .. .*. . *\#
# ##\*\ *.*.*..*.\.*\. \.\..*..**..  .*. .\.\...\.   \  \.*.*\. ..\. *...  \.\*...  *...  ..\. *. .  **\*..   .*.\*. * **.  . .\ .**. **.*\.. .*  **  .* * .*\ .  ..   *  **. #
##\.#. *\*\*.. .. **  ... **.. ***  .*   ..  \. *. * .**. *****.  ....* ..*.*** *.\.\*.*\*\. .\**..*. .*\ \ *.\**..\ . .\ .\* .. . . **.\.  * . .\.\  .* .****   *.\...**..* .#
# #**\.  * .*\* .\*...\. .\. ..*..  ..\*.*\ \ *\*.    .. .**\ * *.*  .\.. . *. *...**..... **  ..* .*. .  . *  .\...**  .. *.* \ .*   .\.*\ . .  .** *\. .* .*.*.   .    .*\ \#
##*\* .  ** .*  .  . .*\  ..*. \.**\* . .. \..*....* .. .\..*.* .. .*.. . . ***. . ....  ..*.  \* ...*\ .. *. *.** **\ \....* \. ..\* . \. *.. .\  .  ..* .\***.. .\*.** *..*.#
##.*# *..*\\ .. ..\ \ .*\ .* *.. .\ *.**.**  \ .  .*.\*...  ..*\ \ .* **\* .*.**\*\.\*    **\*....*  \*   *\.*.\ * .* ... .\.. .. \..**.*   .* . *.*.*\.\  * **  * .*\*....** #
# #. \\. *\. *.*..*.. **. ..*.*. .**. \.\.. ..*\*\..  . ..    .*. .  ..*. .. .*.  *. .  **.*\.   .\  .* \....* ..*.*. .  ..*  .*......*  ** *..  *. ..* ..\.*..\..*** ... *.\ #
# ####.*... ....  ...*.\..*  *.. ..*. ** . . \***.  . \*    *. ...  . ..*..*\**      . *\. \*\.*.**  *.\... .*  *. .* .. *  \ .  .\ *.\ ... .  ....* \*  *.\.**.\.. .* **.* . #
##. ## *.. .*\.*\ .\ *..*..  .\.  ..*\... . ...**..\ ...  *.\*.\.\.\.. .* *.\.. *\ ..\ .\ *..***....*..\...  *. *  ....  *. ..* *.  .\.\ \.* . *..*.  * \*\.*..* **.   *  \  .#
##** #.*.**.* .\.  ***.*.** .\*  *  .      .  .. * .*..\ \.** ****\ *\* * *. \ *.\ \.. .. .....*. .\ ..\*  .*.\ \ ** .\* .*\ *.** ** .*    . *..*.*..*.* .. . .* **\.... .. . #
# #* . *  \*\ \ . ....\..**  .\ *  .  \ **..* *\\* *. ..** .. ..*...\*. .\  ..*.\. ..*** **\**..**\.\ . .   .\..  ... . *. *. .*..*\. *..\ * .  . . .. *\. ..*.. ..**.  ***\**#
## .##\. ... *.\. \*.\ **..* *\..*\**  .\..\* ..*  .\. .*.\ \ \.*** .\.  *.*..**. ....\*....***.....  \\ .\.*.   ..*\ . .**.*. *  .  \.. ...\.. . . *  .*.   * *  *.\\ .*\*\.*#
#####\ **.\*..\. *\.  ***. **\. .* .\ .**  ..\ **. **.*\.* . ... ..*.** **\  .   * ** ..\. ...*..\\*\ .*  ...*\ .  ..* .* \..** .*\ \*\ *  ..**  .**\  ***..*. *.   * \*   .*\#
# **\.\ *\ .\..\.. *  . \..\. *  *...\ **..**..  \ \*\..*.*\* *.\\*..*. .**\.\.. ...  \ ..* \  . *..*\*.  .**\**  *.*** *\*  . \*....\ *\ . \.*.\  *  *....\ * .. * .\ ... .\ #
##*. *.* .  \.*   ..**.*..*.*.  ..\.**.. .\.....*. ..*\\. \*.**.**. *. ..*.. .*\  .\...\** ..*\ ..\ * **.*. ...** *\*.. .\. *   *..*\.*\   .......*.\ *\ .  .. .\*..*.****.***#
# #. ... .*\..*\ \. ** ..*.\.*\*\ .**..\*  \.**\ .  *..**  ... .\.\.*.   .*   .**...*.\.*. *. .\ ... *.. .\  . . \.*.  * **\.* . \ . .\*...\\\ \ *..* .** \*.*    ..\....* *. #
# #.\.*\ ..*\.\*... *\.*\.. \ . * . . *.. ...\..  *.**...*\ .*\ **  .**.*\*\ * .\ *.*..... .. ..**. .*.. *  \**. . .*\.. \* ..  *..  * .*\   .  ..*.\  .**...*\ .... \*..\ *  #
##* .... * .**.. .. . ..*\ * *..  ***...*\   .\.*\...\ .**   .. .....*. .... * \ ...\.\*.. *. .*.*.***.* .  .*.\.*\..  ..\..\ *.\**..  .*** *** \*.\. . ..*.\..\... .**.\* ..*#
##. **.\. **.  ..*.*\*  .**\.*  .  \.*.\\  * * *..\   .... . \.**  . .....   .*. *.  \*.**\  **. .*.. ***. *.. .*\*.*..*.* *..\.*.**\ *..... .. ....  .\  . *  *  .***..*. **.#
# ###...  ..*..\ ...... \.\..**  \..**\*. .**. ***.  .*..*\ ..\\.\.. *.*. .\   * . \.... * * *.   .*.*.... . . *.*.\. **.\ ..\..*.\....****.*  ..\.*  **.\.. *\* .*..*\... \. #
#  #.  #**\* * .*  .. *\...  ..  .  *\.\\. .\ *\*.\ *.   *. *..*  * ..**.*\. *  \    ..* .* **.* .  *. *\ . *. . *  .*\\*..*  .*.*. \  *..**..\ \ \\ .**\ .*..*.   ....\  ..  #
#   # # *#\. ...* . * ..  .\\.\..* *\*.*.\.* *..*..\*.**\.*.*. . *  . \*..*\*\*.\.     \ *.\.. .\.. .* *...*\.  .****...\*\** *..  \    .* ..*\.. ..  ...\ . ** *.\.\.**... *\#
#    ##\..**\*. ..\.*..\..\ . .\.....\ ..  * .  .*.*.*.*. .***. *.\.\\... .*.*.\*** \.  \.\ \ .**.\ .. .. *.*. .*. *.**..*\*. * *. *\*  \.. .. ..\.. .*.   * ..\\.*\* ....\*\.#
#   #.*.*.\.   *\ .. .\ ... .**.\ . \.\*.\*\.*.  \**..... .*.\ .*.****.**.\* **.*\.*\  . \*. .*. .**\\* *.\ ****.\.*.*.*...\\ .\.*\*.*\* .\. .\*\. \.**. .***.*.* *.*.\..*.**.#
###############################################################################################################################################################################