#####################################################################################################################################################################################
#             # ## #*  * \\* .. . ***  **. * * .\ * ...\  ....  .. *\ . .   .  *..*.\. *. **. .\..\.\  \ ... . \*  .. *.. * *\..\.\ . ..   .   .. \ *.*.....*.    . .* . ...  *. .\ #
#            ##\#*#**# ..*\.*.\  .*\.. ...**  . .\.**...   * *.  .. *.    ..*\\...*..\   *\\..*.\\.**...* .  .... .   \. \.\..* .  .*.    *   .\. .*.\ *  *\*. **.  ...    *\*...**.#
#           #.* *....*  .. *..*.*.\*.   \ ..*..** *.\. \*   .\.*\* *.  \  * .*\.\...\*.**.\. \.\.\  \*\ **.\...\ ...*\.  .* \. \.   .. .*    \.. .. .\ \ \. *.* * *\* *****..  \..* #
#           #\# ** .*.*   .\.*.*.\ \**.*..* ** .*.*\ * ** *\.*.\.* . . .\... . ***\ .*.*.*.. * . .*....\*. . .**.  *...  *.\... \ *  .*\..\ *...*   *...\\*   \ . .** ..\.\*\. **..\#
#          # *.*...*. . .* . .**  .**...  \ .**\*.* ...\ *\* ...  . .\  .*.  * \..*. . ..*.\.. \ *. \   . .\.\*.*.*.\*\  *\. \ \..\\*... \\.*\  .***.\ \..... \.  ..\* *....* *. * *#
#         #.\. .**.. .# *.. *\..* \ *  .\...  **.*.**... \.\ .*\..* . * ..\* . .  * * \..**\.**... .. . .. *\ . *.. ....*..\ . .. .\.  * *\ ..* *.*. ...\.*..\.\     *.  ....*...***#
#         #.**\ .**   *..*.**\  . ... . .*. * *..\.*. \..... *..\..***\  *.*.*.* . \**.. \.. .. \. \* *   ....  .\* *\ \.. .\*\ \.* .**. * .**... .\   **.*..  **  \.\..  ** .\ \..*#
#        #.**   *..*  ** *. **....    *\..... . . ...\. \ \ ..  .  . ***\\***\** ...**\*  \\.\.*.* .\ *.**.\* ..*  *\.*  \ \...*.*..\**\.**......\*\ *....* * *\. *  .\..***  . . .*#
#        # .#\\.*.  ..\  **\ .  .** . **      *\ *\\*\..*  ....\*..\ .*.*\...*.. \ .*. .  ..  \ .*.**. ...  .\.\*.*.*...*.*. \*\ *....\ .   .  ****.*. *   ..*..  * \. *.*..  \ *\.*#
#         ##* \..\*\ .   .\ \    ...  .*  .*...*.\.*.. \*.*.\* *\ .\ *.\..\. *.  ** . *. ** \. *.*..\* * *   **....*  **.\..\ * \. **  . *.. ...**.*.  *\   \.  .\.\. ..\.*\ \...***#
#         ###* ..*...*...*.\.  .\ .\.\.*  .\ *.\**.*.\  * * .*...  .... * *\.\*. .. \......  *.*\*.\.. *** ***.. .*  *\ .*.\*.\  \.\** \ . .\ .  .*..\..\ .*..* *. .\.*\ *..*. *..**#
#        #\ .*\.**.*\.*. ...  . .\ .****\ .*.. .*...*...\** . * *...*.. ..**....*.\\  **.  .*\\**..*.  \...*...\. * *.....* .\   .\\..** . .  . ...*\.**  *.  *..   .\*.**.. .\. *..#
#   # ##  ###\...  ..  .\ .* ..\  ..\. .. ..*.*. .* .* * *.\* \\* . .\\..*\*..**.*.\.**..\ *\.* \***..   **\ *.. \*\*\.  ..\* . . *\ *\. ..\   ... ....\ .*   .**\ \*.**     **. . \#
# ## #\.###..*\ . . .. **. ...\ ..*.\ ..\ . .**\*..*\. *  *..* *.\. \*.\* ..*.\** \.*.* ..*..*.  .... .. \ .  ..\.*.. .*\ ***   \ . *. ..*.. *.*...\*.   ....* *. *...  *..**** \**.#
##**\# #\ * *\*.  **  ... .  \.**\.. . .*.\.\ **.. .  .* .\.**....   .**..\.\*.**.... .. *.****.. * \**. ...\**  .\..*\..  *.*.* ..\...*\. ..\ \.\ *\. *  * .\.\  ** \***\ .\.  . . #
# ##.  #*\.\...**....* * . .**\..* .. * ... \* **\.\. \.**.** *.*...* . ..*. .. * * .*. *.*..*. *\. ...\.**  .* . * * ***\ .* \.. \.*.*\....*  .***\.\ .\ . *\\ \..  *..** .*\.\*..\#
###*#. .* \  **#..  .*.. *  \...\.* \ ...\. ..\..*  *.. **.***\ .   \* ...* . .***. .... .. ...  ..*\ * *.. \.*.  *\ *\.**... ..  . .\ . \.*..\..\**..   *. *\.* ..  .* .. *.  **..*#
#*.*#.. ..\\*.\.\*.*\\ \ *.* \  .... *\ *\*\ * \..  ** .*\ **\    *...... * **  ***\.  \.\ *..\\*  ..**   \.. .. *...   .. *\.*\***...* ..\. * *... .  .* * .... \.  ..**\ .  \..*\.#
###*.**#.\#*. *....*.   *. .***.** .*.*.\ .**.\*. .\.. **.. .... ..**.  \  **.  . * **    *..\\ **....*\\..*...\.\ *\\ *\..\.....\\. *. ..\.***.*\ ..  **... \  ..  * \ * *\. .*.\ *#
# #\.\  .  . .*.. *.. ..\.  \......\.\* \.\** .**.  *  \*. ..\.  ** .* *. .\  .   . \* \ **.\. *\..\\ ..*.\.  * ..\.  *...  .  . ...\.\.*\  ..... .*. ...\ *..*. .** .**..... .*\ *\#
#  #.***.*#* ..* ..*\... * *  .\\ ****. * *\. ..\.  .\\....* .  \...*. \   *.. .*\. *.. ..*\**\**\ ***.. ..\     *. ..*.. .**\.*..  *  .*    *....*  .\   .  *..*\...*. ...\ \ . .  #
#   ####*# #\*.***\. .  . \ .** ...... \. * ..   \**.*.    . .    \ **\.* * .**\*  .*...\ \.*. *** . .*\.  .*  \ **. * .\ ****\....*. * ..\  *.   ..* *\.  *..\.... .   * .*  \\.*..#
#       # #**. ***\. \\.*    . **. ..\ .  .    *. ..*.*   .    .**\.* . * .*.*.*. . .*.\ **\.*  .*\. *.    *\.  **\  . . .\..*..** .\ .  ****.  \  * .\**\*. .***. *** .\  .. .**  .#
#          #*. .*    .. *.*..*\.* ..  .*.*.   .* .*.* *..*.*\*. ...\..*\.. . . *\ \   .**** ** \...\ ....*.* *\\..* .  . *. *\* *..* * \*..*.    *. . .\. * . \*  . .. *\    \..\..\#
#        ##**.*\  \ . *** \ .*. *...\.... ..* \**\.\.*\... .**\*.\ .**.  *...* . ....\*\.*. .. *.\. .\.*..* \.*\ ** .\   ..\*.*.* * .. .*.\\. *...  .**\   *\* \ *  \.\..  *.* \... #
#       #*#*  .*\... .*. \.. . *\*\ * .\ .  **\ ..  *** ..**.*.. ..\ .*.\*.*.\ .*  *  ..\.***.   . .   .\*. ** ....\..    ***\*.*  **\ .. *. ***.. ..*\.  .  \..\.  .*. .  .*. .\*. #
#      #\*.*..*.. \* ..\. .\...*.. *. .**  .... ....*\ .**. . * \   ..\..* *.  ..\*.***\*...\ ...  *\    . .\. .   **.*. *....* .*.*.  \ *.\. *. . .*.. .*\... \ **  * .\   . . . *\#
#      #.#*#*\#.*\. \..*. *** ..\ .. .*.\ ..\  .. .\\**..\  **. ... \..  .*.\..\..\ \..**. .*   *. .* **.\ ..    *.. .\. . . \   *\. * ..**. *.  \*.*..\*. \  .....\**\. * .\  *...*#
#       # # ##\ ...... . \*\.\ *. .\. .. .\*\*.*..      \.*.. . .**. .  . * \ ... ...  .  .\. . *\* .... *.* ***. .  ...*.\. .\.\\.*\.\**. \ .\.\.* *    *..  *\ .* .. . .  *. .*\.*#
#           #.*  *  .*\ . .*....  . .    .*    \*.  .. ..*.*. * .\.  *. *\.   . *  ..\. . ***..*****.\ * . ..\..*.*.*.\ *  *. ..*\ .* *... \ . . ..\....**. \ * *..** ..  ..* *..**.#
#       #   #*.*\..\*. * . . ..  **.*.\\*... *...***\*** \.  \.*** **.  .*\. * **\   *... *.* *..**   .*.*\ ..  .* *.  . . ..\ *  *...***\ . .\. .\.  \....\.* .\ ..* \...   *.**** #
#      # ###**.*.*    .* \*. . \**\  .  *.\R\*.\ **...\. . \  *.\. .. .\     ...**\* * . ..\  .. .*.   \*.*\  .*** *\ * ....  ..  ....*.\. . ...**. .\*  *.*\.. .\ .\..\ *   .*.. ..#
#     #**#. **\#.*  .    .\ .*  ...\ .\*.** *.  .*  .**.*.... .*  .   .\*.*\*\*... .. . .. **.\.. .*...\. .*\ ..**\  .\ .. ** .**\. ...  *\\*\.\.. . .\*.*.*  .   ** .*. ** . .*.*.\#
#      #** *..* . ..\ *.* .\ .. .*.**  ..\\ *.\.. *   .\ * *   ..*\ .**.*\..* ..*\      *  *\*** .\. . *   . \. . *. ..  . .\ .\.*.*.\  .\..*... * *\ .. .....\.. ...  \.*\\.. .\. .#
#     #*\\ . ..*. *..* ** .   . .\ .. .   .\.\. *  .  . ** *\***..*. **\.**...  *.\ .*. .\ . \*.\ *..\.. .*\....\**. \.   *  .* .. .....\..\*..  ..\  . *****\ *.\. .**....**\ .  . #
#      ###*.*#\ * * ...\.**.*\ **.   *. \.**. .. ..*. *..\ *.*.*.\. .**.**... \. \**\.   .  \\*  *\*\*.. \. . * \ * \.* .*.**.. *  .*\.*.** ****\  *.. .*\..** ..*\  ..*\ .*. .* .* #
#      #  * #*.  ..\.... *  . \*..**..*. ...\. .* **..* ..***... . *..*.\ . *\ *\ . . . . *......*\..\  ..* *.. .*. ..*. .\.  ..\   .*** *. \.* *.   .. .*..*. . **\.* *...\ *\ *\. #
#       ### #\*\*..** **..\.. .....  .... \ .* \. . \.. \  .....\*.....     . *.**.**. ** .  **\\.*  .\  ***.\.* . .*\.*.*. *    . ....\\ *.. *.\ *  *   .\  * ...*. ..*.** ***. \.*#
#        #.**#\.* .**.\  ..*..\.. \..*\*. .... ... .    .\..\ .\ \..\*..\...  ...* .. .*. ...*...**..*..*.*.. **  * **** * *..\..\*  \ . **. \........   *.*\*. \**..\**..****\  \..#
#         ###. .\* .*. \ \ **\.     *\..* * * **\*.   *. .*\.   .*   ..\ *\\.\.* . \.  .  *\ \.*  * \ *** \ .\.* **  *\.\.* .\ *....*.  * *\   .\*\ .*.\ ... ..\.**.\  .* *.\. . ..*#
#          #\** .. ** . . ....*  \* \. \.*..*.\.*\  *\.\. . .\.*.\  ..*  .*\\  *..... *. .*. ...  .. .*.*. .. .. .*  . \ .*. .\.*\ * . \*.**\*..*. . \..\ \ .... \ ..* .* . *\.**. .#
#          # #.* ..\. .**\...* *. *\.* ... .\  .\  \*. *.* \ ...* \ \  * .*. ..\.*.*\ ..\.. **.*.. \ .. .  .*.* . .** *.\.\.*.*..* \  ..*\\.**. **\..**. .. .    .\. .*\.\ *.  . \* #
#           ## *.\\....**..*\  **\**.*  **.. . ..* *\..\ *.*  ...\  .  .  .*\ \ . ..*  *..  \.*. ...\ ..*...* * .\  . *   ..\...*. .. \..*...** ..  \.*.     .  \  * *. \*.\\.  \*. #
#          #\ *.\*..*  *..\... *.*. **.*\.*.*  . . . .   ...* .**. \.  . . **. *... *. ..  *\ . . \.  *\.  *. .\ .. . \ \.*\ * **.  *\.*. ..\.  .  *\ .\..*.. .*\ .*.  \.\\. .**.* .#
#          #.\..**\ ..*  ..*\* .* ...\*.*\*... \ **  . ..\* *...  *.  *.. .\....* . ..*..*.. *.. .**.*. * ***\**. *\.***.\.*   .*\  **\.. *\.\  .  **\ * *.*.\.. .  ..*  .\ ..* .\* #
#          # *....    \ .*\. .* \  ..   **.. *...*  .\**\  .\ .  .\****\* ... .  .\..\.\ .*\ .. . *..\  ...*..*.. *.*.\. ***..  **\ * . * *.. **  *..  .*\.* .\.. \\ ..**  .\ *  . *#
#         #.*\ . . *  \.. ....*.*  .\  *.#*   . *..  .*.**  . ..* \..* ..* \..*     .\..*.\*  *..    . *.  **\\ . * .\  ..*.  .*.  ..  ..  . ..  \* \..    .*\. ..\ . \\.\ .*...*\**#
#         #\##. #.*. . .. *\  \.. . ...\..*** .... .\.\ *\ .  **.\.\.. \   ...* .*.**\  . *\ * .\ *....* \ .. *. .\   *.  .\*.*  ..\ **\.*  *\. \ . ** .*\*.  *\...*\*.   .   *.   *#
#          #L#\ * . ***\*.**\. *.*  *\..*...*  ..*. *\..* .\  *  *  ..* ** .*..*  ***. ..   .. *.*\\   .*.\*...*.** .* * *.* \*   \.* . .\ .\*. . .*..\ .. \  \.\. .\..   *.. .**\ .#
#          # \. .* .. ....\..*\.* ..*.\*\*  . .\.\..  .\*....\. ..  . .\**\.. \ .\... .    \ **.\..**\*. .*....**.* ..\** .\ .  \*. *..*** ...\    .**.*. *.*    .* **  *\*\*\ .\*. #
#           ##\. ..\*.  .*.  . .\ . *\*\...* *   ... \.\.\* .   \**.  **..\ \.\ * \ *  \.*.. .** .*.* **.\*.\. \.*     ...*.\.** *\ ** . . .\   .*...**** .*\*\ ****\ * *. .\* *.. .#
#           #.#\.. .   .*\* .\. *....*. ..*. .\.* .*\.   *\. *..**..  *.   ..*\ \\  ..\ .\ *.. . ...\ \.*\.* \ ..* .. .. *\...*...  .  .. \.**   *  .*\*...**..**. .... ... * ..\.. #
#           #.##\.. .\*  .\  . **..\ . *. .\  *\..    .*\.  ...\ .*\.....  .**...   *. *\....\ * .\  ..\* ..\ .. . \.**. **. \*   *. ..*  . ** ... *....  **... \ \.**. **. *  .***.#
#           #\*. *. * \  .... \.*.**..\..\ .\ *. * \ *.\ ****. .  \.\ *...  ..\* ..* . * .. **..**..    .\****. \*. \.*.*\  \.*..\*.. .* . ..*.   *. *\ .\....  * ..*\. *.**. .\.   #
#          ###*\.\*   .*..* \* **..\. *  ***** *\. ..*\......*..**.   *.*.\..\**.**..  .  *\.* ***.....\* \. ..*..  ... *  .\.*.* . .  . .*\.*   .\ .*....  \ *\. . **.*\*.* *  *.* #
#         #*.#.   **.\..#\. .\ *  \ *. .....\* *..\ .. \. .*\*. \ .  **..\.  ..   .*.. . ..*\.\.\..\*\ *. .* . *. .*** ..*..\...\...* \  .. . . ***. .... \  ***    .... . * . \**. #
#         #.*..\.\ ..*# *  . ......\*   . \ . .**.*\*. . .*.*\ . *.  *.\\...* .\* *** *..*  *\. \ .*.*.\ \ ** *. ......  . .*.\ \.\.\.*. * \* *.. ..\* ..  .\*..\    .\.* ... . ..*.#
#          ## \  #.#\. ..\*.*..*..\. ..* *.*.  **.\ *... *. * . .**....**..   \ \..*\  \ *.*...\. .. *....* . ....\  .* *\.. .. \.*...\**.\ * .*\ **..*.\*.. .\ .  .\.. ...**..*\...#
#           #\  .## #*.. . . \ \.**    \.*..  .**\ *\.\  \*\. .****..**\  ** *.. .  . ..*.**\ .* .\..\.*\.\ .. \* *.*.. \.*  .  ..**\ * .*.***  ..*.. .  \****.\.    . .\** \*   .. #
#            ####   #\*\ ...* *. .\\****...  *.**...*...*.*.....  *\.* *. .. .**.  .*.\ **\**..*. .. .  **.. *\*.\ .*.*..*.  *\  ... .. .*\*\.\  \  **..*.**.\    ..\.*\*.  .. *.*.\#
#                   #*...  *.\.**\.**. .*..* \....*.\.\**.\*\..*\****\..*    ..*. .*.  ..  .\  .  **\ . **. .. .*.\ .*  \. .**..***\**.\. . **..*..*.\  . .**  \ *  .....  * . ...*.#
#                 ##\..*\\*.  .. . .    . . ..*.**..* *.\.....\...*.*.\\. *...* *. * ****.  .*\. ..* \* *..\ .. .. . .*\ . *\.\\.*  * **..*......*..*  .*  .\*.. . . . .* *..***..*.#
#                #.**..\.#.*  . *.* *.\.. **  *.... ..**  ...** ..\... .. .*..  \* * \.**. * .. .. .\ ..* .  *.  ..*. .*. ...*\*  * ..*.  .*.**.**\.*..\  . .*\.* ..*   .    .*..\*.#
#                # *# \.. *\\ *** \..\*.\ ..* ....*. .\*   \.\*. *. *.\.  *.*\...\.  . .* *. .\..   .. .*.\* ..*.. .*..* . *  **\.*. *.*. ..\..* **.* \.. ** *.**. ..*\   .** .*... #
#                 ###..   .* .  . . .* .\\*.*..*     . .* ..*...\..\.**.\..*.     . *....\*.**..*...*** .\ .. . .*.....*\ \***...\.* ... \ **..* *. . . . ***. ..** * *.   *. \*.\\*#
#                  # **\. .\ .**.\*..*. .   ...* ..  ** .*\  .\..* ..*.   . *\.** \.* .. *.... .\.\ ..\ \...\*\* *.\ **.. .. .\. .\*.. *. **. .. \ **..\.  *..   ..*. \.\ \***.*....#
#                  #.#\*#  ..\.*\ \ .*.*\.\ .** *\....* ....\.**\*\.\**\* **\* ** \ ** . **\ ****\*.\...\. . .*\ . . ..\.\.\ *. ** . * . .** .*\*. \***.* *\ .\..\...\*..  **\**.*..#
#                 #  ... *.*.  . .\. *.\* .. *.. . *. . .*\  * \ \ \. . ...\ *.\...***.  \. .\. .   . .**\ . ..**.\    .*. .\. \.*.  *.. .*.  **. * **.**.   \ ** .  .. \....*\*. . #
#                 #.#**..\ .* \*\  . * * . \ ....\ ... *.  *\*   ..\  .. . ..**.*  .. *  .*.\..  **\  .*... .* ..*.. **. . *  \.** ..  *  *.\.. *..*.*.*  *. .\*.  ..*\..  *.. .* *.#
#                  #\**. *\ **.*   .*\  .. .  . *.* \\...* .*. *  .*\ * .\ . *. *.*. \*****\ ..  ... * ***.. * *  * ...   **..* *...**..* *...*.. ... .. .. .   * ** *.   **  *   .*#
#                   #.*\ *  ..*.   *. *.*..\*.**. *\. * **\..  . **.**.\  .  .. *... . *. \**\\.*.   . ..\ .\.\*.\  *.  * *..\..*\.  *..\.... \*  .. ..\   * .\*\.*\ *. ..*..**.*.**#
#                  #**\#..*. **.***. *****.  *.. . .*.*..* \ . \.*.\*\ *****  . .***. ..\ .\. \* .*\.       ..**\*\ .*. .\.*.  .*. *** . .   \.. \... . *.... **..\*..*..\.\  . *\..#
#                   #***  .*... *..*  .*.. ... . .  .*.\ \.*.\*\.**\...  **\. .. *.*\.. .\ ..*.\ .. *  \\ . ...* \ *..*.....*\ * .\**\ .\   \ \.  .*. * .  **.\.***.\ *.\ ..   .   *#
#                  #*#*\*..  .* .. .\ ....*.... **.  .*... *\.****. . *.*.** \ .*. .. . *.* *.***...*\ ..\\..\.*.. *\ **.* .*. .*  .\.** **. ..  * ..    *.\. *... \**.**.*** .** ..#
#                  #\*.*. *\. . ..*... \. .\    .*\.\ .... .\ ***.\ **.....***  .* \. \ .** *\*.*..\..* \..\... .\.* ..  *\..\. . .. .  ...\.\.*\***  . ....  * \\..*.*..\***  *\ * #
#                  #.##*# \.. *   .*.  ..*\..***  .*\ *   . .....*. . .*\ .\.. * . .  . **. . *.. ........\.*.  *  .*. \ ...\ . \  *.**\  .*.*.* \..\.\* **. *.. .*\..\***..*\** *. #
#                   #  ##.. \**..* .** .**.\ . *  ..  *.. * . \ *. \ * *.*\.* *. .\  .  .\  . . . *..\.**.*.*. .* . * .   \ .*\*\** . *. ...\ \....* *\*\...*.\ . . . .**..*  \*.*  #
#                       #. ..\*\.*.*.*  \.\*.  * .* ..*   *.  ..*\ . .*. .  *.*   * \... .. .. \* .. * *. *\\ . .*.*\**\\ ..*.** ..** *\. **. .. *.*. .* \*  .*. . ..  * *\\. ..\*.\#
#                      ## *.***... .... . . . .\\*  .\\ .*.*.*** .\*  .\.. * *.  .\**\\.\.*\.  \. \*.. * ...** * ... *** *  .\...\ . *..\.*.**  *..\ . .\.*\* .\*..\. *.....* \ *...#
#                     #.. ..*.* . ***.... *   . \. *....  .* .*.    .\.. .\ .\.*. ..*  ..*\.....*..  .\ ... *.    .. **\..  *.. *.*.*..    *\. *... .  **\  .\**. \ ..*\* . .  .. *.#
#                    #.*  # . .**\....\*. .*..* .*.\*.\\..**  **\* .\.**\  * ..     .\.  *..** . .  ......* .*.\.\    .*\ *\. *.... **\*.  .  .\*.\ ...**    *...\. * . \ . ... *\*\#
#                     #* *# . ..*.*    .*  ..*\...*.. *.\..*.  *\. .****..*. ... .\.\   **... ****. .\ *...*...* . *.. ....*..*\.*\.\ *\*..\  *** .* ..*. .\ .*.\..*\**\..*. .**\.\.#
#                      #  #  . .*.\.... *.   . \  ...  . **..\ ..* .***. .... \.\. *\* .\. \ \.*.\. *.\**.*\.* \.\..***  .\.  .*\*.   . \\. ..  . *..\. . \.. ..  \** . .....*.* . *#
#                      #\.* *\.\ *. . *.**\..* **. .* .\ ..\ .. \*\..*..\  .\  \. .  . * \..*.*\* .\...\.*\.**... .*....* ** **\..  .* .. *.  ** \. .. \*.   ... . **. \  **..*..\ .#
#                      ###  ..***......\.  . \*.   .*  *\ \\**....* **.\.*\.**\    \.\ ..\*\*.. * *..  \** .*.**\.\  \.\. . ... *.** . *....  .. . *.\. .... ** \  \. *.. . * .*  . #
#                     #. .\****\.\ * .\ . *.. ..   .. *..   .  * *..\ . .. .. ***  .\**\.* .. . ** *  *......\*..   *.* *.. * . ..** ...   *.*...  .\.*..\\.*..*. ..  *.  ...\\.****#
#                    # #\  .*.*.  *.. .. ..* *..* ..*. *\  .. ..\*.   *.**.. \. \\   .\..*   *.*\..* ...* .   .\ .*\ *\ .**....  . *. .    ...\.*.*.     *. *.\..\ \.**.*  .. ..*\\ #
#                    #  ** \...*.*\*.\   *... .\*\*\* .*   ** \ .\. *.. *\  ***... * . .\\.*\....**.\. *. \\.\. .**..*.\. ..  . .* .. *\.    \.***. .\  .\.. **\ **...*.\*. . *. ...#
#                   #**.## ..*\....*. *.\..**.   *. *  \***..\  \. .\ . ... *\*  *..**. .... **.*\*... . \**..  . * \*.. *.. ***.\*.* .*.  \..\\.*.   ..*.   ***\.**..**\.\*. * . ..#
#                   ##**##\\ ..  .*.  \..\.. * \ . \. .....*..  . .\ .*.. \..*** \\ .* \*\..*..*\..*.\\ *. ...\*  .\.... . . ..\. *\\  .*.....   ** \*.\.. .\.*.\* .  ..\  .* *..  .#
#                  #..**  .. \*\.\..\   * \*.* * *\. .  \. *. *. .. * . *\  \ .* .*..**....\.   .\ ..***\ . .\*.* . ..... * *....*..\ .  \\*\  .*.*. ...*\. . .* ..*.\*  \  * **.\..#
#                   # #\ .\# # . **  *** ....* \.*.* \*.. . \... .\..  ..* \ . . ..\ ... \ .\ *.   **.** *  ..... . * *.. .\.*.*.. .*.  *.\*..\. .*..*\ .* . **   *.. .***.*.\*. .* #
#                   #.\...#*. .*.\. .\*.* .. ..  * . ..*\. . .\*  *  .\  \.*.   . .* *. ...   **\ ....\ .. \*....*. .\* \  \*. . .. .\  .\*.*.*  *. ..*..\ *.\.  *.* .\*..**  \  .* #
#                    ###\*\# \..\..  \.* .\*   .*. ..*.  .   ..****.*..\.\**.. . ....\*..\. ..*...*.  ***. \.* ...\. .. .\  ..  . .*\.. * ......**\ .\..  *  \.*   ..*  \..\\ ** *.\#
#                       ### # \#.**#.. *.* *\ \ *  .. .. .\****\...\......... ..\*\.*.\ ..*\.\.*. . \*..*  .**  \*.*.\.   ** ...*. .*  ......   *. **.  .\.*.*..*\...\ \.... \..\.  #
#                            ###\.\* *..\**..  \* *\\*  \*. ...** * \ .\* ..*.\.** . \** *.* *\..\**.*\ .\ *..*.**\*\*  * *\..\. .  .*\\*.* .. \  *.\ .*\..*\******   .****.*.  * \*#
#####################################################################################################################################################################################