#################################
#                  #.# #####    #
#                 ##\.#**  .# # #
#     ##         # . \####.  #.##
#    #**#       ## #.## #*#..#\*#
#   ##*#       #.**#   #.*.\ #*.#
#  # .. ##    #..#.\.\...*#  ..*#
#   ##\##*#  ##.##\ .*\    .  **#
#   # .\  ### #\.*#..   *. *  ..#
#    # #*#  #\  ***** \#* *\** \#
# ## #\..***\ ..*.***. *.\. .  ##
## *L#.*. \.  ...*.*.\*  \  * .*#
##*. \.  ... . \**.*\.....\** ..#
##*.  ..*#\\ \....  *...*.. *. *#
##\. # . ...*\.\. **\.*\... \  *#
#.*.*..*  .** .**\*\*.*.* *.. \.#
#*#*.\  *  .  .... *....  ..    #
#. \..*.* * .. .. .....\*.. .   #
#.\ **. *.   *  *. \. .*. \.* .*#
#. ..*..* . *.  .*  * .. ..*.. .#
#.\*\.  .\  .* .\.*.*\ .* ....  #
#  \ . ...*. ...*.*.\\ *. \.\...#
#   .\..  .\ ..\.\. *.** \ ..**\#
#.*\ *. *.. \.....*  .*\  ..*.**#
# .*.\* ...\ .* \...* .    *.*..#
#*\...\. *.  \.\  \.* * .\.. *\.#
#* .*.. ..* ..\* \ .*..  .. *.  #
#.  \ *.* ..* ..  * .. . *. .\..#
#..* ..**.  *\ \ *\ ..** \..**\ #
#..*. *. *. .. . . * .  .*.  ...#
#\ . .. \*.*\.\ \*  **.**\...\\ #
#.  *  \.* . .. ** . *\.\ ** \.*#
#.. . . *...*  .\ **.* \. ..\.\.#
#*. .\. . .  *.. *.. .\ . *.* *.#
#.*.\*.. .*.*.*  .*\ .... \ .  *#
#..  . *\.\.* ... .****\  .. **.#
# *\*  .. .*\ .. \ *.\.   *\..\ #
#\***** *. \     .\.   *..**\  *#
#*... ...  ... *.**.\. *.\ \*\**#
#...\ .*. .  .*\.\.. \ .*  . .. #
#\.. * *.\\ . * \..\**\\* ..   \#
#.*\....* *\*.*. ...*.. .\. ..*.#
#*.*  .\... \* *\ \. . .\  \ \..#
#*.*\  \***. .  **.\*.*.*. .* \*#
# ... .*..\**.*..* .*....*  *\..#
#*.*.* .** ..  * *. *\. \..*....#
#**. ..\   .\.\*** \*\.  ...*. *#
#...    *\* **.\*..... ..*. ..*.#
#  \.\.\. * . .*. *\**.   \.  **#
# .  **...\.. .\ *.* **. **\  \ #
#.\**..\ \* ....\\ . . .* ..\  .#
#. .. \.*..\..\  ... *.   .\. *.#
#   .*. ..  **.*\ \  **.. .*.*.*#
# ..\ \.\\  \..*.*.\**.*\**\\ ..#
#. \. .\.. ...\.\*** * .. *. ...#
#..****  \* ...**. *.*  ..*\ . .#
#. *... **. * *.\*.\.  * *.. ...#
# .*.*\ **\ \ ..**\.* ..\***.  \#
#.. *.....  .. *.*.   \ *....\  #
# .*. *   ..*\**...** .** \* . .#
#\ **\*... .*... *\..\     . ..*#
#. .\ *\ .   . ***..\  * \ ...\*#
#  .. ... ... *  .*..\ *  \ .\*.#
#.   .    .\  \ .*.*   *...   ..#
#*   *.\  \*.*.....\   *. .\.*.\#
# **.\    . *.\. .*. .\.*  *.\. #
#.. ..*.* .**. **.\*. .**...\.\ #
# . *  *.. .\. ..* .   .\..\..* #
#.  **.*.\.    .    . . .. *  .*#
#. . . \**  . ..*  **.*..\.**\..#
#\ *.*..*\ ..\..** *..*** \ *..*#
# .\.*.\ *.. **..  *...** ... \*#
#. .... .***.\.**. *  *.... \ **#
#\  *  * *\.* ..** . ...\*.. .\ #
#  \\  \\....** .\ ** .\ .*.  * #
#. . \ *.**\\.. ...*\ ...** \\. #
#.  \... . .**.  \*\  **.\...*  #
#*.****....* **\ . ..\*.*  .\.*.#
#\ \..\ ***.*.. . * *..***.\*.**#
#...  **\. *.  .*.  \* *\*. *.. #
# \ * .. * *   *. .... *.*....\*#
# *... \*  .  ...\*.*. \.\ \*.\ #
#. .\  ..*  ..\.   ..     * .*. #
#\* ....\*.   .\*. . *.* *\\...\#
# *   ** ...* .\*..   *.. .\\.  #
#*. .*.. .. *.**....* \.*  .. . #
#** .*.*\  .*..* *\.. .*. * ***.#
#\* **.\.   .*.*\. **\*\*.* ****#
#*.  .*.....\...  *.. ....* ....#
#\... ..**  * \*..*\*.\*. ....\ #
# *\\. *..**.* * *.\.**. *  .\ *#
# \..*\ *.*..\ .\.* .... .**\ .*#
# .**... ..\*. .\.. ** ..  *.. .#
#  ..*. ...**.* ..\ *\  *   *..*#
#. * * .*\...*\... \*..*.\ **. .#
#..\\.. \.\* .  .. ..*\**.  .* \#
#* *\  \....   .**. .\** \\..\..#
#.\*.....**\. .**\  . .  .*.*..\#
#  .  ...*\*\ **.    *. *\..* ..#
# ..  ..*.*  ..*. . ..*.  . \  *#
#.   **.. \   * \ *.*  ... . * .#
#*  ...\. .*  \. \**.**.. ..*   #
#\* *** . ***\ \..**  .*.**.*  *#
#\. .... \.\  *.  *.\.\.*\..* .*#
#*.    ...*..*..** *  . ..*\..\.#
#* *.. . \. *.. ...\ ...*.\  .*.#
#*. ..*.* *\.*. .**.**\ **.   *.#
#*\   . .*\ .**  ..\*.. *** *\.*#
# *  *\.*  \*\..\* .   ..\   \\*#
#*. *. .\. .*.*\ * *.*.**\..\. .#
#\..*.*. **.* .* ...\*\. **.\..*#
#*.\. .  .\*.. . *.**. \.\. .* *#
#. .  .* \...\...* ... ..*. .\ .#
#.***  . . ****  . ..\..***   ..#
#.* .  \ **.\.*  .\. *.\.\.\ .* #
#   . \.. ..* .  * .   *. *..  .#
# .*.*  . . .  ...   .*. *..    #
#* . .* . .\*   *.  ** *\..\ .\ #
#. ..      *\   *\. *.   . .*  *#
#\*.\ . *      *.*. .*.\ *. ....#
#*\\... *  *  .*..*.. *.\..*..* #
#..* * .*\ .. *.  . \*.* * *. . #
# \.\.* * . \*.*..*.....*\ .*   #
#.. * \...\ .*.** .  \ ...  ..* #
#*.\....*. . \**.  . .* *.**... #
#\...***.\.\ *\.\ .\ *\.*..\*...#
# *  .** \ *.* . \  . *.... .. \#
#*\\.*.  **.....*.   \.** \.. . #
#*...*   *.*  *. .  . *.* .* .\.#
#.*  . .\.*...* . .. \.* .\*.\..#
#..** \ *..    .\. *..*\..\*.  .#
#..*\\  *. \    .**.\...\ * *\  #
# .*  .****\*.  ...   * . *\.. *#
#.* *...\.\. \* . *.*.*.... .  *#
# . *.  .\*.. ...\. ...** **   .#
#.* .    .. *..\     *. . .*\..*#
#.\..\ . .*\.\..*.* .\* *.\*...*#
#   ..*  \.*** .*  *\*\ .*..*.\*#
# .**.\*.* ...* .* ..\.\........#
#\ ...*\ * *..* * .     ..**\.. #
#..   .. *..\  ..\*\*\ \  .\ \ .#
#... **. \**  *  ..*.  **  ... .#
#.  .*..*.*. .\...**.*.\.. *. *.#
#. *\   .\.\ *.*.* . * .\* .\..\#
#.**... \. . ..* \   .  *.\ *   #
#..*.** ..*\. .  .*.\\ ..* .... #
#.*\ ..* \  *. ..\*....  *.   . #
#....* ...  ..   .*.** **. **   #
#*\.*.\.*\**\..*. . *.....*.**  #
# ... .*\.\*.**  R ..***\.. *...#
#.*\.* .**\..*\.  \. \.\ *. *..*#
#.. .*.\**\ .\.  ..*  *\.\.*..*\#
# \. .  .*. *..*.*\..*\...*\  *.#
#\   .. **. **..\.*\.\... . * ..#
# \. .  . .\* *..\..\.. .*.*.*.*#
#. \..\ . *..***\. *.*.\ . * .**#
#  \..\  . . ...*...\ * *  *\.**#
# . *.. *   *** *.  \*..  .* ...#
#\  ..\....*\...  *\.*.. .** \. #
# . .  \. .*.\.*\.\ ...\* *.*. *#
#*  *    *..\* .  * . * .\ *****#
#. .*. \ \ **.   \*\**.*.... *.\#
#...*\ .*\... .\\.**\. **. . \..#
#** .. \\*  \.*\.*..** .\. \..\ #
#..*. .\ .*.*.\*...*.\. *...* ..#
#.   \ . \*\.***.. .*.*.\ .  .*.#
#.\ **... ..* *  ..  ...  .. .*.#
#...*. * \ ***\ .. . .*.  *\ .. #
# *....* ..*.  .... .\ *. .. .. #
#*\..* .*..\.*\*  . **..*..\*...#
#  \ .. .*.. . . .*****\...*.  \#
#  .* \. .*  ** ...*...   ... \*#
# .. *.\  *...*.\*\.\.  *. .    #
#\.\.*  * .\ *.**\ \....\. .**..#
#.   ..*. . ..\.   . ..... .*...#
#..\* ***.\.*\.**\*\.\ .*   . *.#
#\.. \*.\ . . .\..*. ..*\....*..#
#..\    .\.*.*.**...\ .*.\  \.\.#
#..\.* *\ ..\. . \ .. *. *** *\\#
#\  .. . *.\**. * . * .  * .\. *#
#. *  *..*. .*.\ ..\*. .\* ** .*#
# ** *..*.*.*.. * . ..*\..\.*\.\#
#\. ...*.. *.\  . . .\ .\*. ... #
#.  ..*.**.*..** \\ . * .*  \  .#
#.. * ..\.\ **.\ .*   . *  .\.**#
#.\ *.**.\.*.*. . *\ *\*.  **  .#
#\  . .* .***.  . . \. * .*\. **#
# *..*.*..\ .**.*..\.. .\ ...\ .#
#\. ****...  .*..*\. .\  .  .\.*#
#  *. ..***\* *.\.  *\ *\  \.* .#
#.*.  ...\  ........\\ *.. . *. #
#..  .\.\ ....* *.***.*. . ... *#
#\ \ *.**.   *. ..\*..\*.     *.#
#***. \.*\\\*..  *  .  **\    \\#
#\*.. *\ * *...*.\\. .** ..* .. #
#################################