###################
#*#     #         #
#.*#   #.#        #
# #  L##\.#       #
#\###  \.#        #
#\**# \#\#        #
# .\ *.\# # #     #
#*. #\.*## #*##   #
#..#*..\...\* .#  #
#*  \  .  .*. ##  #
#*\ . *..  .  #\# #
#* ** #\*.\*\ *.###
#..*....*\.   \.#.#
#\.   ..*....\. **#
#  .  * .*.\.*** .#
# ..*..*.   \\..* #
#\ \ * \  *   .\. #
#. . *. ...   \**\#
#\. \  .\ **\.... #
#.. . * * *...\**.#
#.\... .\.\*. .\.*#
#* * .   .***.\  \#
#*.** **\\.*. **.*#
#\ .....  *.  .\. #
# \*.. .  .\ **  *#
#**.**. **  ... ..#
#.\.. *..* .*\\.\.#
# . .*.*.\ ..**.. #
#* \ . *.  \.*.**.#
#...  *.*\* \.***.#
# \ .\\*...\** ...#
#\.*.. .\ . *..*\ #
# . * .\******..*\#
#\  . ....*.*\*.**#
#. .  \** ...*\ **#
#.\ **.*.. .  . .*#
#.  ..* *.\*..  .\#
#  ***...  .\ ...*#
#  .\. ** .**  \.*#
#..* * *\.. ..\* .#
#*\**.  .*..* . ..#
#\\.  .. \  .   **#
#..  .* \..* *\.**#
#  *\** . ..\.* *.#
#  . \. **  . . ..#
#\ . .** .\* .  .*#
#.   \ *. *.  \ *.#
#*..  ..\.\ \* .*\#
#.\*.\.*.*\*......#
#.*... . . .* \. .#
#\. * . .*  .\...*#
#*    \. \ *.* .. #
#. .\*\.*..* .\.  #
#  . ...* ..*. ...#
# \*\ *\****.\.*  #
#\... *...*. ....\#
#**\* *  .*.\ . \ #
#*.  *  .\.*   ..\#
#* \.***.*...\ .*.#
#*....**..**  \*..#
#   .*...* . .*.\*#
# \.\*.. **..**  *#
# ..* *   . **.**\#
#.. ..\.\*  *.*.\ #
# .* .   * .**.***#
#\.*  . . *.*. .\.#
# *.  \ * .*\.. . #
#\...\ ... .*\   .#
# .\.*    *\  * **#
#\.... *.*.. .\..\#
#**\.\*\\*.* \.** #
#\\..*..*\ **. ..\#
#   ..\.*.  .\.\*.#
#* . \...*..\. ** #
#.  \. .\***.. ..*#
#\ .  **\.\.*...  #
#   . .\...*\ \  .#
#.\*.....*..**.**\#
# *..\.*.*.\......#
#.*.*....*... . **#
#*....* \. *.\ ..\#
#* *. * .*\.* \. *#
#. .* . * ***..\ *#
# * ****\ \** .*.\#
# ..\*.. .*\. \  .#
# ** .\\.*\ . .\  #
# . \ *. .. .\ . *#
# .*.  . *..  \* *#
#* .... ..*\. .**.#
#\  \. .* .* .\.*\#
#. ****.*...\  .**#
#.*.*\. ... .  \*.#
#\ *\.* .\.  .*..\#
#\.  *..\ *\*.. .*#
#. *.. * ....\. *\#
#*.\ *\*\     .*..#
#\..** . .*\*\*.. #
#*\ .*.. .. .\*** #
#..*     .*.   . *#
#*.   **  *. \.*\.#
#*.\*. ..*. \. ...#
#\  .*\ . \ ..*** #
#.   . \.*.\**..  #
#*. .*\. . .. .*  #
#.... **\ . .\..*.#
# .*. ....\*** *..#
#.\.\* *.\.** .\ .#
#..   *.\ **..* *.#
#*.*..   .. ... **#
#*.*.* .  \.    ..#
#.\...*.*\...R*. .#
#..*\  . *. . \** #
#. . . *\\ ... \.\#
# . . ***  *..\ *.#
# .\ *.*.....*..*\#
#\\.\....\\  ....\#
#.\**  .\ .*. \*. #
###################