######################################################################################################################################################################################
# .\*. .*... . \.*..**.   . .\* . **...   ... .**\* ... *** \**.   ..* **...... ...**. *\...\.*.**. .\ .\.*  \   **. *.*\ **\. \....*... .*.  ..*  .\.\* *.* **.\.****.\*. \#.#      #
# ...\     *...***  .\ .*\.** .  *\.\*  *... . *...\\  * \. ..*..*... ...  *   .** .*\ ***    .*.*\  .. \**\.  \* \. . ..\ .\. .*..***..**\**. . .\....*..\.*...  \... ...** \#      #
#*.   . . *. \ .  . *.. **..**\. .\. *. * . \  **  *.  ...  * **...* *\  . .   *** *. .. ... \\*\.*.\** .\.* .*.*  .*.   *.. \ *.*.**.. .* \...* . \ *.*\.* ...*  ... .. *\.\..#     #
#. ..\\* **.*.  *\*. *. *\*... .*..\..*.. **. .*...\ .*    **.\*.. \**** * .*....* .. .  **  .    *\..*..**.**..* **\*\.*... . **.... .. \ *\\\.**.. .*.*\.   **  ... *.* .\ *\#     #
# *.. .*.... \.\.*.\ ..*.\.  *.*.\..\..\.\..\  .*  *.***....\*\. ...\*.\.. ....* . *  . .*\.   ** .  .*. ...*...\  .\ *\. .  ...*. *.* *...\.. ...*  .\*****\ ..\.\*. *.\ \#*## ##   #
#\ ***..\ *.*... .. ..*.. .\\..\*.*.\ ..\ **.. ..\ . .*.\**\*. *\**\*....\  *... ..*.. . ..*..****. . \  \.** \.** ** .. .  .\....\...*.*  ..\ * \. ...*.* .... **.. *.\  . .###.*#  #
# *\ *  \ .*. .** \.. * *.\ .** **..*...**.\ .*.* .\.... .  \\ . . .* *  ..\ \..* .\*...*\ .\ *..*. \*....*.*\ *.. ....* *    .\\.**. . ...*\*. . *\* * .  **\** .\. .  ..*\  \.  #  #
# \. ......*\. .   *   .*\.\.**.\...*  . \*.*.. \ *   ...*\. ......\.\...\.* ....\. *...* .  .*. ..  .   .\*    .**\  *. . ... \.\** .* * ***  **.*   .. .*.*\..*.*  \ *  . ....\##  #
#..*. .*\.*....*..**   .\. * ..*... .   .. \.*..**   * **.*  . . .\. . **..   * **...*    . . . . ..* .. . \. .*.\.* ....\*. \.*\.*.* . **\**  *.*.. ***.. .   ***. \\\* .\....**.*# #
#*  *.*  .**\ *. *** \. \\.  *.* .* *\. *... .. ...**.*. *.  \.** .**  .\. . ..*.. * .* .*.\. \*\  \..*.. . . .*\... \**.*.\.*\*  ...*. **..\. ....\* ... \* . **.* \....\.\\.\  *#  #
#. \.\*\.* ....**..... . .** *\*...\.. **. *.\*  *...    . . .**.. ...  . .*. .*.  **\. .****  .*.  ..\   ...*\  \..*..\ . . .*\ \...*..* .      . .*.   . ...  . . . .  * *.  .#*#  #
#\*.\ . * ..\.\...\   .* *.*\**.\.\\..*\   . .\.***.   **...* \....  ** \.     .* *. *.. .***.\*\. *\ \ **.\.. . ..    **. \ ..* .\\.* .*   * ..**    .\..*** **. \.\ \.*.\*\.# \#   #
# .. .. *.\*  \\. .*. ..\   .** *...\*.   . ..\. *** ..* .. *\. .  ** * \... **.\.**.  \.  .*..*. .** .  .. .*  . \  * .\* .* .\ \. .\ *. .\. . ..\..*...*.*\  ...... . * .***.** #  #
# *.  * . .* ..**  *  \\*. .\**..*\...   * ** *..**\   *\   ......*.\ . ..  * .. ... . .... **\. ** .**\  \ \.\ *.*....*.  *\**.*\.**.***\ *\**.**  ..\*..\.  .\**. ...  **.. \##*#  #
# ..\ . .* .**.... *** ..  .*.. .\*. .....  .\. ...* \**. . *\ .\.*\.*  *\ \**. \ *  ..\..***.*  *\ \.\..  *.*\.  *\ *\...\....*.*... .\**..**. *  * \ ....*. \ * .* .. **... .***####
#. .***\... .\.. \*.\. . ***. .*. . .*  .*.  ...*\ . * .*.....**. . *. ...*.... ..*. .\.   *.. .\ \    *... * **.\*. . \.\  ..*\..\.\  .... ..* \\ . \.   *. .*\*.**.\  *. *.\...*\.\#
# . ..\ \*\*.*..\..*. \.\R*..\.* *\  .  *.  *  . . . . *.\... .* \  .\ . *\.\**. \ *.\*\ * .*.. ..* *.* .\ *.\.* .*.\  .* .*. .* ** ..*.\.  \** ..  **.\**. .. ...**    .* *\*. #\####
#..\...\ ***  .\*. .**  *.*.** . ...*...\  \\..*..*   ** *  .  *\. .\..  *....*.  .*.\*..  \*\*  ..\* . \  * \ . * .   *. *.\*\* \.** .\ *\... *... ...*..**\*. .*.\. . \.#..\  .* # #
#*. *  *\.** .**.*\..\ ..*  \ .\*\ *. .  \ *. *...**\* *.\\. ..\..   *..\. . \* \*\.  .. *. . .  .\.\... .**  ..  *.* .* *\....*..*\..  .. *   .*** \. .*\..\. ...*..  *.*.  #  ##\# #
#  \.*. ... \\ \*\* \. .\   . \ ..***\.\..*.. ..*\***.\. *.**.... *  .\ * ..**. .\ \ . . \. .  ..**\ .\*  \ . \  ..*. \. ..*\ ...  .. . \**.* . . * .*... * *\.*..\  \*\. \..#**# #  #
#\.. \. .\\ ..  ... .\. .\.   ..  *\**..*..... .  .. \  \*.*.**\. *..\... . ..\...*  \.*\  \...  .\ \ *. ..   .. \\. * .. .....*   .\.. .\.*\. .* .....\..\*. . . *.\.*.. #.*\##     #
#.   ..  .. \* *.\*\*. *    .**\..\**.*.. *\   . *. .   . *.\ .\.....*..*\.*. ..  ..  ****\ *...  ...*\.    \.. *.*   * *\*\.. ...*. .\  \\. *. ... **.  .... *\ .. ....\*#**#       #
#..\.**.. \*\..*\**.*..\ ..* ..*.. ..**. ... * . ..  *.*\ .  .\.\. *.. *...**.*.* .. *\..*..* \..   **  \... .\.*.\ * *.\ .\*  . .\\ *  . .**.**. .\...*. ..\..*..**.#*..*###        #
#  ..*\..\*  ..\  .*. *** \.*.\.. .  .**.**.*. *.* * .\  *  *.* . *.*. .*\.*. . .\\**\.*** .  *..*. ...*....  .\.\.*\.* \ *..   *.* .*.\  .*  .\... *\*  .*\*  .*.**.\*\*.. #        #
#.*  *.** ..* \.  .*  ..*.  .\ \ **  *. . \.. ...**.\.. ...\.**  *\..*  ....*\.\*. .***.*.. **** .\ ...*...*. . *.*.*.* .\.*\* ..\. \..*. ..\* .* ....** *\.  * #... *..   \#        #
#..**.*.\  ..*  ..\.*. *..    .\.***.*\.. ..* .\..****.*   . *\  .** . . .*   \*.***.** \  .\* * .*  *\*.* .\. \* *.. \.. *. *\ \ . .\ .. . *.\  ..\.*.*\..* ** \  . *..  *#         #
#.\ .*..*\* ..\ .  ..*.. ..*..   . *.\    *.    .*..**\.\ **... *. *\** \*\ ...*  .  ** ..\.. *   *\ * *.\\ *  **  \ *.\. .*.  *.*** ...*. . \...**....\ .** .*. *\   ..* ..#        #
# .**...**. ..* .*\* * ... **\.**\ \**\.  .   . **  \..* ***..**..\* ..*....*  .\* * .\.*. .  .\* ** .  \.. . ...\\   ... \*.\\ ..\.\\. \*\   .  \.***\. ... .. ..\*....**  .#       #
#. *\*. ..\. ..\ **..\\ \ . .. ...**...\* **..*.. .  ..*...*. **.\. .. . *. .*    \. ..* \  ..\* \..\...   .\*.   \   . .*..*..\ ...*  . . .* .\  ...    \.\... . ...\ .  .\.\#      #
#  * .. ...\. .**.\\\  \ . **. ... .. ....... .\  ..\  .*.. . .**.\\***\.. .\. . \ \\ ..*. **. . .. **...* *.*. \\ .. ..*.\ .\ * *. .*\.* *.. **....*  \    \.. # \....*...*..#      #
#\..\*.  . * .   .*.\.*.  .. . ..  * . .\ *.*  ...*\.* *. *  ..   .* ...\..\  . .  .   *..  . \  .. *...\..*.  * ...  . .\.\   . ..  .*.*.. \ *.   \..*.*.\..*.\ .  .\ *. *###       #
#. .... * .*.*.\ .* .\*.  \ *   ..*\..  *.. * .*\*\*......* \\ *** .*  ** ..*.***. .* \*\*\    *\\ .  ...* .\*..\***  \.*  . .... ..\** .\. .\. .*.*. . . .. .* . *.\**\...*\#       #
#\  .. .. ..*.* . \..*... .* .\\. ..\.. *\*..\.*   .*. .. . . . \ \.. *\. **  \..\. .* .\..\* .\.  . *..\*\*..  .*\.* *.* * \.\.. . .\. *.\. ..  .\.\**.   * ** *\.#... .\ # *#      #
#\..*...*.  *...*...\. ..**. ***\.* *.\ . *.**.  \  .. .*  \ .*. .* *\*   .*\   **  ..\*  \.*. ..* . *.. * ..**\ \*\.\.. *. *\ \.*\**\. .*.*.. .*..**.**.*.. *\.\  .. ..\*# ##       #
#**.. .**\   .*\....   .\..  \.*. . .\ *...*.\...*.   *.. *. ..*. \ . . *..  .**....*\.. \.*\.  ...***.\ ..\.\.\ .. ... *  .* \...\ \  .**..*   . *....*.....*. *  .\  ...#          #
#...\*. **.*.... *\ . \..*.  .  .*  .**..\.** *. *\ \ .  ..  .*.*.*  \. \..  ..*\\  *. \**.*.* \ .*.**  .\*.*.\...*  .\   ..*...  ...*\*\. ...*  .*\*   ..\* ...*.   .#* ..#         #
# **.*.* .. * ..\*.  * *\  **  *** *..*. * **. . *.\. .**  *.*. . .  ..\. * . **..*.\  . *  .\  *.\ ...  *. *\...\ *. .. ..\.***..\. ... * \* .  ....  .. *. *  .  ** *. #.##        #
#\.**..\**. .  .*\**\.*.. *.\ .***\*.\*. .  **\.*\.  \  *.**\.  ..\*\*.*  \...**  ..\*..\.. .\  .  *. .. *.*.*.* . \* \ *.. \*\..    *.. .  . . . . *.*  . ...*.. *\*\ .*#*.*#       #
# *\.\..*\ . \  \..\. .  ..** *.. .\. .*\ . .\*.. *\..  *  *.   . .\.*.*\.. .\\*. .\. ***\...*... * *..\ **. ...*.  * .\*.\  *.     . .   . . ..*....\..  * \*... \..    *..#        #
#\ *..* *  ****\..\.* *. .\*.....* **\ .  * \. . *.* . .*.. *... .  *. ...  *.**.\*..*.*.   .*..* .\ .  ..*.... .  \*. **  \\.\ * \**.....\.*   .\ **. *\\..\*.\.. . .L  *\.##       #
# .***.*.*  ..\.\** .....* *.\*.*\  .*. \.\*...\*.. .\.**  .*  .  . .\.  .  ***\ . .\.....*\\..\.* .\.    . .*\*.*\*. ... .* *.*.. ... ..  ***\. ....*. .* * ....* * \##*.#** #      #
#*. ..\...\  *   .  * \ .* .* . * .. .*.  .. . \*.\\ *.*.*.\*..  ... .\ .*. *\.\. \ *\. ..* *..  ...*. . \...*..\* *. .\ *** \   *   \*  . .. ***\. ..\***\ .. .. .  #  #.\.#\#      #
#*  .**.*. *....... \ .*.*\ .   **. .***.. . \... *\ **\..*.. * *.** . \*.\.\.\... ***  \ . *.  .*..\....  *  .*......\. ... \.\*\ .\*.\**.*...**. \    \  \ \. **\.\.#  ##*#. #     #
#  *\.....**. * **.*.\\\ ....\.**.\*.*.*\ **\. . \.. *.  **  .\ ...   * *   . \ .\ * *. .   .\.  ..\.. .  *. ..*\. *..***.*  *....  *\*.\. *. *.. \. \*.\.*..*\ ..  ..##   ##*#      #
#\ \*\*  \*..**\.*. . * .*\ .*.*\.*.  \ *\.\* *  *.* .* \ *\* **.*  \*..*. *\.\.**..\*\*.. . \..\..**..\...*\ *.  .....**\. .. *\*  \....  \.. *\*.   \* *.  . .*..** \*#    #       #
######################################################################################################################################################################################