#################################################################################################################################################################################################################################################################################
#              #..\. ...*.* ..** * .*.**.*.\.* . .*.*.\*...\..\....* \. . .. . \ .  .\  *. . * *  .. ....*. . *\ .. \* .  **** .* .   ..\ *  .* .. *\*\...*   .*. ** .  . .** *. *.**\ .\*   .  ....*\.*.\...\..\  *...*.\.*  **...*.*.*.* *\.*. .\* ** .. \.\ \.* .. .. ***\. .#
#              #\. # . .*..\ *   . . ...  *.  .*  .*.**\. \.. .*\.*\.   . .*** . **  .\\**. \*.*\. .. *. .\.* * * . .. .\ ..*.\*.. .    **\ *\ *\\*  * \ .\ . \.\ .\.. ..* .*.\..**...   \.. . \.*.  \..\ *..*...*.**.\.\. .*.\  ..* . \. ..* .* \..*..\   . . .* *..**...*.*\ .#
#               #. ... .\*\. .***..    * .*\ ...*. .\....  \.. .  .**. *. . \. . . .\*....  ....*. . * .\*..   \. ***. *..*..****.  .\   .. .*\.  . *. .\\.. ..      .\\... *..  .\  .. ...**...*\ .* .*  . .* .*. ..\. * . .... \.*.*. \ . .  . \*..\ . \* . \ * * ..* * * \ \ #
#               #*  ** * . \ ....*. .\*. \*   \\. . *  .  ...* \   ..... .**.\ ..**.*.*   .. *\.*..* .  *... \  ..\.. .\. .* \***..**.*\*...\*. *  \ ..***.\.. *.*. .* *.\   . *.  **. **   *. *...\*.\\ \* \ .\.\   ** \  *\ .. \* . \.. .* \. ...\ .\ **.  *  \..****\* ... . #
#              #**\ \*.. . \ *.. ..*..... .. .**\ *\**.\*. .**.  .*.*\**\.. ..\ ..*.. . *    .*.. .\.  \...*...**..**. . . .*.*.\\*\.\ ....\*.*..    .\.\.   ...*.* *.\.\ .\.  \. * *\ .*  *.  . . .     ..*.**. *...*. ..\. \* \.*. \ \   . **.\\\.\. ..\..\.\.  .**.*.* . ..  #
#              #..\..** *... * \ **. *\ \*.. \*\. ....\*  ..**\. .*..  . ..  .**  . **** *. **\.* * ***\ *   . .. *\.. * \ .* \. **.*.\.   ..*. *.* **.\*\     \.*.\.\* .. ..  .\..*. . .. .  .*.. \..\*\* . .  \  .*..**.. .**..**   . .\.\..**. *      .* * * **....*. ..*\.  #
#              # #**.\. . *.  \ ... *.. .\. ... . \ ***  . \*\ \  ..\  ** ** **.\.\..\.* ** .\ . *\ \ ..\*. **  .  *.*..*. *. .  .. ... .\\.   ..*\ ..\ \*  .*\. *.*.   \*.* **  . \.  .\     *** .. . .*..  \*. ..*.. \.*\  \\***..**\*\* *.\*.  .*..  . *\...\. .\ *\..*..  ..#
#             #*\ ....\*  .\ \ .*.\..\\ * ..* \   . *\*.\  ..... . .*\...*\. \.   * \...  .. ** **. .**  .**.*   * .* * * .*\.\.. ** . . \.* ..\  * .*.\.\  *.*..*\.. \..*..  .*\ \.\  ..*\* *.* ..*. \ ..\.. *.*\. \.   .....\.*. \.. ...... *\ .** *.*. ...\  *    \*.\..**\ .#
#              ###*#*#..\  * ...   ...*. .. .*  .*\.*.. .* .. *.\  . ...\*  .\* ..*  .*    \.. ..*\. .*  ... \**.  \ ** .**..*.*. *.* .*\  ..  *....*.\**. \. .* . *.* *..***. .* **   .\.\*.* .  \\**   \.\\*\\*.*.  .** **   ..*\... .  ....  * .\.. .. ..*\  \..**.*  . \\*  #
#            #   #\*\*#*..\.   .*\ \* * \*.****....\.*.  .*...** ..\  **  *...\ **.*.\*...\. ****\.  ..**.\  *.*  ..***. \.*\* *..* .. ...*\\...  * .\*\  \.*..* *.* \ .. *.**. .**   *** .*..\  **  . ... .*. . .*.   *.\*.  .\ . . .... \   \..  .  * .* *.. .  ... .\.  . . .#
#           # #  #* *..*.* .\**. ** ..\. .... \ .. ...*.  .*  .. * * **  .\.\.  *...* *\.*.  . .  \. \.\.. . ..**..\.. *.* ..* ..**.*..\ ...\..\ *\ .***. . *. *. *\..*  ... .. \.* *\.\    .  .  . .*\ *\..*.*. **..*.*  .*****.. .*\*\. * *\.. .\\. .* .*.   *\  .**  \.*.. \.#
#           #\ ##.  .\ *.\  .*.\.* .\*..* *.*.*  \****. ..\.. \.* *...   *.. *  *. ..   .** . . .. \. ..*.\ .  *.** .. .\*. *..\ * *. .*   .*\ .**. ..\  .*.* *.\.**  ....* .. ...* . \. *.* \.. ..  *... .**. *. *.  .\ \..*..*\ *  ... .**. \.\ \*  .  .*** ** *. *\. . \ \*.\#
#         ### .*.*  ##*.\...*.  *.*..*..*.... .*... \.. * . \.* .\*.\  .\. \..\..\* *   .*.\..\.   .   .\* *. \*\.. .*. ...\.\.*... * *..\ .*  \.... \..**.*...*..*... * .\\ * *\***.\. **. *. *. *  . *. \.  .*..*.. \**.*...***\.* * * ... \.\  ...\\\\ .*.*.  \* .. \.**.\.*.#
#        #*   * . .*. .*.  ... .   .*.. . . ...\*  .  * ... .\ . *.*.**  *.. \ ** .*.* *\.* .**.  .\ .\. * * . ..*\\*.. ..  \. .\ \  *\  *\*. *\ *.  ..\..\..*  *..** \.. .***\ **.\.. .\* *.* .\**. ... ..* .\.\***  .\*..   \***...* \. *.*.*.*   .  .. **\*.\*.* *.\* ... .*.#
#   ##    ##*..  \. *. .\..\     .. ..*  .  ..* ..*\. ..*   ..*\. \.*... .  \ ***.\  .*\..* . .**.*.* .. ..\..***. ..\ * *...\*.* *..** ..\.\ *. .**.  . .*\.. .... *. ..\*.\...***.*  ... .*. *.\* .  \.*  *. *....\.. ....\ .\... \...  * .   *  ..*  ...*. .....\.*.\ \*\.***#
#  #..# # #\#\ ...**** \.  . .*.*.*....  \ *.**..*   \* *..   . . .**  . .\ .   \..  \..*.**.  .\***..  .. **.*.*. *. .*...\*\.* \ .**.  \* .    **\  . . **\***.\ .\. ..** ....*\***  *.*  *.*.***\  *..\..... \. \ ** .  .*\ ..*.*.* .*\*  . *.   *\.*\  .* *  ...\.* *.. ....#
####.# #.#. * .. .*... \. .  .**  \**\.*. \....  .  ..\*. . ..  \.  . .**. .\* *\ .*.\\ .*..  *  *\   *.\**.*\. .. *.  * *.*. .\\.* .*. *.. .*....*  * \**.  ****.*.*  *\* \.\.*.\....***  .\.*... *\.*\**\\   * \....**\.*. .. *..... .... *.....\\....  \. *. ... * .\.\..* .*#
#\* *.#...#**    \.*.\*.*. ** .. . .\ .\...*  *.\*..    \ *..\ .* *\\**.* \. ... \  ..  . . *\** ...\*\..** .*. ** *... *. .  . *..... * \.. .\ ***  \..****\*..* . \  . \ .. .*\* ..** .. . ...*.**  **.* .\ *\. .   ...***\.\ .* .. \ \.*\.\. *\...\**   * *.*....** \ .\\*...#
####***\*..\.  \ *.**.\**.**\..*..\. .. *..* .\* \.\  . ..  *  .. . *... .    **\* .* ....*\.*\**.**. *. ****.\ .. *\ ..\. .* ....... ..  *.  .**.. \.  .. ....\  * *\.*\. .   **.R   ..**..*.  . .. ..**. .* *..\....*.  .*..  *.**.* .* .*\. \*.. \*.. *.. \*..\ \.. *  **.  *#
#   #..*.   .**.*.*.. . **.*.**..\.\. ..**.*. *.*. .*..... .* *   **.. \. .\*\ .**\*.\.\**...* *. ... *. .... * .  .\.*** .\  ...  **  * *... *..**\ * .    ****...\ . .*\ ***\.. * \. .*\ .*  *. .* \ **  *  . \ *.\* .\ \.*\*.* **\***.  **  *. .*..* .. ** \ *.*.. ........*.#
#    #\.* .\. .   .** *.*.\  ..  *\ *  \*.\.\ \* . * . **..*.\**.*.* *..*.....*..\ . \  .... . .  . \ . *\  . \ *  **\.*......  .\. ...\*. *\..*...**  .. . **.*.  *. .\..*.\. *   . .\* . **.  *..  ...*...\ . .**.**\ *.. . .\.*. .*** . .*.. ***..* . .*.\  *... *. .\.\.\ \ #
#     #\ ..**\.\. *.\**..\. .*.  ... \\*.*.*........ *..*.\*\.*... .  \..**. \*\* ..*     ..\ * . . ..\.. *....**\***..*\\\..* ... *.* *.. ..\**.\.\\  *..  *.*..\ \\  *.\.*...\. \. .** *.* \*** . *\.  *.. .* ..*.*\**  .  .*..*\..**  \*\.*\ .* \ * .*..\.. \ * \ \. .\ *.  .#
#      ##\#.*\*.\..\ .. * ** **\..*    ..\*.   *.\.. * *.  .  .*.\ .  .   ..\ * *. * \...\    .\.   .\  \ \ *  *\*.**. .   ..\* .*  *.*\\ * \* ..*.. .*\. . . **\ ..****** . .  .. *  .. *.\  ..* * .*       ..  *. * .. ** * .\ . . *.\  \  **\**\\..* .   * .\.*\. .*   *\ * *#
#       # #*\.*\.**..*\ **\* .\\.  *  . ..*.*. \.*\\.* **  *\ ...\. *. .* *\.*.\ **....**.. .** \.**\ **... .  ..   .\. .     *.. *.\ *. .*\.. . *. \.  . \..\ . . ..\... .*\ .* *\  * ...*..**..*.* *\*.. .*. * \ \*.  *.*.\..*. ....**\ .\.*.**\.*... . \ . * *...*\. .  ...\*#
#       #.##* #.  *\*..\.* * \..\*  * . \..*.   ....* \\*     ...  ..\ *\*..... . ** ..* \.. ..\ .*. *.*.\ .**\. *\*  . . .* \.** .\ ...*  **   . . \ \     \ ...  .... * \*  ....*.*.. *..**.**.*.. * .  .\*\..\ . .  .. *\*  . \\.*\... ..* *...** \... *    ..   .\*..*...\**#
#        ###..*.* \.*\.\**.. .\ . .*   .. .\  \.\ \ .\..\ .   \ .*. .* . .**    \ **   \. ...   *\.. .\ *   *. ....\.* .*\ .\.*..**.\*\..* .  ..***.....\.. . ..* *..\   *. . \.\*..*  .\. .  .. . .\* .* ...*. .*.. *  . . .\.. .\*\ ...\.*...*.*.*\*.* ...\   *\..  .\.\.. . *#
#        #.. .**.\. .**.\.*\**.. .*  . \   **.*\...*   \*\..\   * \.\** \.....   ...\ *. *  .......*. *. . *. **.\ .** ..* .. \*\*\  .*. *..  .\*.* * **..* .*..\*. *.**   .  .\ \ .  . * .. \. \*\  ..\**\ .**. ..  ..\ . . \. .\*....\.. .*\*...\**\  \ \... ....*\ \\\..***\.#
#         #. ..\.  *.\.\* *..  .**..* .*. **. . .... \ ..*\ * .**.. \. *. .* * .* *...... .\ . ***.* *.*  .\...\*   *\.** .  ..*..   *\.*.*. * \  . ......\.\*. .....**..* . \. *. *\*.  ... .* ..***...**. \\*.* **   *.*. .   .*\* *..* ..\ .  . *\* *.\.* . *.. \**. .*..*..*#
#          #.*  .\\**  .   *\\.*..*..\ \*.*.. * * \**    *.\..*.\  ...*. * . \**. *.. ***.. *   .*\. \..*   \. *. .\*...*\   *.. ..*\.\ .\\\ *\.*. *.*  \.**... \   . \ *..*..\ .\ *..*  ** * .\  ...  *.*.... ** ..\ *. .. . *  *\.\.*\\ .*.*  ..\\..  *  \*\.*   *..\*\. \.* .#
#           #. .  ..*\..*..*.*.. \*\.*   .**. . .. .. ..*.  \.*.**   \. .*\  ..\* \ .\.* \. .*.  .  .  *.  ** \.*. ..** * .\.\ .*.*. *.   .\.*. .*..\**...... * .  * .. *.\* *. .*..*\. \.. . .*.\ .** .  .** .\*\**  \.*   *\* . *. ** *. * . \*\. .. \..  ..*. .*.*  *..\... *#
#           #*  .. .*\ .\***\. ** ..* .\.*\*.. *\ *.\.*.**  .. *. **.* .*\*..*\ * .*..*.*. *  \. ... .*****..*.  ..  *\ \ .*..*.*..*.. .. .**.*.*... *.*.. . * \  \   *..\..  * \. *.** * .\   . ....* .\ **. \....\.**..\. .......\.*.\.*\*.. ...\  \..*  . *.*..*\*.*..\ .**..#
#    ##    # .*   *.\*.....***. . . .  *.... .*. ... \***.\  . .* ...\ *.*.*\ .*.\ . *. *. *\*.\\. ***...*.**.*\**\*..*\ *\..*. *..* .* *  .  *.* .\ .\*   .*.*.\..\\..\. .*\..*.. . .. \  ..* .*.* ..\* \.\.  ** .  ..\ .* . *\ . \*.. \....*   \.*. ***. **\*. .. * .*.  * *..#
#   #*\#  #.. #*\*.\..*  * .\\ .***.* **\  *\.. . .* ..**.*. .  .\..\ .*...**. .. *** *... .****.\.*\.   *.*.......  ... *.  ..*.  .\*.\...   .*.*\ \**. *..* *\  .   * .. \*.\.\* *  \.   \ \  . *.. *\.. .\ . .* ... . . *. \...  .  . \...\.*\ **. *\.\...*. \.*.  ... ..**..#
#   #  .##. .  .***  .\...\ .* * . *  *.  .. *\ \. .. \....\ .*. .. . \*...*. ... \.. *\.\ *\.*. \...   *.\..\.\ **\*\.  .\* *.. *  *.. *.\..... .\  *..***\  .*....**.. .*..  .**.\ \ ..*\... *... * .*\ * .  ...\.    .*..\* .*\. .  .*.   .**.**\ .**** .\* . .\*..  . ...***#
#    ##\ \ ..\...\*.*\*\* .. *..\. .. *. .* **\.* .* .. * **..\   .*...*\  .*  .  * *.  ** *.** .   \ \ \\.* ... \\. .* *. ...\**. .***. .   *  . *.. *\ * ..  .\..***\. *** *\ **    \\    .*.*..* . *. *. ***\    \*   . *.\.*\*.* \  .  \ *..\* .\ ...**\....   *. \. *  ..**#
#   ##*.*.....\. . \....*.   ..\.\* . ** \*\.   \  . .\...*..... \..\.*  .  .   **\. .*\.*..***\ *..  . .* . .***\ \ **....\\.\.*\.......   *\  *  . ..*.* .  ..  . ..* .*..*.*.\.\  .. .**\*.* .\*.......\*.. .  \  .*.\ *.  ..\... .** . . ...*.*  * *  \.* *. *.. *. \.  .*.\#
#  #*..#*  .*. **  . \*\. .   .*... .....* * .\...  *..* .*\*..* .. . . \ . *. .***.. ** \ *.** \. . *  *.* .* *.  . *****...*   . .*  *\  **. ..\..*...** \* *. .  \..  .\.*\... **.*  .*\..****...**  . *...\. \  \ ***.... . ..  ...*  \.*\..* *. . .*** . .. ..\ ....  **.\.#
#   ###\.    * ..****.\*  *\  ....*  \  .. ** *\ .* .* *  *.  ..*.  .\    ****\. ...*\*\ ... ..\..\ .** . . .* .\.*..**.* * ... .* .    *..*.    .*.**\.\.\. .\*\. *.*  *\* . **. *\ * .*..\*..\*.\ .*  *   .  \ *\*. \.** \. \   ......\ . ....\.*.*\. ..*.\ ... \..\.\.*\.** *#
#     #  \ *. ..#..*.**. .*.. .\* ** .\ \  .\ .*.*  ..**.\.   *.****\ *.\...\*\.\  ***...* .\...\ .\.** \ \ *..... *.*. . . \.\\ ...*. *.****   **\ *. ..... ....\ \...* *.. *  .\ * .**.  *.*.***  *.. \ .\  .  .. ...  *  . ..  *\**\ . ..\ . .***\ .* \.. .*.*.\.. ***..**.\*#
#  # # #\ #...\ .... . *. . \.\*...   .  *...*  .* \\ .*...*\*..\.*. .* .*.\.   .. \**.\.\ .....  \. .*\*\**.**.\* .*\*.**...* \      .. *..*  .... .\. \.\* \. \ . **\.... \ *\   ..*.\.. *   \*.\ .*  *.\ .\      **\*\. *\.*.. \ *..  ..* *.* *\... . .* *\* .. \  **\.\.. *.#
# # #.L.*. ...**. .  * *.\.  . \*. . ..  \. * . .*.\. **..*.*.*\. .*  .*.*\ . **\* ..\*  .\ ..\.**  .\  .. . \.*.**.... .. .\. .\  *.... .**. ** *...*...***  **.* . *.*\....****\*\.*. *\.*..*\.   * \*.   *..\...  **\  ...* \*.. .\..*.\* .\* .*\. ..* .\...* *.\* \. \.. * .#
# # *  .#*.**.*.*\  **\.\.* *. .. .\. .*..\ ..\* \  ..** * *....\.**  \* .\ . \**. *.**\** . ..... ...\. ..\ .\. ...* **..\.*.*...*.\**.. .\.\.....*..*..*\..*.**.   *.. .*. *** .. .\ .* .. .* .......*.. .. ..  * ..* .** ***. *.. .*   .. * *\.\*..\ .. *\.\.\*.*.  *...**.\*#
# #\.\  #*..  . .**... .*.. .\ *..***\..**. *\ ... *..**\.**\.* .*.. ... * *  *..* ..*.*..*.**. \. *..  * ..**.  * *.* .\ .\.*\*...**\....* * .*\ .* \...* . . *.**\**\*....*. *.**.* . \ ***..  \ **\\.**  *   . *\ .\  **\*..*.*\ . .. .*. * \...  . \   .. ****. ..*.***. ***#
##\  #** .\.*..  ....\ *.\*\ .*. .....*  .* *..... \... . .* ..*.* \. .\*....\ *\ \ .*.   .\...\ .\ *\*.. . *   *\ .*   .\.  ...  \.* *\**\\.  *. .\ .   ..*.*.*....*... .*.\.. *..\.**.  *... . \...\***  \\ *.\* ...\. \**..\*\ ..\** *.. \. * * . .  .\**.*..**.**.** .**..*\#
# #*# \.  \*.\*** .* * ......**\ *.\. ..  .\ * ..  ..  *\. .\ .* .  . .*..\.*.\.*   **  *.*.. ...\...*.*...*. **..\  .*  ...*\* **...\...**. ..\..*..  *   ..*.*.*\*..   *. * \ *    ...*.\..* . ..**.*\..\. .\..*..\..*  ...*..*\ *..\**.* \***... .*\. ..*\.. . \..\.  ***.*..#
#  ###.**.\.* *.** * \*.  \**..* .. *. ***\  *.***.\   .*\  .. \..    .. *\****....*.\. .*.. \ \..\. .*. . .\....  *..* *\..*..\  .\  ..*...  .. \. .\..  \ \. .\*..  *.*. . \.** ..*. .\*..**\ \...* .  ..  ..*...   *  \.\ .... \.* *\. *. ..  *\  **.\*.\.  ..*\ .. *.\.*\  *#
#  #.  **...  * *\ .\. . ...** \ .\..\ .... .. .*.**.  .. .*..\.\ .\. *..* ....    . ..*.*\*.    .*\. \*  \ .* \ \.***. .. *\...* ..  . .. .\ ** ....*\ .*\ . \** * *.\*.*.* ...\* *.*\.. \ *\.*. . .....  \  \*  ..\.*.*..*..** .. .\*\  .  .. . **..  .*\*.*.*** *..**\.*..\* #
#  #*#\# .\**\..\  .**\\*.\*..  .. *.*  ..    *.  * .\  * \..\*. * **  ...\..  . *.  * .\\\.. ..  ** \* ** \..  *.\**.*\*.  .\\..*.\\. *  *.. \. ***.. * . .*\...*.\*\ *.*  \ ... ** ..  .. . ..\. \**   * ..\ . ..*. ..\ *..... **....*.*.  \*\.... *\ .**. \. ...***.*..*. ** #
#   #**# ..\*. \.**.*.*..**. ...*  *...*.... *.**.*.  ... . **.. ...\.**. \ \.* .*\\ *\*\....  . *....*..*\.\.. * ..*.  .  *.... *.. *.\    *. * \..**.* \ * .* \.* *  .*.. ...\ \..*   \ ..  ..\...*..\*.\ ..\* ** **.*.**\* \ *. *...\ .* *... * .*..\. .*..* *........ .. .\.#
#  #\..*\*\.*.***\...*..* .*\*.*.***.*.*.. *..\.\*.*.*. .\ *  \   *\..\.. *\. \*.\ .*..*.*.  .\. ***.  **. \*.*.*\***.\* . \ *\   *  ...* ..** *\ .\**.\**.\* *\ *.* \.\ ...**. . .*. **.  . \*\*.\.\ . \\*\...\**.\.*\\. .***.\.\**\  .\*\ . \*\*..*. \*  .\ * *.. .***\. .. *\#
#################################################################################################################################################################################################################################################################################