############################################
#          # \**\... .*. .**.*.* *.*..* \*.#
#          #..#\  * \\.*  *.*.*...***.\....#
#        ##  ***. \..  ..*.\* .***... .    #
#       # #\**   * .\** \.  * ....... . \ .#
#     ##. *.*.. .*. *.. ... . \. *\**... ..#
#    #.*  .*** \...  .. * . * ...* *.*\.\.\#
#    L#*\ *\..*\*.*.   * .* **\.\*\.* .   .#
#   #..\. *.. *..\.. *..  \ .   ..* .  \ .*#
#   #\*\. # **\*.. .. \* *.  * .  * *.. .*.#
#  ##.*.**.... * ..... ..**... \. \  .*.\\.#
# #..####.*. * *  .*\  \ .**  *..* *\* . .*#
##..  .\  ** . \*  **.\.  .* ....* * **\. *#
# #.   ***.** ***...*** ** .. .\*. .**.#* .#
# # **. .#   .*..  ..* R**\  .\\ . * ....  #
## * ..* . ***.\.**  .  . *.. **.\.*..  ...#
#* #.* .**...\...*\.* . \ \ \  \.. .  ..\  #
## #  *.\..*. * *.*  ...\  *.  . ..\  .* **#
##\#\#.\**.\\  *\. **.\  \ \*\ .*\ *\ \*\\*#
############################################