########################################################################################################################################################################################################
#.  \. .. *\. ****.   .**. *. ***.**.*.\.\. ...  *.   **.**\.  *.\.*\ .*      ...** *  \..*. *.\.**.  \.\*.*..*\.\ \ . . *..**.\ *\\ \.. **.*..**.***\ . ..\.*. *\  ....\**\.. * .\*#*#.#.## #         #
#\\  . *  *.\.... \ .. ***\.*  \\  *.\. ....   . *.*.*.\ .* .\..** ***..*.  *\* .**\*\  .\...\ ..* .  . \... .. * ...  *\.* .*\..* .  ...\.*.  .* . \ *  ....*..** ..\. ...*.  * . *\*\ #*#..#         #
#**\ .\*\*.\..**\.  *...  **\\\  *..*.\*\ \ . \. ...*  * ..  *.\. \... \..  *  \.\*.\****...**.. * ...*.  \ *  .*.*  *\*\ *\... **. .. . .*. *.*. .  .. .\ . ..  . .*...\ ..\. .** .  * \. \ \#        #
#...**...**.  .**\...\..**.*.. *...\. *..\.*\ .  ..*. *\.*\ *. *.* ..*\.*.\*\ *\\..*. .\*.* . *\..  . .\*\ ***.\. .\. . *. . ..\..* * .\ ..* *. \. .*\**   **\*.... *.*.... *.\*.* *\ \.. .#. #        #
# **\  \\* ..*..*  ...  .*..  .\\*.*\*..* *. *\*\. ..* * .  . ....  *.. .\ . *.   ...** .*...   *.... \***..... **  \  ..*.  . ..** * . .  ..*..*. **.*\   .....*  \ *.   *\\. .**\.. \.#.# *##        #
#.*.*. .\ .\ .\.*\  .*.. ** ... .. **.. .   .. * ...\**..   *..\.**.\ * \  *.  \..* .\.  *\**  .* *   . .***\  .*. *\* .\.\*.\* *  * *..  *.\.**..*.. **. \.  \.*  . . .. . *.\ ....... \\  .* #       #
#*...**..\*. . \ ..  *** .     .. \\.\*  .*\.. .\..** . *\.\.  .. .\..*\..\  . .. ..* *..* .*\...  ** .  ..\\*\*.\.\ * *.* \. .* .*.*\ . **..  .  *.* ***.  \..*\.\ **.\* \**.. *..\. . .... . .#      #
#..\ *... \ . \ .\..\*.**\. \* * *. . . *.*. .*.*. ...* *. *\\* .*. ***. \. . **.\.\\ .. . *   * .\.. *    **..* .\  * *\* .\*\** ****. .....\.\**\.. *.*.\ .**.  *. ..*. ...*\  * *\.\. .. .*.#       #
#* .\*\.\..*. .. .   .*..  ***... .   * . *  .. *  \* *.\.... *... .. **.**. ... *. *\*\.* *..*....  .\    *.*..*\. *. *.*  * *..*..\. .\*.**\* \... .. ***. .\  .* \  ... .\... .**.*..L.**#.#        #
#..*.\*\    . .*\*..* \ .\.*...   * *.\.  .\.\* *.  .      * **\ *. **.*\.** **..\ \. .. . ..\ *. . *. *. .*.. \*.*.*.\  **** ..*.\ .\ **.*. ... . .* .. *...\*.**...*....  **\* \*\*.*. \.##.#        #
#*\.. \.. ...  \*.*..\.** . \\.\. *.*.. \. . *. .  \..*   .. *\.......\.. .*\ * .* .* \..\.   \ \.\ *\  \. ..*. ...**..  \.. \ **.**.. .*.     .  **. *...** . \..\*.*.\\ . \... .*.* *#..# ##         #
#*.. *. ..*\.*...*. .\ ..\*. .\. **\**. \ *  *  \  .*.*\. *..\ \* ..*.\..*  .\*.**..**\ *. **\.\ .. \.\ .*\.\.*\   *...*  \ .. ..*...  *\.*..**.\...\.*.*.*   ...\ ...*. .* . .*.*.\. *..**# #         #
#.. ** \.\.  ..*.. ...*\.**  .   \*.  * .**\.\*..*..***.  .. .* ***... ...** *  ...\.\. ***\* *. *.\   \*.*  .***...\\  ..   . \..   ...*....*.*..   .*\..  . \.\*..  .\.\*  **.*..  \.***.*.#         #
#   .. .\. .\*...\. . ..**\** \  ... ..\..* .. .  **.\. * \* .* *...*.*.\*..\.  .\.   . .\**\    *. . ...*...  .**     * .**.* ..... * .. .  .   . .  . * . \**\......*. *.  *.\.*** .*.* .#.\#        #
#\.\** \* *\..\....   * *.\.\ .*.  \. .*  .\. \....\* *\.\.. .. \.*  .  *.* .   .* .\.\.* **  \   **\ .  .\ . . . . ....\.*. \..\ \\ . *..  *. *. . \. \.\. .*.*      *    .*.. *..* .*..\. .#         #
#..*\.*.\ . .\*   \*  . \ *.*.***\ .\ **\ * \..\**.*\   *.\  . .**\ .* *. ....\**.    . .*\. *.**\*.\.*\***\... ...   \..*\*\ *\  . *  . *  **..\.\ . .  .. .. ... .  .  **  \ .\  .*.*..***#          #
#..*... *\.     *... .*. ..\ .*\...*..*. \ ..\ \.. .*\  * * * .. .\*.\  ....*  ..* ..  . .. .*\.... ..  *.\.** . .. .  . .....*. ** .  \.*\* ...***.\ .   .   *\  ...* **** . * ..    * .\...#         #
#*...*\ *. ..\* ...\....  . . .**. . \.  . *\ *.*\. * ..*\  . .**  . .* .*. *\* .*.** \**. * **  .* ..  . .\*. .. .\   *\**.\**  **.*.  \. *.  ***.*.\  .\.. .\..** \  .*..   . . *.*.* *.#   #        #
#. ... .*.* \ ..*\* *\.   ** .**.*\.\..  * *. .*\*\ . *...*\*  .... . . *.* ..**\.* ..... . .... \\\ \.\*.. *  *  *  .  .. .*..  *.*.\  * .\**.\**.*.\   **..\.*\..\. . \. *. ... ... . \.. **## #     #
#  \ \  . .*...\  ..\  .. .  ......**.. .\.\  .... . *.*.*.*..\.* .. .\  **. \*\.\.\*.\* *  .   .  .... ...** *. ...*. \**\\.*  \. . \*....*..*.\*\*\ .*.. *\ ..*.* *\..* ....  .  *  .   * ..# #\#    #
#\ .*.. .\. ..*   *...*.**.* **.\.  . \.\*\. ..* *... *.*. *.\.*** .\*.\\*.*.*   \  . *. ...*..*.\ *  \ . * .\**   .*.* .\.\ .*\\. \* . . .*.\.... ..... *      . .**.\ * *. .*.  ..*..\. .  *\ * #    #
#.. *\   . * . *. \*\ \.\ **  .  *. ...*.\ *.\..\. **.*. \  .*..  .\*.\*\.. \ \**..*.  \  *.*..\ .\.\ . ..**  *.\ . .**....  \.. . .*\*.*...\.*\. \ **\*.. *.\..  .\ . ... ..   .* \ \* *. . *.*.#     #
# \ .\. . * .* \....*. . \..... .\..*\ .**.\       .* .*. .*\ .*\   \  . .\ *  .\.\.\  .\*\\..\ \... \\. . \\   ..*  .. *. ...**\ **\\ .  \ ***. .* .* . **. ..  . * *   . .  \** . *.*.... .*. #      #
#**..  *\ *\ **.\..*\..*\* . \*.\ .*. \..\...... . .*.**. *.*  ...*... *.**..\.   . *  * *   \   *. *.\..  . \\ .*. ...\.* . ..**.*. *. *.\.*\.* **\ .  *.. .\ *\.\  . .. * *\..**\ . .\ \\*\ * .#     #
#\.. \ .*.*** . *.*.*  ..\\*  ..*\*..\  .**.  ..* .\..*......  **\..  .*\..* . . .**......\  .\....*.*. *.\ .* . *\ . \ *\*.  .* .*. * *.*..*.\.\..\.. ..\* ...\* . . . . . \  . .. *.....#\. . ..#    #
# .\  .*. ....  * .*\.\.  \   . .*\ ..   *. \.....\. \  .** ** .\  *. .. . ****.. .* . \\ .*.*   .*...* .\ ..*   .*  .  *. . .. \ ...*..\*. .. .. .*.*.\.*.** *.*\ * \    \..  * .  .*\.*...\*.#*##    #
#** .\*.* *.*. \*  .\* \.*\.*    .. .  \*... * *. ....   ..*\ .. *..*.. .  \*.***  \. * *  .\.. *..*  . .****. \***  .*. ..   \.  . . .* .\*  .  .\..*..\. \.\.*   * ..*.\  *\..\ \....*.\ ......#*##  #
# . **. ...*.  . **\\.\*.*. *..***  . .\*  . . ..*..\*..   \  . \...\.. *  .. ... ..*** .. . ..\  .* *\* ....\ .. . .  . *.  ..*\\\  . \.  . ..* .. * .\*.*. **. .\...\ * . \  .. *.*\..\.\\..#*\... # #
# ** . .*\.* \ ....*  .\*.\..  .\.**\.  . \\ \.  .* ..  . ..\  *. .\ *. ..*  . *. ... \. .* . \*\*  .....\ .\*.\.\* ...*.*..\.*.. . \  *.   * *.*\.**..*.\.. *.****\*\ ..  \. .. .\ ..*    .*.\.#.*.*.##
#. *.. .  **. ..\.\ .\ ...** *.  *.*.*...  . .*..*.   \ \** *...  ..  \*\.* *.*.  .  .  *\.*\...\.  .*\ .* ..\.*..\.\  *.. .. .*.. ****...*.*..\ .\\* \ . . \\* ..\**.*\*  ..... ...  . .**..\. * \ \..#
#      \  .. \.\.*. **.. ...\.. ***...\   .  .** *..\.. . ....**..*.\*. *   .*.....*. ..*...  *  . ..... .\ \ \ \  .  \..   *....* *\ ..  .*\***. . \   .  .  .   .*.   ..\ \  ... \*\.. .. ***. ..# .##
#\*  * .*.  .. * .\....*  ..** \...*..* *.**..* ..\..\ **.\*. ..\**.*\\ .* ..*\ *  ...*.  *  *.** . \    . ...\..\\*...*\ \***\ .*\..*   *.\* ... .\.*.*\  * * .*  . . ..\  \...    \..\* *.... # ##*# #
# *. ..*. *\.* ...*.\ ****.*\. .*\***\.\ ...   *..*\ **.\*.**..\..\.. .**  \*. ** . * .  .. **. .    *\ \. \.  .\ .\..*..*.\...\.* *..\. .  . * \  ..*.... .**. . \**\**.*.\*    *  .\    ... ..##  #  #
#\.. \.*. *.*\.\  *.. \. \...\ *\***. . *  . .*.* . .\* *. *\ ...\  * .  . ..*.\  \\**..**\.*.*\ *.  *.** ..**\  .  .\.\*... .*.** \.\..* *.*.. .. . * . *.\.\.***  .**.**. . \... *\.\     .\   \*..# #
#** \... * .. .*. *.\...\.\**.  .*\  . \.\ .***.. \*.*.\*. *\  \.*.  ..**\ *..*.\..    .\  *.**.*.. ** ..\**.\..*  \*. ...\. \.\.*\  ..*. \*.\.\**\  *.. *\ *. *.**.**.\..* \ ..**.\.**\**.*   .\ * #  #
#..\.\.\.. *\... \*...\ .\**  * * *.\ . \*.*.\. *.. *\ *.  *  \   * \ . . .. *.. . \... .*\.**.\..\ *. ***. *\  . * . .. *. *.*.\*.*  \.*  .  *.... ..   .\*.. **.....*  .*..\     *... *\.\  *\  **.# #
#*  *.\.* .**. . **..  * ..*.\*.*\*. *\....**...**..  *.\*..*\.   .*..*  .  .*..\  . ..... ..\. *. .* *. .* \*.**\*\.. .*\. \*..*  *\..*..\.  ..* .\ .*.  *.*\.   . . **.*.*..***.\.  \*. \*\*.    ##\##
#*......*. .. .*\**.\. ..**.\*...*\. *   .**.****...... .\.**.  \  \*.. *..  .*\ \.** \*..*  . ..*... **..****\ * .  .\ ..  .*.*** ...*\  * . .\ \.* *\ \*.*.. \.  . .\.\* .* * \* *.**\ *. ***... #*\##
#... \    .   *\..*.**. *.*  \ .\\.* .*\  *.\ .*\....*\. . \. . .\.. **.* .. .* .*\.*.. . ..* *.*. .* .\.\..\.\.*  .\ . \..  . ...   ..* *\*\  *  *... .....*..* \\.  ***. ***.*.\.**.*... **...\****.##
#.\.. . *..\. \ *\\...\\ *...\ .. .*.\.*      .*. *..*\ \.   ....   \.*\*\\* \*.*  \. .*.\*\. * .* **. ***.  *  .\ .  .\.*  ..\*\.  .*.   .*\.... *. **... ***.. ..\  ....\.* .. . .*.\  *..*..\....\# #
#**.   \*  .**\.. .\.\*...*. ** * *.***.*\*.*  . ....* .* .\ .\. .*\  .   \.. . *\  .*..**..**  ..\\*  .*.. **\   .... \.. ..  .* ... . \. . * \  * .\. .. * * \. \.*.*   ...*\**  \.  *.\.\. ..* \ **##
#.   \ .\ *.......* .*\**\*  .. ** .\.* .*..*.*.*. \.. .\*\ . * \ \. *.. .. *.**. ** .\.*\.\*\ \* *\. . .*\..\* *****.***   *\.*   .  \..*  ** *  .... .\..*.. ..*. *..\ * \ *. \ .  * *.**  ..* \#.## #
#*..*  **...  * \ . .. *\ .  .** *   ..  * * ....*  .. *...*   ..*.*...*.   ..*.* \\*   *\\.\ \.**. ..  *.\... .... .*.\.*\   .. . ... .\.\...*. **.*.. . .*\  **.... *. .*.*..\. \    *.\\*\..*\*##   #
#.\  . ..* *.... ... \**.\..*\ ...  .*\ ** .  .\**..  .. . *   .\\*.. ...*.. *.. *.*      \\\.\ \.. \ ...*..\. * \* \  * . .*.  . \ ** **     *\ .. *\..** ..\.. ..  *.\. *.. *. .\ \.**.. ..**##\#    #
#  \ \*\*..*** \** *\* . **\..  \.  .. * .  .*.**\ \* \   .. *...  ... \ . ..*.\*.**. * *.. ..*..**.*..*.. .**...\*\*.**..\*. .. .. .*.. ..*.... ...* .. . \.... *.\**\.  ..... .\ ....  .....#*\.#    #
#  ........* . ...*\.\.\  *. \ .  **   **...*\ . * \ * ..* *\. **\ *\. . *.*.... ***..* ...... \ **....\.*.*.\..**.\   ...*\\* ...* **. *.***\**.*.\*\  ...*     .\ .. .*\ *** **. *  \.* .*.\.\  .#   #
# .\**.. ..\. *\ \*.\. .. .  .. .*.*    *.. *. *** .*. \* . *\ . .\. * \ \.\ *. *... . ** ...*..\* \*.  .*.... **.  . *  \...* \.*\  .\..*.*.  \*....*. * .\ \\.  **.*. .... . ***.. ***.. \.. . .*#   #
# .   *.\*.**..\ . ..\. .\  .\ ..**\..*..\.  \...*.  . \**.\...*\ ** . ... . . .*. \.* .*  *..\.... \. ***\***.\ .*. .  \.*... .*\  *.*   .. \*\..* ..*.**.. .*  .. .**..  \. \*.**\..\**.*\* \.  #    #
#. . .*..**\..  .***   *.. ....* .\.\*\  . . * \ . .*. .\ *\.*\ .***.  ..\ *\  ***....\ .*\.**.. .* .*..\. ..*.. \*    \ \*. \ .\  ..** .* .\ * ..\.  *\.. ..  .. . \*... ..\\.\ .*. ..**.* \ .\#\##   #
#\  *  ** .*.. \ .*\ \.*** \.. * ** ...*  * .* .  *...    \ *.*.\* .. \..* *. *\* \...  ...... \*\. .*.*   . ..\*.. *  \ ..** *..** .\.. .. . \ ...**..\ ...\*.\.  * .  . .  \.. .. .  .  .. *** * .#  #
# *\.   *..\\.\ \ ..\.. ..\\\\.. ...*.*.*.. ..  .  **.\ .*.   *\..  **\ *. *  . *\ . .*.....  ...   .....\  .\  .. *\.. . * * *.**.\ \*\* \.  .. ..***...  **..  \ \* .. ..\* *\\... .  .\..#. * . * # #
#  **\* ....\  * .*. * *\ .  * *  *\  ...*  *.    .*..   .* .*. ....  **.  **.   .* \.*.\\ .. .*** ** \  .\*.*.\..\.   .**.\..**..**. ...   *  .  *\..\*\. ..  .....*.\ **  . *. *\..** *. \ . #..###  #
#\.*... .\.\.  *.*.*\.\**. *  \*\. *.  .\**.* * *.. .  .*\..*. . ..\\\\**.*...*. ... \..**    .... ..\.**  . .\*.  . .\ .\.*. \  .*.* . * *\  ** *\*  \*. . * ..  **..* .    ..  *.  .\ *\* ....R \#   #
#* .*. . ..\.**. \...**..*.. \..**..\.\ **\.* \...* * *\. ..*  *\  .*. *.\..\ \*.. * .....  . .\   *.. .*  * **.* \ ** .\.*\ *... *\.\ .. . .*. *.* ** . *\. ** .......*.. ..***......** *\ *.\.*...#  #
#. .\*  .\*......*\* ***  **\ .\...\ * ..*..*\* .*  .* ....\.* \.\ ..*\ ***....*\  **. \..  \  ***\. *.**\ .*.. . ..*..\ ..  . . \..\  *  ***. .. . .* ... *  .  *\ **.\.. .*.*\. .. **\.*...\*... #.# #
#\ \..*. .\ .  ***.**  .\..... .\..* *\ .*. ...     **.* *. \*    .**. *... . .   ***  . *. \...*.   * \..* .  * .*.* .*  .\ .  .*\... .  ...  * .. *. . .. *.  *\.***.*** ***\* .\.**. *. ....* *#** ##
#.. \ *\. \ \ *..* .* .. .* *\..**.. ...*.*..**...*.***. \ \ ***.*\.\..\.* \   ......\*  * \..*. *. \. ..\*. * . *\.*...  * **.\\. *..\... .\ ..\**.\. ...*\. ** . ..*. *.\... .*. ..*\*....*.\ *.*.\ ##
# \ ..\*\   . . *    \    . . **..\ . *\*.* **..*\.\..*. .*.*..**.   \ .   *\ ..* .***.\ ..\*\\. . .   ....*.*  \.  . \* ...*** .\...     .\ ******.     \.  ..*\* .***.*  ..*. . ..*\  .  *.\. *. \  ##
# .**.* .    .  .. .. .. .\**.\.**..*.*.... .. .*.\*.* ..\**..****.* .   \ *.  .\* .*...\. *...\*.**  ... \. . .*....  ..\. ... \. ***. \  **\.....  .... **\.\  ...* *.. * *.\  * ..  *.\ . .. **\#.# #
#\..\ * .   **.. \.*.*.** .\.\. .. \*. \.  * *  **  ...*\...\ \***\.   *..*...\..** .. ...*.  *..\** *\*.    * \ **\  **\*  *  ...  .**\\.*..\.**   . ...*\* *.. .. \ .*\. ** \ \.\** *.\#.*\*\*.####  #
#.\..*.*.  ..**\..\. ***.. .*. .*\. .  .* ..\.\*.  *.*.\*\... ..\. *..... \.*..*\*..* \.* **  ** ..... ** .**  . \**.\   \ .   *\ **\ \.  ..*...  * *.\.\... *. *   . \*  \..  *...*..\.. **. .. ***#  #
#\*.**.\ ..  \.****. \.*...*.. \**.\*.\ . \ \.....*.*.\ *. *.\.  *...\. *.     . .\.....\*..\*\. *. ..*.*\.** *  ***.  *  \..  \ \.  ..*.\ *  *. \. .  \*\ ***. .\ \* .\ ..\.. ... * ..\* .\*\..\..**# #
#..\.   .\. ....\.\ .......*... .. .. *  .\  *. * *.\...** *..*. \  **. \  .**..\   \ \ . \ .*. .* .\*.... . .....* *.*.**.  . \ .\\.\ . .*.\ ** . .  *.\.*\.\ .\.. *. .* .\ ** ...*\..\*.\*.** ...#\# #
#.\ .*\*\*\.*..*.. ..\*\.*\*\\* *\.*\. .   ...\.   * \  \...\.       * .*   .. *...* \.   ........*.  \ .*..\.**\ .*.*.***.*.\ ..  **. * \* .  ... .  .\* **  .\. **\ * *.\ *\.\    . .*. .. #.    #*# #
#\*  ** ..  * *\\**\* *..*  .\*\** **  .\ .*\. \*\*..  *.* **\ .  *. ..\** \.*\.\ ..\..\ .\ \ . .*.**\.**\\. ... .*.\.\*\.** *  *....\*.\..\... \*. ***..\.  ** * \...*\.*.  .  .**\*.*\.\ \..*  * ##  #
########################################################################################################################################################################################################