#########################################################################
#    #.# ###.#.*\. ..  * ..*. \*.\ *..* . .*** .***.. *. *  *\*.... ..\.#
#   #..##**.   ..\.. . . . .\...\....*. ..\ *..* *.*..\*\..  \.   *  \**#
#### \..#*# ##*.**\ .  .  * . \ * .*..... .\* .*.\ ..\*\*..  *   .\* .*.#
#..  .*. * *.*. ... *. *  .\  ***..*. \. *. . \. ........**\ *. *\...** #
### * ..**..*** . \. . . . .  ...*..\   .\.\. ..\.  ..*\...*\  *..\..*..#
#  ##. #*.. *** \*..  ** **\ . **.* * .**.*    \.\*\ ... ... .. . .*.*.*#
#  #*  #. \.. *  *.***\.\ ...\.\. . \* \..*\*.\*..* \..\*.\ * *  ...   .#
#  #*## #..# *.*.\*.** .  **  **.. .... * .*. .\ *.*. ..*..*  *  .  *.\ #
#   #  #\  .\*..* ...*\   .\**\. ..  .*..*\.*\...*\.  .***.\.*..  ***. \#
#       #...#.. .  \.\........*. .   *  \* ...**\ .. \.*** . .   \**...*#
#      #.. \* .\.* ***** . *. \..*\ *.* ..*   ...\. *.*.*..  . .  .*   \#
#       #*#*\  *.** .*.*. \.* ....*       ..  ** ....****  *\ \ ..**.. .#
#      #*.\ *\*. .*  . . ..**.* **\  .\ .\*** *.* ..*...* ** \.*.*.. *\.#
#     #\....*..   *.\ \ . ...*..*...\.** *...*.*.**.*  .*.\. \..\**..** #
#      #  \  . \ **\.*.*  * ***\* .\\*....\ *.**.\. . ***\***. *.. .....#
#      #\#*. . .....***  *.*.\. ..**.\ * * .\**. .*** .*..\.. *. * . . \#
#   # #***\  *  . *.\...\.  *... *.\*.  .. ......*...* . ..  .*.*.** . *#
#  #*#.#*.#\*. *\ ...  .. . * \ *.\*\.\*. .\  .*.\\.  ... \ .\. .\.\ * .#
# #*..\\.*.*.\ \*\\ \.*. .\*.* .  *.* ..*. *\...     **  \.\*.... .  . .#
# #*.\..*..   *.. .. *..  . .  . ..**    .*...*\*.\** ... .*. *.*   **. #
# #.#. .** .. \.*  .*.*\* .*.. \\.**.\.. \**.. * * ..  * ...\.  .. *..*.#
#  ## .... .  **..*.*  .\.\* .\..\.*   *  .*.\.**..    ..*.**.. .***. .*#
#   #\ .*#..**#  *#*..*  ...  *.\...\ *.\ *\...\* *..   \ *...*\** .  ..#
#  ####. .\..\#.. .*\.*.***.**...  **... ...  \*.\.  .  ..... *\.*\  *\.#
# #..#\*\*. *#  . ..**.\ * ..\*\   ..*\*\ . .  *.\.\.  ** .\ ** ... \...#
# #* ... . ..\  * *.** . .*. \.*\*\.  .**.\  .*. *.. * ...  * *\*\**..\ #
#  ##\ #  *....*\ . ...* *.\..** .. ..  .\. \*   .*  .. .\ *..*.* *.. .*#
#   #* #. *##\ .#*##*\ **. . *.. *   *.***.***... . .. *.*..\ *..\**.. .#
#    ###\.#  ### # .* .*..*     *\.  *.*.. ..\ * \ ...  . .*. .\*..* \.*#
#       # #      #\#* *#* . .* *..  .* ..\..  *****. *   .  .*. .*.*\.*.#
#        #        # ##\##. *\* ..  .  . *..\.\  **.*..  . *.**.* .    .*#
#                    ##..\... .*\**..\\**. . .\.\. .\*.*. .**.*.\ . *. *#
#                   #.\* . .\\ * ... ..... .  ***\**.* . .\*.  *.\* ..*\#
#                  #\ .*  ....**..* . *...\* *.*.*. . * *..R\.... .  ..*#
#                   ####  *#.*.*.\.. *\.* ..  ..*.* \.* ..**..\*.\*.\  .#
#                     #.*\.* * .\.  .*.\..* . .*...   .*...*.*   .. *\ *#
#                    # \..*\*  . ..**..  .*.  *\ * ..  \.  ...    \.. *\#
#                     #. .*#* ....\.\.#\.*\ *....\..* \.* *.     ... \..#
#                    #..\ ..   **.* .. #\.*  .#**  *.\. **#.   *.*..  . #
#                    #*.# L###\ **.  ##.#*\.. *\.*\.... .#*\**** . \.*. #
#                    #*# #    ##.\# *##\..... \ **..#.\#. .. #.\  *\ **\#
#                     #      # ...*.# #*..#..   *\*...# #.  ###.  .. .. #
#                            #*#*##*# #.#..## .*.**#*.#  #..#*.\.*..*\###
#                             # #  # #.*#\\#  .#####.#    #.#. #* **.\.##
#                                     ###\# ###     #      ##.#*\*\.\ # #
#########################################################################