######################
#.**..* * .*\**. ...*#
#..** .\*   *.*.** ..#
#\ **.\***.** . *. \ #
#.....**.\... **. ...#
#.*.\.... . *...*. *.#
#..  * *.  *.\ \ .\..#
#   ..\ **\  .. *\ **#
#  .* **\** .\ .* \* #
#. \.* **. \  . ** .*#
#...\.* .  .\ .*.\ .*#
#..*.\*..\...\ **.\ .#
#... ..   .\..\.\*  .#
#  . .\*  *.  ...*\ .#
#*.*   .\ .\ * .\** *#
#*.** ..... \.* *.\  #
#. *. .  *\.  . \.  *#
#\*.. ***. *\.* .. .*#
#*.* .\**  .  *....*.#
#*...   ***\\* *.*..\#
#.\. .\**.. .. .\.\.*#
#.\ .\*\..  . ***....#
#.   ..**. .**\ . \**#
#  *. *\**.**\\ ...**#
# ..  ..*...\....\ .*#
#. \.  .*  \..**  .\.#
#...*\..*. .* *.   ..#
# .. .... *\.. . ..**#
#*\.**\*. \.*.* .\ . #
#.  *.*.\ .\..  \ \ *#
#.  \*.***  . *  * .*#
#..\ *\..*   . **..*.#
# \  .*\.   . ..* *..#
# .* *....... \*.*.\ #
# . .. *. * . ..*R \\#
#\*..*  \...... *   .#
#*\  .\ \   . .\*  . #
#* \* * .   .*.*. ...#
#  .. *  ..\.  ..  **#
#\* \ .\ . .*.\ * \ .#
#..\** .*. .** *\  . #
# . .*  .*. ..*..   .#
#  *..\\*.\*\  .**\. #
#\..*\*.*  **.*\.* . #
#. *.... .*..\. .* .\#
# *. ... \. .    *. \#
#\ ..***.  **.. .**\ #
#..* ...*  .*.*...\..#
#*** .**.. \. \*..**\#
#*....*. * ***\*.... #
#*.. *.\ *\*\. .* .* #
#.*.\. ... ..\ .** *\#
#\**** *. .....  *..*#
#*.\.\ .*  .  .. ..**#
#\.. ..*. .   \ . *\ #
#*  **.**. . ....\***#
#*\***.*.\ .* ** \*\.#
#*. ..*. ..\..\.  . *#
#.*.  .. *\*..***.* .#
#**.\.  ....  ..\..\ #
#*. .\...    *. **. .#
#  .* \ * .  **....\.#
#\ ** .*..*\. *.\. .*#
#...*\ \...* ..\.\.*.#
#. \  ..* \..\...* **#
#. .\. ...  *   . .\.#
#*.\ * ..**\...*.  ..#
#*.. .   ..*   *..* .#
#. *.  * .\. .****\.*#
#**\  *\ \* * *..\ . #
#.....** .. *.*. *..\#
#\ . *.*\..\... .. ..#
#.*\.*... . ***...  *#
#*.. ..*. .\ ..** \\.#
#**  * \**.. *** \ . #
#.* ..* ** .**\. ... #
# .. \.\.\..... . .  #
#\....* .\..* \..\.. #
# * *    .*.\  *..*  #
#\.*\*...***. .\****.#
#..***..*.*.  *..*.* #
#..** *   **\*.  ... #
# .**.\* ..* ..\. .. #
#. .**.* ..***   **  #
# \.*..*   *.*\*\*.. #
#* \...\ **\ . .... *#
#\... .* \.\ ... .*\\#
#\*  **.  \. .\ . . .#
#.   *...*. ** ...*\*#
# **. . .* ..... ..  #
#*.. \.\ **... * * \*#
#. . ..*.**.. ****...#
# .\ .\ *.*.  .*..   #
#\.*.. * *\ .. ...\ *#
#.**  *.\*  .\ .**...#
#\** \  .. \ \\*.*..##
#.*. ..*.  ... \ . .*#
##...**.\**\  .\.*..*#
#.\...*... \.**  . .##
#\     .\   *.\ .#...#
# .\*.\ *#.*.\*#*#*.##
# #*.*# \ .\....#*## #
## ##..#. * \  . .#  #
#    ## ####..  # #  #
#        #..*.*.##   #
#         L ####     #
######################