#############################################################################################################################################################################################################################################################
#     # #*.*\  *..\* *.*....\ .. ....*. .**\. . ..**\. .\ .\*  *. *  * \*\\. \.* \   \ *.\ \* .. R.\.. .\*.*\. \** *.. .. *.\.*.\.\*..* . \.*   ..\* .*.. .**.   ..  . **  .  ** **\.\.  \ \. \. \..\ .. \ .**..**.*\*...\... *.*. * ..***   *..**.*.\\.*. *#
#    #*###.# .*.* ..*\.*.***\\.*\    ..\..*\ *   *.\  *...\ . **..    .\** ** *.** * .\.*....\. .\  .  * ****....*\*\ \. .....*.*...*\..**...\ .\. .\** .* ..\ *\..... . .. \..* .. * .\*  **.  .\..*. . . *...\..*. *.\ .... . ..*\.**. *. .*. ..\ ** \. ..#
#   #*....  .\.*\ *\*  .*.* . ...**.\ . ...*.\ *.... *.\\ .*  . * *\\ * ..*. .*.**** ..... . *\.\.   ..*..* ..\  . *. .   * ..   **  .  ....  *** *.**.* .*  . .\*..   . ** *.*.  . ..* .  ...  . * .*..\   .\** * **. * ..**\*** .\*..\ *\\ ...*..*.**.  **#
#   #  \* ..\**.. **..\ . .**.*  *\.     . \. ..*.* \*  .. .*..... .*.* *..*\.. *..\.* .. .**.. *. .* *\. * ..**.*.*\* . .**.* \**\ ... ..\*\ *.*..*\.*\***.\   .\. \ . .*.*.*.*. *.* . .* ..*...\ * \  **..\**\*.. .\. ..*....... ... .... .\\*. * ...   \.#
#   #\*.#.#\.*. .... *  \*\..\ .* .. *    *.  ..\*.  . \.\.* ...\    \.*\. . .. ***\*. . *\...*\*.***.\    *\ .. \ * * . *.. *  ... \ ** .  *.*.\ .   ...**  ..*..*  *.  \\ .\\.. **.*\ *.   . .. *** ***..*...*... *  \**\   ..*..* ..**.*\. .*. * .\ \  \*#
#   ##.##*. **\ .*. \.** .*. *...\.* ..  .* .* .** *.  .\**. .. ***.* ..... .**.* *  \  \ *.  . . .*..** **..   * . *\..\...\*\.. .*..\.\.*** .*. *\.* ...*\   .* .\* ***....**  ..*..\ **...*  *.*.. *.\...\\.. . .*\*..... \*\*..\ . .***. .... . .*..*\\.#
#  #\. .###\#..\ .*\. \. \. *.  **\ **    .\ . *.* *.\. . ....*\ .\. .**\ .*\. ...  . ... \* .. .*    .. ..\..  ..*..  *. *.*..\* * **. \**.*  . ..  . .*\..*\*.*.*.*\. .\ .  *    . ...*.*\ *\\.*.\  . *.* .\*.   *\ .\. *......\. .. .......**.**\\****  *#
#   ##\# *... ****\\.\   .\ . ...   ...... ..\ *\.*\.*\.\**. *\.  .\ .......*   \ *.  *.*...\.\*.. *.***.\ .*. .**.* *\ \.* ..\*\ . ..*..\.*\...*\.**** \.*..... \*..*....\* *.    *. \..***..*\ . \ *\*\*..\\.\ \* ....  .\ \ ... *..\.  *.*.*  *   .\.\  \#
#   #  ..*  **.. *.\   *       *.* \ * .. \. *.*. ...*\***. .**... ..*.\*.. . **...\.\*..**\. .. \ ......*\\  *.\\ *.\*.* *   .*...   .    .\* *. \ .\ . \.*  .* .. .**\ \**\.\*\...\ .* .\ .*.\* *...*....* * . .*..  . *. *. *.  ....*.      ..\  * .\*. .#
#  #..\. ..*. *\ .\* . .*\   .*. *.  **.* \\ .*\....\...***. .*.*\ \ ...*  \\.*\..*....*. * **  ..*\ ..* **...* .  ...  * * .* . .\. *..\..**.\. . \*. . .  .  *\ *. \.... .. * **\*.. .*. .\.\..\..\ . *. ***. *...    .*\\..**\.\.  .** *.*.*... ..*.*.**.#
#  #\ ... ..*  .. *.  ..*...\.*  .**.\*\*..\.\.*.. ..  *.*.\..**.* ...  . *. .*.  \..\*\*  *...\.**.\...\.*.*. .  ...\* * * ......*\..** .  *.     . .*\  ..\.*..*.*.****\  \.*\* ..*\. .***.*. ..*.. *\ .*\\..  \**. ..\..\*\. .\.*\.\.\*.*.*.. *     .*.. #
# #*#   ** ***. .. .  . *.*\  .   . .  ..*.\ **.*.  \ .\ ..   .. *   \\.. .*. .. ...* .*..\.  * .\.\*.*..\...  . .\   ..*\* *\ .  ... *..*.*   *.**.\. *   . . \ .* *..*\* .  ..\ \*\  . .\***\*.** .*...*\. \ ** * \.*  * *.*\.*  *.** * \ .**.\ ** .\*....#
# #*.\ \.. .\.*    . \. \ ..*. * *   .\*....*.\ ..**.. . ..*. .*..**\ .. \  .  \. **  \. ..  ...* \*.*  **.**\..\. **  .*.... .  . *.\*.\*.\*\.*..*\. \*  **\**..*.\.*.. ..   ..**..* \* *\..... .* *. ..*.*. .....*. . *. ..*.. \.* *\...  .*.\*...\*....*\#
#  #\ *..\.  *..  ..\   .. *.. ..*  .. ..\. .*.* .. .*...***.  . .*.   \ .*.. .  \..  .\.* ..\ .. \*.*\**. **.*  . **\*\.* .*.\.\.**. *....*   .  *. * \*\ * **..* .**. .\  * .  ..\*.\... .. .... .....*\   ** *.**\* *   ..\  \ .  .. \.*.*\ *.\ ..\* **. #
#  #* * \...*.  *..* \.*\. .**.. .\  \* ...  ... \...\...... .\.. .\  ..\ .  *.\. .\ ..*..*\..  ............*\.\..*... \. \ .* \* ..\ ***\..   ..\**.. ... \ .\ *.* ... ....*  * * *. .. *.\. *. *. ..\.\ *. ***\ . *. . .   ..**. **..*.*....*..*  .*....\ #
#  L.*.\ *  . * .\....\ ..  .\ .. . *..*. . .    .  . *.. \*.*.  ..*.* .**. **...  .. ..**... *** \   .* *  .  . *  . *.\ ..  \\..\.... .*.**.  .....\* .*\ *  .  ..   *\\....\  . ...*\ .* .\*\.\.\. ..* *.*.*\ . .\.\..*  .*.*.\*..**.*  * .*.\. **..**.. #
#   #. ##.\* *. .* ..* .\. \*.\.*.\ * *\ * .*.\.    \* ***..\. . ..* .   .* ..  ..*    *\*.......*..*.   \.. \ *\. .  .\.    \ . ... .\*...\..  \**\*...******..  .  . *.*\ \  \*\.*  * \***  . *  ..*    .\ .**\ .\* .. ** ... . .\*.. ..\ . .... ...\\..* #
#    #.*..*.\.\ .....*...\\**\*.*.. *..   ..\ .  ...**...*. .*\\..*  \... \ .\* .  *.**.*\ \**.. *\..**...  .* ** . . \* ... . \   ** ... \.... .*.*... ..\.* \..*. .*\. ***\  ..* \   ........\.....\*. .  * ***.   *.. ..  *.. *\*....  .\\ *..*. ..* .\* #
#     #..\.*.*** *.\*.*\.\*.  . *..*  ..* .... .     .  ... \...\...**\.... . .\.. . \...\...*\ \ . \* *\  **\ ..\** ..* *.  *.... \.  *\ *.* *.*.*.. .\* . .\* .. \... ... .**. *..**  *   .*. .*.**.*... *..... . .\*\.\.*.\ *..   .  *.\.  *  . *\ .  .  #
#      #*.*#*.*.* # \..*\*.**.\*\ .....*. \. ... * \*\**.*. .\  * * ...\\ *  *.... ..** *.\ .....*\  \.....*..* * ....\.*. . ...  .\*. . .*  **\ *. . \*. \*..**.\ .*\. .****.\.. *  *\*.\ * .*. \.\. .* ..\ .. . .   ...*.\**.\.*.   \ ...\.*\    .* **...\#
#       ##\ .   .\.... .....* *..  ....\  * .. \ .. ..*... .. . ..**\ ***\*.*\ \.\ .*..*.\. *   *..   .\.  *\*. .*.  **.\*. ..\ *\. .\. .*. ..\..***.. .\.*** *.*.*\ . . ....\ .* *...**. ..  .\.*.** *..**.  * *.  \ ** .*...* \    *.*...*..*  .*\. . .**.#
#        ###  *** ...  .\.**.\.*.***  *. .. .\*.*   *...*.\..* *\ .\ * .... *\ .\...* .  . .\**.*.. .*\\..*\ .... * .*.  \ ..\  .** .\  \* .* *.*.*.\..** *.. * . ..*\    *\.*  . . .**.*\  \ *. *.*.\*\****..*.. **...**.* .*\ . * .. .\ \  *...*... \ * *.#
#       #  .. \.#*.  ..****.  \.  *.. .*\  *\.. . * .  ..* ..*  .*   *\  \*...   *. *.\....**. *....*. .. .*..***.*  ..\  ...* .*..  .* **.*\  **..    .\ .* .  \*...  *  .. .\\ . * *.  . ...\. . * ..*\..*\..\\ \.*\. . .. . .* *. .  .\ .*.*..  .\* .... #
#      #\*. *..  .*.*\*....*.*  ..\. *\..**.  . *\.\\ \* * * . .\.\.*\***.\.*\* .\ ..\.**..**\.*\. \.\ \* *..*.\*.* . ...   * \.. ****\ *.*.*..\. .  .. *\*** \**  \...*\* \* . ***. *  .*.. ..... .\.  .*\*..*.\. **.    * .  *\ .\  \.  . \.. ...  ... ..*#
#      #\## \**** ..\.**. *. \    .**. .\\. . * **...  **.\  .  .  ....*. ***..\** .   .  \**.\.  .. .\.  \.... * .**... ....*.*  ***. ..\*.\...  .  \\.\ .\  ...* *\ *..\*\. ....* *.\*\ *\ .  .* * * \.. .\  .\ .*.. ** .***.*\  *\ .*. ... *.*\.\. .\*  .#
#       #  . ...*\.  .\* *..  .    *...\.  *..**. . *.. \ * * * .\ . . \* * *..*.\.\... * . ***\*. . .   .  .**.* *..\ .\ .*.\ ..\.\.   .*\ *.   *  .\.** \.**..\.* .*. . *. \ *\**.\ . **\ .\  .* *..\.   *\*...*\..***..\..  .  *. **.  *.*\.\*.**. ***. .#
#       #*.  **.*\ . *.\  .\  ... \*\. . ....\...*\*\*. * ...\**.*.*.*. .**... .\ *. .\.*. .**\*. \*\*\*\*.. \*.*.* .  *.. . \ *...\.\  \\ .* .* ...\ ....* ... ...* .*.\ .*\. **.\*... *.*.. . .*\. *  * .*.*.\*\*  **.\ .  \    ..\...*. **.    *.*..\****#
#       #*##**\ \    *** ...\\* .\..\.. ...* * **..*. . *.*. ... .*..*..\.. \..*. ** ..\* .* .*..  . . \.\. \    *.*.. *.... ..*\. .*\ *.. *..* **. .   ...  ..  *..\**. ..  .* . ... * * .  \ \ *. \ \*\ \. *...\. .*..*.* \  *.\*\*\\ * \.\.. .\..\.* **\.#
#     ##\*##. . .. ...*\ \.*.\. *.\ *\.. * \.  .*  \* *..*\    \......... *\.* **..\ . .. \.*.\..*..\ . \.  .  *.\ .   *.\*...* .. \.  \ *..*..*.. . .*..\   .\  ..*.\.  *\.\** . . . \ *. *.. .\..  \.*.\*.* \*.*\..\  .*.\..*. *\..\... *..\.*. . \ . **. #
#    #  ...* *.* .  **...* * *  .* .*\.*.\\**.. \ *. ... *.***... \*\  . .\..* ......\. .**... *\*.***..... .. * *\.**..*.** **  \ . * ....*. ...*.*.\.*\.\*.*     * ..... \ **** * .\ ... * \ .*.  .  .. \..  **.. .\. * **  \ .\* **.\.. .\*\.** *    ..* #
#     #*.. . . .*......  .....*.\.  .*. ..*.\*.\.  * * .*. ..... .**.*\.     . *\* \..\**..    ..\ .*.* *..*. ..*\ \..*.*\ . * . ....     \****\ .**....   *\.\ .*.\.. **.\ .***....**.. ..* .... ... .   \.. .*\ **.. ..*\*.... .* ..* *.\  \..* .*  .* ** #
#     #.*#  *.. \*\\ .  ..*. ** *.*\  ... *. . ..... *\.*.. .\ \ ..\** . . \ ...*.  .  ...*.*\*.  . .*. *  ..  *.*.* *  ..\ *\. ..*\.. .\*. **  . .*.*\... *.   .. .*.. .*...\**..\ \ . \*..\ .  . .\.* *  \ * *  .\  *. *\.\   ** \\ .    ....\ \.*. *.....#
#      ###. .\*  ..*.\ \  * *.\ .\.*\. .\..\   ** .* *. . *.    *\. .. \**. . . \** *. *\.\\..*\.\ ..*   \ ..\.*.*\  ... . ..  .. .* \..*.  *.\* \. .*  *  .*.*\ . *. **..\ **\ .\.*.\. *\  .*. .*\.* *.*\ . ....** \*\ . \ .\***.  *  ..  .**.\*. . . *. * #
#     ##\ .. \...* .*\.. .\..\.* .. \ **.\* ..\.*\.*\.  * \    .  \ ..  .. .    .*  **\..*. . .. ..  *.*\**\.. .*\ .. *. \  .\. .. *\ **.     .*  .     ... . **.  *  . \.. .*. . **  * ..*\.\  ..  . ** .\...*....\\.**\**.  ..* .\.. *  \ *.\  . *. ..  **#
#    #*#.#\   .  .\ * *..\ *   \.*\. *.**. .\ ***..* ** .  . .* .\.  *.....  * .*.  ..   .*.  . ..  ...*. . .  .. . * .**...***.\ ..*\..\..*...*. *   *.\ .\.**..*..  .**.  .\* * .. .* * .*.*   . \*. .  \  .* .**. .*..\.*   .. * *  .......\\.\. .\ . *..#
#  # #..## .. *.   ....\    \...\.*****.\ *.**....\ \*.\.\* . *.\.* \.\.* . .* *. .  \ ..** \**.     *. ..\.\*.**.  \ .\*  ...\. . **\.  * **  *  . . .*..* ...* .  *..\\ *.\ .*..\ .** *. **.*.. *....\*.  ..*.*\  .... ...* .\... .*..**\ .  * **. * *.**\#
# # ## .*#*.**.. ....\ *..  ...*.  .**... \*.\.\.. .\..*.. .\.. * .\.\.*.\. **\.. *. ..*\*\.*.\.. ***. .\..  \       *.... .. * *  *. .  . *\.*.. *. * . \ \  .. *.*  **\*. * .* ..\.****  ... ***.. *.\..*\ \.\.* . .*.*.*\. .*\*....*. .. .***\..\\**.\.*.#
##*  .***.*\.*\.. .\***\   . * .* .*.\.*.*.*  ..* *  .\ *.*\. \*.. ..*.. .*\.\ ..*... \.....\     ..     *.... \*.**...**.\ .*..\..*\.. *  . .*\. .\..  .\..\.   ..* .\\    ...\.**  .. \.. .\..\.**.. .  . . .  .... ...\.\. \.*. *\...\\ . ...* .*\*\* \.*#
# .*# ...##* . . .  ....\.*. *..\.\. . ...\.*.  ....*   **   \. * .\..... * *..\ .... *.\  . *....\** *\*. . *..***... *.* ..  \. * .* *.*  ... ..***. *  * * \.. *\*....** .  **... *.*. \**  ..*. * *... .*\*.*\*  * .**\ .\ *. **. \.*     . . ..\.***.*.#
#### .\.* .**..*\*.. *   *.\.   ....  . *  . ***.*  .\ ..* *\. **. ...\   . * .* *.*\ ..\. .**..*  . *... .*   .....\... \  .\*.  .\..*. .\ * . *.**\ *..   .*...*\ ...  . ..\ ...** . .*\ \.*\ . * . * .\..*....\*.\.\\\. .   \\ ..*.. *  .* *..\..**.\* ..#
# #**\*#. ..#........*.....    .\.* . ...  \... ....\**  .  .  .. *  \. .   ..*\ *.**     .\. \ .* * \*  *. \.\ *.. *.. .*  *. .*  *.*.  \* \.**.  .\   * .\*.\..\ ..* **\ .*.* * .\*\*.* .  . ..\..  * . ..* \\*.*..*.\*.\ *...\   *\. *..*\ *  ..*.\  .\. #
#  ##. .\ \   **\  ..**. ...\ .\ ... *\  \  .**.*. *\* .**\  .*\. .  .*..*. *** *.*.* .\.*.. .  . ..  *  *.\ * .*.* .*\.* ....\.\ .\...*\*............. . . .* ... * *\*. ..***..**.   ** \.\...  **...\.** \*. \\*.*.\... *  ..*  .  ...*....*.\..*..*  .. #
# #.**.*#\.\. ..* .\.*...\. .**.. .\\.*.*..\ .. .. ..\  \.\.. .**\\**** *.\ ... *.\ . *...*\\*.\ *.**\*..\   .*\. . .. *. *.\.**   .. .... ..  .* .\*     *.\.*... .  *.*. \.*\ ..* .* ...* ** \.**.\ .. *.. *.*.*\ \   .\ . .. \.\   ..\.*\*\.\*\  *\\.* \ #
#  #\.#\ .** .\ *  . .* ... ... \.*. \\****.*\..  .  **  ..  \****..*.\ *\*   .*..*.\\**\ .** *. . ..\*   .***\  *....\  ..*.\*.. \*    .\   *..\.***.    .\ .. . *.. .\. \..*..\\* .* .\ ..\ .. ... .....\ .\ ..*..* \. *  *. .. ..*\.*.\**. \ . .*.\ *\*..#
#  #.  \. \.* .*.\.  \* *.\.\..*    . .\.\. *..  . \..* *\ \**. .\ .. **...  *.*...\....\  .  ....  . ....* .\.\.*  ..** * * ** . .* *. ** *.  .. \\.  * .*. *...*.\... * . .*..*.*.* \ *.*....\.** .\*  \.* *..\\*....*\\. ***. * **.* . ** *..** **  *\* .#
# #*\####*.*\*\* .*. ..\.. .. *\   *..  .**...\  *\.\. *\  ... .***... *.\ .. *. *.*\.  *. *\   \ *  *\.\.\  .  \.\* . * .\..*\\.    *.*..\...*.  **. ..\\....\ . \ \  \* * *. ..* ..* \***   ***.*  *. .. *\.***...*  *. * *\  .. . **.  ...\ *  ..\ *. .* #
#  ## # * * .. . ....* *  .  . . *..... *****\ \ * \ .\.  ..\* .. *\..*.  *.*.**.\ * \*\. ...  ..\*..\ .**\*. **  *. \ * .  \.* **\  \ .\*. ..\ . .*****.*    * \ .. .\ *..\ ...*** \. ...*. *\***\..\ . \.*. *** * .. ....* * .  \\\*\ ..\.. *.\.**  **\ *\#
#    # *.\*. *  \*\. * *.*.\* .....\\ * .*\.*..  ** \* \ \. .. *... **..*\. ..*\. .*. ..*.**.***\.*\**\ *\.... ..\ ...*.    ..* .*   \. . .* * . \ *.\** *..\.\..  *.  .. . * * \.*\.   .**\*.. .. *\.  \* . ...*.*.  *.\ . \. ..\.* ...\*. .*. ....  ...\. #
#     ##  *  .* *.*.\..* .***  \*  . .** \. \****...*.\.*. . \ *\.\ ** *..\..\*\*\ \ .\ .\*. *.. ..*.\*.  ...*\.. ..  *\.*.. .........\*\ **.. . .\\.*.\** *. ..\ ... ...\ .\ .\   .*\  .....**.\  * \. .\.\ *  . **..* *.  .   * .. ...  .* .*.\.. . .\..\.#
#      #\#\** \.\ . .\\. *.\.   . ..... \. *...*. ..*  \.\* ..\...**    *** \ \*..**..* *.*.\  **..\ *. *. *\.\*\. *\ \ *.   ** * .*.. ***\.   *\****\ . * \*\  ..* ..\*..***\.*.**.. *. .\. *\*\  *\ \....* \ *.. .*   *. . \ *.\*... \ *\  *.\  **\  .*.  #
#############################################################################################################################################################################################################################################################