#####################
#         #.#       #
#         #\## #    #
#        #*  .#*#   #
#       # .#\*# #   #
#      #*.* #. .#   #
#     #*..\  \# #   #
#     #.##. ....# # #
#     #*\ ..*.* ##\##
#    L  ..##..** .*##
#  #  #.* \#.  #.*.##
# #\##  .*...* ..*.##
##****\.*  * .  \*.\#
##\.#. ..\*\..\.\.  #
# \.*.. **. . .. *  #
#*... ..**.*...* . *#
#.. ..\*. ... \. .*##
#.*.. *.* . *\.  .\.#
#.. \ . *    \. ****#
#\*. * *.    .*.*..\#
#***\. ..**  *.***. #
#..***. \ .. ..*.*.*#
#* .*.\   *. ...\.  #
#. . \. .**  *\ *.\ #
#\.  .\ *.*  ....\ \#
# .  *.\... ...\*  .#
#* .*... .* ..* \ **#
#.....*\ *.   *...*.#
#.* * *.*.* **\* .\.#
#.*\. . \.. .\.\ \..#
#...*  ..\ .\.*. *.*#
#\. *  \ .\\  . \*\.#
#..\ ..*\ . *  *  . #
#...\  ..    \.. .. #
#\    .\**\.\*.* ..*#
#.\ .\ *.  ..*..**..#
#..*.   *.*   \*.**.#
#*\**...\.*. . *.\.*#
#...\*\** *... * **\#
# *\ **.. .. \..*.\ #
# .  ..*..*.*. \.*\\#
#\.   .*** **.. *** #
#* .  .*.. *... **.*#
# .**  *\.\..*.\ .\ #
# .*.*.\.. .....  **#
#...\.\.  . *.\   .*#
#  \ ** * ..  .* . .#
#  .\......\*.**.  *#
#.. * *\ .**** *. .*#
#* ..   .*..* ...* .#
#.\ .\.\.. ** ***.. #
#. . *** . * .*.. *\#
#  . .. .*\**  . .**#
# *\.. \...\*..* .**#
# \*. .   *.*. *****#
#**\. ..... .. ..\..#
#\.\.   ..**.  * **.#
#* .*\..   ...*.\ . #
#\..\. ..\.* *.\.\ *#
#.*.** .*  . .  \. .#
#* **.*....*\  .... #
#.\.*\.***..  ..\ \.#
#.*..*.\.**.\**\*.  #
#... *\.*..\ ...*. .#
# . .\. ..**. * . . #
#.*. .*.  .....* ...#
#** *.** .. .* .  . #
#*..* **\ *..\.\.*  #
#**\.. *......\.*.. #
#...\. . *. .*.  .\.#
# *\*\ **\*  * .....#
#*.*.  \*.* \*.\. .*#
#\**. .**\ \..* . ..#
# .*\.*.* .\..\ \ .*#
# * . ..    * ..* . #
#..** \*  \.. *. \* #
#\.\  \. *.  *\...*.#
#.*.**.\ \..*\*. *..#
# ..*    *  * *\ *.\#
#*.  .**..\. \.*....#
#\. .\ .  ..   ...\.#
# .. ... .. *..  **.#
#*\.. ***** * .*\.\.#
#\ .\ *. *..* \\**  #
#..\. .\*.. .\ ***\ #
#* \**\...\ \..\\.*\#
#**  *  *\ . * ...\.#
#..\ .\.\*\\*. .. ..#
#  ..\.  *.***\*\\. #
#.  \*\..*.\.\***\. #
#*.. *  \.  . \.\. .#
#.\. \  \.\..  \ *.\#
#.  *. .**.... ...**#
# \ *.* **. . \.\...#
#*..*.*.  * .\.\  * #
#. ..... .* \.\ .\* #
# ...\.\ * ...*. .. #
#.*....  . .. ..   .#
#\ \. *.. **.*.  * .#
#\..\.\   *..***.*..#
#. .*.*. .\****.* .*#
# . . . ..**\..**\ .#
#\ . *    \..*.*.  .#
#. ..\*\\ .  .  \...#
#.\\..   \ .* \.\ .\#
#*.** \**.  . ..*** #
#***. .***. .\  **\ #
#.*... \ *. .*\ ...*#
# . \  .\ \.  . \*..#
#\*... \.\  ** . *\\#
# . ..*\ ** \. . .*.#
#\.\\.*  **.  .\. .*#
#*  \   .*.\ \*\ . .#
#*.  .   \*.....  .\#
#...*\ *..\* .\ .. .#
#*\\..*\.. *.\.\...\#
#.  ** ..\ .  .   \.#
# .\*\ \...  . . ...#
#  ...\.\* .\.* \   #
#. . \.**..  \* .. \#
#\. .. ..* *  .*.  *#
# .  *.* . . \..*..*#
#. .\\ \   **.. * .*#
#**\..* *\  *.*\.. *#
#*.\  . ...*... .*\.#
#\\..*\* *\*  *.\.\ #
#..\*\*..* . \.*.  *#
#... .*\..*\* *.  *\#
#  *. .   \** *..*\*#
#  . \......*\**.. \#
#*  .  **\. ..*. . .#
# .*\ ..* \   ..   \#
#\  *.. .  \ . .....#
#  ..\.. *. ..  .**\#
# *.   *.\*.*..*.*..#
#.*\ *  .. *...* . .#
#.*..  .*...  * .   #
#. **.*\..  ....  * #
#**.\ *\**\ \  *..*.#
#**.. .. ** .**.* * #
#\.*. .   .*...\*.  #
# .*\  * * \  ...\ *#
#\ * . ... .. .\ .\ #
#...  **.\*  *\..\ .#
#  **.*..  \.*.*\...#
#\  .\. .*\.*.....*.#
#.\**.** \. **\*  .\#
#\*. *\    ...*. .* #
#*.  . \*.\ *  *  \ #
#** **\ .. .\ *.\ . #
#..*\.**\..* ..\. * #
#* .\ .* * ..   . . #
#.\ . **.\ ......  .#
# . . **.*\* .*.** \#
# \** \. *...\*\..  #
#**.\ ..\.. .  *....#
#.*..\... \**.\.*\*\#
#.. ...\.\ .\   .\ .#
# \  .*.***\. * ..**#
#*. * \\.*..*.* *\ .#
#.\*.\.  .* . . ..\ #
#.*..  .. ...  ***.*#
#  **.\ .***. .....*#
# * .... ...*\*. . .#
# \\ . ..*. .. . *. #
#.* .. *.*..*   ..\ #
#..  R.\*.*\. . *\..#
#*.  .. ...\*\ .*\  #
#*.*\.   .... \..*..#
#...*.\ *....\ . * .#
# \**   .  . ..*\.*.#
#..*.. \ * * \  . .\#
#\*. .*** .....    .#
# *.\ .. .*\ \ .* *.#
#..*.\..\ *...* .\.*#
#  ... **.*.*.*  **.#
#.  * *.. . ...\*...#
#. .\*..  \.\**  **.#
# .. .\ \. .*.. *.**#
#.*\ .* . .. *\..\..#
#*.\.... . .\... . .#
#**. *.*.*   *. .   #
#\*\ ... ..*...*.. *#
# .*.* .\ \..\ **\..#
#* .*. \..    ..* *.#
#.*\.*\* **.\ .*****#
#.\.*.*  \*  .** .*.#
#** \..  ... .  .*. #
#\*\. ..**\ ** * . *#
#** **. ** ..... ***#
#*\ *  .. * . .. .*.#
#* ..**..*...   *.*.#
#*.* ..\.. \*..\.\..#
#.* .* *\.  .*\  ***#
#\* *. \* .* \.  ..*#
#*. \*..\  .**...\* #
#.\ .*.*  .*..* **\ #
#. ....*   .  . .. *#
#***   .* * . ..*...#
#*..\.\***.. *\\..*.#
#\ ...\ .. \..*.\..\#
# ***\.*\*\.\..\... #
#****.\. .* * * . . #
# .\. ***.* ..**\   #
#. .\ \.\.* . \.   \#
#* *. ..*..\.*. \*. #
#* .*. *\*  .  ..**.#
#   \* * . .\. ** \.#
#... .*. \.. ..\..\ #
#..* .***..\**..\.. #
#\   .*..* **.    \.#
#.  * .  \ .. .*....#
#\ ..*.\.. .\*..*..\#
# *. .  *   .\* .*..#
# . *\ ..** *\* *.. #
#   ...  \ . . ..   #
#.\ .. . .*. \ **..*#
# . .\. .  \. ... . #
#..  .. \. .***.. . #
#..** \ .**\.\***.. #
# *... *...**.\.**  #
#* . *...*\.*. .** *#
#\ * ..\ *. .*.*.*..#
# .* \ .*. * . ** * #
#*\   ..*  ..  **.. #
#*.... ..** * *\...\#
#\*.\  .*.* . .   .\#
#*.\.**..*..... ..*.#
#.. .. . .*.. .* **.#
#* * *.  \* .* ** \.#
#.\\.\  **\. * .*\..#
#* .\.\\*  *\.\\  **#
#.. *\...  .. *.. *.#
#.\*..\..\*. ..\\**.#
#. .. *.\ .     **\ #
#  \ *\***  .**..\.*#
#.. .. ..  \.\....\.#
# *   . ..* .*   *.*#
#*...**  ** \.\ *.*.#
# .   \*\..\...  . *#
#*.**\.*..* **.\   .#
#...\.\..*..\\ *\..\#
# . ..  .* **....   #
#\   .\.***.\ *\* .*#
#* *..  ...**\\..\ .#
#     ..\*\.*. . .* #
# \*  ..*. *\.\ . . #
#... \ *\.  *. ..*\\#
#\   *.. . ...*.. * #
#*.. .*. *\    .*.\*#
#\. \*\.\ *\*\ .\. .#
#*  .. ..*\..** ..*\#
#** . \  .  .**\ . *#
#\..\ .\. .\\.*.* *.#
#.\.  **.  * *.*...*#
# ... .\..*.\.***. .#
# .\..* *..* ....*\ #
# *. **  . . ...*..*#
#*.. \.** \   *....*#
#.....     .*..\ \.*#
#\.*.  .    .. *...*#
# \*..\* ....\ .\* .#
#..***   .. *.. ..  #
#. \*.\ . \ ****.*  #
#\*..  \*.\ . .\.. .#
#*.** \.*\   \   .  #
#*. \ .... ..... *.\#
#***....\ * \ *. *\.#
#..  .*.. . ...\  . #
# .\\**\*.*\.\ . *. #
#   ..**\.\...  ..**#
# ** .\.\*. \ \.\..*#
#**.   *    .\.* **.#
#**\...*\*..*.*\ * *#
#****\..*....\.*....#
#.\*. .\.*\ .*   \*.#
# **. \ ..* *.\.\.* #
# \. ..**\..... *\..#
# ..  .. .   .\* *\.#
#\.\..\. *.* \   . *#
#.***\. \\.....*.\ \#
#####################