###########################################################################################################
# ..** ***\*..*. .**.***  *.* . ...*.. .   *.\   *  **...** * .*\ * .** * * \ .. . \ . .*\  . .   *\*\  ..#
#.\....... . *..\ .*..\. *. .  \ . .***. * *.*  .  \..**\.* .* **\*\ ..\*\. .  .* *.. * ..\.*\. ... \ ..\.#
#***\\.  .* \.**.  .*\.. .*\....**  ........ \ * \..*... . .\. . . \. * * \. .\ .**.*.....**. \  *\*. \  .#
#*** .      **\. .  .. *. .**\ . *\. .\.*. .\. \. \*...*  ..*.\.  *..\..* . ..* *.* **\.....* ..* \*  .\*.#
#.*... *\. .*.*\ .\.**. *....* .   ...**.* .     ..*..**. .*** **\**  \.*\**. .\.*.... .. *.  . .  .* .*\ #
# #   *.  . **. \ ***\ *.\\.* .\ *.\.  **\ \.*..*.    .\*..\.* .. .. *\ ....  \ **\**.  *\*. \.*   *.. *..#
#** ...** \\.\. . .*.*\.\  ..\.*.***\ ..\ *..\  * *.\\ .*..*.*.\.*\ ..    **\\ *\*..   \. . ** .....\**...#
#*.  ....\* .*   ..*.. *... .    \... . *  .**......*.. **.*.. ... .**...*...\.* .   .. .\. .* **\ *...  *#
#. .**\ . \**. * * .*... *. .* \ \..  .*.  . ..* *. ..* .. *.    \\...\ ...\*.*.  .*** . .* \. \*.\\*\ **.#
# \*.. * . ..*.. * ..\*\ \.*\. .\ . ..*.. **. \* .\.**  .**...  ..*\..*........\*.  *.  \***.  .. *.*.*..\#
#\..  *.\*...\ * \* .\\..\.. *  .* . *..* ..\. .*\  .. \ .. .\...* **.. .\*..\.\.  .. ..***.\.    *..* .  #
#  \ ...*. \ ...\ **  ..    .. * . .... *  .   . ....**.*.*  *\.\* .........*.*\ . *  *  *.\*. ** .\..\   #
#. ..*....\..\   ..*.\  \.. *\*..    * .*. *. .   . .....*\. ..**. .\ **..\..** \..\  * *.. ...\ * . .*...#
#  * \..*.**\ .... \... \   ...  *.. ..*\.*.\*\**.. .** .... ...... . ...*.. ..\*.\*..**. * * *. **  **** #
#. ...**\..*.\  \*...\* .*\    . *.* ...**.\....\...**. *.\  **  . \.. *.*.* *\.. .. ..*. ..  .*..**\..** #
#\  ..\\.** .*..  * . *  * \\ . * *.. *. *..**.*.** .    ..*  \.**...  . .\\**\* \  *  ... ** *\ ..\*\ .* #
#. .*..\*..  .\* .\.* *\ ..\. *.\ .  .. *.. *..\..*  . .*  . ..\.  . *.*.*  \*.*. .\.*..*  .*..*.*...**.\*#
# ..*..\  . .. .*  *..* ....\.*\   \..  . ... **\.*  .\ **.\  ***  . . * *\ .*\...* *..  ..*. .*.*\.*..* *#
#* ..**  .\...*.***.. \.*. ***. \  . *  *   *.*** . ...*. ..*..*..* .....\ .*** .\\...**.  .* ..\\ \.. ...#
#  . .*\.*.  ..* .. .........*..  .* \ ..*... \* .\ . .*.    . ..*\..      **\*   ..\*\*. \   .. \.. *\  *#
#\.\.\.. ... *.\*.\. *\.    ... .  *\.\   .\. \.\*.  .*.\*\ **\*..*    .*. .\.**.\ ..*.** .  .  *.\. .**.*#
#*\.* **.\ ..*..  .**..* .*\.  .* *. ...  \ \*  ***   \.** .. \.  .\  \  .. *.. ..*.\*.\.\.   \ *\*  **.*.#
# .\* .. .  ... . *.. ..*..  .  . ... \ .*. ..\.*.*\.*...** \ ..  \*..\ .\. *...\.. ....  .* \ \... .....\#
#.*..  * .\*..\.*.\.\. ..\. .\..  .**.......   .*\*.******.\... .\ . ..  .\  . ... *\* \* .\. ...  * .  * #
#..*  \. * \ **  \.\ ***..* .*\..\.\\* ..\.. *.*. ..\...\..*  ...**...*. ..... .**.. .. ..*. ** *.**. ..*\#
#*...*...\*...*.***...*. \.. .*.****\.\.  *\\ ...   .\*  .      .\..*.. .*\. . .\* \   \  **\.\..  ......\#
#. *...*.**. \* **..*..*..*\ .\ .*.\  *  ..  *\ *.\ ..*...  .. . *. .\. *..  *.*. .. \*  \..  ..*\. * ..**#
#\..*\.*  ....**. *. * *...\ *\...\.  ..*.*\ ...\\*.. ..\   .  .\*.\.  ..*\.*.*..     . * . \ .*.. ..**\..#
#  *..* .. *.\ .. .. .** \ . .**.*. .*..\.... . . *.  . .. . * \.\*  \\. * . ..*   \\. .*.\*.....*....... #
#\..  .*.  . ..*.*.\..*.*.\.......*...\ . .*  .. .. .* * *. .* . ** \ ** *\*\**.  *.. ... ..\******.*.\ \.#
#.*\   \.* *. \..\ *.\*..\.  .*\  *\..* .\ ** *...* * \... .\    *  ..*.*. ..\...\. \.... .*.\***..*.  **.#
#*.*.    .... * \\..** *..  . . .. .*.**. .*.. . .\*\\**.\ .  .\.*...*.  \.\**\ ..\..* \\*.......  * *.*..#
#**.\.\.   .... .**.*..\*\\ .\.  .**\... ...\ \.\ .* .***.\ .*\  *. .*\**. *.*.  * . \ . \ \.*** ....** ..#
#..\*. * \  .. \*.* **...  *..\*.\..*\ .. .\.**.***. .*\.*\ .\*. .\  *.\*\*. \* \ **..\   ..  *.  .*\.. ..#
# * .. . ..*   *. *  * \ \ . *. \.  . \.. .*\.*.\. .\*\**.*  . .\*..\.   .. ..* . .\ * \ **. \*.   ..*. * #
#    \.  *..*\.. . \.* ...   * \*   **\....**. . . \.. ..\.. \\.*\\ *..*... \\** .\  .  **. . . ..*.\. .\\#
#. \..     *.\***.\.  ** ....**. *\*\.   ...*   .\.*    \. .. \*.*\..  *\..\. * .\.***  **.\   . \.***.*..#
# .\..\*.  . . .. * ....  **\* ..\* *** ** *.\   .*. .. . .**. *.* *  .*...* .***. \*. \.\ . * **.**\* \ .#
#* *.. . . \.** ..*.* \* *.* **\.. \* . ..*.** .. *   .\*  ... ... .*  *..\..***.*\*..*.* .   *.. **.. \* #
#.*\   \..*..\.* .*.\ ..*.*. ...  *.. . .\.*..\   . .  *.*.\ ** .\  .\ \  .. *.\*****...\ \ .... \.. .\.. #
# .. . ..\.*. \.  .\ *. .**. \..*. * **...  \  \.   . .. .**\*.   *.. . *..\ *\.*.. ..   \ \\ .\... . **\*#
#*   . .. .**   *\ ... . ...*   .\**\**.\  .  *.* \.**.** .* . \. *.\ \ .* .....*  **\ . ..*\  .** *..*. \#
#.* \* \* .\ \.**. \     . ***..* .*.*.. .  ... .\.  ....  .*.\.\ .*. .. **\. ... *..*.\  ***** *.\. \ .* #
#\. . *.**  *. \*\.*. .*** .*. \.*\ ....\ *\*\ .. *.*.. \.\...  .  .\ .**\.** .*  .. . *. \.**  . *.    . #
#**** \***    \..\*.*. . \* . \. .  ..\   \.*.*.\*\ **..... ..*...*\.\.....\. *. . .\\..  * ..\  *..... *.#
#\*.. ..\.  * .\ ...  **... \*.    . ..*  ..* .* ....*..  .   * . \. * .. \ .\.*.  ..*.\  *.*..  ..\ \..*.#
#.. **..    * . \..*  \* .*...*\  . \  . .  .*.  \.\..\.*  \ *\.\..  *\*\ ....... . * \ . .*. \ *  *.***..#
#\**\ .\ *.. * ... .. ...*.** *  ... ..*.*\...  . * *\*.*.* .*.  .\..*..* \ .**.\ .**\ ...\. ..\*.*. *.. .#
#  * ..**   ...\*. \.* \... .*\.**  \..\...\ \..\  ...****.  *..\*.....\.\.  .. * ....  * .*\*.. .\  ..*..#
#***.*\.. ..**...*.*. *.*.*. * \.. *.*\*. *.\.\.\* * .. * ** * .*\.*\  ****\\ .*...****\.   ...    \.**...#
#**.. **.\...\..****. ..* *....\.\  . .*  . .* *....   \*\.. .\**.** . .\ ** . .**\\ .\.   .* ..  ....   .#
#.**.*...***. \.\.\* .\.   \.  .\  .  .  \*\R. .*  .. . *\ .**.\* .*\ * ....\*.*. *** *.  . *..** *. . *\*#
#\.\.**\\.**.  ******  . *\.*\*. .. . *\*.\   * *. ... \..* ..*.\ ..**.\ * \..*   ..*.***..\.*..*\ *\*. . #
#*.... .\.\*\ \ .\*..   \. ..* *  *.* *\.\*\ .  .. *.*\.***.*. .*\ *..\ .\ .*  ..*  ..*..**.\\**. .\.. . .#
#*.*.     .. .\   *. .  .  . *\..**...   **...**. *..**.  *\**\ ... .\* \.  *.\ \***..* .... ... \*.\. . \#
#*** *.\.\ *  *\*..\*\ *..  \* .\* *..\ . *\ .  *.. *\    \ .   ..   *\ . . *.  ...\**. * .. *\ ...*  ...*#
#.*\ *..* .*. .***.*.* *  ...\ . . ..  ....\ *.....* . \*\ \**..\  .*.  ...**\ .** ......* \...\ \ . * *..#
#\\ *..  .**.  **...\\* .*  * .*....**. .\. .\.*...* *  *\*..*.*.*  **\*.***\ . .* * *. .\. ..\.*. . . \ .#
# .*..**\  \. .* . ..... . .\ \..**\**\.**.  *.\.*  .*.\..  .\. \\ ..\.*. .\\ ***  *.\\ ****.. .*. \. \. *#
#*.\.  \  *. *.. *\   . .  .* .*\*..*..  .\.*\\**  *...\ .**.*.\  ** *...*\.* .   * .  *.**. \ * ... ..   #
#***  **.*. .*. . . *\ . .\.  \....*..\\* .\.. . **.*\..*.. ..\  ***...*.**.* *  *.   ......\.  *  . .. .*#
#**.*. **.  ** ....  ...*\ ... .  .*.  .****\ ..* *\\..*...  ...\*.\*.*. .*....  \.*\  \ . *.*...*.. * * .#
#*...*\\\..\.* *..\\.**.. \*\*..\\. **  \ .**.\ . ..\ .*    .   . . ....\*.. . *..*\ . .. ....   ..  * .* #
#..*.\*...** * . . **.**.\..  \\.... \*...**.*...  \ * . ..\.* .    *  ....*.  .\** ..  \*...\    * .* ...#
#* .  .*\.**  \* . ..*\..*.\ *. ..*\\..*\  *\.\  *\. ..\    *.  .. **\**\\.*. \  \..   \ ***   . .. \*.. .#
#*  .*\.*..*  ..\ * .. .\.\ *..* *. *.\\  . ....*. *.    * ..*.**  ..*\.   ..  ... . ..*....  \* ** ..  . #
#*\..\   .\.\* . .\.\. *  ...** .*  * *\ \.... . .*\  \.... .***\ *....\  .\* *..\*  . . \* \. .**.**\  * #
#*. * . \\ \ ..\  * *. . ... .**. . *\.\ .*   ..*..*.*...*.* .\*. .**    ....\**. .  \... .\ ... * .\* ...#
#.\ . . .... **. *.. **.* *.  . ..*..**.\\ .\ .*....  .. *\.\  .\*\..\ .*\... .  . **\.* *** . . \...*   .#
# .   . *\*  ..*.\. *   ..  *.\ *  ..\.   * *...*** *\ * . .. \*.**.\.\  ..*..**. *\*. .   . \. .*  *. . *#
#\** *\ ... . \*.*  . *** .**. *..  .. .**. .*\ .*. ..*  *. *  . ..*\** ..*. . .\..*. . \*\**...\* \.  *.*#
#.** \..*\..\ .**.\*. *.*. *....\. ... \..  .\*.*. . .. *. ...*.\ *\ .\. \*.\**\..*\* \ *. **  ... .*. . \#
#.****. .  **\... ..... \.*\   . .*  \..*..\*.*.....\  ..*. ...* .. *\.\..  ***.. \ **.*.  .\\  .*.. . ..\#
#*.*\.\   **\ * .  . .*..*. **\  *.*.\ .. . .*.\ .\.    *. \ * ..\*.*.*.**.*. .** .\ .\.   ..\*.  .*..\*\ #
#.*.*...\.... . \ . .*..\. .*.. .. .* ..\ **.* ... ..*\*.\.. * *\*\ .\.*\*.. .*.* . *.* **. ...* . * * .  #
#**\.. \   * . .****..*. .\ *.. * .\..*..\.*\. ..\ \*..***. .. .*. \....**...\.*.\  ....\. *\\ . *.. . \ .#
#...*. .*.\**..\ * * *   ..\...**\* ..\..\.* *.. .*.. *.*.... * .    . \.\ . .***. \  ..  ..*  *\.****  \.#
#  \. .*.. .\ *... .\.\*.. \ *\.\.*.    .**.*.. *.. \ .... .*\\  .**.*\..  *... . *  \.\. .  \ ..\.\.. .  #
# .\ *. .  .....  . .\ ...* ..* *\..*\ \.**.\* *\*  . \..   . *. ..*. .. ***  .*\.\. . .* . .** ..\ ...* *#
#  .*\..**\* .  ..\\.**  . \* .*..*\. .\..*\  *...     \\. ** .\.* .* . ..*.*\  .\ \*.\.. *.\*\.. *... \ *#
#.\..*\... .. . .\ \ . \ . ..\ \ \.*.\ .*.\.*...\. .. **.* ..*..* \..*.\  \.*...**\.*\. . \. .  .*.\*.*.\*#
#\ . .*  * . .\   * .\.  \*.*..**  ...** \* .*.* .. *\. *... .*   . \.. .*.. * ...* . .*. ..\ \\ **\. *.*\#
#   . *\*.\ \ ..*.. **\   **.***.\.\..... \**...  * .**** \  .. .. ...\ \.. .\ .. .. \\ *. \*..\* .* * *\ #
#\. * \ .. .  * .\**.*..  .\ .*\ \.      .*.*.*\. *.. **\.....\.* .*\.... .*. \**** . .**   \.. . *.*.\\ .#
#...      *\  .    *..  *...\  .\.   *\..\. *. .*.. * *..   .\... .\ *.\*\ **  .*.*. .*.  ** . .*. \..  \ #
#\* *. ...*. . *\ *..** .\*. . \\* * *  ..... ...*   .*.  .*. * .... *.... ** . **.** *\. *. . *.   ..\. *#
#.*...*..\.*.  *  ...\....\*.   .. . *... . ** .. .\.  ** *.*.** \*\*.......  .*..*.\ .  \*.*\ . . \.*. **#
#*.   ..**.*.*** *   *.. \.* .*\* *. . .  .*  ..*  ..*\.*  .\ *.  . .*.\\\ *\*..* * ***.\.* **..**  . \...#
#..    \*   \.\**\ . .   .  \ ... *\.  . .**\ *\ *\.\\* . ..*.**    *.. \ . *.\.. \ ..*\.*.\..*    \\.*.* #
#*. ****\ *. .*\\...\.. *...*\ \ \ .\ . ** **** \.. *...  ..* *. .. *.   .. .** *. * \*. \.. . .....   *. #
#* *\***..  \ ...\**  * . *..*\     * *\. *\.*\ . . .    . .\ **  .*..*....**.. \..\***\..\*   .  .\ .*..*#
#\ ..\**.. \ \.*. \. ... **  .. *  . \. **\. ..**.  **\\*\  *..\.  ...**\. *...*. \** .  .**...\\**\ **\  #
#*. ***\.*.  . .**.*.* . *\. **..  *. *\.   \* *.*. . . * .* ... .\  *..... .**.\. . \. *\  \. . .. .\....#
#...\ *\ * \  . *...\.\ .......*\**.*\.   \.*. . *. *... * .  ** .* ..*\* * *.. *.\*  ..*.\ .. .* ...  *  #
#. ....*.  .\..*.*\**..**\. \ ...\.**.   . \.. \..   **..  *\..* .. *\ *...... .\\.*\ . . *   * ..\. .*\  #
#* ..* *... ..*. * ..*\..*.  \*\.*..\ *.*.  *\ .\\*.* . *. ..*.* \. .* . .*.... .. ..  .\.*\.. ..**  .*  *#
#.\*\. ***  \*.*.. ..**..*\**... .* .\.*\\.. .*.*.*.*. .. *. ..\. *.\.  \ *\. *  * ** \  \ .* \\  .  . \.*#
# ..*..*.\..... . *  *.  . **   .*. .. \.\ .    . \..\**\\******... .. ...\. ..*  *.*\   ..*...\ .\.\ *. .#
#*... *.*.*.\. \ **   \  \.*\   .\  *  .. .\  \   .* *..* .\...\ ** \  *.* **  ..*. .*.* ....\. .  \. .*\.#
#*  ..*.. \  **..*. .****  ...  .. ...  .*. *.***.*.  *\.*.* *...\*.* .* * *.*.. \**.* \ ** . *\. . * *.* #
#. **\* *..*.. *\*** .\.\**... \.    * ****.* * ...*. .  ..* \..\\ ..*\..\ *\.... *..\... . .\ .. . ..\..*#
# ***** .. * **.. .*.* ..\*  *..  * .. ..**  ... . . \ .  ... ** \** \ .*  *\.. \..\.  .*... *     \.*\  .#
# *\*.\ * .. .*\.  *  . .*. *..**..\   **.* . . . .** .*.. ...\.\.\. ** .\ \  . \.    . ** *..*\\.*  *\.*\#
# .* \*.. .\. ..\    .*..*... **\*\  \.\. .*\ .*.  . .*. *.**.  ..\.**.  *.   \. *..*..\ **  .... ...\* . #
# *.\...\.  *\*\ ..* *\*. .\.\..*.*\ * ***    \* . .*.**\*.\*..*****.* *....\..   \*. .*\*\ *\*. ***..... #
#\.. .\.*.. . .*. . .*. \.*** .**** *.  \*.   ..  *.....*  .*  .\*. .*\..*.\.  *. .*.*.... \.\*. .*..\*...#
#.\ *. .** **. ...\.*. *...*.  .*** . * ....*...  *... \. ..\.  .   *..\... .. ..  *\*  \. ...*   *\  *\. #
#..   * .*   .\. *. .*\....**.*\* *\*.\  .*\** \.*... *    ** *** . ..  ** \*  .*\. .* * * .  ** \ ... .\ #
#.\. ..**\ .\  * ..\\ ** .\.* *\. . .  *. ...\ . .\\  .\. *. . \.. .**\ .\... ***\..*. .** \   ..*. \ *..*#
#   .* * *# ...\.*.  .\.*  .**.*\ . * *.. \  .*...**\ ......\ *. ..*.**. *. .. ***\***.* \*   **\* .*  . .#
#.* \..*\*. \** ...\\ **.   .......\*. . . .* \.\.\ . .*..**.\. .\.\ **  * ... .......\.*.* . ** . .*.\.. #
#*.. \\. . *.*  *\.  .\....* \.*. *.\.*..* **...* .** ...***.  \.*\.*. ...* \*.* \** . ...*. *\..\   .*.**#
#. \.. * .....*\  \ \.**. ..\  . . \*\.*   \ **.*\..  ..****..*. \..*. *.\..**\ *.... .\.*. \  .*.\ *..*. #
## ..\.\ .*.* . ...\ **. .\ \  **\. .. \.\ .   *.*...\  \.... . * ..*. **.  .\ .* ** .  \\ . *..*.. . .**.#
### *.. . *\.  . .  ..*.    .\\*.   ..*. *.\ .*. .   .\.\.**  ....*\* .*. **\* \..*\. \. . .\.  ..* \.\.\.#
#*. ##\\.*.\ *.  .\.. *.. . \  *.*  * .*..  ..* **..   \ ..*  . ..\....* \.*..\  .*.*\.**\. . .  *.*. . .\#
###   *\.*. ..  **   *.   . * .**\ .. .. . \**.\***.*...*  ..  .\\.*.* \ .\..*  \ ... .\..\..   ..  * .*  #
###.**.. .*\ . \ .* .* .\**... .. ***.**  \ .*. ...**** . **\**\ .\...  . ***.\   .\.\**\\**..**. .\*   * #
#*  .  *.\.    .* ..  .\  ...\. ..**. **\** .\. . ....*.* *\... * *. ***\ ***.* .*\.*... \*..*.\    *  *  #
#\ .  **\.*   .*....\  *\*.\*..\ .**\ ..\.*.\*\*.  *\...\ ... .\*\.*.*\*. *.***. .*..\\...\. .***.\..\.. \#
# ..*...* ***\ *. \ **.. \. .*   *.  * .. ..*.*\**... * .* *..  *  **..\* *\.\.. \.. **. ... .\\.. \  * \.#
#\ \*..\. .*.  . **.*.**. .. .\.\.*\..\  ...*.\.. .\*..\..\ \..*.. .*\. ... ...* .\* ..\    . ...* . \.\..#
#...\* .**.**.\ ..... .*.  \ *.. ..*\ .***. ** \  * \*\ .** .. .\   *.    .*\ \.. \     *.**.\     .*.... #
#.*.*.\ .....*....*.. * *   *. \...\ * *\.  *  .\ . ... *..\*.* . ...   .*.. ..*\*\* .* *\.. .** ..*.*..* #
# . \*.  ..*\..  ... *....*\ * .* . *. .*.  \* \* *.   *** *. \.*\ \.*.\\. ..\*...\* .. .* . \*\. .\.*.***#
#\ ...  . .. *  .*..*\ ***.. . .*   .\*\... . . *\.   ....*\. . \. .\.\  *    .. * ...\**  **..* *.*.\. \.#
#.\ .\\ *..  . .\*\. .\...*. * .. .*. *\.\***..  .* * *** .. \.*\ ...\.  ...*.* ..     \\ *..\ . . .  ... #
###. .*.*.   . * ..\*..\  \..* . . \ . . \.. .\.*\*.*.*..* . .* .\*.* .*. **.*.\..*...**.\* .  *.\**  .** #
# #...*#*\. *.** * ... *\ ..*\.* *. \**  . .\ *.**\ * * *.  *\. *.***. ...*\.  . \*.   .\.*\ .\ *. .* .*..#
# #.*###  \ ...\   .**....* \ *\ * *  *\. ****\.... * ...*.*.. .. *.*.\\* . .  * *. \ *\ .*. *.\* \ .. .*\#
#  ##  #\ .* \...*..**\  \  ...* \..**  .. .\... *..*.  *. * * * . . * ...  ..\.*\......\    **.. \...\ * #
#       #* *#..\ \***\... *  .#. ..*.* **  #. .. .  . * .  .\.   ..* ..* .\** \.\  *    **  *.** .* *...**#
#      # .*#..\.  ..  ..*..\. ..* \. # .    ..* . *\  *  .\.** ..\ *...   ...  ..*..\.. .*.\.*..\*...\   .#
#       ### # . .*. .\ ***..#**..    .\ . *.*.*\.\.** *  .\ *\ *\\\\* .. .\  .. * .* ..  .** .*  . **.   *#
#            #..*..* .*... *\ *\*\*\  \ *\....\ *.... *.*\...  .*.\..*.... \ ......\. .* \ . \* \...\ .   #
#             # \#.*  ...**\. .  #** **\ * .. ...\.*\..*.. .*.*...* \.\  . .  .....** .** * \ *.\ . .   ..#
#             #\  *. * . *.## \.\ #.#*\.*\   . . .\.* *.. ***** *..*.  .*.\ .\ .*. *. . .\..  .. .. *\*..\#
#              ## . .* * .  *.\\. #\.#  .* .\*. *\.*. *. \. \*..\.*.\. . *... .*...\.\. *.. .*.*.**.**.\*.#
#               #*\. . .  \ . * # \###  .#  .*... # *.*...** ..*.*.\ * *...**.\.*...*.\ .. ..  .   ...*.\ #
#              ###.\. .  \   ## ###  #. ##\ \. *.\.\\ *..  .  *..* ..\ ....\**.\......  ..  ...*\.*  ** *.#
#             #**. .**\. ...*.#*#     # .#*.. *..* *.*...*  ..* ..\.** \**.*...  * *....*. . . .**. ..*..*#
#              #..\.\ #*.** . ##       ###....\. . *  ... ..  .*...*..  *.*.\.** . .\ .*. .\. . \.* . *.\ #
#               ##  ..\. . .#*#          #. ..***... ..*.*.  *.. *#**. *...**...  .**  .**  .. * ..\.\*.  #
#                #   #.* . \##           #*\  ..*.#    . .  **.#.# .  .\ . .\**.  ***. .*\.*. .. ****** \ #
#               #** .\\. ...#          ### * *  \   *.\   *\\... .  .  ##**.*.** \* . . ***.*\.**.**.\. .*#
#                ###*# .#*..#         #*\*\.*   .*  .*.\..*.* *. \.\. *....#* *. .\. ..\*.. #. *.*.*##.# ##
#                  #.  .## .#         #\## #..**  .***..*\*...*. #.**\.\. \ \.* \.* . \... . \.  \*. .\.. #
#                  #*#  ##\ #         # #  **# #* \. .  ##. ###*.#### \## #..#* . * *.. * \.*.  . .\. #**\#
#                   # ##  ##          #.#. # ## #\#  ...##*#   #\#  #\#  #.  #* *.. \ **\ #* *****.\*\* #*#
#                                      ##\ ##   #.#\..##  #    # #   #   # .*#.**.*#.... \\#*#..\.# *#*..##
#                                        ##    #. \*\.*#        #        # *.# ** .#. .\*#*#\#.*###*# # # #
#                                              #*..##*#                 #.\.#. ##* *\ # *#.## ##   #   #  #
#                                               ####* #                  ##*### #**\#.*\# #               #
#                                                   ##                     #     ###L.#*#                 #
#                                                                                   # ##                  #
###########################################################################################################