#########################################################################################################################################
#*..* * .*..\. ..  .** ....* \*.. \ .  . .** .. .*\.*...**\  *. ** ..  . .. *\. **.**..\ * ..*\\.* .*\...  **. .\ *\.\..*. *   *\ \. .**#
### \ ..*#*\..* . . ..\.**.\ .***  ** *\ *\.*\  \*.***.. **.\.. \*  **\\.\     ......* .......*\.  .\*** *\. ....  \ \.\. *.\.\*...*.**.#
#  ##*\#.\  .*.. *.*. *.  .. .\ ..\..*\ *\. .* \. .....* ..* ..  .* \**\* .* \* \*\* .*\*. ..\..... *\. \..*  . . *. .*  \* . \*\ .. *\.#
# ###*#.**... . \.\.\**..   .. *.* ..   ..\  .*...\ *. .*\*.  * ***...*.   *.   .  .  ...*... *. .\.\ *  *.\ .  * . **.\.  *  ...*. *.**#
##    \*.\ . *...\ *.  **. *.\ .*.  .** .\ \    ..*.\* .*.  *.\ \.... .  *.*\.  *\*\.*. *\ . *..*. **.. . ..   .. . ... \.... \*\  *.   #
# ##...#**\..*\. ..*. .*   ..* \*\* **.**  \* *\*..\ ..*\.*  \*.. .*...*\.*\**. . . *.\  . ..\.**. ** .\** ..  .*..\. ... *.**....     *#
# #* .  \****. \ ...\....* \ *\* ....\*. * \ .\..*.*  * ....\   . ..* \.***..*. \.*.**. .*\..\  .....  *\*** \*.*\\*   *\.. ..\.. .* . *#
#  #.*..*.*..  .**.*\   ** .*...*\ .\...   ..**\   ..*   *\**.. \ **\*.\ ..  . **.  \.** .. *... . . .\...*....*.. . *..  .. . \  *. ...#
#  #\**\*\..\.* *. .*.* .\.*.. .*..  .*  .\**...\ *...\ ** .*.* ....*.\.\   *  \.*\ .. .* .....\ * .  *.. .\*  **. * *. *.**.\. * .     #
#   # . *  .*..\   *. .**..*.*..\. . ..  ....\.\ .*  \ .\.\ .*\ . .  ...** .\*. .\*.*.. ..*. * . .. .*.*.\  . *\.*.*.*  ...*... .. * \*.#
#  #*\**.. *.\ *.\**\ *..*.. . ..\ . .\ ***. * * .\  .....  *\.. .\*.   ... *.. ***.*  **\\*.*..  ...***\. .\. .** \ . \ .*..\.*  . \...#
#  #  \... **. *\ ** \.\.*.* ....*   .   ..\ ****\. *.   .R \ .*. .\..  ..* .\*\.*\ .  .\  ..*\**  * *...  .*  .\* .* *.. \..\...*\.*\\ #
#  #.#.*   *\..\..*.  ** .**\  \..\   \  .\. .. ... . .  .\.* *...   .\.***.*.*. * . . \*.   .*..  \*...\.  .. .*.  ..\\. .... \**\* .\.#
#   #\ #*\*.\  .\..\ * . *.*.. * .* .... . ..*..**. ..   ** \.  .*\.*. \... .\.  \    *. \. \\. **.\\..\** .....* .....* .  ** ... . * *#
#  #.  *\**..\..  ..\. **. .\..\  . *. *..****  ..   *. \..*.\.*\.* .. *. .*..  \. .     .... . ..* *. . \.\. . **\ .\  .* * *.****.\*.*#
#  ##*L \#\.*  . .*   .*...\.\...  .\.*. ..\*****\ **.\*...** . *..\.**..    *..*.*  ..*\.\. \  ....*  * \. .\   ****. \.  .\. ... . . .#
# #.  \ *  .. \..*.   *.\  .  **\*.   \ . \ *.\.. .**..\.....* *.*\.*\..\  \ .. \*.   ..* .\ .* .  ** \.  ..  . .. *\.  . .*.\* ..\. .\.#
# #\  .*..**.... ..\. .  *.* *.* *.\.  .**\**\\.  . . .* \ . \*  .... . .\..\  * .... ....  . .**\*..  .*.*.. **\ .*.\..*. .. *\.* . . .#
#  ## ***.*.\.** .  . \*\******...\.. **.....**\*\ .***. * .. ..      .\.\. .\ ...** \ ...\ *..*.\**\...\ * .*.*....*.\. \ ....  .   .  #
#    ####*# ..\..*\*...\*.*..*.* .* **.**   \*.*.*.***\*.. \  *  *\ \*.*.\\*\.  * ....\*\**.. \ * *.  *\**.. .*.*\\ * \\** **.\ \...\  *#
#########################################################################################################################################