###########################################
#       #*##                  #           #
#  #    #\  #                #\#          #
###\# ###** *#           #  # . #     #   #
#*# ##...\.*#       # ###.#  #. .#  ## #  #
#\* #*L #* . #     #.#\ #\###*\*# ##..*## #
##  ....\\* ##   ###**  .*#\.....#*..*.. ##
##\##. \.\\ **# #*  ##\.# *.*. .  .\ \*.  #
#.**. .# .  . .#\.*  .**#*# *\\ * * .\.** #
#*\..**.*. .. . * \....*#....  ..\#..*... #
#.#\ \..**.   #.  .. .**.\..*#..  \ .. ..\#
# .........  ....*.  \...** \....\   ..\  #
#* *.*.* \#\   . .\ * .. \ * **  #. \.  \.#
#**\*\ *\.. \\*  .  \ \* . *...\**. .\ \#.#
#\*.\ ....... .  ..\** *\. .   *.*.\*\ .. #
# \* . *.\.*\ *\..**..* .* \.**..*  .*\.. #
#..* *\ \* ....  .*.#... * .* .\.**.  ..\ #
#. ..*\*.. .*\\ * ..* \* ** .** ..*. \\ *\#
#\* \.*..\...*  .. \.*.. . *..  . . ... **#
# .\..*..   .. ***\..**\*.\.****.. ...#\* #
#\*.\.. \*.\* *..*.\ ..*.* ..   *.\ \ ... #
#*\*  *. *\..\.   ...\ .**\ *  ..* *.\ .* #
#\\..\.*.\ .\. *.* .*..*. *.. ....   .*.\*#
#. . .* ... .. ..\. *\.*\  . .\.*\\.  .* \#
#  .*.*..   . .  ...\.*\*  .\ *\.  \  \ \*#
#. .\\*.  . \     .........\ *.*.. .*. \. #
#*\** \* . *. . *\* \*.  * ..\*\..*\.    .#
#\*..*.. **  \****\...*\.*.  ..***\.  * \*#
# .. . \ . .....*.. *..*..*..*\ .*  .\* ..#
#.. .\  .*\..*.**.*\ * \* .\*.**.  ...**..#
#*   *.* **. *.. ....\\ .\   .*\ *   .*\*\#
#.\ ...\ ..*\   . *     *.  .*   . ..*..  #
#* *\ . *\.* .\.*   .  \ *.*\.**.*.*.*.  .#
#\\  .\.   .. *..\.   \ *.  *  *...***....#
#. * . * .\ . * . * **.*.  ..*.* *..**\ \ #
#\..   ..\.*. .  ..\ . ... .* *. .**.\*   #
# *.*.** . \. **  \..*.. . \...\  . *\\ * #
#.* *..\.\*.....\. .   *.. ...\. .\ * .\.\#
# . ... .\..*.. ..*** . .   *\   . **\ .\.#
#\.* \* ..*..*.\ **.\.*..\... .. ....*. . #
#. \. .\...\ \.. \  .\. *.***\.*.*.**    .#
#  .   .* *...*  ..  \ **\.. .....*.*\ . *#
#.*. *   ..*  . .*.* ..*..* . *. **.*. ..\#
#\. ..*\. .\.  . *. .... .*.. *.. .   .  *#
# *.. ..*  *. ....\. .\\  .* **. \.\  * \*#
# .* .  ..*..*.\\..  .* *. ..*\ \.\*. .\\ #
#  * *****\** * .* *. . .......**.  . *..\#
#  \.\\.*.\.. *.*..** .* \*\   \.\  .\\.*.#
#.\. *.*..  . .**.. *. *    \.*.*..** .   #
# ....  .\*. *.. .\.** .\  . .\..*..*   **#
#\  . ..*. . .*.   .** **. . \.. .*.. ... #
# \ \.*.*\.  ..*  .. **..  ...  *.*  *..*.#
#\.* \.\\.***.\*.\.*\*.\  .    *. *.\.  ..#
#. .\.  *.\.\ \. *\***...  **.*\ .\..\.*..#
# **  .*.\....*  .. . ****. .**.\ ..\.*.\*#
#  *  .. . . .\*.. .\..\.\.  .. .\ .....*.#
# \... . ** ..*.\.*.   .* \ \.\ ... .. .\*#
#..*.*.*\...* . *.* ... * \. * .  .  *.\.*#
#.\.   .. ..* .*\** ...\.*...*\ .\  .  *.*#
# *..\ *\ **.. . *.** *..**\.*. . * **\***#
#\**.. \...  .**  *. . \ .*. *... .*\.*\..#
#\ .*\ .  . .\... .\..\.  .*\\.* \.**....*#
#.\*\ *.****..\* \.. \. .* *  ..\.*.. ..*.#
#..*...*..*.*..  . .\.   \ . .* **... *..\#
#\*.*  .*....*\ . *  . . *.. ..**.* *..*..#
#.\*  **.   .\. ..\ ..\* .*  .\*. . .  ..\#
# \*.....\.*\\ .\.  ** .. .\.\ . .\...*. .#
#... *.*. \  \.*.*.**.   .*\*..* .*\ . ** #
#\.\\*.*. .*\ \.\.* ...**.. .. *\ . *.*.* #
#....*.. * * *. * *. ..   \  * ** .\*.. .*#
#.* **. .*\*\.**. ..   \\. .. ....*..*.\.\#
#*. \** **\**\... *... . .... .*.*.\*.\.  #
#..   \ ..... *..\.  ** *.\ *\  .*....*.  #
#.*\**.\.  .*\  *.*.\.* .....*.. .\.. .   #
#.. ***.*\* .\*..\..* . \*. \.   \. \..*. #
#  ..*.. ..*.. \   .. . ....\. .*   *... .#
#*\**... *\*. \.\*.    *\ *..  ** *.* .\. #
#\\** .*.*****.**.\..  . .*..\.....  \ *\ #
#.*.\***.....\..\ .   *. ..  .* * .*. *** #
#.*.* *** .\..* .\ ** *** *..*. \ ..*\\.. #
#*.\...\. ..\ . *. \. ..\ * \*.*..\.    **#
#.* .*. *\  *\ . . .**...* ..**\.*   *. . #
# .. ..*\ *\*..*.*. ***. ..*...... . \..  #
# . *\. *..*.* .  .*\.*. \ .* .* *.*\. .. #
#.  .* .**.\..*\*.*. ** *.\ . *  . * \*. .#
# ..**  . . *\ ..*..*.\ ..*.  ..*   **.* \#
# *\*. \  ....**.\.\*** \   .*.**\  ***\. #
# ...*\.*\  .  *.  \.\* .*.*.*.** .\*.\*\ #
#*.  .... .\. **  .\. .  \..*.*.\*.\...***#
#\* \. .*... .. *\.\*  \. . *\. .** *. ..*#
#\\  ....  ..*.*\**.. . \   ** \  *\ \  \.#
#* *..    *...\..\***   ..*\.*.*..\.   .**#
#.    \.*.. .\\. *\ * .. \.. *\*.**.....*.#
#...**.   \ ... .**.*\*.. .\ ....\.\... *.#
#.. .*  \ \. *   .\*..\\* ...\***. .\   \\#
# .\..\. *...*. . .*\   * .*\ .*.*\ .. . .#
#... *.  . . *..\ .. *. \ \..   ..* . *.. #
# . *.\ \.\ ..\  *  .*\. .* * **  .**.*   #
#*.\..*  .  ....\.*..\. \ *\. *. . .\ .** #
#.\*  .. .. **  *\.*\ . .  . .** .  *  .**#
#\..\* .   **\.** ...   **\... . * \ *. \\#
#** ..*..* \. *.\   ... .\.***. \... ..*.\#
#.  \* * * .\.**  ....\..*.\. **\ **  \...#
#*. ..  * \  .* *. .   * .\*\ \..\.*** .. #
#. .\****.*..*..\..\  .*.*.*. ..\..\.\ \..#
#.   ....\  . **..  .  .*... .*\ *\* **.*.#
#.\** .\  \*....\  .* **\\. .*.. ..*...   #
#\ ** ...\.*  . .  *. **... * *. *\.\.\.*.#
#. .\..* ...  * *  ..*..\  *..   .*\.*. *.#
#.*..*** ***.\* .. .  * .*..\***\*****\ .\#
#*.  .\ *.*.  .  \ ...  *.**...* \..*..\**#
# * .\...  *.\  *.* .\ ...*..*\..\.\. \.*\#
#\.\*.*..  \\.\*... * * ..*...*. .* ..\*.*#
#.* . \ .\** . \. *\.. ..  \**..*\.* ..* *#
# *. ..* ..*\  .* \...  \...*..\.*.** \* *#
#...\......... .. .. \.*.\.... . *..**..\\#
# *.. *..** .*.*.*.   ...* . \ . .**.. .. #
#....**\..***..*.. * *\*...* .    .** *  \#
#  **.***\.*.*...\*.\....**.....\. \. .* *#
#\  *.*.*..  *.* *..   **.**\. **.*.*. . .#
#. **. .. ..**.  ..    * *.*. ***\\ .  \ *#
#  *..*. **.*\.  ..\*  . ....  ..  .    .*#
# .\. \. . * ..*\. ..\. . *\*. .*.*.*... .#
# .. *\ \.*\ *\..\ ..***.... . .. \...\ **#
#.\\*. *...... .\   ...\ .   ...   \.  \.*#
#*. ....\..... .\..*.\.***.* \ **\.  \ . .#
#*..\\.\*\.\.* * ..*   .. .*..\*..\.**    #
#  * . .\...*. . *.\.\ ...*\ \..* .*..\ .\#
# *** \  . .*\...\.*\ .\.\.  *. *\...... .#
# .\. . .....*\.\ \.   .\*  .**\ *.... .**#
# .. . \ *..*. \...  \.\.. .\.* \.\  . .\.#
#.. ......  *....  . ..*.* .  \\.*  *.*..*#
#. \\. .*. ... \.   **.*.* .**\.*.\*. ....#
# . . \\ ** .*  ....\. . .  \. .\  .\.  **#
# ** \.\.*   ..\...*. \.*.  .\ * . \ . *.\#
#\**..*..* *      \.\.  \.\...*..  * ..*  #
#\*\.  **..**.*.  *\ ..*    . ... . ...\.*#
#\. *....\.*.*. *..*\..*****.\ \  .*\..* .#
# .\..  ...*\. .\. ** **.\.* .  *****\ *  #
#\  * .\.  \ .\.*** *. .  \..*  \.. .*..  #
# *.. *. ...\ .\..*.. ..\   ** \     *.* .#
#\* . .*.*.\..*..\.. .  **. \. . *. *...  #
# . . ... . . .. ..\*..*.\ \  .**\* .*. **#
#  **.. \.*  .\  * ..* .   ... .*\.\*.\.*.#
#. *. **.*.. .  * . \*....\. .\ .  .. .**.#
#  .\*. \..    ..\. ...\ .  \* .  *\*\ .\ #
#\* \*  \\.. . *. . * ...  \.* ..  .*. * *#
#....*...*.*\ .\ \*  \  .\*.\..* * *...\ *#
#. .*.  *. .*** . .  .\*..** .** . .*. \  #
# . \ . ..  *\*  . **. * ..**.**. .\*. .  #
# .\.  .*. *. *\*\**.. *  \....*  .. \ .\.#
#...**.... .*\....*** \*  *.\. *.**. .*\..#
#* ....** .*.*. * . .... *.  * . **  *. . #
#*. \ *..\..\..*\\ ***.. .*.\.. **.* .*. .#
#  \. .*. ..*.   ..**.. * ....\..  .*\.\ *#
#.*.\ .*..  .\*. \ \*..\. ... \*...** *. .#
# .\* **\.  \*.\\.  .*.  *  ..** . .*.*. .#
#.\.. *\ .  .*.****...  \.    .   * . ...*#
#\.*. *.\  .*....* .*  *.   * ..  \ *  .*.#
#. .\* .. . . .*..\ \.\\**.....* *.*  \ **#
# .  *.**\  ...** .*..*...\  **.*... ..*\.#
#.*.\*\*.   *\ .* *.\ *.*  *\ .... .\     #
# . . *  * \. *\* .\.* **..** ..    ..\ .*#
#* ** \. . * *.  .    ..***\.**. .. ** .\*#
#*\.* . \.* \. *\. ..\* **\.     ...**\...#
#..** ... .* . ..*... ..\.*\  .* .  .   *.#
# ..  .. * *..*. .  *** **..**.* *\*** * .#
#..\.*. . *..*...*  *. ****.** . \*..**. .#
# *    * ..  ..  ..*.. \...  *.\ *..*\.. *#
#\  ..* . . ...  *..**\ *..* **..\*\*..  .#
# ..\.* ..*.\.   * .\.*.. **..\ \*\  *  . #
#.*..*...\..* \\.\ .. *R . .  *. \. .\.* .#
#..  . .** .* . ... . *.\  *.\..*. .*  .. #
#\ \ *.*...*\ *.\... . . .\.\* *****..\ ..#
#*. .. .*.\.  . ... \.  ...*. \ .*.. ...  #
#..* * ....*\.**.*.\* .    **\  ..  ... ..#
#*.\*.*.. \.  \\...*.\.  *...**\**\\  ** \#
#*\.  ** \ .**  .***..*.. ..*....\ ***..\ #
#..* \\ ......  .*..***\.**\....*..\.\.** #
#*\. . .* *.  **.*...\..*.\..*. *\..**.** #
#.*  **\...*\ .... .\**. .* **.*..  *. \..#
#**.\** \ \..* ** .  ...* . .* .\ *....* *#
#.**.*.*..* .. *.       .*.* .   *..\**. *#
#**..*\* ..**..\*  *\*.  .\.. ...  ..*. ..#
#... *...*.. *..\    .*.*. ..\.\.\ *... *\#
#. .\*..\ *. *  . * . .*\. * . .  * .*. **#
#.**.**.* **....  .*..**** . \.*..\..**...#
#\..  *\*.\...\ . ..  .\.  *\ *** ... *.\\#
#.\ ..\.\*  *    \ .*..**. ....**\* *.. .*#
#*..\ ...*...  ...* ..\...* \.  ..* ... **#
#**. * \ ** *. .*.. ..* . . . .. .....* \*#
#.**..   ..    *.*.  *. .\ \ * ** \*. \.. #
#\.*\.*.. .  ...*.* * .. .  * .  ... .***.#
#**\. \ \ ..\...\...\ . **..**  ..\...\* \#
#.. \ . **.\...\.*\ .   *\*...** *.*....  #
#\ .  \\.  .\ *...   *. .\.*. \  ... *.*..#
#.\  .. . *  **...* .. .***.. ..*  *\.\*. #
# . . \   *  .*  ... .. ..\\.... .\.\ ..* #
#\.\**    .\* *\* . .*\. . \*\.\  *   \ ..#
#  .. \.*...\*. .  . .*    .*....  \.   .\#
# . ..  .\.. *\.  \ .\* *.*\ *\*.. .** .* #
#.\ .  .**\** . *\ . .**..**.. ..\...**.*.#
#\...** .\.*.*.   ** *. ***. **\  . ...  .#
#.*.\\*.*..****.  .**.. ..*.... .\ ....   #
# .\. *\ .. ..\. \.. . ..\..*\* **  ..***.#
#\  .. .*\ *..\*\.**\  \ ** .\ \ . \  *\*.#
#..*\.. ...  ****.* .**  ** .* *.**.. ...*#
# \. *\*  ..  ..*. *\. ...* *. .*. .. ***.#
#\. **.* . \  . *..*.. .**.* .. *.   ..\* #
#.  .. .***. .*...\.*   . *..*\.*\ .  .*  #
#* .\. . ...***\  . *\    *.\.....\.  .\  #
#.   *** *\*\.\* ***...* .. *\..*\. *   .\#
#.  ..*.*\*..\\* .. \\*.    ..\..**.*.\..\#
# .. \... .\.*   . ...*  ...  .   . ..* ..#
#..\*.. *.* \  .*.. .. ..\*.\*.. ...*.\.\ #
#\. **. . *..  *.. *  *. .. ..\\* ...\   .#
#.*.*\.  *\ *   .*\. ** ..\.  .*. .\*.. . #
# ....***.* .\. *** ...     .* ..  .*.*  *#
#\ \* .\.*.\  .*....*  * .\.*  \.*.*.*.. *#
# .*.\ .\..*.  \..... \ . * *.*.**.*\*..*.#
#* ..  . ..* .\. .* * .\*.. *\****.*.*\.* #
# **\  \  \***.\. *\* \...  **. *.*\*.*.. #
#.  ..*..\ **.** *\\* **\ *\..\***. * .\ .#
###########################################