#############################################################################################################################################
#.\.\* .*..\**....   . . .. \** .  . *.... ** *...\.\.*.. *.  *...\   . .*.. . \**\\.. *.**.\* *. *.*....\. .*.* \.  .  .   \  *\.* ...*\  \#
#.. ..*.*.\*.\*\.\.\..*\  **... .  .. .  \.\.**\ **\..... **.*.*  . . \.*..* *..\...\**.*.  .* . .\** .\  * ..   . \  .\\\*. *.\.  ...\*   .#
#\.\...**. . .*R\...\ .*\..**. .\... ...* *. \. .*.* *.  * . . *.\ . ..\. ...\.   . **.. **  ...****   ***.\*   .*.. ...... .**.\\.  .*.  . #
#. * ..*..*..*..**\ * ..*\..*..... \  \ . . \  \ *..   .\.  .. *. .*\ *..\*  *    . ..\ *\.    . \.*.**\.**...*.\.** * .\\ . *\* .* .*.*  .*#
#* .\ .*... ... *.*  ...* .*..\.\..   ..\***. ..** \..* *\   ..\  \.. \  *.\..\**. .*..**\ .  \.   ...**\ \.**... *  .  .\....    ..\*. .  *#
#* .. .\.    **.*\ *.. *. \. \\..***... .. \ \*..  .  * **.  .\*  .\.\.*..\ ..\..*.*\  .*.\*  . *\ .*\****...\ .\ *.      \ .*  *.* .*.. .*.#
#\ .\.\ .* .*. ....\ **... \*.\*** .  * * *.* \.\ .\  . * *  ..\..\..*\*.* ..*. ..* ... *\..*.* ..*...... **.** . .  ...*... .\ **.**..*...\#
#     *. *.\...   ... *.  ... .\*\*. *  ..**.\.*.   ** ..*\\ *\.  ** .***.. *.. . .. .*\.*...*   ***..\.. ..*..\ .   ..***..  ....\* \..**.*#
#. .. .*\ *..    . ...\ * *\* .****.. .***\ .\*\*.. .. **\**.\.\ *..  \.*..\.  .  *. \.. \* \.. ...*. .  .  \*...\**..\.. * . ..**  \*.**\. #
#.\ \ ... .\\\*.** **.*\.\.*\ * ..** *..* *  . .**\. . ..* .\*. *.*.*.   \..*.*  \**..  \ * . ***  *. \ .\..**.* . **. ....    ** ...*.*.**.#
#    .***   .\.*\ *..*\.* *.     *...*. ....  * *.*..   **  ..\ .*..**.. .*\.* \. .. ..\ *.**\...\* . ..*. .*. \.\..* *  \  .. *. \ \. *. *.#
#   \*... **.  .  . *\.*\*..  ..*..*..\\ .. . .*. .\ .. \ *.\*.*\\*   . \ .* *. .. *  .  ..*\* *\  .  **  *..*.\.*. . \* .*. ... .   .  **..#
# **.....*.  .* ...*.*\.*.* .. ...* .  ...*   \.*. *\\*.\. ...*\*\. *\.*  .  **..* *.. .* .*.  * .*\.. *\.. .*..***   *.  ...*.. .    *  ***#
#..****.. . . ..***\.*  *\    * \*.. *.**\. **... .**.*.**.*\ .*. \ *  .** \... \....\  .*..*\.\. *.*\ .\...\...**..\**.. * * \.\*..*\.  \..#
#\ . *.\* . .. *...  * **.*\.\.. ... ***..  \. ..  ...  .*\ *\...\. *...\   * *..  *.    .** ...  ..* .  ...* \....* *..**\* *...*\*. **\.* #
#*** *. *.\.\  **\  ...*. \ \*** **  .....  .****. \ \ ... **.*\**...*. *\.*.*.*.* * .*. ....**. . \**.  . ..** .... *  .*\..\*\ \..*\.*.\. #
#.\. ..\.\.  *  .** . .  .\ *.*.*. \  .. *\*.*..***..\ ...  . .\ ..  .. .* .  .*.**   *\ \*...* ..  .**.\..* .*. ..* . . .. *...**\*....... #
#.*..*.  ..  ...\.*\.*  . ** \* ...\.*\*\.. . \. .*.\.  .  .*\ .  \**    ..**  *\ .. ..\*.. *.. ..\****\.\.***..\ \*\*. .* ..* *..*.\ \ .\ .#
# *. .\ \.  \.**.*..*.*  .. ...* \.***.* ..\*.  . *\ . .\\ .   *\ *..    .... \  * *\. \... **.  ....... \ \**. *..* .*  .*....*.\\. *   .**#
#  ...*\   .* .*  .     ..*\.\.**  ... **\ .*.. .   ** .. *  . *.....\ .**.*. ....\.. ...*..*...* ** \.**. ..*\** * ..*\*\.  ** . . ..*.* ..#
# *....  ..**. . \.*.\ \ \**....* **..*.* *. ..***\ *.  * .\* *\.  *.   \.  *.*  \* .*\...  . .*.\*.*...*\.*\*** .\  *.*... *..\   \* .  .*\#
#\.   * *  \. * ..\ *  .* ... \ \ .* *.\. ...\.*..\ .*.**.*.. . \. ***...* .*.* * *\*. .\****... *.\.\ *\ \****.*...  * .\  .\**\\\ .*\.  *.#
# ..* . *    ..*  \...\ .*.. ..  ***\   . \.\  .\*..*.  \  ..\* .\ .*.. .\\..  *.*\.*...*.*..\.*...... .* \.\* .\ .  \..\. \.*.**. .\*.    .#
#   . .*.\ . .... .*.\ \*\  *  .*.... *.  .. ..\.. * .\   * **..*.**.\ ...  . .*\...    .  ** *\*.  \....\** **  .\*  *...*.\. .. .. ** ***.#
#\ *\...**.*  ..\.**.\ .\. ..  *.. \ .. ..*  .\.. *\ \.\ *..\.  .*.\. *..  \ ***.\ \  \*\.\...*.*\\*..**.*..\.. ** ***\*..  *...\. \  . **\\#
#**\ * ***.*\ .*..\*... .  *\\.*** .. .   * .   * *.***..\\* *. \..   .*..  \. *. *. \.**\.*\  .. ....*\..*\.  *...*...* \  \. * * .\\ ..\.*#
#*.*.* **...*.\ *\ ..***  .\. .\..   . .**.\ *.*.*...\*.  .. **\. . *.\..  ..* \ *.\...\* .*.*  .* .  .**\... *. ..*.*\.\.* \.\.\...  *..** #
#*\... . *. .* ..**\.*** .\**\**. ** * *.*\ ..*.*.\.\ .. .** ... .**\ *.**.. *. .   .  .* ..*.*...\ . *.* .**\.**\\.*.*  \.*. .*..\*\ .\..\*#
#*..*\*.\.*.** .... ..\. .  ... *.* .*\.*\ .\ . ..  .\.** .*  *.\.\.* .*\...*\*... \  \*\.*.  \**.... \*.**....\. .\.*.**.....*.\.*\ .\* . .#
#* .. *\  . . \*....\\.***..\  .* .*.\. . \ .\*.\.  .* .. ....  .* ... * \..\..\.* **... *.**... .\. .\\. *..*\ . *. ....   . .. \.*\*.    *#
#.....\*.  ..  ...* ..*\.. .  * . \.*..\*..\ ..\ \ . .  .      . .\*.\ ...\.  **..  .   *\..\  * \* .  .*\..\..  .\.  .* .\  .\.*. ***.*.*.*#
#.\.*... * .* .  ** .\..\.   *.   .*..  . ... * \ ..*\.**. *.\*..**\ .\ \*.. ** ..  .\* .*.  ..* .. . . ..*  * *. . .*\\...\\** *.. ***\.\.*#
# ..\ * .**..    .. ..  *  .*. .\**.*\ * *. ...   .... ..  \ .*.  ..\ .  \ .***. \.  .* *  *  *\... .* ..  *.* ..\ *....\  * .\.\ .\.... .*.#
#\* ..\\.*\   ** .. * \... .\ . *.\ ....\....\   * \   *  .....  ..*  *  .*\\..\  .. ***.\.\\ \*   *\. .* .... *. ..*\**.... *   ..*   .* .*#
# .\ *..*.*  *... \ \.*.\.* .\ .\.* .\*.*\..  \\\.  . *. ** *..\*..\.\ \.\..*\ . *. .*\**  * *.*\**..\  * ..*\..   \.\ .**\*\**. . .\ \..\ .#
#\**. .*.\..*.\***.\...   ***.*\ **  .**.*   . .**\.  ...*\..  *. .*.\*. .****.. . * \.*\*\...  *..\* *... *.  *   **. ..*....  .*\\*..\...\#
#*..*  *.  *.. .\. **.*.*\... .. *.*\\..\. \*\ ...\. *\. ... ...\..\ .. *.*\ . .\*\...\ ...*\ * .\ .\ ..\. \ .* .\\.*.\. * .*. .   ..** . *\#
#..\ *.\.   .* **  \**.*.    ..\  ..... *. *.... .*\.   .\. .\* .* .*   .... .  ... \ *.     *. .**. \*.\ . . . * \ . .*\. **\ \. .\*. .\ .*#
#\.. *  \  .**.... ..... .  .*\..* ..\ ***.  *\ .**..* ** * .*\\ * *\   .. \..  ..**.\***.   *.***.\  \..* *. .\ \\.\...  .\.*.. .... \ *  .#
#  . . *.....** .*\.\ . \\  *..*.  *...*\\..**. .*...* \  \  . *\**\.  . . .  ** .*.  *.*..\* *..**.. .. ..** * *. .*..\. ...\  .   . ..*.\ #
#.\.....*.   . * .....  * .*..  .  *\. .    \.\ \. .*. . . .\.\ .\..* . \ * .*.*.... .**.. . *.  *..* *\   ..*\..** *. *.  .*.   ***.    #.##
# **.. ..**.. ..\  \* ...**  ..\.* . ** **  .*... **.\.. . \**.*.  .*.*.. *  \**..  .**..*.*... . ..* . . .*.*.\.*.*.*..*\.* *\ \. ..\  .**.#
#**.   .\* .  . . * .  . .. .*  .* *  .* . ..**   .* .  \.\.*.\.*.*. ..\  . *..**.. \.  ..* *.   . \.\   .\. .  .** ..\ .*.. . . *.. . *...##
#\*.. ** ***\.*.. * ***   ..*  . * *.*\*.  *\*.. \*\   ..\ ..*  ...\ \ . *.*.  .** .*\.*..\ .\\*  *..\ ..*.    . \.\.. .*\\ *..\..*  * .*\# #
#... .\... .* ..\ .\ .*.*..*.\*...  \...* *. \  \.*. *.*\*..\ \*\. . ...*..*\**.**\ . .. *  .  ..**  *\ ...\  *. .*.*.* ... .. .. . \***..# #
#\*.*  . *\  .**. *.\  *.*\.*... .. .\ ***. \.\..  . ..\... * ....    *\. .. .. \*. ...*......\.* ***...*.   .. ..*  .**\  \ * *\. ... *.*# #
# ...\..\.... .*  . ... .* *.***.*** .\ ... .   \    ** * \*. \*. .*\\..\.*.\. * ..\ ....\\  * .*\..*.     *.\***.. ...  \ . *.**. \* \#.## #
#\*...*.* .....*..\ *\.* \ .*...*\\.  . ...\\ * .  **.... ..*... . .*. \ *.\*  . \*    * .\ *.\*. .\..\.  *...\ ..   *.*..*. *... \.\ \#.# ##
#..\ .* .   **..**..*. * * * ** \* ...  *.*. .\*.. ..\.*\\**.**\ * .. *..* \. . ..\\* .. *  ...  *. .  .*.. *.* *.*..* * \* *..  \..** .*  ##
#\\   #..*. .. ..* ....\  \*.*.*\. \..*..     . ****.***.*.*..**.\  \ *...*.\*\. .*.. *\ .  .\*\ .  * *.   *\.  * . \.\*\.\ . \*.  #**.\#. ##
# .\*.#. .*.. **\. * \ .*\  ** *\  . \.*.*.**    .\.*.*..**. *.\. * ...*.**  **  ***.  .**.\ **.*.* .\. .. .  **\ * .\* *#. . ..***. ..# #.##
# *.*.... \\*.\.** .*..*.*\ \*\.** . .*.. \.*  ** . *\..*\.  \*     .\*.**..***..*...   ...\ ..  ..  . \...*.\*.***.... .  .... .**.. .#  # #
#\*.*.. .\**.. * .*.... .    **.** * ..  .. .**.  **..\..* \... ..\   .*...*.... *   .\. *.\\  .  . . *** ..\*....\... .\ \ . ..#.\***\#    #
#.\**.****\.. \.*.\**\\. **.\.*.. *.*.* *\* \.... *.. ..\**.. .  *.*   ... .  .. * \.\*\*\. * . \.*   . .. * **. .\  * * ..** ** ..\##*#    #
# .*. .\... *...*.**\*\.*..\.****.   .*\.....*.* \.. *  ***.\** ** *\*\** * ** .*.. . .  .\ . ..\\  *\  .\.. **. \* .. . \.*\*...#.#  #     #
##** *  *  .\ .*.\... * *.. .****.*\.  .. .\ .*.*. ...*.* . *.\. **... ***.\*.*\.* \.* \.**\ \*  .**.\*  .   .\***.\* *... . .\*.## #       #
# *.#.  \  *.\ . .  .***\. *\.\\.\\.. **.. ..*. \.  . *  ** *. ..\.**  .\*****\.\\.*\\...*..... . \...*..\**\..*\. * .\*.  *...*  ##.#      #
#\*.\#. .  . *. .   \.\.*..* \. *. .\  ..   ..**.*.\. \ *.*.\ .   *.. .  .* \  *.\  \ * .*. .    \ *. ..\ **  .**  .** .*\..*.*..\*\.#      #
## .## . .  *\. * .*. ** . . ...*.  * * ..\*.*..** .  \..*.\.   *..  \. .**  . . *.. .*  ** . .\..*.*\.**.*.\....*\.*.*.*   **  ..#* ###    #
##. #\ . # .**.*. ...* ... **\ .    . \. *.. \* .\**\* **\. .*...  .  *. *\ .\*    *\..* .*.. \. ....\ .\\ \*.*.**..... \ \ .***.*\. \ .L   #
# #\#\***#\ .**. . .*.  \ ...\..*...* .. . .*.\** .. . .* \*.* *... ... \. .\.\ \.\***\**\.**. *    .. . \.. . .**.***.  * .**.. .#* .##    #
#  # #\.\*   * **.\..\.  \**.. ...***. . \**.. ..* .\\*\.\.* * \. \..* ...  * ...  ...\.   * ...*.. . .  .*  .*. . .*..*.* *...*. ..* #     #
#    #*##*.*.. *.\... . \ \.*..*.....*.. ....*\ \.* * .  . *\...\ .  . ..  ..\.  . \*** .\*\ *\. .\.**....* *\*.\ ....* *. ..* .** #* .#    #
#   #.. ###.*  .** .. *. .. \ .  .*. *.  * .**.\. .\*  \*.. ..   *\\ \. *** * *. . \*\*\.  .*\.*  ..\.\. .*  .*..* * \.\*\. .* *..*** #     #
#    #*# #* . \**..\....**.\.\. . .. ..*.. *\ ** *..**.... .  ...*.\*  \.\.*  .. ..... *.  *. **\.*\.*  \*....\ *  ..  .*    **...##..#     #
#     #   # * # .*\**. ..* * **.\* . \\**. .  *. .*\.\.    *** \*\* *.*. .  . * .  \ . . ..*\*...*.... .... *** ..   *****  . *. *#.##      #
#          ## # *.  .\ .....\.***\.\ . **..\ *\..\.  **... . .\ . . *.*.\.* .\ .....  *  .  *.***. *. .**\  . \\\. . .**.* .* .* \ *#       #
#           #.#..  \ **.    \.... *.    ..  *** \ . *\\ .*.\  *.   .*\. . *.\ .* * .\.*\\.\.*  \...    * \.   ..\ .\. **  .\  *#\###        #
#          #  ## *. . \* . ..*.*  .*...   \**.\**\*\..\ \.\. *.*.*. \.  ** .. \*.*\ * .. *  **.*..\*** * . ...*.... .*. **... .\..#         #
#           ##  #..\*  .. ***\ ..\ #. *\ \...* .*..  ...* *..\..\.\\ **\ \*. . .  ..   * *...\*.\ *...*. \.   .\*   \*.\.\ .*.* ..###       #
#               #\.**** \**.*.*.  .* .. .. *...*.* .*  .*\.*..  .  ..*.  * \\  *      \*\. *\..*. . ***. *    **\  .   .*.**. \.*.. *#      #
#                # **..* ..****. ..* *   .*. \ .\.  *.**. ... \*.*..\.**..  **\. .*...\*.\...* **.  *. . **\ **. \* . .\**..  **.#\ #       #
#               #*\.\*\  .**..*...\\ *.** ..*\ .*. \\. ....\  * * .*  .. .* \   \. ..\..** **\*\\ \ .*.*........*..*...**.*...  **.#        #
#               #    .** ....*\.\  .**.\    .....\\... * . ..*.\.  * .**\ ... .\.* \ .  *...*... ... ...**   \. *. * ..\..#**.\*.*#         #
#               # .* ..*   *. . . . \.*. **\......   * ..*\*..     ..**\. * *\ .\** .. .  .... \\***.*\...  ..\*..\..  ..\ .*****#          #
#               #  \#.....\.*.\ \   . . \.**\.* ..\ .* *...  *   \..\...*\.....  *.\ .*\ ..... .**.*......  **.\    *   #*\...***##         #
#                #####*.#*. #.\ ...**  . .* . * .  ..*.  .\ \* .\...\.* . *..\ * ...*..  *  *  .**\ **.... ..\  \.*.\.\.##.*. .*..*#        #
#                 #**** ###  .. ** ..\.*. . .\..    ..   * \..\ * .. .\..   . .. .\ .**\ . ....*..*..*\. .*\*.* **.   # # *\.  ..##         #
#                  # ..##* ..*\.*.\* **.   .  .\ .\ .*  *. .* * .  .\.* \*.\....*.*.**.*.. . * . ..***.\  ....##\.  .##...*.*#*##           #
#                   #*# #*. \.. .* * ** .*  .* .**** * ..   .*\.  .. \.  .\  *..*\...*\... . .\* ..*\.. .   .# #*.\.\*##*\..# #             #
#                  #**#  #*  \***. *.*.\** . *. **\. .* *   ..  ...\. . ***  ..*.*  .. **** .*.*.\*.. .* .**\ # ##*#.#  #.\#                #
#                   ##   #\#####*\.#.**..**.  ..\..\ *. . .*.*.*..      ..\.\* **. \  *\...\.* ....*  ..*  **#    # #   # #                 #
#                         #     #*##.##.*#.#\..*.*.#. .. ..\   *****.\.\*.  .\...  . \*.*\*   . \**.*\  ** *\#          #*#                 #
#                                #  ## \*.\# .\..  ..\  ..\. .. *\.\..   *.. . ** *\ ..\.*\..*\..... . *\.*##            #                  #
#                                     #*.*#.\ **.\..*. \* ** **.. ..\ .\ \.*  **.*.*.  * . ... \. * *....*.#                                #
#                                     #..\#**.*##. .#  *. .. .\..*.*.\*.....*\.*.***\  *.*  **\ *. .***.\  \#                               #
#                                     #*## #* #.*  *.\.*    ..**...**..\.#*#* .**..****.\.*  **.\*.* ..\ *##                                #
#                                      #    ## \#..\*. .\  ... . *.*.\  ... **  .#*..\.   .   ..*... *\.. #                                 #
#                                             #.\.*#   .**# **  . . . ..  \  # .* *.***\ *.*** \ .\.*** #*#                                 #
#                                             #\**##. . ..*...* \\*.\ # .#\...*.#*####.* .*..\. .*. .\\ ##                                  #
#                                             #.#\* . .... *#**.. .*.***  # *. \.**#**\.\*..  \*\ ..**..#                                   #
#                                              # *.\ *.*  #\ .*.. *. .###\** .##.*  .*#.## #\...* . *..\.#                                  #
#                                              # # ###.* #*..* . *..*#   #*# *.#**#### #  #... ..  *.*\##                                   #
#                                              # ##*..\. *. #. * \\ *#    ##.## ##        #\\..\\ *#\.#                                     #
#                                               #  ##*#\ *.*#... .###       #            #*  .* ****#  #                                    #
#                                                    #.. \#\## #....#                     # .\* ..\## #                                     #
#                                                    # \##*.##*#####                       #.# .. #  #                                      #
#                                                    #.#  ##  #                             ##\.* \#                                        #
#                                                     #                                      #*\*##                                         #
#                                                                                           # . **#                                         #
#                                                                                            #\ **#                                         #
#                                                                                             ###\#                                         #
#############################################################################################################################################