##################################################################################################################################################################################################################################################################################################
# .. \..*  * \...*** *.\.\. . ... .*. *\  .*.* . ....\. .*.  * .* *\..\ ..* *. .*\... \\ ... * ..\*.   ..\.* .\  * .  * *.\. ..\ * . \ .\ . .***.....***\..* *..  *.. . *\***\   \ .*. .*\**.*. ... *\ . ..\.\*...\ \.  **   \.   . \ *  *.\.. *.*** ..\\ .  .* . *.*.*\ .*.**** \.*\..\*..\#    #
# .....\**    .  .. *.*. . .**\  .  .*. ....*..  \ \  .*  ***.  *.\\   * \* * .  \. .*.\..*.. \ ..\  *\ * ..  \ *. . .  .**. ...... *.\**. **.*  .. **\. .  *..*\*\.*\.\..\ \.  \ \... \*\... *...* **   .\. * ...*   .\..\.. * . *. **  .*. *.\..\.* ..*...*..\  .*..*  *\...*...*..*. *.*###   #
#  . *..* \.  ..  *.\ .   \ * \\.. **.*   ..*.*....   *. ...*.  .\.*.  ... *    ...*\. *..  .. *\   \ . ....**.* ..\. .*  \ * .\....*  \*. .. *.* .*.\ .*. .\*.* ..\....\* ...\   .\. .*..* .\**\ ...\*.\* \....  . .*..* .\.*\. *\  *.* .\* .. *.*.* ..\\**.. . .  *\.  . .  *\**. \*. *.*\ \#  #
#... *..\. . .\.* .* .   ..***   \*\.\. *.* . \**   * \.. \ .. *  ** * \  *.. . *. .\  . * .******. .....\. ..*.* *.   * *.\**\.\* .\.. .*.\* .* .\   .\ * .*. \.*...\ \.**\.\**  . \*.... \  ...\. ... .\*.\*..\*.\ ..\.  . \........  *. . *\.\.**.  \. \* \ .\* *.*.  *. ..\* *.\ ...# * *#   #
#\ .*..*.* .    \ ..\* .  ....\   . * .\. .*\..*.\ **... ..**\.......*\.  ..   .**. ***..*\**.. .*.. . ...\** . \   .**\ \..\*.  * * *.* **\. ..*  **\ . ....*\.  \ \.. .*  .**...*..*. *** \.   *  *  \.*.   *. . *  \.\* . . **. . \\\\.. ... \*..*.  *.*   * ..\* ..\ \.. * * *.  \ *\ *\.#   #
#***. ** .. . *. .*\ * \ .    .\ .\*.  .  \**... \...*.... .****.\ *... * .\ . \*.  ...\.. *.* .*\ .***\*  *\  *.  .*\..  . ..\. \ .**\* **.*\  .**.* *.\ *****. *\*.* \ * .  . *\ ...* \**\.*\ ... .\  ....  . \..\**.* *    ...*. . * * ..*.\ .*. .**....\ ..* .....\..  *...*\.\..\*. ..*..#  #
#*...\**. . ...*.*.**.*..  *    \.. **.* ***\ .\.\   .**. * \... ...\.. .\ *.\* *.\* .\*\  *.. \  *.\  ..*... *\. . .\*.*.*..... .  *. .\...*\ \\ .*. . ..\ ***.*. ..*   .* ..* . .. *. ***. *    . .  * \ .*\.  . .\  .**.*. *.\. **....*\\  \  .. \*\..*.. .  . **......*. **. \*.* .*  \* *#  #
#.*..*** . **\ * * ..*.*.....  . .. \.\* .*\***...*. .* ... . .\  \. *.*  *\*.. . .  . *.. \....... * .\.*.** *  ...  . \* *  *\.\*.*\*\ \ \. .*  *\*.* ... *. \. \ ..\.*\.  **\ .\.\.\. \*.\...**.* ** \ \ .\....\ .    .** \..*\ *.  .\\.*.\...*\ .* *....* .. *\.*\.*\...\.. *.\ ..*. *.**#   #
#\*.**.*   .\  ... . .**.* **.\\\.*  \..**.**... \..* .\   .\. .*.*.*..*\\\ *\*  *.   .... .\.  **..*  ..*.\. ..\  * * .  ..\*\*\  ... . *  \\.. .*.\.. \\. .**. \  .* .\..* .\ \  *.\ * .\\..*.. .\ . ...\ * *.\.\. *. .\. ..\*.* \. .**\ .\ *  *.*.* . \.* . .....*.***    .*.*  \..*.*.\\*##  #
#*\ \*\.*..  ..  .. ..*.*  .\  .*..\ ...\.\..... .\*. \ .** ** .\...***..**. ..  .***.\  * **\.***  ...* .  ..\  *\.. ** * ... \..*... *\.*  *.*\.**. . \.. .\.  .  *   .*** .\ .**....\ ..\..*.. .. **.\  .. \. \* .**.*   ..*.**  *\ ..*  ..\..\ ... **... ***. .\* *..*****. .* \. *.*..\.**# #
#*.\ ..**.  **.*  .\ .* .. . \*.*  ....*\.*\*  \ . *.  . *.... .*  .\.* *.**\*\ .*...*. *. **.  . \ .  .\\ .  ***  \.***...... .  \.  .* .**...*. .  .**..  *.* \..*.  \ *.\.* ..\.\* .** *. .*.\ ** .\ *.\.*\.\..  .\*.. ****.\..  .  ..\ **\*. .*....*. *\ ....\ .\.*. .***.   .*.. *..\.  **.##
#* .\  .*..\** ***\ \.\ .\....***   . ... ...  .  ..* ..*\.* .  \ \*..* \.*\... .. . . ..\...\. .       .. *\.\ . ..*\ *  **.* \.* .*..*  .** \.\\ .\ .\* ..\* . .\.* *.*.\. .. *. \*  .. . . ***...  *.\ .\.*. *.*  ..\ . ..*.*..* *...* .\.*.\  . . ...\...*    ..  .*  *.\*..... \*. .*\.\.#\##
# \ *.  *. ..*\**\ ....\** **...*\ ...**\.\..* \.*\.. ..** .. **..*..\.*.   \ *.\ * \ *\ .\  * . .\    .. * \*.\ *.\... .....\** ***\\\*\* .\\.\. **.\.  * **.*.  * \.. .\  *\*..\ ..  *.* ** . .\..*  ... .. .*. . .* .**\*..\.*\. .\ .   .\.* *.   .  \\. ....\ \...\. \\. ... .* .... \* ## # #
#\ ..  ..  \** \..**\***.\\...* .* \  *        ** . *\.\ *\ *\ ***.*.*.  *\.***.* .  \ * .*  * *\\ \ \**  .. .*\**      .. .. ****\. * .*.\ .**.\... .****\*. .* .. .    * ...\ .. \\. *  *.\ .  .\.. \*  \..  *   . .* \...*    * *. .\. .** . .*.. ..\ .. \.\ ...*...   * .** . .***\\\.#*#    #
#..*  **\. \*\ * .*.*.\ \*   .. . .\.*\ **\ .**.* .* **   .\.\ *.**..*\..\**\.. .\ . \... *  * .*    ... ... .. .*.*\ *   .  ..*.....\.\\** .**** *\ \  .. .   ...    \ *..**. . . .*. ..*.**\***.***. .\*.  *\.\.*  ..*..   ** . **\ .. **\   *\.. *..   .\ \.  .*\.\.. ** . * .* .**..\. #     #
#**\.\.*  \.\.*.  ..\......*  \ \*\. \.**.\ *.*..*..... \  .**..*.*.*..\\*..** \  .*..* . ..* .**. **\ ...\*.*   .   ..*** . \...\*.*. . ... *.\* .  .*\  \** ... ***.. **\*.\   .\*. **..   ..* *.\. * ..\ *.... \ *..* *. .... * * .  ..\.* \***...\ . . . **. .. ....*.....* ..*   #*  **#### #
# \..*. *\.*..\.  \**   .**... .\\.  .\*.***.\\.*. \ . *...**\.\. *  \* *.\..** *\ *..*  \.  * *.*\.\*.*.... .\.  *..* .\* * ..\...*\.*  .\**.* \\  * .     *.*.  \\..**\ .*    .* .*.\. \ *   *** ..*\.  *.\. \\*.\*...* .*..  .*\.\..  *. ..*.\.. \.  *.*\ .*.  . ** *..\.. ..\ .**..\  .#\*\.##
# ..\. .* *..*...\..... .\ .  \ ... .. **.   .* ....\  .\  *..*.\ .  .* .\ . .*..* \ *. .\  *.\..\*\.* *     ..\**\\.*\*.*. .\ . .***\..  .*..* ... . \    .* *\ *.***.*.* ..* . . ... *\**..\*\. **\*. ... \. ..  .. **.   \\**\  *.  ...\ *.....\  *.\ *. .. .*.\...*. ..* *\..  .. .\.***..#*##
# \* *  ... \*   .**.\  * *\*  \* \ . ***  .*.***\.*.**..* . ... * *..\.\  . *... .. *    **\  .   ..\ .*\*\  \...* ..\* ..*.  .\.*. *\ \ ***** \***  *****\. .. .  .. .\* * . \ . *\.....\.*.*.* .\**  . \ .. ***** * \***...**  \*\\**\.* .  ..*.*... *\ * \.**.*\  **.  . . .\ \ #  **.\**# # #
#. .\.. ... \.. \.*.    .*.*\ . .*.   . * . .*.*.  *.. * ..** *\.\\.. .   .\.*..\*   .*.. .*\*  *.. \* *\*.. *..* *.  ..\..*..*  ..*   .*. ... . **. .  *\.\..*.\ . * .\.**. ...\R..\    *..* ..* . ..... . \ \ ..*..\*. \. *.... \.* *\.....   *.\***.\.* *...\.*\.  ..\    .\*. . \ .  ####    #
#  .*...\.*\. \*. * ..*.\*. .\  .**** .**.* **\.. . *  . *.*.*   .\*\.\\*.  *. ... *. .*\*.* * **.**...* . .   \. * ...* \..\*. .  .*  \... . *..\..**. *..*  .*.\...   .*.  *\ **  .*.\ \ ** \.. *\..*.* .*.*.\* .  *\\* **..\\ .*..  *  ..  ..*... ..\ .*..**\.  *.  .  *.\* ** ..  *.*# #     #
#\  * .    .. . .* *....... ...\ ...*... \. .*. . .   \ .... **.**.....\. .**\.    .* .... .*.\** \** .* . *.*\* .* .\..** *.\*  \*. .** * \* \.* **.** .*. \*... .\ \*\*   .. ..\ **\ ...\* ...*.  \ \.   .* . . *.*.  .* . ..*.***\ *\.\...* .\  *.*\*\..  *. . \  *\ . ..*.*.. *. ##..* \#    #
#.* .*. .   **.*\*\.* ..* * . \. *\ \.**... ***   *.....*  .... ...    .  . . *. .*\  .\. .**   .* .*.   *\*.... ***\..***\. *\\..\ . . ** **.  . \*.\.\ . \*. .* ..  . ...**\.   .\. ..  .*\... \ . ..*. ..*..  *......\.*...**...*..\.\.*\.. . .*..  ....  \*..* \..** . * *.*  *  *..**.#######
#*. .\ \**. ..\.* .    .. .*.\.*..**. .. .. .  . .**\..\ **...\* .** .*. **.** . *. \. ..* \  .  .  **** \.**.  \.\*.   .\.* \* .* * * ..\ ..... ..***  . ..*\ *  **.. . *.*.*.. * . . \.... . \ . *   . **. . . .....*..  . \.... ......*. *.* .  *. .\.\ *..**..\*\..\ * \.*\.*****..**.***..\.#
#** \..*... ...*\  *.* \ \ *. .. ..*\ **\\.\ .* .\**  . *\. .. *.... *..\....\.\ *.\.*.*.*\..**..*  .\**..\ . **  ... \*  .*.   ....*..   .  .. *. \. \  .*.**.* *  *\ .. \* **...*..* .\ .   * *\   **\..\ .**  .   ..\\  \ ..*.*\.   .\  *\..   * *\ . . \...* .\..\\... . .* *  .. . *.*.. ####
#.*  .\**.. \...\ ** *\.\ ***..*.*... .**.. .*. .*\. ***.. .   .....\..\. \*\ **.\*.\*\.\*.\ ..* .*. *.. **   .\*.*.* ....**   \. .*  .. .\ *   .\. .* \..\ \ .* ..  . . ....*** \.***  .\. . *...** \..*.   *.. *** \  ....\.*..\.. **.. *  .** \\\. *.....\ *\ ..\*..*  \.  \.\. .*\. \.. *#   #
#* .\. ..\  \*.**.*.*.   . \*. . . ..*\.. *. . . *.. *\* .\ . .\. .. *..*.*..\*  ** .\.. . .  *.**.\.. *....\ ... .\ *\. ..\  .. .\.  *.*..\*..\**..  .. . *.  .\. \.\.\  *  \\...\.  *** **.   . *.*.**.\ .\. \.... ..* *..   ***  .*. * .\.\..\ **.  . ..* ...\ ....*\.  ...  *\ ..***\..\\#   #
#\\*.*.  ..* .\.\* .\ .* \* .**. *..\..   . . .**   *. . .*.\  .\.  *. *.. .* .\... \... * . . ...  ..\*\..  \ *. ...*  \ *.  *   *.* ..  ****...** **  *.*\ *. .*.. *  .\ . .**. .* \ .*\.*. *. * ..\**. \ ..*.\***. * \.  ...... *. .\. .*...\.**.. ..*\ *  ....*..*  ****... *..\.* ..\*##    #
#* ...* *.*\.*.. .   **... . * .  **.  *..*   .*.\ \*\ * **** .*.*. .*     *.\ ..*. *.* .\** *..* *.....   *\.*..* .\ *.. .  *\ ..**...* ..*. **.*. \.*. **  *.\*.*.**   *... .. ..\* .\.*... ...  \*.**...\*..\**.\.  ....* ..* \ . . *\..* .\\.\.*\ . .*\ .* ..\.*** \*.*..*..   ..*.. ## ##   #
#\. \. \. ** . . * * * .  *.\.*\ *.*..\.*.*. *\* ..*. *\  ...*** *   *..* **\..  ...\ .. *..*\. . . \  .   . *.* *.   *** .\  ..      *.** \ ..* .\. ** *\..... ..\ \.. .\...\ . *..\* *.*    *.  * .. \*\*..  .****.**   \.   ....  *\.** . *. ** * \*\ .. ** . ** .. ... *  .**  .\.   ..#. ## #
#* ..... .\*. .*\**.   \.\.*\ \**..*.\*\..*. .  * *.. ** * *. \***.*...** ... \ . *.. . *\  ... .** **.  .* .**. ...  . ..\   . ..** .*\ *\  *.....\..... ****\.*\..  . ... *\  \* **\ ..  **..*\.* . \. ..*......*\**. \ .. *. ***.\..*...\ . .*.\  . .*..... * .  \.   .  *.**\ . ***.. ....L.##
#.* .. ..\.\*  *...\.\ .\ \.\. ** *.  \*.\.* \.*.\  \.   *\..*...\  .*..\. *\ \\.\*\  *\..\*.*\ *..\*  *.  \**\ *.\.\\.\*\* ..*.\ *.\...*** .** **\ ***.*. .\*.*.*..\ .  \.*..\* *\*.\  . *....*...\.  *.* **\.  .\*.*. . **.**  .\    \...**\ .\...**.\*\  *  *.**    *.\.*.\***.*\.*.\*..\ *.*##
##################################################################################################################################################################################################################################################################################################