#########################################################
#   ..\... .*\.  **...\.* \.*\. .*. .*.*.* *..**. * . .*#
#.  *    . \ .\** **...*.\..* \.    .*.... \**..*  .**..#
#\  * . .***...*.\.. ....     .*.\.....\**...*.\.\* ...\#
#.\***.* *..   .. .* \..*\ .*  .*.. *. ..* *. .. .\*.*.\#
#**\.*...\.  .*\ .** \ ...  *  *... *\. *.*\  ..   *\   #
#**. .*\ .. \... \ * ..  \  \*.*\.**.* ... .\    *\.***.#
#. ...... . .\*.   .   \ * . \ .**.. *.  *. * *. .*.*\.\#
#** ..* *.    * .*..*\ .\*\**. . ...*..* * \.  *.. .* . #
#\.\.. \. *. .*. *.\.  .*....* .. * . \.*\. *\.. ....*..#
#*\...\. \.*.\\ .*.*.\**...  *  . \.   .\.* * \ \ .*  ..#
#.*..  * . *..   \. * *.*   ..\*.  .\ .\. **\ .  ..\*.. #
# *.*\ ...\\.* \..  ..\ .\.   *\\..*..\.*..\.. .*   .   #
#*\*  \  . **.  *. . *\*...\ ** . .\. **..** * ..* . . .#
#..\*\..  *... ***.\. .\   .\. \.. .\ ....**\.   \ *... #
#\*.. \ . .*\\ *..\. *  *..*  .  . ...  .... . .*..     #
#..* .*. ...\*.* .*\..\*....** . . \ ...* \..***..   .\.#
#..\*\.\ ..\.*.\.\* .. .**\*\\ *  ...  *\ ..*...  *..*  #
# .  *\.. *.*.*  .  \.. ..*\....**. * .*.**.*.\ . \. \ .#
#    ..** ..\ ** .\*...  *\..*\ ..**   . .\.**.*.*..\.  #
#.  .  .*  .*\\. .*..*. ..\*\.***...*.. .. *...  ....*\.#
#  **.*..**\ ..\ ****...*.\  . *.  **    **** \***.*.. *#
#\ *\\. *. .  *.\ ...\ .*.*    .. .*. *...**\  *\..*.* .#
# \*.** .. . *... ...*  ... . *\.**.*.\ . *. ***  ***. *#
# ** .. *\.* ..*   *\\\    .*\ . .\ .***\..*\*....\.\ \*#
#.\.. ..\   .. . *.\ .**    ..***\*... *.*\..\*.\ .*....#
#. \ ..*  ..* .\ \ .***\.\...\ .*\.  \ ** .**.**....\   #
#...*\ . .\*. \*..* *.\. ** .* \ **.* *.   *.*. **.\* \.#
#*\ .  *. .\*...* . .* ...  *. . .*\.  .. *.\  \......\ #
#\*\** \. .... .\**. . .*\.**. * ... .. .**  **.*** * . #
# .*.. ...  . *\**...*....\ **** ** \.*\*..***...\  .\*\#
#\  * *  .   *  . ****\   *. ..*.\.* .*.\* ..\. *.*  ...#
#*.*\...  .**. *  ** ..\ \ ..**.  *.  *\.*  .  ..* *.. .#
#..*.   .  ** .\.\ *.\\.* ...*  * .   .*\..\  .**.*.**  #
#\ .  . \ \\*   **.*\ \   * \  *   .* . ... ..****...**.#
#  .*.      ..**.. *  .*  **....  ...\ *.  ..  ...\* ...#
# *  .   .**.\.\   .\. *  \.*  *..     .  .   .   \*.\**#
# . . .  **   \** *\.  \ .. *. . \ *.      . \.*  . \ ..#
#\ .. .****. .. \..*.\..*.... .  ..\.. *  .\ .\..* *. .*#
#. *\ *..\.** * .\ *..  .  * \. .*\.. ...\*. *.* . .... #
#* . \.*. .*.*.  ....  ..*.*\ ** **.\ . .* .*..** .*. *.#
#. .  . . ..*\    .\. ...*.*   .  * *.  **.**..*  **  *.#
#* . \ \ ..\*. .. .\*\*.**\.**. \.. ..*.\**..* * * \*..\#
#*\* \ .*.. .. .\   * *..\* .\.* \.**\* .*. *. . . ..\  #
#.**.\  \  * . ...*....*..\ .....\ ..*\*\*... .* \. .*  #
#.**   .*  ..  \... ** .*.*\ \.*..\* *..**. *\ .*   *. *#
#* .*.* . * \   *\..*\ .**. * \.\..* **\.. *. \. .\*\  .#
#. .**.\* \*.*  .\ .. * \.. .\... .. \**.\ \.*.. . . .  #
#.  .\**\...\.  .**\...\.*. \.*\*\*. .*.....\ \ ** .\  *#
#*\...\...\* . ..* . ** .\*  *. ... * .  .**.\  .. \ * .#
#.* . \  *.*\ \ . .\ .    \ *. .***.   *.*.. . ..\.\ ..\#
# R\  .\..\... * .**** .*.. .**  * \.\ .**.\..\...**\  *#
#.** *. .\.**\*. \*..*\* .   .** .*\..   .\  .\\ ..**. .#
#\*  * *.*.... \*... \   \ *..** *\.  *\*. .\ .*.*   *..#
#*..\  \... .  *.****...*  \ *...\ *  *..\.*  *.\* **\.*#
# .\. * * .     \.  \. ***.*.\..*. \  ..\ \ .**  * \ ...#
#..  .*  \\. ..*   *  ...*.\. \**\ *\**...\ \**... ...\ #
#\ . \.\*  *.  .  * .* *... .  *\ .\ ..\    .* .\  .*\**#
#\.\.  \.* .\.*  \. *.\* . * ..***\ *...\ .\.. .****. .*#
#*.* \. \\.*  . .*  * ....\. . . .* .**  . *** * .*.\ ..#
#\... *..  *\  ...*.. ...* \.*. . * .**** . *.\ ..*. .* #
# . *\..\.\*.. ***.  *   * \ . . **.\. \. . ..*. \ *\*..#
# . ..*\   * \\.*.  .. . \.    ...*.  \*. *. ..\ .\. .*.#
#\ .*\*. *..\ .  *  *. ...  **\ \..*.\..* *. ..  ..**  .#
#.. *....***.. .*\. * * *  .\.**..\.\. .* ...*  .. *\ . #
#.. .  .\..*..... *.*\*..  *.....\ * * *.   ..\*\.\  * .#
#.*. *.. \\.\  . ..  *..\. *\ *\.*.* * . .\.* .*. *  . *#
# \.*.\ .. *.*\  .\ .*\.*\*.* *  .*.**. \ .**\ .\**...\\#
# . *.. *\*\     ** ...* . .* .**..**. *.  **.   ...\  .#
#.* .**\..**. ..\\.\*.\....\.  ..  *.\ . .\.* \.**.. .\ #
#.. *  .. ..   \ ...* *.\.\ *\*\.. *.*\*\ .*...\\...*\**#
#.  * *\ . *. .... *.  **.* \*.. ***..*\.. ..* \.* * .  #
#  \. * .\ * \.\\. . *..  ....*.\\..** .*\   .\.  *.*. *#
#.. * .* * .****\.   *.. ..\..**\*.\*..*...\  **.**... .#
#.* .  **\ .*...\*  ** .  .  ..*.* .****. . .*.\.*.*.*.*#
# .. \ *.*.\\*. \*\*\.*  *  .....*  .*.* .  . *..***...*#
#.*   .\**\*\...*.*. .\.\*  ...\  .\***.\. .  ..\ *..  .#
# \  *.. * .  *\.  \* *  . \\ * .\ ..*.\  \ ... *..*  **#
#...* \ .. *.\*. .*\. ..* ***..  **. . \... . *\*.\. \..#
#  ..** .  \* . ..\  **..   ..\  .**.   .* .\   .\.\*.\.#
#\****.  . .* .. *.* .**\.\. \* * . ..*.*.\ * .. \. *..*#
# \ \*.\.*\ .*  .*. ... * . *.. .\   *   *..\\ .*...****#
#. ... **.*. . * * * *. .* \*.**.*  \   .\. .*  .\ ...\\#
#  \..*.. *.***.\\ * \.\*. \*.\* .   ..\ .  .... .....*\#
# ...*. \*.  *.*. \... *..  \....\ *\. .\*. . \*. .** ..#
#  .\ *...*  .....\ * .***.. .\  ***.. \*.*. . ..* .*. \#
#\    .*\..\*. \\. ..* **.* .. *..*. **.*..  \*\.\*. **.#
#.*. **\..**   .*  \ * *.\*..*\. *.*\ *...   *.**.**..*\#
#.. \.*.  .  .  \ \...**** **** * .\ \.\ . . .**. . . .*#
#.\.*..   ..  \..*.*. \\..\.*.. .  *..*  * ..\ * . .  .*#
#. *  .. *\. *.*. *.. . \.*.. .\..**.*\\ * .\**\..*\\* .#
#* \*\.*.  ... . .. * .. **** \. \.**..*\**\  *   .* .**#
#**.**.\    .  *  *..  . ..\* \   \.* ..\.  . *.* \.  .\#
#.\.. ..**\.... *.*.     ..**   ...**.. .. \**.*.   . \.#
#*. \   *\. .\ .\  * *\* .*.* .** \. . \  . .\.\.  ...  #
#\** .  **\.*\ ..... .*.\\ . \*..\. ..\  \.\ ...\... . *#
#*.**. *.\**\. ..\   *..*\ *. .. .   .** .. * ** .*\   *#
#.. .\\.* *.**.*\.*.\*...\ * \.  ..\  .**.... .\.*. .   #
#. \.\..... .*... .*..*\  .... **.*. \.\* . *. * ... *.*#
#**.. .\*  ..\.** \***. .\ .\\. .... .. *  ...... *\ \ *#
#** *\\.. .  .*\. . .. ** \. ..  *\*.. .. .*.\*.\.**. ..#
#*\*..*  *  . .. *\ *\*\\ *..   ....*\*. . ..\. .\.*  **#
#*   ..**.* .** .** .*. .**.*.*\.. .. \ \ \ ..  *.* . ..#
#\ ***.. *\.\. \.**\*.* .. *** .. ..   *.*\* ...*\\ **\*#
# ..*..\. * .  ....**..* .\ ...  \.*.*. .*.\*\  \. .*.*.#
#\.*.. . ..\......\ ....\.. *.\*\.  *.\.   . . ..\.\.*\*#
#. .\..\***. .   .  .*\ .*  **..* * .  *\ .  *\ **....*.#
# . . * \... *.*     *..*. *...\* ..  *.  \ *.  .\  \...#
#\**. .. .\\ .*.\ **.. *\*.\   ...*  . . **.* . .* \*.. #
#.*...   ..**\....*\ .......*\ *\..\  * ..* *\.\* ..\...#
# *\  . *. .. .  ******\.*..  .* *.* .\* \..\  ...\   **#
#... . \. .\ .* ......**\*..*  . .*\ ....\.\  . * . *** #
# .\.\..**..\*..**.. *..*.  .    *.. .   ..* * *. *.*\  #
# \ ** .** . .* ** ....\.*..*.  .* *\  **. *\...* \**. .#
# . .*  .\ * .\*.\ *.\ .. .*. .*....*.*... .  .*\.... \ #
#*\   \.**\..\... .. ...  ..\ ...\.\*..*.***  *...\    .#
#*.   .*.\.**.\. . \* . .* \\.. ......\.\ .*\*\  .  .\ .#
#..\  *.. \*.\ \..\.    ..*.\.\.  *. \.*. *.**.*.  \\.*\#
#..*..* \ .***..*. .*.\.. ..** .. ...* *   *.... \ .*. .#
# \\.*. ..*....\...*.. .*  *.\ *\* ...... *..*  .. *.. \#
# ..**...* ..*. ..***.  *.*.*.\..*.*\ .   .\.* **\.**.*.#
#.  .*\. .*   *\.*..*\**.\.** **.\.\ **.     *..\..\\*.*#
#. . .... *\....    \.\....**..\ .\.\.*..\.. .\   .\ . .#
#\.*.\ *\*. ...   .*\.* .* .. . *...\..\.*   .. . ***. .#
#  *  *....   . \*...*.\ ..\..\.... *\* *.* ... \  \ *\*#
#\.\. ...*  *\....*.*\...* ....*\ **.*. **. *.. . *\. *.#
#....  ....*.  ..*..** * .\.*..\..** . **.. .\**  . ... #
# .**\.*.\\.... .. *..*.*..  .. . *    .\*.\*.**\. \*   #
#.. ... .. .. .**  * ..  *  \* ** .\..* .\ * . . .*.\. \#
#.  . * ** *\ *\.\.\*..\*.. .. .*\** .*. . .*.. ..* .* .#
# ....* *\**.\.* .. .*\.**.*\* .\ .**\...\.\ *...\**\. \#
# .* * *. ..*  .\ *...\.*..**  ..*\*. ... **\***.*.\. ..#
#\.. .\ *\. ** .**\  .. ..  ..   .*.\* * \\.\.*\\.   .*.#
# *\*.* ... \. *  * **\*..*\\\\.***.*...  ... \  \\.* .*#
# . *\**  \*  *.\..... \  .....  *. **.* . *.\*. .   \\.#
#   *....\*\. .. *\. .*    **\..*.\  . *.***. .* .   ***#
# .** .  ..** * ..  . **\. \... .\*  ..*. *    ..\. ..**#
# ..* .  . ... .****. **..*\**\*.*\ *\ . .* . ..*.. . ..#
#*.*...\*\\ .\.\* *. \*.. *....\.  .. .. ... .\ \ * ..* #
#*.*\* . .   *.** *.\.  ..\.*. .  **...* \.***.  *.\*   #
#.. ....\ ..** ..\. ..  *\..**   .\\.***   ***..   ..  .#
# ..\*.    ..\. ..* * ..* . *  * *.. ..*  *.*.. *..** ..#
#*.\.. \*\.* .**..* *.\.*..*.  .\.  .* .  .\.* * \ *...\#
#..*..\..  . \\.\..**    *.\ .* *..  ...**  ..*\** \..  #
#\ .   \\ ..  * .*\..\ *\. *  *\.* \..\\.**\  \*\   .. .#
#*\   * *    .*. .. * *....* .. *.\..\. .\. *.*. *.**.* #
#..\.\.*.***. **. \ .\.*..   ** .. ...\.*   \*..*   *.. #
# \  .**. ...**\*  .\ .*   .\ *\\* ..  \..   . ** .\.  *#
# .*\ *  * **. *. \*  *..\ ..*..\. *  *..\..**... *** . #
#  .*. \....\....*  * *\.*  \. *** *\**\ * .*..\\..* .* #
#\   *..*\  ....\.\*..**.**  * .\. *...*** .*...\.\.  . #
#* . .  **  .*..**.\* *...\\*.*   .** ...* ...  .\ \   \#
#\.**\\ *\.......\* *..**  *. \ *** * \.*.\*.*.  .\.*  .#
# \..\. .*\  * \*...\*.*.*.\...  .  \  ** *\   \ *  * ..#
# . .    *. .   .*\ .*.  .* ..*\ *\*\*.*.**.\  ... ..* .#
#*..\* *\..* **. .*  .*. ..  \.*....** .\.* ..\*  * .. .#
#. *\*.* ***\*. .\. .*.* .. ..\.. ..**.  ..\  .\..**\*.\#
#  * ...  .\ .*... . .\.... .* .*   .\ ..\*   ..  * ... #
#*.. *.. \*.* .. *.. .....\.*. .* *. .*..**.     .. *   #
#..\* *.. .\*\ ...*  .*. *. .  ** \   . .\.\.\ ..**..\* #
#\.*.*. \   * .  *.**\   .. * .\ *. * \ ..*.\.   ...  .\#
#**.\\...  *..*.*.\. *... .  .. ... ..*.. . ..\*\* *.\*.#
#**...  .. . *. .** .**\* \....  .. .*\* .. *  . .*.**.*#
#*. \ ..\.*\*. . *\* .*\.    .*..\ \*.\.    .   .\  .*\*#
# . **\.*.\*. .*\.**.\\*...*  *\*.*..\.\  .*\.\ \ . **.*#
#. ..* ..*    \.. **. .  ..*  ..*..  * .* ..\**.*.. *.\.#
#*. ..  *... \  \ .*. *  . ..* \    ..  *\ .\*..\*.\ *. #
# \*\.\*\   .... ....*\  *\ .\*. ... *.  . *. . .*  *.\.#
# .*.\ .\. ..\.  * **\ .***.*.*\. .\.*..***\.*\...  *.  #
#. ..***.*. . **\.... .*.*..*  ..  . *  .\. .\********\*#
#. *.*.*.\*** .\* *\. ..* \.. \       *\.* \.*..*.......#
#..\***\*.*.\**.. . \  .. *.\..* *  .  . .\.*.. \.  *  *#
# *..* .**... \.* .\.   .*.   \. .*..  *.*  \.\.. \..\ *#
# . \ .*\**..*..* *  . .  . *.*.. \\ ..* . ..* .* .**. .#
#. *.*.... . .*...\ . * \ .\ *\ *.  ** *\\*  .\  *.*.**.#
#\ . .**..\* \. .. .*.\ .*\.. .\..  .. .. ... \.\..  *.*#
#**..*.. .***. **\*.\  *... . \*   ..   .\ *. ** .  .. *#
#.. . \   ....*. .\... \* *. . *  .  **  *.\..**  *. *..#
#\**.*. \..\ *.  *. .  *\ ..  ..**. .\.*** .  *  *  ..\.#
# * .  ...* *.*..\*.  *..   \**..*\.\* .  ... \.   \....#
# .. .. ***\....\* . *.....*.\** . ...\. .****.*...*.*..#
# .\ .\ ..  \* * . *.* *.....***.  ...  .*..*...*...*\. #
#  .** **\ . .*. \* ...\  .  **..\. .....*   \ ...*..*. #
#.\...  .**  .\* ..  ** ....\**\ .  *.* \...   *.* * ..\#
#. .* . .*.   .  \ \  .\... ..*. .. . **\ *  * \ ... .. #
#\.  .*. **.  \.*. \  . *.*\  *..**.\ ...*  *. \. .\.\  #
#.. * \*..\** \ .*.* \..*.*   *. . *. *\..*\. *. *.* *. #
#.**. ...\.*..   * . . .  \**.. ***.. .   *.. .*\. ...\ #
# .   *\  ..   .\..\.*.**  .*..*... \ .. ...\***.*.* ..\#
#   **.**.. .  \... *..*  . \..\\.* . .**\ .*  ** **  . #
#*. *. .\.  *. ...... \.\*.* .*  . *\.\**. \* \\. . \ *\#
#* **.\    *\  *  ** *.\..    .\ ....  .** .\   . \..\. #
#..**** *    **.\ *.*. ..\.  *..**. . .\*.*.*\ * *  ....#
#  #. . \***. . .* **.. .  .*.\**** . \ . *. ... .   .* #
#..\.**....\..* ** .*. \ .  *....*...\ . ** \. .* ..\\  #
#\ ...\ *.\*.  ..\*\. \*.\ ** \.\**\  ...\. *.  . *.*.*.#
#.. ....*    \*  .. *..***  * . ..*.\. ..***\ .\  \**.\.#
#..\  * ..\   *   *.\ ..*. ....\.   *..  *\* .\ .... .. #
# ..\ *.    .*..\ \ .*. \ . \ \..*.\*.  \* .  * .. \ . .#
#..\\** \.**. #   ..*\. .. ..*\*  ..***.**\.\..*\.. .\ .#
#..*...\.. .\.*\*.**.. .\*..  ....*\*.*\.. \.\.. \*\**  #
##.*\\\ \  . .**..\.\*   ..\*** **...*. *.... .\\.**.** #
#...*.* *..*.. .* .  \ .. . .**. .\ *..\. **\\  *... .\.#
#\...#.#* **.\\..  \...\\. .* ..**.*\...  .  *\*.*.\  .\#
###\#. .. ..#\. .... \*.   \ .   .\. ..... \ \*\ .  .*\\#
# #.##\ .\** *#.**.  . *.\ . .\\#*.\ .*.**\  .#  *   \ *#
#  # #..#*##  . ***...\*..**... ##*. .\*\  .**\  . * *.*#
#     #*## * .. ** * \*.* #*  . \**.\  **.  .\#*  \#..#\#
#      # #\.#.. .\ . . *.\.*..  ##...\*.* .*.  #*.# #.###
#        # *#*\  ..\ ** #...   *#* ..*.#. .*... *#   #  #
#         ## ####*###\ \  .\  ## #..\ **  *#\*\##       #
#               #* **  * **....# #.* .#*. # .\ #        #
#                ##.###*#*#* \*.##*\.*##*\##*##         #
#                 #\L #.###*\#*##..#.#  ##  #           #
#                  #   #  #\##.# ## #                   #
#                         #.# #                         #
#                         #.#                           #
#########################################################