##############################################################################################
#   ##\ *.. \ .*\.....   .*** *  . .*  .\*.**   \   \ .* . .* . *.**\.. .  \*..   *#.# #*#   #
#  #.#...#.   .**.  .. * *  .. . . .    ..*... . *. .\.. *.\* **\ *\  ***.*..\  ...#. ##*#   #
#  #.# *.**.**\.*..*  \*...\ * \ *  *  \.. \.\*\*** .   *. ** *.. \*\. ..\.\ . .  .  . . #   #
# #*.#.#..  ...\\ .. \...*\..* *. . ..*. * .\ .**  **  *\. ..\.\   .* .* . . \.#  * \. ..\#  #
#  #\ .\* .\*.. \\ .  ..***.\ .. .   **. *  ..**. *...   *\ *...\. *.\ \.\..\.  \ \ .. *##   #
# #*.#.#.**.*. .  .*. *.*.. ***.\*  *..\ *\*\ \ *.*.*   .** ... *.*..* . * *. . .* .  .\#    #
# # *.* \ ... .\.  *\.\.. . ..*\.  ..\. .. * ..\.*  * *.*.*.\ *....  .. .**\. *.\\ ..*.  #   #
#  #. *.. *  .\... *..* . . .. . *  \.*..\*.\.  ...*\*....*.**. ..   .*  .\*\*.**    .**.#   #
#  #*\. * *\..* #  \. \..     .\ \.\\*.**.*\.*..*.\...* .\ .\.. .\*. * \  *\..*\.. . ..#* #  #
### #.\.*.\.\.. *\* *...*\..*    . . .*.* . .. *..*.. . .* \*. .  ..*. .\.\*. .    \ \ .***###
#\ ## * .*.   * .*    \ . .\. . \* *.\.**  *\... .* .*\. .... . \** .\ .\ ....\ *... .. ... .#
#..** .\. .*....**\. .    ..\.*  \ *... \ . .....*. *\*\ .... ...*..    ** \* ....* *.\ \ .*##
#.* #\. .\.\.\* . . *.\ *.\  ..\.* . **.*..*\  .\.*\.*... **\. \..\. . ..**...*\. *.\..***.# #
#*. ..\ .. .\*** . ... ..  ...*  . ..\\***..**. .* \\.*. *...   \ .\ . \  \.**.*  ***.**.##  #
##*.**..** *...* * \ .\* . .  . .. ...\...  ..*\.* \ ** .*..  .\.\ *. *.  . \ . . #.. ** . # #
#. .\. **\ .** .**\..*\ *\*   ..*.\.\*. ..\.  .**.  \* . .*..**. **. *.   * *  * \.. .\. .\# #
##.***..\.*....... .\.... .. *\  **.\.**  ***\...**. .\\  .* .   ..\.. .**... .\ .*.\* ..*## #
# .\*. .\ .  **.\.***.* .  \  *.\..*.**\ . .. *. **...*\..  \*  .* ..***.\*\ *. # *\.#\*\.\*##
# #  . * ..** * . \..\.\  . . .\.*\.. ..\ . ... .*..*\. .\ ...*  *****\**\.\*.\.\\..#* .*### #
#** .  \ ...\  *.      . .     ....*..\*\.. *\ \.. \*.   .*. \.\*...\*  *.\.* \..#*.\..##    #
#.*. **. *. .*.**\.\*.  *..*.. \.. .. ..*.\ . \  .\.*.*.*. \*\*  .. .  ..\*.  .* .*.*\ #     #
#*.. .\  *  \\ ..*. .   .  .  .  .\**.. .\ * \.*.\. *\..  ..* . .. * .**\.. .\**.  \ .*#     #
#. .\ .\.\...*..  ..*\*  * * . .\ . * .**.\* \ * .\.. \.  .  .\ * .*\*.\.\*.. .*#\ .*##      #
#L..# ....\*  .*.. . *. *.**. .**  .*\ ..\ . .*.  . .   * * * ...\..  .. .\ \. .\.**\#       #
#..*.*\**.*. **.. *..* *\.* *.  .\*** ** .    ..*.\ . .*..\ . .\ * .  .. *.**.\. .*\.#       #
#. ##* * **.***.*..\ ... .\\.  \ *.\. ** .*.\.. ..\   **.*.*.\.*. . *   * \.\.  .\###        #
##*.*. #... .*. *\.*\ .......*.  \.. .\.... ..R\   ..*.. \.. .\    .* .*\..**.*\##           #
# ##### *\.* **\.. *. *\.\\ \.      . ** \.\.*.. *\. .. ...  ..* *.\.*...  ......#           #
#      # ..*\.. .**.  . ..* .\.. .\\.\. *. .....  .*. .\.* * ...* .. .\.  #*\ \  #           #
#      #\*.*... \..**\   .*  .**. * ..**..\.\\.* **.. \ ..\.. .  *. **.\*. ... * .#          #
#      # . *.  ** .** .*. ... ..\\*  .*\ *. .  ...*. ..   ...  . .. .\*.\ *\..\. *.#         #
#     #\\ ..\  *\\.\. \*.*  *\.\..***... * ***\  * .**   \.  \*.. .   \*. \.#*** ##          #
#    #.*##.  .... .. ..* \.*.  *.*.\* \. ..*...  *.*.. \. \*..*. . *.* ...*.*..\ \ #         #
#     ###\..** *   *  *.*..**  .. *.\.  .......**\*. . .*\ .\ .*  ..*.\ \ ****\ ###          #
#      #\ *... *. **\..*\ *\.  *\*.\.\   ** *.* .. .*\\*.   .*\.  \**\. *.#\.\*##            #
#     #  \**  *..*.\.\ .*.. .*.\.* .   . .. . .  .   .\**.\..\    #.#  *\. * ** \#           #
#      #**.. *#** *.   \...* . * ..\  * . .* ..* *\.\.\*.**...\ \ \*. .**. \.####            #
#       #\.**\#\##. .\    *....\.* ... *.. * ..**\.*...\#*.**.*. ...\*#*.. *##               #
#        #*\ .#...   *  \** . ..\* .\ .**. * ..... \..*# . .*.*.  \ ..##.#*** #              #
#       #*.. #\ *.. \*\ .. .  .*..*...\. .*. *** \  *\.  \ \ . .\*#...\ *#.\* #              #
#        # .\####*. *. * .\ *.\\# *#* . .*.\ .\. ..\.*  *.*  .*.**..**.. .\###               #
#         ##**# #. \#\....  ** * *.*.  . .... .\.  .**  **#  *\ ***\*. .## #                 #
#           #*#  # ..#\  \.*.##. .\..*\*..**\  .*..**. ..#* *...*#*.*..*# #                  #
#            #    #  \.\  . \.\..*. \*.**#*... .. *\*#* **. **   .# * #.#                    #
#                  #  .*\*\.** *\*.*.\..* *  #*  *\ .##**.#\ * \.# ### #                     #
##############################################################################################