########################################
#          ####*##.#*  .  \* #         #
#       # #**\ *#.\\**.*..*  #         #
#      #.#.*.*#..** * **.. \ .##       #
#     # *### ...  *L. ..*.*...#*#      #
#      #..#  * .  ..  . ..\ *.  *#     #
#      # . **. *. .. *  .* \...\ \#    #
#    ### . .*. .****.. .***.. .#.#     #
#   #\ .*** *. *. ..\.\ *... ..  .#    #
####   .\*  *.. . ...** *.\.. *.  #    #
#   *..*......  . .\... .  \. **...#   #
#*.* ..... .*\..*.  \\ .  ..  *\.#*#   #
#*** . .*.* \. .\. *\*  \. .*  .*.#    #
# ..\.\ ..  .\..*  *.*\\.\ *.\*\  #    #
#*##* .* ** \ \*.*. . .*.*\ **. . .#   #
#**#** .... .... ..  ...*.. .... .###  #
#.*  ...  *\.  ..* .. .*\  \*..* ##. ###
# * . *\  . . *.**. \  . .* ..\*.. *\.*#
# *  ..** ..*.* .\...*\ \ . *.. \.* #.##
#\  *....\*** **\ .* **..\. \\  ..*  # #
#.*.. *.....****..\\ .. . *\..*\ \*\*# #
#**\*\  . *..*.*\. * \ .*...  . #.*#.*##
#...\* \ ..  \..* *.\  *.. .  ..\ *### #
#\. .*.. \ .\. .  \ . *.. \.*..\*##    #
#  *\**\ .*. *...   .\* *.. ... \##    #
#***.....*\**.   . ..* \.* \*\ ... #   #
#*\.*.* \.*..\ **\ .\.  . ...\. . #    #
###.## .# *.. .*\ *\. .\  \ ..*.  \#   #
# #.*\  ##. #.*.. ..  ** *\  * **.#    #
##.*## .*#\ .\.  ** ..**  . . \##.*#   #
# ###.\ .. **. \...   .* *\  \#  ##    #
#  #***\.\*#..     .. *.*...R #        #
#   #..*. # * . . *  *    *..#         #
#    #*.  *.#.. . .*\... .*  *#        #
#     ###*#\##**\.*.. .*  *# #         #
#        # #  #\*..    \#.#* .#        #
#             #...   .**.# #\#         #
#             #\.*  ...#### #          #
#              #*. .*.\ .\*#           #
#             ##\. \# #\.##            #
#         ####.* . ##.###              #
#        # **.** ...# #                #
#         ###..*\ * ..*#               #
########################################