###################
#   #\# .*.**\  .##
#   #\.#\* *.\ .  #
# L#. .  ....*.***#
##\. ..   *.\....*#
# *\.* *  *\.*. *##
#####.* \ **\.\.\*#
#  #\...... * ....#
#  #...\  .*.R..* #
###################