#################
#   ##. .... .\.#
#  #\**..** .\*.#
#   #...*. . **.#
####L ...*.* *. #
#\ \.. ..*..**\.#
###.\   **\.R*..#
#  #\*.* .*.\.. #
#   #.* . .\*  .#
#  #. .*. .  .. #
#   ##.\\.\ \.\.#
#################