#############################################################################################################################################################################################################################################################################
#.\    \ **  .   .\\*.* \.* **  .. . \..\..*.\.*.  \ **.\.   ** *\ ..  **. * *..  ** *. ...*.. *\   *\.*\.. *\. .*....... . *. .. .. * *.*.*\** .  *.\.* ..* \\.\**... .. . ..   *  ..\..  \* \.*.* \.... ..\   . ..   .*     *..*.  *. \. ** \.* ......*.*..\.. \   #      #
#. . . .\**.. ..*\...*. *  \\..      .\... *.\..\..  ...*\. .\....*.  ..\ ..**\**.**\*.\ .\. \*. \ \*.\.  * *  .*.\***..*   .*.*. .. .  **.\ ... .\.**\.\.\*..*  **.**  ** .*. .\ *.  ..*. .. .\  * *.  ..*\ \* . .*** \*..***.*.. \.* *..*.. . * *   \....\ ...*. .##      #
#. * * *. . *. \... .\.*. **.* *..*. *  . ....  . ... .*. .. ... .. \. *  ..\* *. .. .*.* *.\*.**.  . .  *\..  \.  .. *.. .. . * .*. .... ..\ *  .**\.  **. \ .  \......*. ..\.\. .. .*.\ \..\ .. \. *.. *. *.*\       ..* ...\.. \. .  .*.  . \.** ... .\\..   .*..**#     #
#... *..  * . *... . * . .\* . *. ..  *.  .  ...  ..  *.*.*. .*..**.**..\.*  *..*  .  . *\..*\...*  \. *\* \.   \ ..  .*  ... .*  *.\ *  .\\  . *..\\\  .. .. *.\.. ...*  .*\*..\*... .*. ..    ... ..\. ...\**...\* ..* *.*  *\*\  .\   *   .* .*.**..   .   *\.***##      #
#   *\..   **\ .\*.**.  **.*.  .*    ...***.. .\...* .\..... ....*. .\.\.\*\...  .**   ..**\.  . .\ .\ ..\.. .*.. \. *\*. **. . **..  . \ *.*. \*\\.*  ... *\.\ ..\.**\. *\. .  ...**.*.** ..*. \ . \  .* .  ...*  *.\.. .\* *.* .*.  *. . *.*.* ....*..  \.\*. . .###      #
#\ \ *\.\..*...* . .\  \* .*.*.* . \.\ \.\.\.\ *. ..  **\. ..\*....   \*\ ** .* \ *.  ** .* .** .\  ** . . . ** *\   * ** *.*****..  . *. .*. ..\.... **.  .  ..\. .\***...   .. **.***.* .  \ . .\*.\ *. . .*. .. .. \.\.*.\\\\. .*.*..   ..*.**.   .  .  \ . \..  \.#     #
#.....  .**. *..\ . ** *\...*... . **.\  . ..  . ... . \ . * *\ .   ...*. ..\\. . * \.\...*. \.*... .... ... *. ..* . *.*.. ..***\.\  . *.***.\.. \* \ \ \  .*.*\. .*..** .\*. * .\. .\**.*....*\.*.*  \. \...*\ \  \..  ****.. .  **.. \  .*....\ *.  . *\. \... **#..#    #
# * **..*..*\ .\.* ..*.*  ..\.. . *.*.   \  *\.\**\*  ..*.\. ..*\.* .. .*.\. *\***\.\ *.\*.**.***.*\ .. . *  *\.  *\ ...  **. ..\ .* . ..... .. .\ \* .. ...\.**. . \.*...* .\ .  \ .  *.*.\...*.\ *....   . *\...  .\. .\*\..*  .****\. .*.. ..\**.  *\ *.**.\*. ** .##    #
#*.  .  \  ..  .\*..\. * .*\ .   *\... *..\ * *.*. .**.*. **   .*.* .\ .  ** . *..**.\.  .\* \....*..  . ..**.  * *  \.**..  . *..  . . . *.    *.. . * \ \**...* .*..* *\. **\ .*.\   \ .\..\.*\ ..   .. .\ \.\. ..*. .**\*.*.*  . *\.*...\\.. . ... *.\\ *  .**..*  **#   #
#\ *..*...\ \. *....\*..\\.*.\ ..\.\* \\* .\ ...*   ..\.\**.\.*\... \ \. .\.   . \.**  \*\. *. . ...* * *.\.*\**.*.  .*.\.*.*\**\...**\  *. ..*.. \\* .*.\. . *\ ...*\*   ..\...*\*..* .\ ..\. . . *. .  . .  .. \  ..*.. ........*\* \.**..*. . *.*.**...*. ..\**#* ...#   #
#*...**.. ...  \*.\. . \.*.*  *  . .*.  *.*\\.\* *\.. ... .  ... .* *..\\  . .*.  ... \.*\*...\.. \.\ .\.\**. **..\.. .*..*....\  *\*.\  .. .*.\\ .... *.* .   ..* .....* * ** \.   *.. *..\ **    .. \ ...*  ***.\. .*. *. \** \*.** .... \.. **\.**..\*\ *\.  *.*.   *##  #
# *. ..\. . .\...   *.\. ..*\    .* \.\* .... . .\ .. .  **\. * ..**\.. .  .* .. .  \ . .*.* ..*  \ *\ . ..* ..*. . *  **..**\. .*. .*.*  \* .   . . .**.\ .. .* *.*.\* *....*..\  .**\.*\.  \** .*.*. *.\ .  \\*... ***.\...... ......*.\.. . .*  ** ..\*.\ ....\.\\  \. ###
#.\..**.   .\...*  **.   ..\ *.. *..* ..** .*.* .     .  * . \\ .....*R.\. .. .. *...*. ...\.**\..  . * .. . ...   \..*\..... .*. ..\* .*...   .  \. *\\*.\. \ ** *.*..  .\   .\*** *\. \*\. \..\.*\. .***.    ** *.*..*. *.*. *..\ ......   **....*.  .....*.. . #.**  .* \#
#  **...*.\ . ...\ ..\ .**.*.**\... \*\ **. * .\..**    .* * . ....\ \.** \.\**. ..\*.*   \*\ . *.  \.** \\ ..*\.*.....*.. . ..*.*  .*...\. *.\   * *. \  * .. .**.\ \.  ....*\*.....*  .... .  ***\ ..\.. .   .. ...*\.\*.*.****    . .*  .**.\ . \*..*\.  * \. *\ .   #####
#.**\.\ \  **..\*.* ....*...*...*. ..* . ..\*..\.**. ..\*.*. . .*.. *.**.**.*.\.. ** \. . .*\*.\*\*  \..  .. ..** .. ......\ ... \.**.. * * ...*.*\ *.* ..  .\\..*  ..\ *.**..*  ** .*.  *\ .\. .*\... ..* ..\.  **. .**.\ * ...\ .\..*  ...** .*.... .\*.. ..*.\*.. .\.#   #
# .*.  . *. . .*. .. .* ..* \  *. ..*.*.\.*..*. * *\\ **   ** .. \..\ .*.*..*** *..*.. \... .* **\.  .\   \ **.* .\   ..*\ .\ . ....\ .\ .\.*   \  ...\     ***. .  ** ...\.\*.. ..  *  .*.* \ . .**    * . *\ * ..**. . .  \*. ......\.\.\..\*\...*.*  **  ...\..*.*.##    #
# .\...*..*\\. ...* * . ....\. *\.\. *. **.* .* \.***.... * **\  . . ..*\.. * *..*...*** * ....*** .\. *** *. *   .**\  *..  \ *. .. .....    *\.\.*...*\..... ...   *.* .. *..*  . \*\..*..   \.*.\  . ..*\... .*. \ * *\......  .* ..*.  .\*\  *.\    .\..*. \*.####      #
#\\ *\\**..*\...\*...  * \. ..\....*   .***.\*.  ..\.*...\.*..  **  \  .* *.. \  .. *.\\..**.....**.*. .*.\*. *  *.*. . . *. .*. .\.****.  *. ..*.   \.\.\. **\* . .*..\   .**...  \.  . **...  .*.** \ . . .*\  **.. .\..\   ..  .\   *  . * ..*.*.*.\.\ *...**\*..\.#     #
#  *.. .  \....* \ .\ *...*      ... *  *.*  .   *\.\.. *  * \ *..  .\  * .    \..*.. .**... **. ..*. ** .*....\.* . \. ...*. ..\*..\* . * .* *.\\**..  *. . **\.***.\.*.*..**.*** ...\.\.*..*.  . *\..\ \\* \...\ *..   ..  *.**. .** .. *. .\..\.... . \... ..*\*.**.#    #
#\*\.*\ ...* .\. ..**...\....\ *. *.\. ..*** .**.*  .*\..   ** * . ..* .. .*\*\...\\ * . . .* ..\  .*..\ *..\*..* . ..**.\.\. . *..*.. * *.*.\*. .*.. ***.. .\. .\..   *** *... .*\ *\** *..\.*.. .. .* .. *\..    \ * **.\. .\\*...*.*.* .    .\.** .. . ...\.\\. ...#     #
# ..  ..*.\.  ..  *  *.  ...*. * \.*  *\\.\..*..  .* .  .\.\. **\....**.\ \*.\ \ **.\\*..** . **...   .*.* ...*\..*.. .. * * .\.\..*.\..*\.\*.... **. *..\  \  ..* .. .**... ..**.**\.. ..*.* .**. *  * *  .*.*..  .\ ..*\.\  **.***  .   .\* .  **..\*.. .. ... * *.\ #    #
#. *..\.** . *  . \.**.\   .****.\*. *..*  **..*** . . * .. . ..  *.\    .... ..*\ .*   .****.\* *. .\ .**. \..*  *.\  . .\.. ** *...\\.. ***.** \.* \... . . **\    *\* \     \ *\...\. .**. ***\ \**  \.\ .*  \ *. ..\..*    \* *  .. *.\...\*..\*.  ...***.*  ..*****#   #
# .\**.*....  . ...**.. *.* ..\  ..* . ..\   \..*.. *..** \  * .**. ..*\  . .* .\* \.*.  \.** ..*\.\ *\..\.*.\..*.*\. . \.. \    . .  .*\ .*\ \*.. *\.**\\*  . .. ** *.  .   \.. ..*  *. *..*.....*.\.**.*   *... \   **\ .*.. .***.* ... * \.. \..*..* *....*..\**.#.**.#  #
#\.**\ . ..    .  *..\* \...**   ***  \ .. .\ .\ . .*.*..\..\.* ...\  * ..\  .*  *....  ..*.*\ . ..*.**.***.*\.*..** ..*.*.  .* ..  . .*\.**  \. . **\ **... \. .*.. .*\ .. \... \.\\ \. \.\*** \ .*. ..*\*.*\...*.*\  * . .. \*\* . ...*\*..*** \*. . \.**.*. ..*.\#*###   #
#.****.**  \\\ \ *..* .\*   \.* .*\. *... .  **\.**..*..**.* \* . *..\* *..*..\.\... ..*.\* . * ... **  ..  *.**....*. ....\.**\\  .. .\. *  *.    .* ..\** \ \. \.. .. \ *  ..  . \  .. . . .. . ...  *......** \*..***.\..\..* ...*. *. ...*.***** \ . *\. .# #  # .#     #
# .*\ \...\ \*..*.....*.  * . *. .  ...***.. *.. . \\ *.\..   ..\\.\ *. .\* ..*.**\.   *.\*. . .*  *..\. \ *.*... *\. .* *. \.\*\.  *. . *\ \.*... \.*\******    .****..* . .*..   .\. *.... .. *  .. *..  *. .*.... *.\* * \* . \ *. \.* .*..\.  ..\. ** *   *.* \###      #
#\*\* **... ..****.  .* ***\*.\.*\.. ...\.\.. .*..\.  * .* .**\* .. ..\ \.\ .\.. *. .*.....\.  ....**\. ..**    . . * \. ...\....  * .* *.. ..*.*  ....** *\*  \ \ \* *.**.*\ .\.. \. .  *   .. *..\**\*. .*.* .  \..\* .\  .*\    \  **....   ...  .. ...*. \ *.#.  #      #
#* .*.\ . .\*\. .\. * *....\\*. . ** .   **** ** .. .. *.* ..***  .. . *..*  .*. ..**.. *  * \. ...*..*\....*. .\ ...\.  .* . \.  *.    *..  ....***..\.\ ...\.. .  ...  *..\*\.  ..\. ... \*.*\..*\ .\ *  . *...* \..*  .  \. \.\  . ***.**\.  . ..  *..*.*\*.\ \..#       #
#. \.*..\. *.. *. .*.   *\*. . * . . * \.\ ....* *.. *..**. .\.* *** .\.\ .** ...\**..*\.***.  *  .*.... ...\.* ..  . *.* *.\.. *..*   ***  . .. **\*\*. . .* . \.  ..* **..   .   .\* * .. .*.*.**  ****\. **\  .* .\.\ * . . .  *  \ *\ .\*. \.*  .*\\*.**.\.  . # #      #
#.*.. \ \ ....*\ ....\  * *  *..  .**.  . .. **.*.*. \.. \*    .\.... .\**  *** .*.* . *. ..** .\    *\..*  .\ . * *..\ ....*\. . .\. *\ \ .  . *....\..\  ** * ..  ..  *....*  *......\*.\*  .*.. .\*.**  *\..  * **.*.**\. ****.* *..\   *. .     * *\. \*.... ***\#      #
# *...   \.. ** .\* .   *.*. .*\ .\... .\..  ..*.   \.  ... .  .*  .  **\*  . \\ .**\... * *.\.\***. ....**.*\ **..*.\  *. *\.  .\  .\. *.*... .    ..  . .* .*  .*\ ..**. *\*.*\   ..\.\. ..... ...**.\ *...\. *..\*.\*.\  \.*.**.*\* . *...\. *.. .*  \. ....  *###       #
#\.**\..  *\.\*.. * *.. .\ ..*. .\*\\\ *. .*  ..   .** .***\.\ .\  . * *.. *.*....\....*.\....\.......   ..*.*.\.. \*\* **.**. . .**. .\.*  *  * **. \. \* **.. * .**\  .\..*.*......\...*  .. *  *  ..*..*  . .\.  *..\ *.** \**** *\   **.\.... **   ...  .. *...#        #
# *.*. ..\*  *...\.*..*.***.***. .  \ ..  *...*.*.\.*..*\*\*..*.. .\.\..**.*.* .*\*.* ..**.\ .    .*.  \ \*.. .... \.*..* \ *..\.*..\*. *.*\ . . .*.*.* ..\ .\.*.. .. . .* .\.....*. .\*\*.*  ...\.\.*\*  .    \*.... .  *\ *..** ....\.   .. \ . .\  * \..*.  .  ###       #
#..\..  **\*..*. \*  *** ..*..\  . ... . .*  .. .    . ..  .  ... \* **\.**.\ . ****.  .*  .. .*  *\. .. .*.**.\  . ...*\. .**. *.  ..\.. . ..\ ...\* **\.*.*.\.\.***. .\**   \   *   ..*....  ***  \ *. \..  \ *...**  \\.. \..*\****.\  .  .**..* .*\..\*.. **. #* #      #
#  . . *.......\* *..\...  .  .*.*....*. *.\ * *..**.*  \.*. *  .*.*\*. *..   * \.\.\.. *. .. ..\.\*  \. *... **..\   \*. . .***\ ...\. .\  ...*...*\ . .*\. .*    ..* . \.    *.\.. . ..\.. * .*. ..*. \.*\.*  \ \..* *. . *.* . *\ .  *\.. **\.  \**  .* . ...\  *..#     #
#**.*\.... .\   . . \**..*..  *\\.*  .*.*... .\.\ .*..  ..****\  .** .* .** . ....*   .*.  * . ..  . .\ *....  .    *\...  .  \ ..*\  .*....  *.  ....  .*.. ..  **.\**.... **** .  *   *  \..\ .**.*..\*  *.. *.\ *. \.\\. *** * ...\\*.** \.. *\*\*..\..  .*   *..##.#    #
# *\.*. .*\* .*\* *. .\*  ..\.\*...\*.*..** . . \*.\.. *...*. * * .. .. ..*.* . *\   . **..*.** \ .  .\...*.   *.**\***.*\ * .  .*.* *\ . \    \*\ *\\ *.*.** \  .**.*..*.\.*..  *.*\ .\*\ ..*.\\. ..*..*  ....*. \* .. . *.*......\ .\. .\. *\***.*.. ** *.\*. *. **..\#   #
#.. .* .*..\. .*. **\  . .**.* \ *   .. \*\ .. *  ..*. ...\.. .\.*.*\ \    .*\ .* *.\   . .* *\*..   \* \.*.. .... ... *. ... *.*.*\.. ** .\   ..* . ...*  .* ... *\**  . .*.. ... ...   .. *. *.* . .**..*  ...* ... *\*.. ......  *** ** ...... **\..*..*\.*\  ..\..##    #
#**\**     \****.\..**...*.* .*..*  \.... .\*\ . *  . * **  .*.* . .. ..   **. \. \. . *.* . .*.   .\.  ...\  **\..* *...*\.* ..* *..\.*  *.  \  *  \.\**\..* *. *.*.*.. .   \     \  . \ .*.. . .  .  * *  *. *.. . .*.*.* *\*  *. .**   * ..\..\ \ * \. ..\.*   .  #      #
#.*** \\.*.. .*..**.*..  ...\ ..  .* . \ \ ..*.\ . *** .*.**....*..\ .  .\*\\.*..\.\.. *...**\*\ **.*. *...\ ***  ..\*  \.. . . ...\ *...*\.  * . .*.**.* * \.*\ * . *...\ **.*. \ *...*.  .\   .*.    **.*.*\...\ .* ..*\.***. * *.*...*..\ . * . .\ .. * ..\.. ..  \##    #
# *.. ..*.* **..*...   \. .***. .   * \.  . \*. . .*.*.*.. \*.*\. .**\  . .\  ...\ .  *** \* *..*.. ***.\*... . \**...*\  ** * ...\*.*...* .\\*.* .\.* . ..\.**.\\ **\.. *..*\*.* *   . \.* . *.\.. *.*. . *** . ..*\  ** .* .  . .  .    \* * . . .  .. .\..*\ ..\  \  #   #
# ... *** ...\* *. .. .  * *.*. . .....*. *. .***  *..*.\  . \.. . *.\  \* * \ .*  **.\.*...**\. .\ *.*\. *.\  .... * . ..*\.*. \. ..* ***.. .*.\.*.*.* * .*  * .**\..  ****\ ..\ * . ... . . ..   ***. \ .*... .*. .  .. .  .*. .  ..\.\ ***.**..\..\ \...* **\ .#. .##    #
#\...*. . . **  ..  \.\*\. ...*. **...\*.*.. ...* *  \.*.\.*\*. * .  ... .*.\  .. ..*.  .*\ .***\ *..*** ...* .  .* *** *..* ..  *.* .\.\..***...\. *** * .. \**  \.  *.*..*.*....\ *..   .  *\. \..*.... \.\..\  .*\ \* .. ...    *  *..**.\ .* *. .** *\*.*\*..  # \##    #
#..*..  .\*\**\  . .. . ..*  ... ** *.. ***.*. \*\*....**... .  \ *.*.    .\* \*\.. .* * ....* . ...\**. .  *\ \* **.\* * \..\.*.** *  **\*..\. * .*... . .  .. *..   .*.\.\*.***\*\*..* . ...  . . . .. .... . * .\*...  ..*.\ . .. *  ...\*.   \  .   *.\. **\   #.***L   #
#*\.*  \ ........ . ..*.*\...\*  \.\.  .. ...\  *.\   ..* ..*..  .. .  * *  *\..     **. *. * ****.**...\..*...  .. \ * **** ..* . ** \.*\..\*..\.\.\. .\..\..\..* ** .* **.\ ..*..  . *. ... **\. . * *. \.\.  ...\ * *  \.\  .\.***\... * . *.*. .. . * .*.. *  ..*.##    #
#. \*\* *    ..** .\. \** .\*\.  ..** .. .****. *. .. . .  .*. . .*   . .  . *  ....\*\ ***.\**..* .  *. *.  \  *.\.**. .\. .*\....*. . .\.**.. * .   \  *...\  * \.   .\.....\ \..\ \...\.\ *.*. . .\\ . * . .**.. *. * ..\..  ***... \*.\...***\* .\ .*.* .* . .\ # ##    #
#\\.**. .  * *.... ....  .* \...  \...*.\*  .\ ***\..*..*\ ..*.*\*..\*\*\ ..... .\.  .**\..\**\* \  . .. .\   .\* .**\.\  *.  *.\ *.*.*.. ... * *.* \*. *.\*. *.* **.*. *.\*. *. \..*. **.\. ..\.\    ..\*.* .\*..\ .  \ .\* *\* *. .. .* . \...  *\..   * *..\ ** **..*#   #
#\  ....\  .* *  .  . .*  . ...  *..\ . *. .  \.\***\.. *..\... . .*. *. .\*...   \.. ****.*.. \ *  * .* **.\  **  .\*... .. \..\ **.*. ..* ** .\ .  \*.*..  . .\*....\*\*.. *. ..  .*... .*.*\ *..*  .*  \.*.*\.* . .*.\.** .\. .    **. *\ ....* . ....  .  * . #.. ##    #
#..*.. *. .\**.  * ... \ *.\  ..* .\*. * .*\.* .*...  ...\    ... .   *\ ... \  *.. *... **\  \. \ .*.*. ... .*..***.*..*..* *\ ......*.\**.\. ... \ \ *.\...   .\.\ \..*.** ..   . .**\.\*.* . ..*..*\ ...\ ** *.  . .  ***** .. .\* .\  . .  .\..****\. * ..**.\.\* #     #
#.\.*.\.. \..* .*.. ...*.. ..*.*.\*\.*.\***.\*.*** \.. *. .*\ .   * **. *  .\*.\ ...*\.* ....*.*....**... * \.** .*.\.  *\\. ...* \.. .* .** \...*... .  ..\ . *.**...\ ****\.\*  *. . . .* *. *  .\ .. .\**...*  .* * ....*.*  \  *...  \  ..*.  *...***.#  .*..\.* \ #    #
#.. .**. \* .\. ..\ .. ....  * .*.. \ **. .\ \.*...  .*..**\.*    .\ . **\..   *.  \*.\. *.. \.\.. ..*..*.*... .\.. ...** .* *\\ .  *. **..**. *\.  *.. ..\.  *. ***.   ** .*.. **..\*  ** *.*. .   **. *. *   .\ *.\** *.*... *.\..*\  *.\  .*.   .*..\.** *... . .#.#     #
#.\ * \ . . . .   . .***\*   ..... *. *.*. * ...*   .\. \.*  . \...*  \  *\*..\. .\ .** .***...     ..*\... \ *\. .  . .* \.\\ *.\. *. \.* .*  *.\ *..*..\*. ...*..\..\.*\.\.*..*. . *.  . .*  \.\*...**.. . * \ ....\. .*...\ .. \ ...   .  *\.\ **\   *\... \\ \ *\ #     #
#  *.\.. .* . * .* * ..... . \  ..***\..*  .\. \*.\ .**. **\\ .\ * . *..**.. *\  .*\.  \   .**.. .*. .\. * ...* *.* ..****.\..\.*.\ \....*  \.     ......*. *\* *  .. *\.*. *. .\ \* * . ..*.\*. *\*\  * .\. .  \\.. .    *\** .\\.   \. ** \.  .... .\ ...*\*.* #.#*#      #
#...  .  \*\  .\*.***  ..* \  \ *\**\.  ... ..\..\.**... \ ... \ \* *..*.\..*\.. .**. * *  *\.**....  *.*.**.\..... ...... **..**.* *.*... .\  *.*.**\ **. \*.. *\ .*.* .\ .** *\...\. *\.\..*\..\ *\  * ....\\.. *****.... \. .* *  .*..**....*\  *.\ .*....#\ ## ##       #
#*\**. *. \* .\ . .*..* \ .. .... * ...* .. . *...   .*\*.**\  ......\* . \.*. \  ..\. ..*.. *..  .\ .\ .  *..*. *\. .\* ...** .. . ...\* .*. .\\.*  . \.  .*   .*\..  ... *.*.* ..*   ..  \ \..\ *.**...**.**. * ...\****\. *. **.*\*.\  . \***  *.\ .* ..  ..*.##         #
# .*....\... *... **\.*  *******  .  \**.*.\ ***  .   .  .*.... \  *  .* \. *.  .*    .*\..  .*  .*   ** ..   \**\. . *.*. **.\* *.\.\ .\  .\. *  .\.  ...  . **.*    \ \*\*.. .\  *.* .  ... * . \* **.*..**.*....  *.\\..  . .... *..   . .*\... .***. .  . ..#           #
# *. .  .\*\*\.*..*....*\....*. .* * .. *\*.*.*..*.  .*\ .. *.  \ **\*   ***. .*..\*.*...... ...\...\..*** . \..\...*.\ ..\.*\ * ...* **. \  . ... .\*. ..... .*..*  . ..*..\ .*.. .*   * *.\  *  .*\***\.\ *\ .\. . . ..*..  .*   .... .  * .*.*. \** .#.*.#\. ##          #
# **\... . .*. \. \ .\\.* *.\*  .*\* .**....*..*... .****.\  \.\.*.\.\ *  ..\  .*..*..***\ . \.*. ***...*. * . *  * . ..\  \ . *..\ ..**\  .. . ...**..   * \.*\ \..  *. \ \ ...\.. **.  .. *  \  ...\.*. *.* .*. \ .* \\\ . .\. *  *.\*.  \..* ...... .. ...* \# #         #
# *.. \*\ .  .*.....\ .**... *..   . \.. . . . . . ...  *. .  **....*. ..\..*\ \** .\  .***.\.*.**\** *.**.*\*\..*\  * .. *. .*\..  \....\*   .  *..*. .* \\**\. . . .    *****\ ..**.. . .  . *..\ **..  .\. *.*..**.  ..\\ ****. *.\ .  \    .*..  . *\**..\.. .*#        #
#\*\*\*...**\ .*.\ .*.*.*\.. .\***\** \ * * * *\. \*. . *.*.\.* .* .*\\.*.\ \.*..** ..\...*.\** *...*...\ **.*.\ *\\*\  \*\.*  . \ \ .*..*. \*\ *.*\ * .\ . \*.**\*.*... **..*.* .\.*\*.. \  \ *\   \. \ \ ***  .\ .\\   *.*\*..\..\ .\. ..  . .*...*#.###*\.#* #\#         #
#############################################################################################################################################################################################################################################################################