#########################################################
#                            # #                        #
#                           ##.\#  #               #### #
#                          #. .#  #*#        # #  # *  ##
#                    #    ## *.## #.##      #\# ##   .# #
#             ##    #\## #* ...*.##\#.#    ##* ...* . # #
#           ##\\#  #\.**###.\#\. #. #\#  ##\#.  *\. *\*##
#         ## ..*\#  # #*#.**.\  \.\. *# #\***\... **.*# #
#        #\#. .  \#  #* #.  ..*** ..\####.#.. * . #   .##
#       #\.#   ###   #\.   ..  *.  .. .**.*....  .  *.\.#
#   #####.*###.   # #**. \..........\*  ..*   .* *\ ..  #
#  #. *.##*#*. #\.## ###....*\.*   .*.  .*...\*\  .. * .#
###.  . #.\**.   ##.#\# #*....*#*.  \    * . *\.\. * . *#
# *  #.* .*.*.*..##*\* .*.\ .  ..* \. \... . * *  \* \ .#
#\*.#* .*\*.* .* .L .#* .\ * *. ..  *\ ..\..*. .*\ . . *#
##\ .\   .**..   *\.**.\***. ** .\..\.  \ \*.* ..*..* .*#
#..##.. *\..... #*#.#\..*... **.  .  . . \ . ** .\  . *.#
# .# ...#.*\ .**#*.* ..\.* **.\ #.**  **..  ... * ..*.. #
#* . ** \ . \ ...*...  * .  *  #   ..*..*.  .* ..    .*.#
#.\. .* \*. .  * \*   \** . *   **.... .*.. ..* \.*.****#
#. ..\# . *  *.* .. ... \\. \\ .*\..*.**...  .*..*..*...#
#.*    *. .  . .\.....** .* .\* \..**.\.\*..* .\ \. ...\#
#.*.\*\#. *..***  \.  *. .\.\     *\...*.*..*\ .* ..   *#
#... * .\.. .\... .*..\.. ..*..**..*\.**..* .   . \. ..*#
#***. .**.  \ .* .** *.*. ...\*.***.*.**\ .  .\    **. *#
#*.\.  ..*   . .\ .\.\ ..** *.*..*\\.\*.. *  \   *\*....#
#  *..  *** \.... ..*.\**.\*\*.\* ..*.* .*. ..* *. ... .#
# *. ****..* \.*\ *\*\. .  *\.* ....***. .\ *...* .*.\ *#
# .*.* .*..\    . ...*\..**\.** .* .\.* ..*..\ .. **. \.#
#.*... \.\.* . .  \....  .** .....*\   . \** .. .* ** ..#
# .  .\.. \\* .\.*.**....*. ** .* ..**.\ ***.*  ..\.*\.\#
#.*   ..*.. ..  *.\. .*. . *. *.\. \..*  .\. .*.\*...  .#
#* ***   *\... *..\*  \..\..* \. * .  . .\. * .*.\..*\.\#
#\.\.. ...  ..**. .* ..\.  .\. . .  \.\ ..\ .   . . .*. #
#\ * ..*.*. ****. ..*\.\**  .*.\.. .....\ *..   *. * *\.#
#.. . \. . **.\. ..*..\..* *. *.\ * *\ \..\  . ...*\  **#
#. .   .\.....  .*.    *.\ ** *  .. . ..*.. *. \ ... ..\#
#*  .. ....***..  . *  *  *\. .       .*.\ *.\*.* **.  .#
#.\..\ ** \..\.*.\    ** *... *..... . .. \. .**..\.** .#
#.   *.\*.\.. *.*.. **.  \ *...*..*. .*.\*.*   *......\ #
#\*.  .*. ..\*\***\*\.**.. *   *. .*\    \ . \ **. .....#
#..*\*. . . ....**.*...* .**  \* ...  * *..... * . ..*\ #
#...*\\* .* .  **.\. \ *\ *  *\  ..\.* *\*...*\..\   *\.#
#*\ . \*. .. *\ .* \.. . .\ ... * *  . .*...*..  *.... .#
#\ * *.   .  *.\ ..  \*  \**..\*\ *\  .*\. \\ \ ...* . .#
#* **.*..  .\*. * ..  ..\ ..***\.\...\.\.*. * ..*....*.*#
#* ..\  .\ . *...\*  *..\ \.. .\  ....\ ..**. \..**..*\.#
#*.  . *..\**.\..\.*.\*..*..    *  * . * .*.. .** * .\. #
#.*.*\.*..*.\.*...*.*   \.   .*\.  * *... ..\  * *  ** *#
#.... .*  *\  \.\.* \ .\.*.  *.* ..... \.   \   ..  *.* #
#** \ \. .* ...  ..\. . *.* **..  *\*\* .***..\  ..\\ \.#
#.. .. . .*  .*  ... ... ..*\...\.**..*....**..       ..#
# *.*\ .. \.\    ..\ .*\.* .* .\ *\....**..*.....* **.*.#
#. .\*..   . \.   ..*....*  \.\. .** .\*.**..**. \ ...*.#
#*   .**** \.  ..\  *.   . \.   * .\.\ .\.*..\. .*.\.\. #
#.   **.\ ..  .*.  \* *\ *\  .     .. .\..\  . *..* \* *#
# .\*. .. * .  ..\...*.  ***\  . . \.*..   *..**. . ...*#
# .** . *..  *.\..**\. .*\ . *.\ ..  .*\. *.\....  .***.#
#. * .  .\  . . \*..*..   .....**.. ..\...\..**\.\ **...#
#**\..   .......*..\.\...*.  . .. .*  *\ ..* **. \ *\  \#
#.*  ** . *. .*\*.* *. . .  ...*..** ..    .   * . * ** #
#.  .. .*......*. . *......\.\ .\*.*** *\ \ **..\  \  .\#
#.. ..*.* ** * \..\.. ..*.**  . .\.\*.*. *.*.**.*   .   #
# . \.*\.. *\  \.  *\   *\.*\ ** ** ... \.*.\\ *\. .*.\.#
#** *... *.. .....\.** ..**.  ..*.* \*..  .  \ .***.*  .#
#* .....*. *  .*  ...*. ..   . \..* ..*.. .\..*\**\.. *.#
#   *.\ *.*..  .**. ..***..\* .  .* * ** **\*\.*..  * \ #
#.... ...\*.. \...\ *\*.. .*\ *** *\.* *\** *.\.\. .\ ..#
# *  . .*... . \ .\*.** \  .\ \.. .* *\..\. \ .\  ** .**#
# . \ \ *.* .. .\  .  \ ... \ ..  .\...*\ . ..  \*..  ..#
#..*   . *.\ *.*.\   \  \.*.*..\*. \ . \..* . .  ...   \#
#.\.. .  *. *. \\ * * \*....    .... .   .. * \..**.\  *#
#     * ..  .\...**.*..**\. *.  \*. **  \ **...  .\*.*.*#
#*\.\ \.  .*\*.* .* \\*.\.**\** .*..... ..**.   . *\*.\.#
#.***   \. *....\.... *\. .**.\. ... *.... . ..** *.\*..#
#. ..   . ..  \* *..*..*\ *. .\...*\ .* .. . . *...*    #
#  \. .*\ ...*.. .  \*.... *.... .*.*.\ .***\ ..\ .*..*.#
#\\.*..* *\ .  * \.***. .* .\  \..\ .*.. **\ . . .*... *#
#.... *..  ...\**.**\.*. \ . \*..... .\. .*  . .  *.\*..#
# *\*..  * *\.*.*  .*\*..  \  \. ...*  \ .*.  **\ .. ..*#
#*. .*** .*. *..  .*.*. .* *.  \. \ ..*. ..**.*....   ..#
#.*   .\ *\.*  \..** .*...*\..\     ..***  .*.. **   *.*#
#\.*.**    *....* *.\ . \..* .* *\***  *.*\*..\ .*...\.*#
#..\. .. .... .*.\*\ . *... \. ** *.  .**...* ....*\  \.#
#\*   \*.* *. *. *.*\*....*. \* * .* . .\.    *..\ *.  *#
#.**  .**.\* ..\.\*....\ * . .. \ ... .*.**\ ***\ *\.\. #
#.*... ** *.. \    *. \. .*\ .**  . .\ .**.. **. ..  . *#
#..* *.*..**  .\..\* *.  \  * *   \..*\ *..* \**  \.*   #
#\ . \**** .** *..*. ..* . .. *\.\.  \....*. .*..*.*.\\.#
# ..\.*\*.  *\..**.. *...\*  *..**... * **.* .**.*.  ...#
#\. .\. .\.\...  .\*\.  . .\..\.\*   \. ...\*. . .\..\..#
#*\.*..*..  *.\......**  \ ....  .\..\    . . \.*\** .. #
#. .** \  *..\.\     .. * \  .*.. * ..*.. *..\. ........#
#.\.. \*. . . ..* **.. **  *.\. . .\.*\ \..  *. ...*  \.#
#.*  \..  ...\* .*.\. ..\ .. . *. *  *. .\\.**.\...     #
# * ...***.\ .*  .\** . . \*. \...* *.*..**\*\...\..\* .#
#\* . .*..***.*..   \  ..\...\  \. \.\. \.*     *.*. *.*#
#.* .\ .\...\   .. ...*.\... .... *.   .  .. *\*\ *\ **\#
#. . *.***. .* ..\.  ... . *  * . . ..*..* \*\*** *  \. #
#..  ...*..  . .. ..\ \*  *.*\.*\..\  .  . .. .**..* .\*#
#..   **.*..    ..*. *.\ \....* *\   * *.\  .   \ *\....#
#.  ******.\ .\.  .\.\ ...* *\...\*.*. .  . ****... ..\.#
#. *....**... .  ..\ * .\ * \*. \.*.*\ \*. .. ..\ ... * #
#* *. \*\.  **.\ *  .. .*...*\. \ .\\.. .  \.** .\ *\..*#
#\ * * .* *..* *.\   *...   .* *.\ . .. *. .... *  .*.\*#
# *\..* \ ..\. ..  ....\....  . \ * *.*...** \\ . *...*.#
#.... .*. ...*..****....   .*.  ..   .*.\ .* .\*.\**. . #
#\.*** .***.\.  ....  ..\ . . .** ... *    ****.* ... ..#
#. .\ .\..*\ ...\..\*\*\.. ..\*.. *.\ .\ ..\*.**\*. ..  #
#*. \ *. .. * ..    ...* ** *....*. ... *\ . *\.*..  \. #
#. ...  *.... .**... \..\.*...*\** *  \. .\  ..   ..* * #
#.. *. * *\. .***..\* * *.....*... *  .*. ..  *.*\*\... #
#*  **....**. .\**... ... ..\ ....**\..*... **. ** . . .#
#** . * . . .* .*..*. \*. .**.\*  \... ***  **. \.  .   #
#.*. .  **\ \. **    .\* * *.  *  . *.\* . ..\..\... *\.#
#.* * ...*   **.. . ..\. ...*.\ \.\ * *. ..\.*. . . .*.*#
# .*  *.   ** . ..  *.*. ..* *... .\.. .  .. .\ **  *.*.#
#*\. **   ...*.*. \.*...   . ***. **. \ \.\.  . *\. . .\#
#.... ..\. . .* *.*.. \*  . .*.. *..  . *.**. .\  .**\ .#
# * **  ... . *.*..*   . . * . . *   *...\\. .\.*. *..*.#
#.* *..  .\..  *.... .. *  \   *. ..*\.  .*  . .** .. \ #
#*.\ *   .*.  **..*.\...*..  \ .*. ....  .*. **\.* \.  .#
#*..  .* \*  ..*\..  . \..... \ .\ .\  .   * *.\...*.*.\#
#.* \  *\. *. ***...*\ .. .\  ....\. * \.. ......*  ***.#
#*.... **.** ..\..\\.      .**. \ .\ *. . .. ***\. \.. .#
#. * \ .. ... .*   . ...  . .* ***\. ..\ .  *\.*.**. ...#
#  \  .*.  *\  .*.. .   *  ***\*\. \ *  . ..*. ..\. .*. #
#* .  .*.\. . \. *.*\ \.\ .. .\\\    *\  .. \   .\....* #
#**. **.\.. \. .\*..\**\..\*.. *\   .\ *..* ..\.*..*.*. #
#.  \ * ****.* . . ** ...\*.\**.\..*...\ ..** *\..*   **#
# \ .. \. .*. .   \.. . .*.\ .\* .****\  .\*. ** * \* .*#
#\.*\....  .\ . *. .  ...* . .*   *...***....\.. *  \* .#
#\*..* *\**\** *...  ..\.*. \*. \ \\ . .* ..\ .*\.. *. .#
#.\*\... ..\. .*.  ** **.*.*.\. ..*..*. .\**   .**.\.\ .#
# *.  \.\.*   \.    ..\..*.. .\   *.\.*\  \...****    . #
# *\.    *. *.**.*.*..\ ** *\ .*. \. ...\*.*  ..   \. ..#
#...** ..\  ..*. .*.. .    **...  ...*....  .. .\\..\ \ #
#* *\*  *.  \ *. *. *. *  \..* . \ .*. **.. \... \* *..\#
#..\ * .  \..*.***\**......* .. \ *.*... . *  \.*\**.  *#
#\ ... *   ..*  .* .*** \ .* *. ***.*.*.. ...*.\. *  *\.#
#  .*R .\. . \ ..\\*..\ *.. .\..***....  .*\.\ .. *...*.#
#\.\.*.\ *. . .*. *..**..*.* **..\\ . .  ..**.   .* \.. #
#  ....*\.*..*  ...*.\. * ....  *\.*   ... .. . **.\ *\ #
#..\..\. * \ **. *\. .*..*\.**. \ **\.\  .\.\  *...*.*..#
#\ ..*.. *... \ .\ . ... ...**\*. .*.....*..   *..\  \..#
#.... \ \    *... .*    \ *  \  .  *\*\.\*. \. . *..  .*#
# . **    * .*..** ..**  *.. .*.. ...\* **\.*. ..* * .**#
#.. *\.\. * \*. .\.*\... ..\  ..  . . *....*.\.. . .....#
#\**  . * ....\* ... .*... . .**  *.* ..** *.   *..     #
# **  .** .... * *. .**.. \  *..*.*.* \**  ..**\. .\ .\.#
#\.* ***. .*  \.\*\  **.*.  ..*.* *.**.. *  .\...  ** * #
#.. \ \* .*.\*.....* . .. .. **.\ . **.\.* ..*.\ *.*. . #
#.   .. . ..*..*.* *. .*  .. ..\. *...\.*\* ..  .\ ..* .#
#  . \\*\ *\ *.*..* *.*... * ...  ..*.\ ***..   ..*\.. *#
#\....\..*..  \. \.\***\  .. \  .*.\*\..\..* **\ *.**.*.#
#.*.*.\* . *  *...** ..  *. \... ..*.* .*... *. *. ..\.\#
#  .*.*. .*.**.*... \.. .. ..***. .*\. .* .* .  .*\   .*#
#\***\.. \. .\*\*.*... .   . .\.* .... **  \ \* ..*.**..#
# *.*.*  .\**.. ..  \.. ..\.   .* \\**.\...  .*\ ..*..* #
#**..** .. .  .**\*\.* *  ....\.***\.\\. \...*....\.* . #
#*.\ *. **.  *  .*. .**..* *.\* . . ... *.*  \ *. ..*.\*#
#\*..\ ***  *\ ***.\\.. . \.*\*\ .. .  .....  ... . . *.#
#..*   . .\ ..\.\..  .*\ ....\** **  .*. *..** *\..\.\..#
#\..\*   ** **..  *.  .*\    .\  *. ***. \   *\ .  * .  #
#   ......\... .. .*\* .  \..  .*\*  \..   \\*.**.***. .#
#  . *.***.. \\ .  *.  \.*.\* . ..*  ...**. \*\*  ... .*#
# ...* ..\ *..* ...\*.  ..\  \.*.\  * .\*.* .*.***\ .**.#
#.  * .*...* **  . .\.   *\.*. .  .....*.  ..*....*. .\*#
#  .\*\..  *.. \.. *. .*.\*.* *.*  .   . .*.\. \  . \\\ #
# \..*  **....\ *\.  .*   . .\. ..*. \**\ .. ....   \ .*#
# ...  *\ **. \ .*  .*.* .. .*\.\      \..    *** *   *.#
#     ...*.  . . .. \*..... ..    *..  **.  ***\. . .*\.#
#\   .**...*. ..  .    .**.* .\ *\\\  .... *. ....* \..*#
# . . ....\. .*... * *. \.\ *. *\** .*\.\**.. ***\.     #
#*. .\ . *.\ *\*.\ . \... ***\.  ....\*  ...\..\\**.*.*.#
#.\. ..*..**.**.\. *.\* ....*... \  . .\. ..*\. **.\**. #
#\..\**.\..*.*... \..*.  *.. \... *  .*.   .    .** **. #
# .\ ..\ *\....\**.\*.\*... . .  .\ . . ..* * ...**.**..#
#\...** .   *.***\* .\ .*  \  ...\ ..\*.*\.*\ .\ .**. *.#
# \ ..*  .  \.\.. .  .    *   *... .. .\.* **.\ ****  ..#
#*..\\*. .*\ \*.* \.\ .*  *.* . .   ..\*...**.**.\.  *  #
#.*\.\... *.\ * ...*. . ..  . *  \* .\*** ..\\.*.. **.  #
# ...*..*..   .....** . . . **.\.*..\*..* . *...**.*\ .*#
# ..*. *..*  \ ..**\* .. ..   .*\**.*. ...* . \ ..*\ * .#
#***.\*. *  \*  *\... .. ..    . ....*. . ..**. *.  ..* #
#.... *.*.*..* *..*. . .. ..  .* ...\...*   ** .. .  .\*#
#.   **.\.*\**\. ** .\ * ....\\*.\*.. . ..  *.* *\..\*\.#
#* * .\*. .. **\*..  .*.\  \. . . .*    . \ .  ..  .* \*#
#\*. **\ * .. ..\..*  ..*.*..*\  . ..\.*\ . *.......\ \.#
#*.\ ...**\. *  ..  **. . .. ****\\**.*. . .*\ .\..**. *#
#*...*.*.\*  . \  .\.. *. *  ..\\\*\* * .  ..** \*  .. .#
#* ..*.\\ ...* ..   \..\**  *  * *. . .\. ....\*..  *..*#
#*\\*..*...*\*   . . ...**.*   *\*\.*\.***\.  **   .. \*#
#.  .... .. *           .**\ \..*\ .. *\.   .*.*.**.\...#
#..    .*  .**.\  ..  . .\***.. . *\*\**..  . .***.\..\.#
#  *... *.... .**.**  *.\*..... *. .. \.\*  *. \\* * . .#
# \ .\. ** \**.*. .* .*  ..\..*.. .    ..* *  \ . **\ **#
#. \ ...\*..*.** . ..\..  .***.**   . * \\.  *.  **.*\*\#
#  .. \**\*....  . .* *  *\*.\.*.\\*    ...\ \*.*...... #
#....  .. .*\..**...* . ..\..\\***..   \. * . * \***.\**#
#..\* . *\ ** ...  .\ \.   \*.*....  \*.  **... ..*  *. #
#*...***.  .*.*.. .*\*\*\\*. ..**.***** \ ..\.\*..* *.*\#
#*.... .. .\..  * \.***... ..*...\.\ .*. *.*\* *.*.*.\**#
#..  ..*.**.*\*\. .*.*..** * .\ . ..* **.\ *.*.*..*.. ..#
#.. * ..**. .  .... .\.. ..\ \*.\*   *.*\  *.. *.*.\   *#
#\.**\ . .*\..\ \ . *. ..... \.\  .* ..\.\** *..*. *.* .#
#..**.  \ * ....  * . * .\ ... \...\ \ *...\.* .  \.*.**#
#\ .   .. \***.*  **..*  ..\. *..\ .  \*  * \*.\. . .*..#
#.  \*\ .*** .\. *... .* * *.  .. . * ...\..*.  * *\....#
#*.*\. *\*\*. **** *  **.* ...** ..*..  \. *.\*\. . ... #
#  .   **. .* *.\.*.\  *\*  \*... .* *. .*...*. .* .\ .\#
#.   \...  .\ .*  \* *  .... \*. ..  .* \.***\.* \  .\ *#
#  \ . ** *... .*..**.*\\.. *.. ..  .*  .* *\ .\*.. .** #
#\ .\*\\...*..  * ***\.*\...\.\* . .\*  . . *\*.***  *..#
#*..* .\.. .   .* ***  *..* *..  .\ ..*\ .  ..*...*.* * #
#*.** \.*   .\**\...\ .\. *\..\ \.*...\*.. \ *\. \\ .*.\#
#\..*..  \.. .**.  **  *\.  .....*\*\ *..   \* .. ***. *#
# **.\..* *..**..*.*.*..*.*....  .*.. \*.\ ...* .  .. *.#
#*.*.*\ ****\..*...\...\*... *\ .*.\ \ . *\*\*\ *.* ..\*#
#*...\ . .**. ..  .    ..****.  .. .   * . *.*  . . \ .*#
#\.* ..  .. .\ .\ ..  ..\.\....* \ * * ..  . \*  . .*\ .#
# \ * *   . . ....  .*\ .\. \ **..*.  **.*.* .. . .\ . .#
#  ..\. .** \.*    . \ .\.. *. . * .. ** *. \  .\.... \*#
#.   \ . .*.... *.\ *.*.*.\. \. **. * * ** *.\ *.   . ..#
#  .   * *.**  \. *.*\ .  .   . ..\ .\.*\*. \ \\  \. .\ #
# .*.*.*\ . *\..*\**. ** \   *\\* *    ...*.*\...  . .*.#
#\..*.** \ . .. *.\..*.. . *..*** *\ *.*\\. \.*\.  *****#
#. *\****.* .* . \ ....    .\.... *\.\****\*.\**  *..*..#
#. ***.\. ..\.   **   *   *...\.  . ..\...  **\.***  ..*#
#. \ .*. * *.* \ .* .*. \..***. .*\  **.\.. \*. . \  *\*#
#. ** .. \ \ .*. * .\.. **  \. . .. \.. . *\. .*. . ....#
#\  . *...  * . *  \*  .  \ .*  \.\  .   *.** *...   *.*#
#***....\.\..   . \.*..  *....  * .\*. .  .** \    **.**#
#. * . .* **. .*.. \* ** .\*.  .  .   .*\.** \ \*. .. *.#
#.** .*..... \.....\*.\.\  \   *   * \ . *..* * **..\\. #
#\.   . *\.\*  .. *..*..*  .\. .*\*** .*... . ..**   .\ #
#\  *\ . .** . ..\.*.*.. .**** *.*.*. *..\*  \ .*. ...**#
#** ...   ..\*.\ . **.\ ...*.*\ \. **. .**. ..\. . .. ..#
# . .  .* *\  .\. \.\ .  \ .*.   .... *\.... . * \. *. \#
#\    . ....*\.*.*.\. .*  . ...\. *\ ...  .**\..    .. .#
#. \* \**. *.. * .\*  ..   ..*.\..  .*.\ **..**\. ..\.  #
#  .\*.* **..***\ . *\   *. *..\\*\*.. .*... *.  .. *  .#
#.  *. . **\..**  ..*.\...*.***.\* .*\ ..\\  \*.* ..*\. #
# ***. **.\ \.** \  ... ..* \. \*.  **** .. ... .*. ..\.#
#\.\.....*... *. .....\. ..* .... ...*\  .. \ * .\.\ ..\#
#*. *  **\*...\* .**..   ..\  \*\.  .\. *. ...*   *. ...#
#* * .* .... .** ..*.\*. .*.***.*..\ .\ ..\*\.*\. *..*.\#
#*.\   ..\ * \.\ \.  ..*  ...*...\.. ..\   .\*..  *\ ***#
#.  *.\ .*.* .  . \**.*..\.* *.*.*.*  *..\. *. **.  ...\#
#*  ... * *\.  .   ..\\*.... .. *...\*.\*  .. . . ...\..#
#. *\.\\* *\* . .** \  \ **..* *\.\ *..*.\*.*.* \..  \..#
#########################################################