#################
# \\\\#   *  *  #
#  ##   !!#..@. ####
#*    @.!!####.....#
#\\   \@...........#
#\  # .\@    #  #.########
#\  # ..\@   #  W..   .  #
#\  # .. \@  #   ..   .@ #
#\  # *.. \@    #######\\#
#\  # ###  \@   #     #\\#
### #       \@  #     ##L#
#...#@@@*@@**\@ #
#R ..........!\##
#################

Growth 25
Water 2
