                                             .@......@\*****************************.............                    .     . .                        
                                  ..@***********************************************************\....                                                 
                                ..*******.................*\*************\\**\\\\************************\@.                                          
                              ..*****\.           ..\****@...................@@@@@**************\\\***********.                                       
                              .####.           .*##\....@@*\\\##********#\\*@@...............@@@@@@*\\#@.\######*...                                  
                            .####\         .@*#*@..\*#*@\.............. ......@\\\\\\\\\\\\\\@.........**  .@######@.                                 
                          ..####.       ..\*@..@\#\@\*\**\\*@@@@@@@@*##*.             .......\\\\\\@.          .*####@..                              
                          .####.      .**@..@#*@.\*#\...            .\#\             .***..........@*#*@.        .\###@.                              
                        ..####       .#.  @##..#*\.                   .#.              @#.           ..\#.         \##\                               
                        .####.          .##..##.    .............      #@             .#.               \#         @###.                              
                      ..####.            .  \.  ..#################\.  ..             @#                 *         .###@                              
                    .@#####.                  .###############**######*.              .# ..\\#########*.            @###\..                           
                  ..######*\\\\\..    ...\@. ################\... .@#####.            ..#################..... .......#####\.                         
                ..########******\\.   \###\..#####################\...####       .##*@###################..##\#*\\\\#*..*####.                        
               .######*.  ..*########\....#. .@**\..  .@##. ..@##########\       .###########****.......          ...\#*@.*###.                       
              .####*#@  .\################\..      ..*####.      .@\###@.          .@###*..               ........@@*##.\#.*###                       
            .*###\@#.  .####@@\\\\#..\##################@            .               *##.         .@.   .\##########\.*# .#.###                       
            .###. @#  .###*@@\\\.###.    .@*########*..                              *##\.       .####*#####\....\###.@#  @####                       
            .##*  @#  ###*@@....######@..                      .. .......            .#####*.     .######## .##.   .. .#. *####                       
            .*#*  @#  ###@@***#####*######*..         .........##*#######              .######@.            \##.      @#. #.###                       
            ..##. .#  ###******####   .*######*\.     *\\\\\\\\..###@........             \#####.           *###*  .\#*. \#####.                      
             .\#\ .#. .###......###*      .*#######*\..         .###. #########.         @########**@      .#####.  ...\######..                      
               ###.\#. @###     \####\.      #############*@.   .####.*##.@\##*.  .@   .####. ..   .\#\  .######## *#*@..####.                        
               .###..##*..      .\#######\.  ###.  ..\*##########*.\\             ########.           .*##########..    ####..                        
              ..###.#@..@#@       .##############*.   2   ****###########*....    .####*.       ...*#######.######.    ####.                          
                ..#..###\          .####..#########*@@.   \\\.*##..*##################################*..###.#####.   .###..                          
                 ...#..#*.   A       *###.  .#############..\C*#*       ....####\*############**\@###.   ### .####.   @##\                            
                    ...###.           .####. .###@##############\.          @##.      .###        ####  \#########.   @##@                            
                      ..###.            ####*#### B ..\###############*@@@@@####@@@@@@@###@@@@@\##################.   @##@                            
                      . ..##.            .######. 1    \...\######################################################.   @##@                            
                         #.##.             .#####.  \\\\\\\\###..@\###############################################.   @##@                            
                         ..###@              .#####\\\\\\\.####     ....@########################################\    @##@                            
                          .\####@              .@######\\\###*            ###...@\\\\\##############\####.###*###     @##@                            
                          ...#####@  ...   ....   .@#########.            ###        .###.   .###\ .#### #######.     @##@                            
                              .\####\.\##\...***@..  ..########\@...     .###        \##.    *###  *###@@*#####.      @##@                            
                                .@#####\..##*@..@@#*@.R  ..\*###########**###@.......###@..@####*###########*.        @###..                          
                                  .#######\..@*#\@..@*#\\..   ...@#####################################@...           .###@                           
                                    ...######*...\\\*@...\#**@@..      ............................        .#.    .    ####                           
                                        ..\######*....\#*\@...\\#*@@...     \******************@        ..##.    .#    .###                           
                                            .@#########...@\*#\\*@\\###\\\@..........................@*##\.     .\#    .###                           
                                               ..@\########@......@@\*###\##\\@......@\\\\\\\\\\\\\*....    .@*##..    .###                           
                                                    ..@*######*..       ...@\@\\**\\\\\\\\@...............\*##..       *###.                          
                                                     .   ..*######*..             ........@@@@@@@@@@@@@@@@@.         .\###..                          
                                                             .@#######*@.@@..                                       .####.                            
                                                                 .@*###########**.....                           .@#####.                             
                                                                     ..@@@@#############*.....             ....#######...                             
                                                                               .\\\ ...  WW\\WW\\WW\\W.. .. .\.  .                                    
L                                                                                        @@**##############***.  .                                     
