###############################################
#****................#..1...\\\\\\\B..#   @   #
#R.......############################## ..### #
#.. ..................................# .***. #
#.. ........       \            ......# ..\.. #
#.. .@. ....**.*...#....... ..........#       #
#.. ... ....\\\\...#.A..... ..........#   #...#
#.. .@. ....\ .....#..*\\\.    *  \\..#   #...#
#.. ... ....\......#..* ... ..........#   #...#
#.. ... ....\......#### ##. ..........#   #...#
#.. ... ...........#L.# #...........**#   #...#
#..\\\\\...........#...\#...........\\#   #...#
########### ############## ############   #...#
#...*.................................@\\\#...#
#....*..................        ......#####...#
#... .*....*.............. ..... .....#\ .....#
#....*2*........########.. ..... .....#####...#
#...*...*.......#\\\#..... ...*.......#**#    #
#.....\\\.......#\\\#....**..***......#\\#  # #
#....    .......#\\\#*................# ##### #
#...............#\\\#*...**...*.......#  # #  #
#...............#.....................#. ..#  #
######       ############## ### #######. # #  #
#\\\\\\\\\\\\\\\\\\C\\\\\\\\\\\\\\\\\\*\ # 3  #
###############################################

Trampoline A targets 1
Trampoline B targets 2
Trampoline C targets 3
